bedrooms,bathrooms,sqft_living,sqft_lot,floors,waterfront,view,condition,grade,sqft_above,sqft_basement,yr_built,yr_renovated,zipcode,lat,long,sqft_living15,sqft_lot15,price,day_bought,month_bought,year_bought,yr_diff_renovated,yr_diff_bought,sqrt_diff,sqrt_diff_15,yr_renovated_binary,basement_binary,zip_binary
3,1.0,1180,5650,1.0,0,0,3,7,1180,0,1955,0,98178,47.5112,-122.257,1340,5650,221900,13,10,2014,0,59,4470,4310,0,0,1
3,2.25,2570,7242,2.0,0,0,3,7,2170,400,1951,1991,98125,47.721,-122.319,1690,7639,538000,9,12,2014,40,63,4672,5949,1,1,1
2,1.0,770,10000,1.0,0,0,3,6,770,0,1933,0,98028,47.7379,-122.233,2720,8062,180000,25,2,2015,0,82,9230,5342,0,0,0
4,3.0,1960,5000,1.0,0,0,5,7,1050,910,1965,0,98136,47.5208,-122.393,1360,5000,604000,9,12,2014,0,49,3040,3640,0,1,1
3,2.0,1680,8080,1.0,0,0,3,8,1680,0,1987,0,98074,47.6168,-122.045,1800,7503,510000,18,2,2015,0,28,6400,5703,0,0,0
3,2.25,1715,6819,2.0,0,0,3,7,1715,0,1995,0,98003,47.3097,-122.327,2238,6819,257500,27,6,2014,0,19,5104,4581,0,0,0
3,1.5,1060,9711,1.0,0,0,3,7,1060,0,1963,0,98198,47.4095,-122.315,1650,9711,291850,15,1,2015,0,52,8651,8061,0,0,1
3,1.0,1780,7470,1.0,0,0,3,7,1050,730,1960,0,98146,47.5123,-122.337,1780,8113,229500,15,4,2015,0,55,5690,6333,0,1,1
3,2.5,1890,6560,2.0,0,0,3,7,1890,0,2003,0,98038,47.3684,-122.031,2390,7570,323000,12,3,2015,0,12,4670,5180,0,0,0
3,2.5,3560,9796,1.0,0,0,3,8,1860,1700,1965,0,98007,47.6007,-122.145,2210,8925,662500,3,4,2015,0,50,6236,6715,0,1,0
2,1.0,1160,6000,1.0,0,0,4,7,860,300,1942,0,98115,47.69,-122.292,1330,6000,468000,27,5,2014,0,72,4840,4670,0,1,1
3,1.75,1370,9680,1.0,0,0,4,7,1370,0,1977,0,98074,47.6127,-122.045,1370,10208,400000,7,10,2014,0,37,8310,8838,0,0,0
5,2.0,1810,4850,1.5,0,0,3,7,1810,0,1900,0,98107,47.67,-122.394,1360,4850,530000,12,3,2015,0,115,3040,3490,0,0,1
4,3.0,2950,5000,2.0,0,3,3,9,1980,970,1979,0,98126,47.5714,-122.375,2140,4000,650000,24,1,2015,0,36,2050,1860,0,1,1
3,2.0,1890,14040,2.0,0,0,3,7,1890,0,1994,0,98019,47.7277,-121.962,1890,14018,395000,31,7,2014,0,20,12150,12128,0,0,0
4,1.0,1600,4300,1.5,0,0,4,7,1600,0,1916,0,98103,47.6648,-122.343,1610,4300,485000,29,5,2014,0,98,2700,2690,0,0,1
2,1.0,1200,9850,1.0,0,0,4,7,1200,0,1921,0,98002,47.3089,-122.21,1060,5095,189000,5,12,2014,0,93,8650,4035,0,0,0
3,1.0,1250,9774,1.0,0,0,4,7,1250,0,1969,0,98003,47.3343,-122.306,1280,8850,230000,24,4,2015,0,46,8524,7570,0,0,0
4,1.75,1620,4980,1.0,0,0,4,7,860,760,1947,0,98133,47.7025,-122.341,1400,4980,385000,14,5,2014,0,67,3360,3580,0,1,1
5,2.5,2270,6300,2.0,0,0,3,8,2270,0,1995,0,98092,47.3266,-122.169,2240,7005,285000,3,7,2014,0,19,4030,4765,0,0,0
2,1.5,1070,9643,1.0,0,0,3,7,1070,0,1985,0,98030,47.3533,-122.166,1220,8386,252700,16,5,2014,0,29,8573,7166,0,0,0
3,2.25,2450,6500,2.0,0,0,4,8,2450,0,1985,0,98030,47.3739,-122.172,2200,6865,329000,20,11,2014,0,29,4050,4665,0,0,0
3,2.0,1710,4697,1.5,0,0,5,6,1710,0,1941,0,98002,47.3048,-122.218,1030,4705,233000,3,11,2014,0,73,2987,3675,0,0,0
3,1.75,2450,2691,2.0,0,0,3,8,1750,700,1915,0,98119,47.6386,-122.36,1760,3573,937000,26,6,2014,0,99,241,1813,0,1,1
3,1.0,1400,1581,1.5,0,0,5,8,1400,0,1909,0,98112,47.6221,-122.314,1860,3861,667000,1,12,2014,0,105,181,2001,0,0,1
3,1.75,1520,6380,1.0,0,0,3,7,790,730,1948,0,98115,47.695,-122.304,1520,6235,438000,24,6,2014,0,66,4860,4715,0,1,1
4,2.5,2570,7173,2.0,0,0,3,8,2570,0,2005,0,98052,47.7073,-122.11,2630,6026,719000,2,3,2015,0,10,4603,3396,0,0,0
3,2.5,2320,3980,2.0,0,0,3,8,2320,0,2003,0,98027,47.5391,-122.07,2580,3980,580500,10,11,2014,0,11,1660,1400,0,0,0
2,1.5,1190,1265,3.0,0,0,3,7,1190,0,2005,0,98133,47.7274,-122.357,1390,1756,280000,1,12,2014,0,9,75,366,0,0,1
4,1.75,2330,5000,1.5,0,0,4,7,1510,820,1929,0,98117,47.6823,-122.368,1460,5000,687500,24,6,2014,0,85,2670,3540,0,1,1
3,1.0,1090,3000,1.5,0,0,4,8,1090,0,1929,0,98117,47.6889,-122.375,1570,5080,535000,10,11,2014,0,85,1910,3510,0,0,1
4,2.75,2060,6659,1.0,0,0,3,7,1280,780,1981,0,98058,47.4276,-122.157,2020,8720,322500,3,12,2014,0,33,4599,6700,0,1,0
3,2.5,2300,3060,1.5,0,0,3,8,1510,790,1930,2002,98115,47.6827,-122.31,1590,3264,696000,13,6,2014,72,84,760,1674,1,1,1
4,2.0,2360,6000,2.0,0,0,4,8,2360,0,1904,0,98107,47.6702,-122.362,1730,4700,640000,30,12,2014,0,110,3640,2970,0,0,1
4,1.0,1220,8075,1.0,0,0,2,7,890,330,1969,0,98001,47.3341,-122.282,1290,7800,240000,13,2,2015,0,46,6855,6510,0,1,0
4,2.5,2620,7553,2.0,0,0,3,8,2620,0,1996,0,98056,47.5301,-122.18,2620,11884,605000,20,6,2014,0,18,4933,9264,0,0,0
4,2.5,2570,5520,2.0,0,0,3,9,2570,0,2000,0,98074,47.6145,-122.027,2470,5669,625000,15,7,2014,0,14,2950,3199,0,0,0
5,2.75,3595,5639,2.0,0,0,3,9,3595,0,2014,0,98053,47.6848,-122.016,3625,5639,861990,7,7,2014,0,0,2044,2014,0,0,0
3,1.0,1570,2280,2.0,0,0,3,7,1570,0,1922,0,98119,47.6413,-122.364,1580,2640,685000,28,10,2014,0,92,710,1060,0,0,1
3,1.0,1280,9656,1.0,0,0,4,6,920,360,1959,0,98058,47.4485,-122.175,1340,8808,309000,29,7,2014,0,55,8376,7468,0,1,0
3,2.5,3160,13603,2.0,0,0,3,8,3160,0,2003,0,98019,47.7443,-121.977,3050,9232,488000,18,7,2014,0,11,10443,6182,0,0,0
3,1.0,990,8528,1.0,0,0,3,6,990,0,1966,0,98023,47.3066,-122.371,1228,8840,210490,25,3,2015,0,49,7538,7612,0,0,0
4,2.5,2290,13416,2.0,0,0,4,9,2290,0,1981,0,98007,47.6194,-122.151,2680,13685,785000,16,7,2014,0,33,11126,11005,0,0,0
3,1.75,1250,5963,1.0,0,0,4,7,1250,0,1953,0,98115,47.6796,-122.301,970,5100,450000,28,4,2015,0,62,4713,4130,0,0,1
3,1.0,1190,9199,1.0,0,0,3,7,1190,0,1955,0,98148,47.4258,-122.322,1190,9364,228000,16,9,2014,0,59,8009,8174,0,0,1
5,2.5,3150,9134,1.0,0,0,4,8,1640,1510,1966,0,98056,47.4934,-122.189,1990,9133,345000,17,2,2015,0,49,5984,7143,0,1,0
3,1.75,1410,4080,1.0,0,0,4,7,1000,410,1950,0,98117,47.6808,-122.384,1410,4080,600000,31,12,2014,0,64,2670,2670,0,1,1
2,1.75,1980,8550,1.0,0,0,3,7,990,990,1981,0,98117,47.6989,-122.369,1480,6738,585000,5,2,2015,0,34,6570,5258,0,1,1
5,2.25,2730,6000,1.5,0,0,3,8,2130,600,1927,0,98105,47.6571,-122.281,2730,6000,920000,3,3,2015,0,88,3270,3270,0,1,1
4,2.5,2830,5000,2.0,0,0,3,9,2830,0,1995,0,98105,47.6597,-122.29,1950,5000,885000,12,5,2014,0,19,2170,3050,0,0,1
4,2.5,2250,4495,2.0,0,0,3,7,2250,0,2008,0,98042,47.3663,-122.114,2250,4500,292500,19,8,2014,0,6,2245,2250,0,0,0
3,2.5,2420,4750,2.0,0,0,3,8,2420,0,2003,0,98042,47.3663,-122.122,2690,4750,301000,7,4,2015,0,12,2330,2060,0,0,0
5,3.25,3250,14342,2.0,0,4,4,8,3250,0,1968,0,98008,47.588,-122.116,2960,11044,951000,27,8,2014,0,46,11092,8084,0,0,0
4,3.0,1850,9976,2.0,0,0,3,8,1850,0,1991,0,98059,47.5059,-122.149,2270,8542,430000,23,2,2015,0,24,8126,6272,0,0,0
3,1.75,1260,8400,1.0,0,0,3,7,1260,0,1954,0,98148,47.4366,-122.335,1290,8750,289000,28,8,2014,0,60,7140,7460,0,0,1
3,1.75,2519,8690,2.0,0,0,5,8,2519,0,1973,0,98166,47.4428,-122.344,2500,9500,505000,21,10,2014,0,41,6171,7000,0,0,1
3,1.75,1540,1044,3.0,0,0,3,8,1540,0,2014,0,98115,47.6765,-122.32,1580,3090,549000,7,12,2014,0,0,-496,1510,0,0,1
3,2.25,1660,6000,1.0,0,0,3,7,1110,550,1979,0,98122,47.6113,-122.297,1440,4080,425000,3,6,2014,0,35,4340,2640,0,1,1
3,2.75,2770,3809,1.5,0,0,5,7,1770,1000,1925,0,98144,47.5747,-122.304,1440,4000,317625,20,11,2014,0,89,1039,2560,0,1,1
4,2.5,2720,11049,2.0,0,0,3,10,2720,0,1989,0,98004,47.5815,-122.192,2750,11049,975000,9,9,2014,0,25,8329,8299,0,0,0
4,2.5,2240,4648,2.0,0,0,3,7,2240,0,2005,0,98001,47.3378,-122.257,2221,4557,287000,9,10,2014,0,9,2408,2336,0,0,0
3,1.0,1000,12070,1.0,0,0,4,7,1000,0,1968,0,98042,47.3621,-122.11,1010,12635,204000,25,8,2014,0,46,11070,11625,0,0,0
3,2.0,1260,5612,1.0,0,0,4,7,1260,0,1972,0,98034,47.7362,-122.179,1640,4745,325000,5,1,2015,0,43,4352,3105,0,0,0
4,2.0,2750,7807,1.5,0,0,5,7,2250,500,1916,0,98125,47.7168,-122.287,1510,7807,571000,10,6,2014,0,98,5057,6297,0,1,1
4,2.5,2380,5000,2.0,0,0,3,8,2380,0,2005,0,98038,47.3608,-122.036,2420,5000,360000,10,7,2014,0,9,2620,2580,0,0,0
4,1.75,1760,7300,1.0,0,0,3,7,880,880,1956,0,98008,47.6034,-122.125,1680,7500,380000,13,10,2014,0,58,5540,5820,0,1,0
3,1.0,1040,5060,1.0,0,0,3,7,1040,0,1941,0,98116,47.5636,-122.394,890,5060,480000,20,4,2015,0,74,4020,4170,0,0,1
3,1.0,1410,5060,1.0,0,0,4,7,910,500,1956,0,98133,47.7073,-122.34,1130,5693,410000,9,6,2014,0,58,3650,4563,0,1,1
3,2.5,2350,5100,2.0,0,0,3,8,2350,0,2003,0,98038,47.3512,-122.008,2350,5363,390000,2,12,2014,0,11,2750,3013,0,0,0
4,2.5,1900,5889,2.0,0,0,3,7,1900,0,1992,0,98038,47.349,-122.031,1870,6405,360000,22,12,2014,0,22,3989,4535,0,0,0
2,1.0,2020,6720,1.0,0,0,3,7,1010,1010,1948,0,98118,47.5474,-122.291,1720,6720,355000,28,10,2014,0,66,4700,5000,0,1,1
3,1.5,1680,8712,1.0,0,0,3,8,1680,0,1964,0,98059,47.4811,-122.149,1850,8797,356000,28,1,2015,0,51,7032,6947,0,0,0
3,1.0,960,6634,1.0,0,0,3,6,960,0,1952,0,98125,47.7264,-122.31,1570,7203,315000,2,6,2014,0,62,5674,5633,0,0,1
3,1.5,2140,3600,2.0,0,0,3,9,1900,240,1925,0,98119,47.6337,-122.365,2020,4800,940000,14,11,2014,0,89,1460,2780,0,1,1
5,2.25,2660,8400,1.5,0,0,5,7,2660,0,1961,0,98092,47.2909,-122.189,1590,8165,305000,3,11,2014,0,53,5740,6575,0,0,0
3,3.25,2770,6278,2.0,0,0,3,9,1980,790,2006,0,98056,47.5228,-122.199,1900,7349,461000,18,6,2014,0,8,3508,5449,0,1,0
2,2.25,1610,2040,2.0,0,0,4,7,1610,0,1979,0,98056,47.518,-122.194,1950,2025,215000,19,5,2014,0,35,430,75,0,0,0
2,1.75,1030,1066,2.0,0,0,3,7,765,265,2006,0,98136,47.5394,-122.387,1030,1106,335000,4,9,2014,0,8,36,76,0,1,1
4,2.5,1980,7403,2.0,0,0,3,7,1980,0,1988,0,98023,47.2897,-122.372,1980,7510,243500,22,5,2014,0,26,5423,5530,0,0,0
5,2.75,3520,6353,2.0,0,0,4,10,3520,0,2001,0,98199,47.6506,-122.391,2520,6250,1100000,11,3,2015,0,14,2833,3730,0,0,1
3,1.0,1200,10500,1.0,0,0,3,7,1200,0,1962,0,98023,47.322,-122.351,1350,10500,153000,26,2,2015,0,53,9300,9150,0,0,0
3,1.5,1580,5000,1.0,0,0,3,8,1290,290,1939,0,98117,47.687,-122.386,1570,4500,430000,25,7,2014,0,75,3420,2930,0,1,1
3,1.5,1580,5000,1.0,0,0,3,8,1290,290,1939,0,98117,47.687,-122.386,1570,4500,700000,23,12,2014,0,75,3420,2930,0,1,1
4,2.5,3300,10250,1.0,0,0,3,7,2390,910,1946,1991,98040,47.5873,-122.249,1950,6045,905000,8,9,2014,45,68,6950,4095,1,1,0
4,1.5,1160,6400,1.0,0,0,4,7,1160,0,1975,0,98023,47.3036,-122.378,1160,6400,199000,12,9,2014,0,39,5240,5240,0,0,0
3,2.5,2070,13241,1.5,0,0,5,9,1270,800,1910,0,98102,47.6415,-122.315,2200,4500,850830,11,6,2014,0,104,11171,2300,0,1,1
3,2.0,1980,3478,1.5,0,0,4,7,1440,540,1929,0,98117,47.6775,-122.372,1610,3478,555000,27,10,2014,0,85,1498,1868,0,1,1
3,2.5,2920,8113,2.0,0,0,3,8,2920,0,1950,2010,98004,47.5814,-122.196,2370,8113,1090000,7,10,2014,60,64,5193,5743,1,0,0
3,2.5,2340,10005,1.0,0,0,4,8,1460,880,1978,0,98058,47.4431,-122.133,2250,8162,375000,2,4,2015,0,37,7665,5912,0,1,0
3,1.0,1670,4005,1.5,0,0,4,7,1170,500,1939,0,98117,47.6878,-122.38,1240,4005,460000,23,5,2014,0,75,2335,2765,0,1,1
2,1.75,1240,2493,1.0,0,0,4,8,1240,0,1985,0,98198,47.3813,-122.322,1270,4966,188500,23,7,2014,0,29,1253,3696,0,0,1
5,1.75,2030,12342,2.0,0,0,4,7,2030,0,1942,0,98052,47.6417,-122.109,2500,9433,470000,27,8,2014,0,72,10312,6933,0,0,0
4,2.5,2310,9624,2.0,0,0,3,8,2310,0,1984,0,98027,47.5386,-122.053,1940,9636,597750,25,7,2014,0,30,7314,7696,0,0,0
3,1.75,1260,3328,1.0,0,0,5,6,700,560,1905,0,98103,47.6823,-122.349,1380,3536,570000,4,3,2015,0,110,2068,2156,0,1,1
3,1.75,1540,12600,1.0,0,0,4,7,1160,380,1980,0,98038,47.3624,-122.031,1540,11656,272500,16,9,2014,0,34,11060,10116,0,1,0
3,1.75,2080,5969,1.0,0,2,3,7,1080,1000,1971,0,98108,47.5474,-122.295,2090,5500,329950,24,11,2014,0,43,3889,3410,0,1,1
4,2.5,3230,16171,2.0,0,3,3,9,2520,710,2001,0,98001,47.3183,-122.253,2640,8517,480000,28,10,2014,0,13,12941,5877,0,1,0
3,3.5,4380,6350,2.0,0,0,3,8,2780,1600,1900,1999,98117,47.6981,-122.368,1830,6350,740500,21,11,2014,99,114,1970,4520,1,1,1
3,3.5,1590,1102,3.0,0,0,3,8,1590,0,2010,0,98103,47.6824,-122.347,1620,3166,518500,26,6,2014,0,4,-488,1546,0,0,1
2,1.0,880,6780,1.0,0,0,4,6,880,0,1945,0,98178,47.5009,-122.248,1190,6780,205425,23,6,2014,0,69,5900,5590,0,0,1
4,2.0,1570,9600,1.0,0,0,3,6,1570,0,1950,0,98168,47.4965,-122.303,1880,9000,171800,8,1,2015,0,65,8030,7120,0,0,1
4,1.0,1610,2982,1.5,0,0,4,7,1610,0,1925,0,98144,47.587,-122.294,1610,4040,535000,11,5,2015,0,90,1372,2430,0,0,1
3,2.5,2400,6474,1.0,0,2,3,8,1560,840,1964,0,98177,47.7728,-122.386,2340,10856,660000,2,1,2015,0,51,4074,8516,0,1,1
3,2.0,1450,9132,1.0,0,0,3,7,1450,0,1987,0,98034,47.7288,-122.226,1580,9104,391500,19,11,2014,0,27,7682,7524,0,0,0
2,1.0,770,6000,1.0,0,0,3,6,770,0,1953,0,98117,47.6999,-122.364,1710,6000,395000,6,4,2015,0,62,5230,4290,0,0,1
4,1.75,2100,4400,1.5,0,0,5,7,1720,380,1924,0,98118,47.5299,-122.266,1850,4400,445000,4,11,2014,0,90,2300,2550,0,1,1
3,2.25,2910,10204,2.0,0,0,3,9,2910,0,1990,0,98052,47.6897,-122.098,2700,13992,770000,18,6,2014,0,24,7294,11292,0,0,0
4,2.75,2750,17789,1.5,0,0,3,8,1980,770,1914,1992,98004,47.6141,-122.212,3060,11275,1450000,2,3,2015,78,101,15039,8215,1,1,0
3,2.25,2100,8201,1.0,0,2,3,8,1620,480,1967,0,98178,47.5091,-122.244,2660,8712,445000,17,7,2014,0,47,6101,6052,0,1,1
4,2.25,2160,8811,1.0,0,0,3,8,1360,800,1978,0,98023,47.3129,-122.39,2090,8400,260000,17,7,2014,0,36,6651,6310,0,1,0
5,3.5,2320,4960,2.0,0,0,5,7,1720,600,1926,0,98103,47.6763,-122.352,1700,4960,822500,13,6,2014,0,88,2640,3260,0,1,1
4,2.5,2070,4310,2.0,0,0,3,7,2070,0,2004,0,98065,47.5319,-121.85,1970,3748,430000,6,4,2015,0,11,2240,1778,0,0,0
3,1.75,1060,7875,1.0,0,0,4,7,1060,0,1986,0,98092,47.2761,-122.152,1420,7680,212000,5,1,2015,0,29,6815,6260,0,0,0
4,2.25,2010,9603,1.0,0,0,3,8,1440,570,1986,0,98027,47.5343,-122.054,2060,9793,660500,28,4,2015,0,29,7593,7733,0,1,0
3,2.5,2010,2287,2.0,0,0,3,8,1390,620,2014,0,98029,47.5517,-121.998,1690,1662,453246,12,5,2014,0,0,277,-28,0,1,0
4,3.5,2140,2278,3.0,0,0,3,9,2140,0,2005,0,98107,47.6734,-122.38,1540,2285,675000,26,1,2015,0,10,138,745,0,0,1
4,1.75,2020,7840,1.0,0,0,3,7,1010,1010,1968,0,98003,47.3309,-122.299,1750,8140,220000,5,8,2014,0,46,5820,6390,0,1,0
4,2.25,2590,10002,1.0,0,0,4,8,1340,1250,1968,0,98028,47.7689,-122.266,1550,10436,452000,29,5,2014,0,46,7412,8886,0,1,0
2,1.0,1190,4440,1.0,0,0,3,6,1190,0,1981,0,98125,47.7135,-122.287,1060,5715,382500,7,7,2014,0,33,3250,4655,0,0,1
3,2.25,1170,1249,3.0,0,0,3,8,1170,0,2014,0,98107,47.6722,-122.381,1350,1310,519950,7,5,2014,0,0,79,-40,0,0,1
2,1.0,1110,3200,1.0,0,0,3,7,1110,0,1925,0,98119,47.6338,-122.358,1170,3600,665000,27,6,2014,0,89,2090,2430,0,0,1
5,2.5,2820,9375,1.0,0,0,4,8,1550,1270,1968,0,98006,47.5707,-122.128,2820,9375,527700,8,7,2014,0,46,6555,6555,0,1,0
3,1.0,1610,8579,1.0,0,0,4,7,1010,600,1962,0,98058,47.4563,-122.171,1610,8579,205000,8,5,2015,0,53,6969,6969,0,1,0
3,1.0,1060,8097,1.0,0,0,4,7,940,120,1923,0,98133,47.7144,-122.351,1560,7940,420000,15,4,2015,0,92,7037,6380,0,1,1
4,2.25,2030,8517,1.0,0,0,4,8,1380,650,1961,0,98006,47.5495,-122.174,2230,8824,500000,27,2,2015,0,54,6487,6594,0,1,0
4,1.0,2550,4000,2.0,0,0,3,8,2370,180,1905,0,98109,47.6354,-122.353,2200,4000,890000,25,6,2014,0,109,1450,1800,0,1,1
3,1.0,1430,3455,1.0,0,0,3,7,980,450,1947,0,98103,47.6873,-122.336,1450,4599,511000,4,11,2014,0,67,2025,3149,0,1,1
3,2.0,1360,3090,2.0,0,0,3,8,1360,0,1990,0,98103,47.6838,-122.353,1500,3090,532170,20,8,2014,0,24,1730,1590,0,0,1
3,1.0,1110,5000,1.5,0,0,3,7,1110,0,1947,0,98107,47.655,-122.359,1420,5000,560000,9,4,2015,0,68,3890,3580,0,0,1
3,1.0,1250,8200,1.0,0,0,4,7,1250,0,1954,0,98003,47.3255,-122.304,1680,8633,282950,31,3,2015,0,61,6950,6953,0,0,0
1,1.0,700,5100,1.0,0,0,3,7,700,0,1942,0,98115,47.679,-122.3,1010,5100,350000,16,5,2014,0,72,4400,4090,0,0,1
3,1.0,1180,7669,1.0,0,0,4,7,1180,0,1967,0,98058,47.4479,-122.176,1190,7669,215000,28,7,2014,0,47,6489,6479,0,0,0
4,2.75,2640,7500,1.0,0,0,3,8,1620,1020,1967,0,98023,47.3135,-122.369,1980,7875,320000,7,8,2014,0,47,4860,5895,0,1,0
3,2.0,1270,7198,1.5,0,0,3,7,1270,0,1916,2013,98022,47.2086,-121.996,1160,7198,247000,13,11,2014,97,98,5928,6038,1,0,0
4,1.75,1760,11180,1.0,0,0,4,8,1760,0,1968,0,98059,47.4715,-122.118,1730,11180,320000,3,10,2014,0,46,9420,9450,0,0,0
5,2.25,2060,8632,1.0,0,0,3,7,1030,1030,1962,0,98146,47.4877,-122.335,1010,11680,255000,7,5,2014,0,52,6572,10670,0,1,1
3,1.75,1780,9660,1.0,0,0,3,7,1780,0,1962,0,98034,47.7171,-122.193,1200,9660,438000,9,3,2015,0,53,7880,8460,0,0,0
3,2.5,3400,16603,2.0,0,0,3,10,3400,0,2000,0,98075,47.6012,-122.023,3400,12601,900000,4,3,2015,0,15,13203,9201,0,0,0
3,2.75,1910,7280,1.0,0,0,3,7,1160,750,1979,0,98034,47.7319,-122.224,1710,8152,441000,20,6,2014,0,35,5370,6442,0,1,0
3,1.75,1580,7000,1.0,0,0,3,7,1180,400,1976,0,98034,47.7209,-122.168,1640,7500,370000,8,12,2014,0,38,5420,5860,0,1,0
2,1.75,1340,7250,1.0,0,0,5,5,700,640,1949,0,98198,47.408,-122.327,1830,9750,269950,19,2,2015,0,66,5910,7920,0,1,1
4,2.5,2680,4499,2.0,0,0,3,9,2680,0,1999,0,98006,47.565,-122.125,2920,4500,807100,24,3,2015,0,16,1819,1580,0,0,0
3,2.5,2680,9750,1.0,0,0,4,8,1610,1070,1979,0,98034,47.7028,-122.231,2480,8750,653000,5,6,2014,0,35,7070,6270,0,1,0
3,2.0,1370,8336,1.0,0,0,5,7,1370,0,1964,0,98133,47.7458,-122.331,1770,7288,371500,11,6,2014,0,50,6966,5518,0,0,1
3,1.75,2160,7140,1.0,0,0,4,7,1670,490,1978,0,98023,47.3026,-122.374,1930,7350,272000,2,1,2015,0,37,4980,5420,0,1,0
3,1.5,1340,7912,1.5,0,0,3,7,1340,0,1955,0,98133,47.7658,-122.339,1480,7940,313000,2,5,2014,0,59,6572,6460,0,0,1
4,2.25,2590,8190,2.0,0,0,4,8,2590,0,1980,0,98006,47.5619,-122.125,2260,8335,673000,29,9,2014,0,34,5600,6075,0,0,0
3,2.5,1120,1100,2.0,0,0,3,8,820,300,2008,0,98122,47.6106,-122.31,1590,1795,425000,10,2,2015,0,7,-20,205,0,1,1
5,2.75,1970,5400,1.0,0,0,3,7,1320,650,1986,0,98144,47.5868,-122.308,1280,2150,399950,9,7,2014,0,28,3430,870,0,1,1
3,1.0,1220,4800,1.0,0,0,3,6,1220,0,1901,0,98122,47.6101,-122.307,1200,4800,385000,30,5,2014,0,113,3580,3600,0,0,1
3,1.5,1950,7560,1.0,0,2,4,7,1320,630,1975,0,98022,47.1976,-121.999,1950,8941,269950,17,11,2014,0,39,5610,6991,0,1,0
2,1.0,1350,8220,1.0,0,0,3,7,1060,290,1949,0,98177,47.7224,-122.358,1540,8280,330000,7,1,2015,0,66,6870,6740,0,1,1
3,2.5,1670,5797,2.0,0,0,3,7,1670,0,1988,0,98030,47.3505,-122.179,1670,6183,260000,25,7,2014,0,26,4127,4513,0,0,0
4,3.0,2380,5125,1.5,0,0,4,7,1680,700,1925,0,98126,47.5384,-122.376,1410,5375,470000,14,4,2015,0,90,2745,3965,0,1,1
4,3.0,2440,9600,2.0,0,0,5,7,2440,0,1961,0,98034,47.7044,-122.2,2290,9600,589000,13,6,2014,0,53,7160,7310,0,0,0
2,1.5,1050,3419,2.0,0,0,3,7,1050,0,1996,0,98038,47.3848,-122.039,1050,3417,163500,23,7,2014,0,18,2369,2367,0,0,0
4,2.75,3130,13412,2.0,0,0,3,9,2140,990,1993,0,98052,47.6993,-122.102,2260,9984,835000,5,9,2014,0,21,10282,7724,0,1,0
5,3.0,4090,12850,1.0,0,2,4,10,2090,2000,1986,0,98033,47.6627,-122.188,2540,10270,1100000,21,11,2014,0,28,8760,7730,0,1,0
4,1.75,1490,10000,1.0,0,0,4,8,1100,390,1969,0,98023,47.3099,-122.379,2190,8910,269000,15,4,2015,0,46,8510,6720,0,1,0
3,2.5,1900,8744,2.0,0,0,3,8,1900,0,1987,0,98074,47.62,-122.043,2030,8744,560000,5,5,2014,0,27,6844,6714,0,0,0
4,1.0,1330,2400,1.5,0,0,4,6,1330,0,1901,0,98103,47.65,-122.34,1330,4400,615000,18,4,2015,0,114,1070,3070,0,0,1
3,2.25,2230,10026,1.0,0,0,3,8,1430,800,1975,0,98052,47.6647,-122.153,2230,9340,585188,5,12,2014,0,39,7796,7110,0,1,0
3,1.75,1650,9480,1.0,0,0,3,7,1220,430,1977,0,98034,47.726,-122.191,1540,8400,305000,18,8,2014,0,37,7830,6860,0,1,0
3,1.0,1190,8820,1.0,0,0,3,6,1190,0,1959,0,98058,47.4616,-122.184,1230,7980,166950,5,11,2014,0,55,7630,6750,0,0,0
3,2.5,2140,9897,1.0,0,0,4,8,2140,0,1959,0,98040,47.5505,-122.219,2680,10083,799000,12,9,2014,0,55,7757,7403,0,0,0
3,2.5,2180,7508,1.0,0,0,4,7,1420,760,1962,0,98133,47.7606,-122.336,1900,7818,400000,25,6,2014,0,52,5328,5918,0,1,1
3,1.0,1060,10228,1.0,0,0,3,7,1060,0,1948,0,98155,47.7481,-122.3,1570,10228,230000,1,12,2014,0,66,9168,8658,0,0,1
3,2.5,1690,5025,2.0,0,0,3,8,1690,0,2003,0,98023,47.2779,-122.347,2550,5001,256883,15,5,2014,0,11,3335,2451,0,0,0
4,2.0,1970,6480,1.5,0,0,5,7,1130,840,1920,0,98108,47.5511,-122.312,1500,6480,423000,11,11,2014,0,94,4510,4980,0,1,1
3,2.5,2150,4084,2.0,0,0,3,8,2150,0,2007,0,98126,47.5488,-122.372,1750,2385,465000,23,7,2014,0,7,1934,635,0,0,1
3,1.0,860,11725,1.0,0,0,4,6,860,0,1943,0,98056,47.5093,-122.184,1300,9514,210000,11,3,2015,0,72,10865,8214,0,0,0
3,2.5,1940,14952,2.0,0,0,3,8,1940,0,1994,0,98042,47.3777,-122.165,2030,10450,297000,12,11,2014,0,20,13012,8420,0,0,0
3,1.0,1010,5000,1.0,0,0,3,7,1010,0,1952,0,98107,47.675,-122.394,1680,5000,470000,16,7,2014,0,62,3990,3320,0,0,1
3,1.5,1300,7370,1.0,0,0,4,7,900,400,1976,0,98023,47.3025,-122.37,1430,7500,226500,4,8,2014,0,38,6070,6070,0,1,0
3,1.0,910,8450,1.0,0,0,4,6,910,0,1962,0,98059,47.4787,-122.158,1400,8040,274250,3,3,2015,0,53,7540,6640,0,0,0
4,1.75,2480,11010,1.0,0,0,4,9,1630,850,1966,0,98040,47.5378,-122.219,2770,10744,840000,4,8,2014,0,48,8530,7974,0,1,0
3,2.5,2440,4587,2.0,0,0,3,8,2440,0,2010,0,98052,47.7073,-122.114,2750,4587,677900,19,9,2014,0,4,2147,1837,0,0,0
3,1.0,1010,5864,1.0,0,0,3,7,1010,0,1915,0,98116,47.5733,-122.381,1290,5000,425000,5,2,2015,0,100,4854,3710,0,0,1
2,0.75,900,9600,1.0,0,0,3,6,900,0,1941,0,98166,47.4604,-122.339,1250,14280,180250,23,11,2014,0,73,8700,13030,0,0,1
6,3.0,2300,3404,2.0,0,0,3,7,1600,700,1920,1994,98133,47.7067,-122.343,1560,1312,464000,17,7,2014,74,94,1104,-248,1,1,1
4,2.25,1550,7579,2.0,0,0,3,8,1550,0,1993,0,98038,47.354,-122.047,1630,6397,320000,22,4,2015,0,22,6029,4767,0,0,0
3,2.25,1270,1566,2.0,0,0,3,8,1060,210,2014,0,98105,47.6647,-122.284,1160,1327,625504,17,7,2014,0,0,296,167,0,1,1
4,2.5,2240,12032,1.0,0,0,3,9,2240,0,1983,0,98074,47.6143,-122.017,2520,12368,592500,15,5,2014,0,31,9792,9848,0,0,0
4,2.75,1720,6270,2.0,0,0,3,8,1720,0,1978,0,98118,47.5458,-122.268,2130,8700,477000,27,5,2014,0,36,4550,6570,0,0,1
2,1.0,850,16400,1.0,0,0,3,6,850,0,1923,0,98168,47.4889,-122.299,1100,14459,280000,15,1,2015,0,92,15550,13359,0,0,1
3,2.5,2250,5692,2.0,0,0,3,8,2250,0,2000,0,98146,47.5133,-122.379,1320,5390,445838,3,7,2014,0,14,3442,4070,0,0,1
2,2.25,3900,14864,1.0,0,3,3,8,1950,1950,1947,0,98144,47.5884,-122.291,2580,5184,1070000,28,8,2014,0,67,10964,2604,0,1,1
2,1.5,1320,10800,1.0,0,0,4,8,1320,0,1947,0,98177,47.7145,-122.367,2120,12040,467000,23,10,2014,0,67,9480,9920,0,0,1
4,2.5,2760,6440,2.0,0,0,3,10,2760,0,1999,0,98075,47.5836,-122.026,3070,8127,686000,22,8,2014,0,15,3680,5057,0,0,0
3,2.0,1750,9750,1.0,0,0,3,7,1350,400,1961,0,98198,47.398,-122.299,1900,10125,279950,5,6,2014,0,53,8000,8225,0,1,1
3,2.25,2220,16020,1.0,0,0,4,8,1780,440,1966,0,98030,47.3758,-122.217,2080,9583,325000,18,9,2014,0,48,13800,7503,0,1,0
3,2.25,2020,8379,2.0,0,0,3,7,2020,0,1994,0,98038,47.3828,-122.023,2020,8031,328000,3,9,2014,0,20,6359,6011,0,0,0
3,2.25,1250,7500,1.0,0,0,5,7,1250,0,1942,0,98146,47.5123,-122.373,1280,7392,390000,4,6,2014,0,72,6250,6112,0,0,1
2,2.0,1510,6516,1.0,0,0,3,8,1510,0,2005,0,98053,47.7076,-122.013,1640,6009,479950,9,3,2015,0,10,5006,4369,0,0,0
4,2.25,1720,9753,1.0,0,0,4,7,1120,600,1978,0,98023,47.2922,-122.371,1510,9753,264950,29,5,2014,0,36,8033,8243,0,1,0
3,1.0,1430,15246,1.0,0,0,4,7,980,450,1961,0,98031,47.4075,-122.214,1960,13068,235000,15,1,2015,0,54,13816,11108,0,1,0
3,2.5,1480,4729,2.0,0,0,3,7,1480,0,2004,0,98053,47.6794,-122.034,2250,4729,516500,3,3,2015,0,11,3249,2479,0,0,0
2,1.75,1450,15798,2.0,1,4,3,7,1230,220,1915,1978,98166,47.4497,-122.375,2030,13193,655000,13,4,2015,63,100,14348,11163,1,1,1
6,2.75,2940,7350,1.0,0,0,3,8,1780,1160,1978,0,98023,47.3103,-122.339,2120,8236,315000,21,11,2014,0,36,4410,6116,0,1,0
2,1.0,1000,10200,1.0,0,0,3,6,1000,0,1961,0,98024,47.5687,-121.899,1150,13702,213000,20,11,2014,0,53,9200,12552,0,0,0
3,1.5,2480,5280,1.5,0,0,5,7,1620,860,1947,0,98108,47.5575,-122.303,2090,4800,475000,2,9,2014,0,67,2800,2710,0,1,1
4,1.0,1970,4740,1.5,0,0,3,7,1670,300,1904,2005,98122,47.6136,-122.303,1510,4740,410000,20,3,2015,101,111,2770,3230,1,1,1
6,2.5,4410,14034,1.0,0,2,4,9,2350,2060,1965,0,98003,47.3376,-122.324,2600,13988,472000,29,5,2014,0,49,9624,11388,0,1,0
3,1.75,1430,8505,1.0,0,0,4,7,1430,0,1968,0,98003,47.3173,-122.319,1190,8640,225000,8,12,2014,0,46,7075,7450,0,0,0
2,1.0,830,6000,1.0,0,0,3,6,830,0,1940,0,98126,47.5308,-122.376,830,4960,210000,1,10,2014,0,74,5170,4130,0,0,1
2,1.0,1430,5000,1.5,0,0,2,7,1430,0,1925,0,98115,47.6727,-122.299,1450,3750,455000,27,1,2015,0,90,3570,2300,0,0,1
3,1.0,1300,8316,1.0,0,0,4,6,1300,0,1954,0,98002,47.3221,-122.216,1260,8316,225000,27,4,2015,0,61,7016,7056,0,0,0
2,1.0,1030,3060,1.0,0,2,4,7,790,240,1918,0,98103,47.6779,-122.353,1390,3060,480000,26,8,2014,0,96,2030,1670,0,1,1
3,2.5,2740,11872,2.0,0,0,3,9,2740,0,1990,0,98023,47.3076,-122.395,2570,10377,363000,12,2,2015,0,25,9132,7807,0,0,0
2,1.5,720,5120,1.0,0,0,3,6,720,0,1954,0,98106,47.5218,-122.357,1150,2566,181000,26,2,2015,0,61,4400,1416,0,0,1
4,2.0,2010,7312,1.0,0,0,4,7,2010,0,1976,0,98002,47.2785,-122.213,2010,7650,250000,14,3,2015,0,39,5302,5640,0,0,0
3,1.75,1560,3000,1.0,0,0,4,6,770,790,1918,0,98103,47.6846,-122.345,1390,3000,481000,22,4,2015,0,97,1440,1610,0,1,1
3,2.0,1810,7209,1.0,0,0,4,7,1240,570,1978,0,98032,47.3656,-122.278,1750,7209,260000,23,9,2014,0,36,5399,5459,0,1,0
4,2.5,3360,7685,2.0,0,0,3,9,3360,0,2001,0,98058,47.4369,-122.111,3060,6567,455000,13,5,2014,0,13,4325,3507,0,0,0
3,1.0,1400,3538,1.0,0,0,3,7,800,600,1953,0,98118,47.5405,-122.27,1620,6331,349500,21,4,2015,0,62,2138,4711,0,1,1
3,2.5,1730,7442,2.0,0,0,3,7,1730,0,1987,0,98030,47.3507,-122.178,1630,6458,245000,29,9,2014,0,27,5712,4828,0,0,0
2,2.0,1420,9191,1.5,0,2,5,7,1420,0,1928,0,98115,47.6979,-122.32,1420,6816,592500,19,5,2014,0,86,7771,5396,0,0,1
4,1.75,2360,7620,1.0,0,0,4,7,1180,1180,1955,0,98106,47.5278,-122.345,1910,7620,385000,20,10,2014,0,59,5260,5710,0,1,1
3,1.75,1580,11455,1.0,0,0,4,7,1200,380,1974,0,98059,47.4756,-122.147,1550,10650,315000,11,2,2015,0,41,9875,9100,0,1,0
3,1.0,1230,10170,1.0,0,0,3,7,1230,0,1979,0,98045,47.4437,-121.772,1380,10098,255000,24,11,2014,0,35,8940,8718,0,0,0
4,2.5,2460,4425,2.0,0,0,3,8,2460,0,2006,0,98052,47.7048,-122.109,2990,5659,693000,29,8,2014,0,8,1965,2669,0,0,0
3,1.0,1660,4400,1.5,0,0,3,8,1460,200,1911,0,98112,47.6362,-122.302,1660,4400,780000,2,12,2014,0,103,2740,2740,0,1,1
3,1.75,1270,8470,1.0,0,0,4,7,1270,0,1960,0,98198,47.4207,-122.29,1600,8470,237000,24,10,2014,0,54,7200,6870,0,0,1
2,1.0,770,5040,1.0,0,0,3,5,770,0,1930,0,98144,47.5964,-122.299,1330,2580,425000,28,4,2015,0,85,4270,1250,0,0,1
1,0.75,760,10079,1.0,1,4,5,5,760,0,1936,0,98070,47.4683,-122.438,1230,14267,369900,27,10,2014,0,78,9319,13037,0,0,0
4,2.5,1700,7280,2.0,0,0,4,7,1700,0,1988,0,98031,47.4045,-122.171,1950,7475,290000,19,5,2014,0,26,5580,5525,0,0,0
3,1.0,1120,10701,1.0,0,0,3,7,1120,0,1954,0,98106,47.5544,-122.358,1130,6350,285000,29,9,2014,0,60,9581,5220,0,0,1
2,1.0,1070,4500,1.0,0,0,3,7,1070,0,1937,0,98115,47.6802,-122.29,1320,4465,415000,14,8,2014,0,77,3430,3145,0,0,1
3,2.5,2070,9900,1.0,0,0,3,8,1420,650,1979,0,98023,47.2988,-122.371,2070,8250,272500,9,4,2015,0,36,7830,6180,0,1,0
2,1.0,1040,7538,1.0,0,0,4,7,1040,0,1939,0,98133,47.7107,-122.352,1440,7530,436000,1,5,2015,0,76,6498,6090,0,0,1
3,1.0,1700,11390,1.0,0,0,4,7,1700,0,1967,0,98003,47.3271,-122.323,1350,8164,210000,17,10,2014,0,47,9690,6814,0,0,0
3,1.0,1300,5898,1.0,0,0,3,7,1300,0,1961,0,98178,47.5053,-122.255,1320,7619,236000,25,9,2014,0,53,4598,6299,0,0,1
3,1.75,1080,1306,1.0,0,0,3,7,580,500,1954,2003,98199,47.6601,-122.4,1440,2225,331000,24,11,2014,49,60,226,785,1,1,1
3,2.5,2653,4510,2.0,0,0,3,8,2653,0,2006,0,98031,47.4145,-122.166,2653,4927,365000,20,3,2015,0,9,1857,2274,0,0,0
3,2.0,2290,16258,1.0,0,0,5,8,2290,0,1960,0,98058,47.4672,-122.165,1660,10530,450000,27,1,2015,0,55,13968,8870,0,0,0
3,1.75,2390,6000,1.0,0,0,3,6,1240,1150,1908,0,98118,47.5362,-122.268,2020,6000,405000,5,5,2015,0,107,3610,3980,0,1,1
4,1.75,2600,11325,1.0,0,0,4,7,1610,990,1969,0,98031,47.3954,-122.206,1720,11088,304900,3,7,2014,0,45,8725,9368,0,1,0
2,1.0,860,5265,1.0,0,0,3,6,860,0,1931,0,98178,47.5048,-122.272,1650,8775,170000,27,2,2015,0,84,4405,7125,0,0,1
5,3.0,3830,8480,2.0,0,1,5,9,2630,1200,1905,1994,98122,47.6166,-122.287,3050,7556,2050000,13,5,2015,89,110,4650,4506,1,1,1
4,2.5,3500,7048,2.0,0,0,3,9,3500,0,2005,0,98053,47.6811,-122.025,3920,7864,780000,30,6,2014,0,9,3548,3944,0,0,0
3,3.0,2420,13959,1.0,0,0,4,8,1740,680,1988,0,98028,47.7486,-122.23,2570,13300,330000,10,4,2015,0,27,11539,10730,0,1,0
4,2.5,2720,8666,2.0,0,0,3,9,2720,0,1992,0,98030,47.3846,-122.169,2410,8100,370000,5,9,2014,0,22,5946,5690,0,0,0
5,2.25,2500,13500,1.0,0,0,3,7,1850,650,1979,0,98072,47.7564,-122.144,2300,9750,467000,17,10,2014,0,35,11000,7450,0,1,0
3,1.75,1670,6720,1.0,0,0,3,7,1140,530,1980,0,98034,47.7198,-122.193,1670,7320,405000,9,2,2015,0,35,5050,5650,0,1,0
5,2.25,2900,10300,1.0,0,0,3,8,1450,1450,1985,0,98006,47.5461,-122.151,2310,10300,675000,2,7,2014,0,29,7400,7990,0,1,0
2,1.0,1640,14100,1.0,0,0,4,7,1140,500,1954,0,98006,47.5712,-122.143,1520,13527,500000,12,8,2014,0,60,12460,12007,0,1,0
4,1.75,2950,9025,1.0,0,2,4,8,1780,1170,1975,0,98034,47.7128,-122.223,2120,9600,630000,24,2,2015,0,40,6075,7480,0,1,0
4,2.5,2160,9528,2.0,0,0,3,9,2160,0,1992,0,98001,47.3341,-122.255,2280,9937,360000,22,10,2014,0,22,7368,7657,0,0,0
4,3.0,3280,11060,2.0,0,0,3,8,2270,1010,1986,0,98056,47.5399,-122.181,2320,11004,580000,2,10,2014,0,28,7780,8684,0,1,0
3,2.0,1970,4166,2.0,0,3,5,8,1270,700,1929,0,98126,47.5717,-122.375,2390,4166,550000,9,7,2014,0,85,2196,1776,0,1,1
3,2.0,1320,8959,1.0,0,0,3,7,1320,0,1993,0,98042,47.3536,-122.144,1740,7316,265000,22,8,2014,0,21,7639,5576,0,0,0
3,2.5,2650,7286,2.0,0,0,3,8,2650,0,1990,0,98059,47.5084,-122.154,2400,7220,446500,4,3,2015,0,25,4636,4820,0,0,0
3,1.5,2030,8880,1.0,0,0,3,7,1330,700,1963,0,98108,47.5586,-122.311,2140,5592,404000,2,6,2014,0,51,6850,3452,0,1,1
3,1.75,1590,11914,1.0,0,2,3,7,1090,500,1957,0,98188,47.4427,-122.274,1630,9052,267500,29,5,2014,0,57,10324,7422,0,1,1
3,2.5,2440,7632,2.0,0,0,3,8,2440,0,1998,0,98003,47.3494,-122.301,2510,7903,335000,11,8,2014,0,16,5192,5393,0,0,0
3,2.5,1940,9000,1.0,0,0,4,7,970,970,1948,0,98117,47.6933,-122.393,2190,7310,576000,19,6,2014,0,66,7060,5120,0,1,1
3,2.5,2040,3810,2.0,0,0,3,8,2040,0,2006,0,98038,47.3537,-122.0,2370,4590,208633,1,4,2015,0,9,1770,2220,0,0,0
3,2.25,2200,8750,1.0,0,0,4,7,1120,1080,1964,0,98166,47.476,-122.337,1460,10139,315000,15,1,2015,0,51,6550,8679,0,1,1
3,1.75,1920,3300,1.0,0,0,4,8,960,960,1913,0,98112,47.6239,-122.298,1740,4000,725000,17,2,2015,0,102,1380,2260,0,1,1
4,2.75,1800,7750,1.0,0,0,4,8,1400,400,1965,0,98177,47.7776,-122.384,1800,8275,550000,3,4,2015,0,50,5950,6475,0,1,1
4,2.25,2180,7297,2.0,0,0,3,8,2180,0,1984,0,98074,47.6459,-122.058,2250,9781,610750,12,6,2014,0,30,5117,7531,0,0,0
2,1.0,1010,5000,1.5,0,0,4,6,1010,0,1908,0,98105,47.6692,-122.297,1460,5000,550700,28,2,2015,0,107,3990,3540,0,0,1
4,2.75,3320,10574,2.0,0,0,5,8,2220,1100,1960,0,98056,47.5376,-122.18,2720,8330,665000,8,1,2015,0,55,7254,5610,0,1,0
4,2.5,2370,4000,1.5,0,2,5,8,1980,390,1928,0,98144,47.601,-122.294,2440,5750,834000,9,2,2015,0,87,1630,3310,0,1,1
5,2.5,3650,9050,2.0,0,4,5,10,3370,280,1921,0,98119,47.6345,-122.367,2880,5400,2380000,2,5,2014,0,93,5400,2520,0,1,1
4,3.25,4290,12103,1.0,0,3,3,11,2690,1600,1997,0,98006,47.5503,-122.102,3860,11244,1380000,18,6,2014,0,17,7813,7384,0,1,0
4,3.25,4290,12103,1.0,0,3,3,11,2690,1600,1997,0,98006,47.5503,-122.102,3860,11244,1400000,9,12,2014,0,17,7813,7384,0,1,0
4,2.25,1950,7700,1.0,0,0,3,8,1350,600,1979,0,98058,47.4441,-122.125,2150,7350,305000,5,11,2014,0,35,5750,5200,0,1,0
3,2.0,2590,14052,1.0,0,0,5,8,1720,870,1948,0,98133,47.7357,-122.333,1570,8162,487000,8,4,2015,0,67,11462,6592,0,1,1
2,1.0,1470,3864,1.0,0,0,4,7,1170,300,1916,0,98103,47.6638,-122.345,1570,3864,548000,23,7,2014,0,98,2394,2294,0,1,1
4,1.0,800,8775,1.0,0,0,3,6,800,0,1943,0,98166,47.48,-122.336,1310,8775,268750,22,11,2014,0,71,7975,7465,0,0,1
5,2.75,3150,7119,2.0,0,0,3,9,3150,0,2013,0,98052,47.6759,-122.151,1560,8384,819900,13,5,2014,0,1,3969,6824,0,0,0
3,2.0,1450,11204,1.0,0,0,3,7,1450,0,2003,0,98001,47.2639,-122.252,1520,9518,230000,21,7,2014,0,11,9754,7998,0,0,0
3,1.75,1510,10248,1.0,0,0,3,7,1510,0,1969,0,98023,47.2929,-122.371,1510,9753,240000,2,2,2015,0,46,8738,8243,0,0,0
2,1.0,1240,12092,1.0,0,0,3,6,960,280,1922,1984,98146,47.4957,-122.352,1820,7460,232000,5,9,2014,62,92,10852,5640,1,1,1
2,1.0,1240,12092,1.0,0,0,3,6,960,280,1922,1984,98146,47.4957,-122.352,1820,7460,240500,11,3,2015,62,93,10852,5640,1,1,1
4,2.0,2050,4400,1.5,0,0,4,9,2050,0,1922,0,98102,47.644,-122.319,2320,5500,740000,5,9,2014,0,92,2350,3180,0,0,1
3,1.0,1000,7636,1.0,0,0,2,7,1000,0,1952,0,98166,47.472,-122.344,1150,7600,186375,28,4,2015,0,63,6636,6450,0,0,1
3,2.25,2370,10289,1.0,0,0,4,9,1590,780,1977,0,98005,47.592,-122.166,2500,10004,790000,25,7,2014,0,37,7919,7504,0,1,0
4,3.5,2800,6750,2.0,0,0,3,9,1890,910,1951,2002,98105,47.669,-122.275,2370,6120,880000,16,9,2014,51,63,3950,3750,1,1,1
6,1.75,2240,11180,2.0,0,0,4,7,2240,0,1955,0,98198,47.42,-122.323,1590,7955,279000,16,4,2015,0,60,8940,6365,0,0,1
3,2.0,1810,10530,1.0,0,2,3,8,1810,0,1991,0,98022,47.1913,-122.012,1910,10450,295000,29,7,2014,0,23,8720,8540,0,0,0
2,1.0,1070,5000,1.0,0,0,3,7,1070,0,1924,0,98103,47.6666,-122.331,1710,5000,640000,8,4,2015,0,91,3930,3290,0,0,1
4,2.0,2490,9525,2.0,0,0,5,9,2490,0,1968,0,98040,47.5639,-122.217,2770,9525,940000,3,7,2014,0,46,7035,6755,0,0,0
4,2.5,1960,5238,2.0,0,0,3,7,1960,0,2003,0,98038,47.3483,-122.052,1800,5894,260000,7,10,2014,0,11,3278,4094,0,0,0
3,2.75,2930,5569,1.0,0,0,3,9,1860,1070,2004,0,98072,47.7648,-122.164,2580,11045,559900,2,6,2014,0,10,2639,8465,0,1,0
4,2.0,1510,3500,1.5,0,0,5,7,1510,0,1911,0,98103,47.6794,-122.357,1820,3750,791500,22,7,2014,0,103,1990,1930,0,0,1
3,1.75,1420,8250,1.0,0,0,3,7,1420,0,1954,0,98133,47.7535,-122.354,1740,8000,265000,26,8,2014,0,60,6830,6260,0,0,1
4,3.5,3040,8414,2.0,0,0,3,9,2420,620,2010,0,98059,47.5222,-122.157,3470,8066,684000,6,11,2014,0,4,5374,4596,0,1,0
3,1.75,2500,6840,1.0,0,0,3,8,1300,1200,1957,0,98125,47.7222,-122.32,1580,8691,425000,9,9,2014,0,57,4340,7111,0,1,1
4,2.5,2580,5823,2.0,0,0,3,8,2580,0,2002,0,98065,47.5374,-121.875,2380,5823,552250,18,7,2014,0,12,3243,3443,0,0,0
4,1.0,1000,7134,1.0,0,0,3,6,1000,0,1943,0,98178,47.4897,-122.24,1020,7138,165000,23,7,2014,0,71,6134,6118,0,0,1
4,1.0,1000,7134,1.0,0,0,3,6,1000,0,1943,0,98178,47.4897,-122.24,1020,7138,239900,29,12,2014,0,71,6134,6118,0,0,1
3,2.0,1390,13464,1.0,0,0,4,7,1390,0,1987,0,98030,47.3581,-122.173,1720,12080,206600,21,10,2014,0,27,12074,10360,0,0,0
4,1.75,2500,7690,1.0,0,0,3,7,1250,1250,1973,0,98155,47.7713,-122.307,2040,8646,387000,16,4,2015,0,42,5190,6606,0,1,1
4,2.75,2270,10460,2.0,0,0,3,9,2270,0,1965,0,98040,47.5603,-122.222,2610,10180,855000,22,9,2014,0,49,8190,7570,0,0,0
3,1.0,1900,14400,1.0,0,0,4,7,1300,600,1954,0,98166,47.4147,-122.337,1940,14400,315000,26,1,2015,0,61,12500,12460,0,1,1
2,1.0,990,3120,1.0,0,2,5,7,790,200,1907,0,98103,47.68,-122.353,1930,3120,437500,3,12,2014,0,107,2130,1190,0,1,1
4,1.75,2200,7475,1.0,0,0,5,7,1100,1100,1955,0,98118,47.543,-122.28,1600,5766,375000,4,6,2014,0,59,5275,4166,0,1,1
4,2.5,1910,4862,2.0,0,0,3,7,1910,0,2005,0,98038,47.3607,-122.034,2010,5091,300000,6,8,2014,0,9,2952,3081,0,0,0
4,1.0,1750,9600,1.5,0,0,4,7,1750,0,1954,0,98006,47.5759,-122.137,1750,10530,420000,6,10,2014,0,60,7850,8780,0,0,0
3,2.5,2440,5750,2.0,0,2,3,9,1980,460,2000,0,98116,47.565,-122.381,1520,5750,679900,5,8,2014,0,14,3310,4230,0,1,1
5,2.5,2760,11340,2.0,0,0,4,9,2760,0,1978,0,98059,47.4769,-122.141,2470,11340,380000,28,8,2014,0,36,8580,8870,0,0,0
4,2.5,1820,7912,2.0,0,0,3,7,1820,0,1994,0,98038,47.3845,-122.029,1820,8168,329500,10,12,2014,0,20,6092,6348,0,0,0
3,2.5,2110,5608,1.0,0,0,3,8,1340,770,2013,0,98033,47.6743,-122.184,2040,9363,604950,19,8,2014,0,1,3498,7323,0,1,0
5,2.5,3040,9570,1.0,0,2,4,8,1640,1400,1966,0,98006,47.5651,-122.164,2920,8800,795000,17,9,2014,0,48,6530,5880,0,1,0
4,3.0,2090,7500,1.0,0,0,3,7,1370,720,1986,0,98056,47.4888,-122.182,1810,7650,338000,20,11,2014,0,28,5410,5840,0,1,0
3,2.25,1430,7222,2.0,0,0,3,7,1430,0,1993,0,98056,47.5112,-122.19,1430,7220,280000,4,12,2014,0,21,5792,5790,0,0,0
4,2.25,2180,10754,1.0,0,0,5,7,1100,1080,1954,0,98133,47.7711,-122.341,1810,6929,315000,1,10,2014,0,60,8574,5119,0,1,1
4,2.25,2180,10754,1.0,0,0,5,7,1100,1080,1954,0,98133,47.7711,-122.341,1810,6929,530000,24,3,2015,0,61,8574,5119,0,1,1
5,3.0,3450,9914,2.0,0,0,3,9,3450,0,2004,0,98023,47.2813,-122.345,2860,9721,380000,23,12,2014,0,10,6464,6861,0,0,0
3,2.25,1450,7562,2.0,0,0,3,7,1450,0,1994,0,98056,47.5038,-122.189,1650,7625,297000,11,8,2014,0,20,6112,5975,0,0,0
4,2.5,3230,7331,2.0,0,0,3,10,3230,0,2004,0,98075,47.5823,-121.97,3480,7447,730000,20,5,2014,0,10,4101,3967,0,0,0
3,1.75,1640,13500,1.0,0,0,3,7,1110,530,1940,0,98125,47.7164,-122.304,1770,12600,450000,9,6,2014,0,74,11860,10830,0,1,1
3,3.0,1590,7750,1.0,0,0,3,7,1060,530,1997,0,98038,47.3624,-122.045,1680,7500,275000,27,10,2014,0,17,6160,5820,0,1,0
4,2.0,2020,2849,2.0,0,0,3,7,2020,0,1960,0,98115,47.6831,-122.329,1910,3120,595000,29,4,2015,0,55,829,1210,0,0,1
3,1.5,1300,3348,1.5,0,0,3,7,1300,0,1904,2014,98144,47.592,-122.307,1590,2577,435000,21,4,2015,110,111,2048,987,1,0,1
3,3.0,4040,14338,2.0,0,0,3,10,3030,1010,1986,0,98077,47.7268,-122.06,3360,14142,950000,5,8,2014,0,28,10298,10782,0,1,0
4,2.25,2130,5337,2.0,0,0,3,7,2130,0,2001,0,98019,47.7237,-121.959,2300,6930,389000,13,3,2015,0,14,3207,4630,0,0,0
4,2.25,2550,7800,1.0,0,0,3,8,1580,970,1968,0,98052,47.6283,-122.095,2420,8050,560000,21,1,2015,0,47,5250,5630,0,1,0
4,2.25,2510,11585,2.0,0,0,4,8,2510,0,1969,0,98040,47.5483,-122.226,2450,9691,799000,11,11,2014,0,45,9075,7241,0,0,0
3,2.0,1410,9600,1.0,0,0,4,7,1410,0,1983,0,98072,47.7591,-122.146,1410,9600,365500,25,6,2014,0,31,8190,8190,0,0,0
3,2.0,1650,7352,1.0,0,0,3,7,1160,490,1979,0,98058,47.4612,-122.169,1710,7350,252350,15,5,2014,0,35,5702,5640,0,1,0
4,2.5,2120,13780,2.0,0,0,3,8,2120,0,1993,0,98146,47.4987,-122.365,1880,12000,403950,5,9,2014,0,21,11660,10120,0,0,1
4,1.5,2040,10726,1.0,0,0,3,7,1380,660,1954,0,98177,47.772,-122.358,1610,10020,385000,1,8,2014,0,60,8686,8410,0,1,1
4,1.0,1550,7620,1.5,0,0,3,7,1550,0,1957,0,98106,47.5287,-122.35,1450,7620,345000,10,12,2014,0,57,6070,6170,0,0,1
3,2.75,1980,3128,2.0,0,0,4,9,1980,0,1979,0,98008,47.6109,-122.114,1950,2856,490000,17,9,2014,0,35,1148,906,0,0,0
4,2.75,3300,12090,2.0,0,0,3,8,3300,0,1953,0,98004,47.6294,-122.218,3180,12239,927000,12,5,2014,0,61,8790,9059,0,0,0
2,1.0,1220,10000,1.0,0,0,5,7,1220,0,1950,0,98028,47.7405,-122.241,2000,9600,330000,30,4,2015,0,65,8780,7600,0,0,0
5,2.25,2720,8800,1.0,0,0,4,7,1500,1220,1958,0,98008,47.5976,-122.118,2110,8800,530000,9,3,2015,0,57,6080,6690,0,1,0
3,2.5,2160,3000,1.5,0,0,3,7,1260,900,1909,2011,98118,47.5644,-122.289,1060,3500,378750,19,6,2014,102,105,840,2440,1,1,1
4,1.75,1530,8750,1.5,0,0,4,7,1530,0,1968,0,98058,47.4556,-122.157,1390,8750,269900,19,6,2014,0,46,7220,7360,0,0,0
3,3.5,1710,2096,2.0,0,0,3,8,1290,420,2008,0,98122,47.6055,-122.305,1630,1543,557000,6,3,2015,0,7,386,-87,0,1,1
2,1.0,940,5000,1.0,0,0,4,7,940,0,1937,0,98117,47.6879,-122.385,1560,4500,352000,22,4,2015,0,78,4060,2940,0,0,1
4,2.5,1820,6753,2.0,0,0,3,7,1820,0,1994,0,98038,47.3845,-122.032,1820,7107,322500,18,6,2014,0,20,4933,5287,0,0,0
3,3.25,1510,2000,2.0,0,0,3,9,1330,180,2001,0,98116,47.5815,-122.402,1510,1352,650000,12,9,2014,0,13,490,-158,0,1,1
3,2.0,1290,1213,3.0,0,0,3,8,1290,0,2001,0,98103,47.6609,-122.344,1290,3235,450000,6,8,2014,0,13,-77,1945,0,0,1
3,2.0,1570,5250,1.0,0,0,3,7,1570,0,1998,0,98092,47.3163,-122.188,1570,5250,278500,17,4,2015,0,17,3680,3680,0,0,0
4,2.5,1930,6957,2.0,0,0,3,8,1930,0,1995,0,98055,47.4309,-122.191,2090,6996,364950,27,4,2015,0,20,5027,4906,0,0,0
3,2.5,1550,8134,2.0,0,0,3,7,1550,0,1991,0,98031,47.404,-122.191,1550,8134,268000,18,3,2015,0,24,6584,6584,0,0,0
3,2.5,2000,7251,2.0,0,0,3,9,2000,0,1995,0,98034,47.7067,-122.2,2450,8118,577500,23,7,2014,0,19,5251,5668,0,0,0
4,1.5,2390,7480,1.5,0,2,3,7,2390,0,1920,0,98178,47.504,-122.227,2850,6867,339000,12,2,2015,0,95,5090,4017,0,0,1
4,2.25,2200,9351,1.0,0,0,5,7,1290,910,1962,0,98133,47.7448,-122.333,1910,8660,423000,5,1,2015,0,53,7151,6750,0,1,1
3,2.25,1860,5028,2.0,0,0,3,8,1860,0,2012,0,98019,47.7318,-121.982,2320,5465,355000,23,12,2014,0,2,3168,3145,0,0,0
2,1.0,950,3960,1.0,0,0,3,7,950,0,1941,0,98103,47.6885,-122.337,1320,4050,482000,3,12,2014,0,73,3010,2730,0,0,1
3,1.75,1600,9135,1.0,0,0,5,7,1600,0,1955,0,98006,47.5724,-122.179,1580,9800,625000,30,7,2014,0,59,7535,8220,0,0,0
3,2.5,2250,11632,2.0,0,0,3,8,2250,0,1988,0,98056,47.5272,-122.169,2360,11632,538000,19,12,2014,0,26,9382,9272,0,0,0
3,2.5,2280,10255,2.0,0,0,4,8,2280,0,1985,0,98058,47.4334,-122.161,2310,10094,380000,7,1,2015,0,30,7975,7784,0,0,0
2,1.0,940,5120,1.0,0,0,3,7,940,0,1909,0,98122,47.6073,-122.308,1300,5120,375000,17,7,2014,0,105,4180,3820,0,0,1
3,2.5,1530,8500,1.0,0,0,5,7,1030,500,1996,0,98038,47.3592,-122.046,1850,8140,245000,3,4,2015,0,19,6970,6290,0,1,0
4,2.0,1440,7680,1.0,0,0,3,7,1200,240,1971,0,98034,47.7245,-122.2,1460,9660,397000,6,5,2014,0,43,6240,8200,0,1,0
3,2.5,2200,4052,2.0,0,0,3,8,2200,0,2005,0,98058,47.4362,-122.178,2310,5082,365000,12,5,2015,0,10,1852,2772,0,0,0
4,3.0,2290,8250,2.0,0,0,3,9,2290,0,1990,0,98042,47.3739,-122.156,2290,8250,328500,28,10,2014,0,24,5960,5960,0,0,0
4,2.5,2610,3277,1.5,0,0,5,8,1920,690,1922,0,98103,47.6636,-122.33,1810,3277,1000000,22,7,2014,0,92,667,1467,0,1,1
3,2.5,1490,2138,2.0,0,0,3,7,1490,0,2005,0,98055,47.4324,-122.197,1490,2094,237000,3,9,2014,0,9,648,604,0,0,0
4,2.5,2450,5280,2.0,0,0,3,8,2450,0,2003,0,98011,47.7734,-122.224,2300,4674,525000,19,9,2014,0,11,2830,2374,0,0,0
4,2.5,1710,9627,1.0,0,0,3,9,1440,270,1976,2014,98006,47.559,-122.164,2140,9131,749000,16,9,2014,38,38,7917,6991,1,1,0
5,2.5,4870,11800,2.0,0,0,3,10,3470,1400,1983,0,98074,47.633,-122.041,3180,11398,722500,21,8,2014,0,31,6930,8218,0,1,0
3,2.5,3130,8750,2.0,0,0,3,10,3130,0,1991,0,98052,47.6954,-122.103,2860,9003,843000,12,3,2015,0,24,5620,6143,0,0,0
2,2.0,1270,1372,3.0,0,0,3,8,1270,0,2000,0,98115,47.6776,-122.318,1610,3090,438000,8,7,2014,0,14,102,1480,0,0,1
3,1.75,2120,10875,1.0,0,2,3,8,1540,580,1977,0,98146,47.504,-122.382,2460,11760,578000,16,9,2014,0,37,8755,9300,0,1,1
3,1.5,1670,8230,1.0,0,0,5,7,1670,0,1954,0,98001,47.2613,-122.255,2077,4910,227950,23,9,2014,0,60,6560,2833,0,0,0
3,2.25,2070,11576,2.0,0,0,3,7,2070,0,1974,0,98001,47.3417,-122.271,1890,7519,196000,22,7,2014,0,40,9506,5629,0,0,0
2,1.0,1420,5332,1.0,0,0,3,8,1070,350,1953,0,98105,47.6694,-122.275,2400,5406,641000,15,7,2014,0,61,3912,3006,0,1,1
3,1.0,940,7980,1.0,0,0,4,7,940,0,1960,0,98032,47.3838,-122.289,1150,8050,205000,19,8,2014,0,54,7040,6900,0,0,0
3,1.75,1920,9102,1.0,0,0,3,7,1920,0,1968,0,98072,47.7487,-122.082,1920,9760,400000,2,12,2014,0,46,7182,7840,0,0,0
3,2.5,3545,9816,1.0,0,0,3,10,2610,935,2005,0,98027,47.5534,-122.078,3630,7704,1030000,10,11,2014,0,9,6271,4074,0,1,0
3,2.0,1260,5460,1.0,0,0,3,7,1260,0,1972,0,98034,47.7355,-122.18,1510,5460,505000,19,3,2015,0,43,4200,3950,0,0,0
5,2.5,2340,7200,1.0,0,0,3,7,1300,1040,1975,0,98034,47.7206,-122.211,1930,7221,475000,9,10,2014,0,39,4860,5291,0,1,0
3,2.25,2590,9263,1.0,0,0,5,8,1440,1150,1977,0,98028,47.7691,-122.262,2580,9450,520000,5,11,2014,0,37,6673,6870,0,1,0
3,1.75,1220,9732,1.0,0,0,3,7,1220,0,1965,0,98011,47.7736,-122.214,1630,10007,333500,31,12,2014,0,49,8512,8377,0,0,0
3,1.0,1400,10403,1.0,0,0,4,6,1400,0,1976,0,98038,47.362,-122.029,1230,10209,232000,22,2,2015,0,39,9003,8979,0,0,0
3,1.75,1870,9897,1.0,0,0,4,8,1870,0,1960,0,98040,47.5505,-122.221,1900,10005,811000,14,10,2014,0,54,8027,8105,0,0,0
3,2.5,2830,5802,2.0,0,0,3,9,2830,0,2001,0,98028,47.7605,-122.234,2500,5788,551000,20,5,2014,0,13,2972,3288,0,0,0
3,2.5,2260,3640,2.0,0,0,3,8,2260,0,1994,0,98072,47.7356,-122.157,2350,3710,496500,8,1,2015,0,21,1380,1360,0,0,0
4,2.5,3140,9225,1.0,0,2,5,9,1770,1370,1966,0,98055,47.4904,-122.226,2460,9600,578000,12,6,2014,0,48,6085,7140,0,1,0
3,1.75,1240,8659,1.0,0,0,5,7,1240,0,1986,0,98042,47.3663,-122.089,1490,8223,255000,28,1,2015,0,29,7419,6733,0,0,0
4,3.5,3450,7832,2.0,0,0,3,10,3450,0,2007,0,98006,47.5637,-122.123,3220,8567,1050000,26,6,2014,0,7,4382,5347,0,0,0
3,2.25,2570,8491,2.0,0,0,4,8,2570,0,1989,0,98042,47.3759,-122.125,2400,8049,348000,5,3,2015,0,26,5921,5649,0,0,0
3,2.0,1510,3413,2.0,0,0,3,7,1510,0,1985,0,98031,47.3912,-122.167,1570,3777,230000,4,11,2014,0,29,1903,2207,0,0,0
4,2.25,2390,11250,2.0,0,0,3,9,2390,0,1988,0,98023,47.3305,-122.371,2480,11250,359500,9,12,2014,0,26,8860,8770,0,0,0
3,1.0,980,7000,1.0,0,0,3,6,980,0,1953,0,98133,47.7617,-122.357,1220,7000,330000,12,11,2014,0,61,6020,5780,0,0,1
1,0.75,430,5050,1.0,0,0,2,4,430,0,1912,0,98014,47.6499,-121.909,1200,7500,80000,23,5,2014,0,102,4620,6300,0,0,0
3,1.75,1480,6360,1.0,0,0,3,7,1480,0,1954,0,98133,47.7311,-122.353,1480,6360,465000,1,12,2014,0,60,4880,4880,0,0,1
4,2.5,1850,7324,2.0,0,0,3,8,1850,0,1997,0,98042,47.3701,-122.107,2100,7329,325000,15,10,2014,0,17,5474,5229,0,0,0
3,2.5,1810,5192,2.0,0,0,3,8,1810,0,1993,0,98038,47.3724,-122.042,1810,6200,342500,6,1,2015,0,22,3382,4390,0,0,0
2,2.0,1610,17600,2.0,0,0,3,6,1610,0,1930,1983,98178,47.4855,-122.266,1310,12950,290900,23,6,2014,53,84,15990,11640,1,0,1
3,4.25,3840,6161,2.0,0,0,3,10,3840,0,2000,0,98074,47.6336,-122.064,3230,7709,868700,13,2,2015,0,15,2321,4479,0,0,0
4,2.75,4110,8400,2.0,0,1,3,9,3130,980,1928,2013,98125,47.717,-122.281,2820,8400,1200000,13,11,2014,85,86,4290,5580,1,1,1
4,3.25,4190,10259,2.0,0,0,3,11,3150,1040,2000,0,98074,47.6332,-122.066,4300,11919,1150000,14,10,2014,0,14,6069,7619,0,1,0
4,2.75,3390,6298,2.0,0,0,3,9,3390,0,2011,0,98074,47.5906,-122.062,3390,7111,859900,11,8,2014,0,3,2908,3721,0,0,0
4,2.25,1890,3006,2.0,0,0,3,7,1890,0,2003,0,98029,47.5461,-121.998,1580,3000,520000,8,8,2014,0,11,1116,1420,0,0,0
3,2.5,1610,2527,2.0,0,2,3,9,1080,530,2005,0,98118,47.5674,-122.29,1610,4173,460000,11,7,2014,0,9,917,2563,0,1,1
3,1.5,1050,4590,1.0,0,0,3,7,850,200,1949,0,98115,47.6943,-122.29,1770,5400,438924,1,9,2014,0,65,3540,3630,0,1,1
2,1.0,630,6550,1.0,0,0,3,5,630,0,1918,0,98126,47.5486,-122.38,1420,6550,315000,6,4,2015,0,97,5920,5130,0,0,1
4,2.75,2910,10650,1.0,0,2,3,8,1780,1130,1975,0,98033,47.6658,-122.188,2920,10988,590000,18,7,2014,0,39,7740,8068,0,1,0
4,1.75,1700,8640,1.0,0,0,3,7,850,850,1955,0,98006,47.5772,-122.153,1620,9000,378500,4,11,2014,0,59,6940,7380,0,1,0
3,2.5,1950,8130,2.0,0,0,4,9,1950,0,1990,0,98042,47.3875,-122.161,2350,7691,328500,3,6,2014,0,24,6180,5341,0,0,0
3,3.0,2990,9773,2.0,0,0,4,8,2990,0,1973,0,98005,47.6344,-122.174,2230,11553,849950,25,3,2015,0,42,6783,9323,0,0,0
3,1.5,1350,6000,1.0,0,2,3,7,900,450,1950,0,98136,47.5275,-122.391,1730,6012,525000,27,10,2014,0,64,4650,4282,0,1,1
4,2.5,2160,7725,1.0,0,0,4,8,1460,700,1978,0,98023,47.3078,-122.378,2060,8250,295000,28,4,2015,0,37,5565,6190,0,1,0
6,3.5,4860,11793,2.0,0,0,3,11,3860,1000,1998,0,98006,47.5521,-122.137,3600,11793,1070000,11,7,2014,0,16,6933,8193,0,1,0
2,2.0,890,5000,1.0,0,0,3,6,890,0,1917,0,98118,47.5158,-122.264,1860,5000,207950,21,7,2014,0,97,4110,3140,0,0,1
4,2.75,2810,7302,2.0,0,0,3,9,2810,0,2002,0,98075,47.5985,-121.977,2820,7302,699900,16,12,2014,0,12,4492,4482,0,0,0
5,2.5,3400,9500,2.0,0,1,4,8,3400,0,1977,0,98027,47.5645,-122.082,3080,11081,1280000,10,2,2015,0,38,6100,8001,0,0,0
4,1.5,1580,7350,1.0,0,0,4,7,960,620,1963,0,98052,47.6734,-122.154,1560,7350,452000,20,11,2014,0,51,5770,5790,0,1,0
3,2.0,1680,5036,1.0,0,1,4,7,1680,0,1987,0,98055,47.4734,-122.186,1680,4921,370000,5,2,2015,0,28,3356,3241,0,0,0
3,1.75,1300,11230,1.0,0,0,5,7,1300,0,1968,0,98042,47.3811,-122.087,1300,10794,232000,27,1,2015,0,47,9930,9494,0,0,0
5,2.5,2820,14062,2.0,0,0,4,7,2380,440,1960,0,98034,47.7081,-122.215,1910,10392,669950,30,10,2014,0,54,11242,8482,0,1,0
3,2.0,1510,6710,1.0,0,0,3,7,1070,440,1972,0,98034,47.7193,-122.216,1660,6600,397500,14,6,2014,0,42,5200,4940,0,1,0
2,2.5,1230,1391,2.0,0,0,3,8,870,360,2004,0,98112,47.6192,-122.301,1240,1350,490000,12,5,2014,0,10,161,110,0,1,1
4,2.0,2110,4140,2.0,0,0,3,9,1710,400,1925,2003,98116,47.5836,-122.387,1440,4420,725000,28,1,2015,78,90,2030,2980,1,1,1
2,1.5,1490,5750,1.5,0,0,4,7,1190,300,1900,0,98116,47.5872,-122.39,1590,4025,625000,18,8,2014,0,114,4260,2435,0,1,1
3,2.5,2120,4500,2.0,0,0,3,7,2120,0,2000,0,98065,47.5322,-121.88,2530,4816,437500,6,11,2014,0,14,2380,2286,0,0,0
4,2.5,3180,5438,2.0,0,0,3,9,3180,0,2003,0,98065,47.5416,-121.864,3030,5335,650000,10,5,2015,0,12,2258,2305,0,0,0
2,1.0,1490,3825,1.0,0,0,3,7,860,630,1929,0,98117,47.6799,-122.381,1460,3825,475000,19,5,2014,0,85,2335,2365,0,1,1
3,2.0,1930,11947,1.0,0,0,4,8,1930,0,1966,0,98042,47.3672,-122.151,2200,12825,342000,2,5,2014,0,48,10017,10625,0,0,0
4,2.5,2770,7800,2.0,0,0,3,10,2770,0,1999,0,98033,47.684,-122.205,2720,10000,1200000,15,10,2014,0,15,5030,7280,0,0,0
3,1.5,1670,11610,1.0,0,0,4,7,1670,0,1963,0,98055,47.4404,-122.191,1930,10200,280000,10,2,2015,0,52,9940,8270,0,0,0
2,1.75,1330,7200,1.0,0,0,3,7,1330,0,1993,0,98188,47.4467,-122.281,1450,11682,240000,21,5,2014,0,21,5870,10232,0,0,1
3,1.0,1210,3328,1.5,0,0,4,7,1210,0,1924,0,98107,47.6729,-122.363,1640,3333,529000,27,5,2014,0,90,2118,1693,0,0,1
3,1.0,1190,5100,1.0,0,0,4,7,1030,160,1941,0,98136,47.5346,-122.385,1690,5100,442000,2,2,2015,0,74,3910,3410,0,1,1
2,1.0,1540,6872,1.0,0,0,4,7,820,720,1946,0,98119,47.6454,-122.373,1420,5538,615000,8,5,2014,0,68,5332,4118,0,1,1
4,3.75,4030,10800,2.0,0,0,3,10,4030,0,2006,0,98033,47.6821,-122.196,2160,7200,1490000,12,6,2014,0,8,6770,5040,0,0,0
4,1.75,2430,7559,1.0,0,0,4,8,1580,850,1981,0,98052,47.7206,-122.11,1980,8750,585000,5,5,2015,0,34,5129,6770,0,1,0
4,2.5,2600,7787,2.0,0,0,3,8,2600,0,2005,0,98059,47.4877,-122.139,2830,7787,480000,5,3,2015,0,10,5187,4957,0,0,0
4,1.0,1330,8184,1.5,0,0,3,7,1330,0,1949,0,98133,47.7343,-122.347,1220,660,290000,5,11,2014,0,65,6854,-560,0,0,1
3,1.75,1900,5000,1.0,0,0,5,7,950,950,1951,0,98116,47.5789,-122.393,1770,5000,615000,20,8,2014,0,63,3100,3230,0,1,1
2,1.0,1100,7680,1.0,0,0,4,7,1100,0,1950,0,98133,47.7439,-122.339,1460,7680,300000,11,3,2015,0,65,6580,6220,0,0,1
3,2.5,2400,7745,2.0,0,0,3,9,2400,0,2001,0,98033,47.6734,-122.173,2080,8615,750000,7,5,2015,0,14,5345,6535,0,0,0
4,2.25,4760,8036,2.5,0,0,5,9,3390,1370,1916,0,98112,47.6415,-122.285,2950,9323,2250000,14,11,2014,0,98,3276,6373,0,1,1
3,1.0,1190,7560,1.0,0,0,5,6,1190,0,1958,0,98058,47.452,-122.177,1190,7560,288000,25,3,2015,0,57,6370,6370,0,0,0
2,1.0,630,6000,1.0,0,0,3,6,630,0,1943,2005,98178,47.4973,-122.221,1470,6840,190000,6,9,2014,62,71,5370,5370,1,0,1
5,3.0,2530,5105,1.0,0,0,3,8,1520,1010,2005,0,98133,47.7546,-122.341,2290,4011,515000,26,3,2015,0,10,2575,1721,0,1,1
4,1.5,1690,11054,1.0,0,0,4,5,1690,0,1930,0,98055,47.4667,-122.215,1690,9040,235000,5,11,2014,0,84,9364,7350,0,0,0
2,1.0,940,5000,1.0,0,0,3,6,940,0,1951,0,98126,47.5186,-122.374,940,5000,275000,18,8,2014,0,63,4060,4060,0,0,1
2,2.0,1240,9119,1.0,0,0,4,7,1240,0,1952,0,98004,47.6221,-122.193,1380,9121,727500,21,11,2014,0,62,7879,7741,0,0,0
4,2.5,3040,6587,2.0,0,0,3,7,3040,0,2003,0,98053,47.683,-122.039,2740,6587,650000,20,6,2014,0,11,3547,3847,0,0,0
4,1.0,1590,7085,1.5,0,0,3,6,1590,0,1944,0,98125,47.7315,-122.305,1320,7085,365000,5,11,2014,0,70,5495,5765,0,0,1
3,2.5,1780,7848,1.0,0,0,3,7,1320,460,1978,0,98038,47.3608,-122.056,1680,7848,270500,29,4,2015,0,37,6068,6168,0,1,0
2,1.5,1360,1898,2.0,0,0,3,7,1360,0,1978,0,98092,47.2852,-122.19,1360,1898,200000,5,5,2015,0,37,538,538,0,0,0
3,1.5,1010,9600,1.0,0,0,4,7,1010,0,1962,0,98198,47.4097,-122.316,1400,9660,160000,24,6,2014,0,52,8590,8260,0,0,1
3,1.0,1040,7405,1.0,0,0,4,6,1040,0,1971,0,98010,47.3105,-122.021,1580,7405,204000,18,2,2015,0,44,6365,5825,0,0,0
3,2.25,1610,6655,2.0,0,0,4,7,1610,0,1985,0,98058,47.4296,-122.161,1780,7529,358000,18,2,2015,0,30,5045,5749,0,0,0
4,1.75,1570,8268,1.0,0,0,3,7,1570,0,1979,0,98011,47.7373,-122.197,1870,8190,452000,1,5,2015,0,36,6698,6320,0,0,0
2,2.0,1510,4000,1.0,0,0,4,7,1010,500,1900,0,98103,47.6582,-122.345,1920,4000,595000,4,12,2014,0,114,2490,2080,0,1,1
3,2.0,1360,6082,1.0,0,0,3,7,1360,0,1994,0,98042,47.3577,-122.16,1360,6987,249000,10,4,2015,0,21,4722,5627,0,0,0
4,2.5,1970,5106,2.0,0,0,3,8,1970,0,1999,0,98055,47.449,-122.205,2230,5109,346900,10,3,2015,0,16,3136,2879,0,0,0
4,2.5,1560,4350,2.0,0,0,3,7,1560,0,2003,0,98056,47.5025,-122.186,1560,4350,280000,30,10,2014,0,11,2790,2790,0,0,0
4,1.75,2320,12000,1.0,0,0,4,8,2270,50,1973,0,98032,47.3644,-122.28,2120,9880,318888,13,10,2014,0,41,9680,7760,0,1,0
3,2.25,2120,18500,2.0,0,0,4,8,2120,0,1983,0,98031,47.3914,-122.169,2120,14479,375000,21,11,2014,0,31,16380,12359,0,0,0
4,2.5,2380,9614,2.0,0,0,4,10,2380,0,1991,0,98006,47.5623,-122.116,2560,9770,782000,23,5,2014,0,23,7234,7210,0,0,0
2,2.0,1070,649,2.0,0,0,3,9,720,350,2008,0,98106,47.5213,-122.357,1070,928,259950,19,3,2015,0,7,-421,-142,0,1,1
4,2.75,2300,18360,1.0,0,0,4,7,1560,740,1979,0,98058,47.4518,-122.16,1870,9588,315000,23,9,2014,0,35,16060,7718,0,1,0
2,1.0,1320,8865,1.0,0,0,4,6,1320,0,1943,0,98168,47.4949,-122.3,1190,6490,215000,28,5,2014,0,71,7545,5300,0,0,1
3,1.75,2180,10221,1.0,0,2,4,7,1140,1040,1946,0,98040,47.5885,-122.248,2180,8535,705000,23,7,2014,0,68,8041,6355,0,1,0
3,3.0,4380,6320,2.0,0,3,5,10,3580,800,1952,0,98199,47.6452,-122.411,3080,7680,1450000,13,10,2014,0,62,1940,4600,0,1,1
3,1.75,1790,9813,2.0,0,0,3,7,1790,0,1949,0,98155,47.749,-122.305,1520,10125,451000,8,5,2015,0,66,8023,8605,0,0,1
2,1.0,750,8125,1.0,0,0,4,6,750,0,1943,0,98055,47.4727,-122.198,1340,8750,261000,2,9,2014,0,71,7375,7410,0,0,0
3,1.5,1300,8280,1.0,0,0,5,7,1300,0,1956,0,98028,47.7403,-122.256,1570,8692,396000,17,11,2014,0,58,6980,7122,0,0,0
4,1.0,1400,7242,1.5,0,0,3,7,1400,0,1959,0,98188,47.4339,-122.291,1310,7314,238000,15,7,2014,0,55,5842,6004,0,0,1
6,1.75,2750,9563,2.0,0,0,4,8,2750,0,1973,0,98052,47.6368,-122.097,2040,9563,750000,27,4,2015,0,42,6813,7523,0,0,0
4,2.5,2050,10271,2.0,0,0,3,7,2050,0,1998,0,98042,47.3628,-122.075,2050,8103,331500,27,10,2014,0,16,8221,6053,0,0,0
3,2.5,2870,5163,2.0,0,0,3,9,2870,0,2014,0,98103,47.6935,-122.352,1630,7995,880000,17,12,2014,0,0,2293,6365,0,0,1
3,1.75,2080,9162,1.0,0,0,3,7,1370,710,1960,0,98005,47.5846,-122.168,1870,8944,638700,16,12,2014,0,54,7082,7074,0,1,0
3,2.5,1840,5680,2.0,0,0,3,7,1840,0,2008,0,98053,47.6969,-122.026,1600,4697,435000,28,7,2014,0,6,3840,3097,0,0,0
3,1.0,1180,5350,1.5,0,0,4,6,1180,0,1959,0,98178,47.505,-122.259,1490,5350,260000,31,12,2014,0,55,4170,3860,0,0,1
5,2.75,2160,4000,1.5,0,0,5,7,1530,630,1927,0,98105,47.667,-122.289,2040,4000,671500,14,8,2014,0,87,1840,1960,0,1,1
3,1.0,1180,3400,1.5,0,0,3,8,1180,0,1907,0,98109,47.6376,-122.353,1440,3400,610000,22,10,2014,0,107,2220,1960,0,0,1
4,2.5,1830,5612,2.0,0,0,3,7,1830,0,2003,0,98038,47.3572,-122.015,1830,5998,338900,18,7,2014,0,11,3782,4168,0,0,0
4,4.0,3200,7708,2.0,0,0,3,10,3200,0,2004,0,98075,47.5816,-121.97,3480,7944,720000,23,1,2015,0,11,4508,4464,0,0,0
5,3.0,2560,5445,1.5,0,0,4,7,1760,800,1927,0,98108,47.5502,-122.311,1080,5445,442000,24,4,2015,0,88,2885,4365,0,1,1
5,2.75,2550,5040,1.5,0,0,5,8,2550,0,1902,0,98122,47.6136,-122.299,1590,3840,650000,3,6,2014,0,112,2490,2250,0,0,1
3,1.75,1330,9917,1.0,0,0,3,7,1040,290,1981,0,98058,47.4478,-122.161,1330,9081,263500,2,1,2015,0,34,8587,7751,0,1,0
3,2.5,1805,3402,2.0,0,0,3,7,1805,0,2009,0,98002,47.3521,-122.212,2095,3402,266000,9,12,2014,0,5,1597,1307,0,0,0
4,2.5,2320,5493,2.0,0,0,3,8,2320,0,2004,0,98028,47.7727,-122.229,2450,5471,530000,27,1,2015,0,11,3173,3021,0,0,0
3,1.0,1384,8960,1.0,0,0,4,6,1384,0,1965,0,98023,47.3062,-122.371,1000,8470,180000,11,12,2014,0,49,7576,7470,0,0,0
3,2.5,2720,6439,2.0,0,0,3,9,2720,0,2005,0,98065,47.5422,-121.86,3180,7320,619000,16,5,2014,0,9,3719,4140,0,0,0
3,1.5,1820,10608,1.0,0,0,4,7,1820,0,1962,0,98003,47.3366,-122.306,1380,8976,264000,21,8,2014,0,52,8788,7596,0,0,0
2,2.25,2130,4920,1.5,0,4,4,7,1530,600,1941,0,98116,47.573,-122.409,2130,4920,730000,1,7,2014,0,73,2790,2790,0,1,1
4,2.25,2060,10070,2.0,0,0,3,7,2060,0,1975,0,98034,47.7258,-122.177,2060,8155,439000,22,10,2014,0,39,8010,6095,0,0,0
4,1.75,1420,7500,1.0,0,0,4,7,1080,340,1981,0,98031,47.4025,-122.176,1500,7260,268500,17,11,2014,0,33,6080,5760,0,1,0
3,2.5,2160,4000,1.5,0,0,3,8,1960,200,1903,2013,98122,47.6045,-122.307,2160,5120,640000,19,8,2014,110,111,1840,2960,1,1,1
3,2.5,3180,12600,2.0,0,0,4,11,3180,0,1978,0,98074,47.6366,-122.058,3030,12835,900000,8,7,2014,0,36,9420,9805,0,0,0
3,2.25,2110,13300,2.0,0,0,4,8,2110,0,1985,0,98038,47.3725,-122.06,2470,14000,370000,30,9,2014,0,29,11190,11530,0,0,0
3,2.0,2060,2900,1.5,0,0,5,8,1330,730,1931,0,98144,47.5897,-122.292,1910,3900,685000,14,3,2015,0,84,840,1990,0,1,1
3,2.5,1610,2937,2.0,0,0,3,8,1610,0,2006,0,98055,47.4489,-122.188,1610,3049,290000,24,3,2015,0,9,1327,1439,0,0,0
4,2.5,1780,3600,2.0,0,0,3,7,1780,0,2006,0,98038,47.3665,-122.017,2020,3802,296000,2,9,2014,0,8,1820,1782,0,0,0
4,2.5,1840,9611,2.0,0,0,3,7,1840,0,1996,0,98178,47.4964,-122.251,1830,8505,360000,13,2,2015,0,19,7771,6675,0,0,1
3,1.75,1460,10584,1.0,0,0,3,7,990,470,1997,0,98168,47.492,-122.317,1220,12012,240500,4,6,2014,0,17,9124,10792,0,1,1
2,2.5,1400,2958,2.0,0,0,3,8,1400,0,2007,0,98126,47.5496,-122.373,1540,2385,372500,22,7,2014,0,7,1558,845,0,0,1
3,2.5,3370,14402,2.0,0,2,3,9,3370,0,2004,0,98045,47.5008,-121.776,3330,9691,595000,2,10,2014,0,10,11032,6361,0,0,0
4,3.0,3590,8249,2.0,0,0,3,9,3590,0,1997,0,98023,47.2846,-122.341,2860,7995,515000,17,10,2014,0,17,4659,5135,0,0,0
2,1.75,1670,6460,1.0,0,0,3,8,1670,0,2004,0,98053,47.7123,-122.027,2170,6254,507000,9,10,2014,0,10,4790,4084,0,0,0
3,1.75,1430,10816,2.0,0,0,3,7,1430,0,1994,0,98010,47.3122,-121.996,1560,10816,185000,20,8,2014,0,20,9386,9256,0,0,0
3,1.75,1440,7070,1.0,0,0,3,7,1440,0,1980,0,98052,47.6947,-122.125,1440,7210,460000,25,8,2014,0,34,5630,5770,0,0,0
3,2.25,1450,4789,2.0,0,0,3,7,1450,0,1985,0,98029,47.5665,-122.018,1560,4490,435500,24,2,2015,0,30,3339,2930,0,0,0
4,2.75,3550,13938,1.0,0,0,5,8,2100,1450,1966,0,98188,47.425,-122.283,2050,9000,469000,8,4,2015,0,49,10388,6950,0,1,1
2,3.0,1270,1175,2.0,0,0,3,8,1110,160,2000,0,98103,47.6634,-122.34,1290,1800,531000,5,5,2014,0,14,-95,510,0,1,1
2,1.0,940,6804,1.0,0,0,3,7,940,0,1949,0,98177,47.7047,-122.373,1150,6930,443500,6,2,2015,0,66,5864,5780,0,0,1
3,2.0,1670,6824,1.0,0,0,3,7,1300,370,1990,0,98042,47.3666,-122.084,1660,7586,223000,26,11,2014,0,24,5154,5926,0,1,0
2,2.5,1100,1760,3.0,0,0,3,7,1100,0,1997,0,98103,47.6972,-122.35,1200,1415,340000,9,12,2014,0,17,660,215,0,0,1
3,2.0,1870,3388,1.0,0,0,4,8,1230,640,1925,0,98199,47.6372,-122.395,1780,4050,650000,5,11,2014,0,89,1518,2270,0,1,1
3,2.5,1930,5080,2.0,0,0,4,8,1930,0,1990,0,98029,47.5694,-122.001,2190,5085,533600,25,9,2014,0,24,3150,2895,0,0,0
3,2.75,2540,4694,2.0,0,0,3,9,2540,0,2005,0,98074,47.6214,-122.024,2600,6344,695000,10,6,2014,0,9,2154,3744,0,0,0
3,1.75,1280,7524,1.5,0,0,4,7,1280,0,1988,0,98031,47.3961,-122.188,1500,7777,242000,17,6,2014,0,26,6244,6277,0,0,0
3,2.25,1820,8814,1.0,0,0,3,7,1280,540,1967,0,98125,47.7162,-122.309,1810,7515,425000,14,1,2015,0,48,6994,5705,0,1,1
3,2.25,1490,9414,2.0,0,0,3,7,1490,0,1981,0,98052,47.6844,-122.113,1290,10125,525000,6,5,2015,0,34,7924,8835,0,0,0
3,2.5,1880,5502,2.0,0,0,3,8,1880,0,1988,0,98029,47.5737,-122.018,2040,5411,485000,22,9,2014,0,26,3622,3371,0,0,0
3,1.0,1250,9775,1.0,0,0,3,7,1250,0,1971,0,98045,47.4474,-121.771,1390,9650,175000,13,1,2015,0,44,8525,8260,0,0,0
3,2.0,1440,7210,1.0,0,0,3,8,1440,0,1983,0,98092,47.3128,-122.184,1700,7245,210000,19,6,2014,0,31,5770,5545,0,0,0
3,2.5,1920,7415,2.0,0,0,3,7,1920,0,1989,0,98031,47.4022,-122.171,1930,7536,260000,15,4,2015,0,26,5495,5606,0,0,0
3,2.5,2060,5750,1.0,0,0,3,7,1330,730,1976,0,98116,47.5671,-122.391,1920,5750,577000,23,6,2014,0,38,3690,3830,0,1,1
3,1.5,1210,10588,1.0,0,0,4,7,1210,0,1958,0,98002,47.2876,-122.212,1408,10588,200000,21,10,2014,0,56,9378,9180,0,0,0
2,1.75,1760,5000,1.0,0,0,4,7,940,820,1927,0,98117,47.682,-122.372,1530,5000,605000,25,2,2015,0,88,3240,3470,0,1,1
3,1.0,990,6750,1.0,0,0,4,6,990,0,1947,0,98133,47.7125,-122.331,1440,6860,325000,21,5,2014,0,67,5760,5420,0,0,1
3,1.0,960,6400,1.0,0,0,4,6,820,140,1944,0,98178,47.496,-122.239,1200,6600,289500,14,8,2014,0,70,5440,5400,0,1,1
3,2.5,1660,1458,3.0,0,0,3,9,1660,0,2014,0,98144,47.5876,-122.309,1660,1784,559950,8,8,2014,0,0,-202,124,0,0,1
3,1.75,1900,9375,1.0,0,1,4,8,1330,570,1941,0,98115,47.6821,-122.273,2760,9375,1040000,6,4,2015,0,74,7475,6615,0,1,1
3,2.25,1270,2790,1.0,0,0,3,7,990,280,1970,0,98199,47.6581,-122.396,1920,4000,543500,9,10,2014,0,44,1520,2080,0,1,1
3,1.0,960,9633,1.0,0,0,5,6,960,0,1982,0,98022,47.1951,-122.001,1080,8610,218000,23,5,2014,0,32,8673,7530,0,0,0
2,1.75,1330,6000,1.0,0,0,4,7,960,370,1914,1945,98199,47.6539,-122.396,1620,6000,565000,22,6,2014,31,100,4670,4380,1,1,1
3,1.75,2080,7700,1.0,0,0,5,7,1600,480,1968,0,98056,47.5375,-122.178,1680,7700,426700,12,12,2014,0,46,5620,6020,0,1,0
3,2.5,2690,11575,1.0,0,3,3,8,2130,560,1957,0,98028,47.7605,-122.267,2390,11782,650000,12,9,2014,0,57,8885,9392,0,1,0
2,1.0,890,3060,1.0,0,0,3,7,770,120,1910,0,98105,47.6663,-122.326,1760,4080,542000,24,9,2014,0,104,2170,2320,0,1,1
3,1.75,1070,8000,1.0,0,0,3,7,1070,0,1977,0,98052,47.6978,-122.13,1200,7990,415000,24,6,2014,0,37,6930,6790,0,0,0
3,1.0,1200,8316,1.0,0,0,4,6,1200,0,1953,0,98002,47.3221,-122.215,1200,8316,214000,15,8,2014,0,61,7116,7116,0,0,0
3,1.5,1360,8910,2.0,0,0,5,7,1360,0,1949,0,98188,47.4488,-122.275,1220,8912,245000,21,1,2015,0,66,7550,7692,0,0,1
3,2.0,2050,13303,1.0,0,0,3,8,2050,0,1993,0,98003,47.2681,-122.31,2180,11590,314500,1,7,2014,0,21,11253,9410,0,0,0
3,1.5,3000,5750,2.0,0,0,5,9,2000,1000,1924,0,98116,47.5821,-122.39,1820,5750,1120000,9,4,2015,0,91,2750,3930,0,1,1
2,2.0,1300,3850,1.0,0,0,3,7,800,500,1963,0,98136,47.5395,-122.39,950,5500,378000,3,3,2015,0,52,2550,4550,0,1,1
4,2.5,2250,9091,1.0,0,0,3,7,1340,910,1982,0,98001,47.336,-122.269,1540,7802,305000,28,7,2014,0,32,6841,6262,0,1,0
5,2.75,3740,6750,1.0,0,0,4,8,1980,1760,1978,0,98028,47.7679,-122.261,2620,7920,595000,20,3,2015,0,37,3010,5300,0,1,0
3,2.5,1660,1091,3.0,0,1,3,9,1530,130,2015,0,98116,47.5818,-122.402,1510,1352,729500,12,5,2015,0,0,-569,-158,0,1,1
3,2.5,2360,6699,2.0,0,0,3,7,2360,0,2003,0,98065,47.5317,-121.853,2360,4744,430000,30,9,2014,0,11,4339,2384,0,0,0
3,1.75,1760,6500,1.0,0,0,3,7,1150,610,1987,0,98038,47.3647,-122.05,1760,8125,240000,9,4,2015,0,28,4740,6365,0,1,0
3,1.75,1680,6200,1.5,0,0,3,7,1680,0,1916,0,98136,47.5338,-122.384,1680,5100,545000,20,3,2015,0,99,4520,3420,0,0,1
3,1.75,1320,2500,1.0,0,0,3,7,870,450,1918,0,98105,47.6681,-122.305,1580,2750,530000,7,7,2014,0,96,1180,1170,0,1,1
4,1.0,1260,7645,1.5,0,0,3,6,1260,0,1925,0,98146,47.5044,-122.35,1170,7649,425000,7,4,2015,0,90,6385,6479,0,0,1
3,1.0,1000,6020,1.0,0,0,3,6,1000,0,1944,0,98166,47.4793,-122.346,1300,8640,220000,17,11,2014,0,70,5020,7340,0,0,1
3,1.0,1920,6862,1.0,0,2,3,7,1120,800,1952,0,98118,47.5193,-122.274,2000,6900,325000,23,5,2014,0,62,4942,4900,0,1,1
3,2.0,2150,5400,1.5,0,0,4,7,1380,770,1911,0,98126,47.555,-122.379,1940,6500,597500,3,4,2015,0,104,3250,4560,0,1,1
3,2.5,1470,3976,2.0,0,0,3,7,1470,0,1999,0,98065,47.526,-121.826,1490,4400,337000,23,7,2014,0,15,2506,2910,0,0,0
3,2.5,3180,10492,2.0,0,2,3,10,3180,0,1991,0,98052,47.655,-122.124,3000,9812,1000000,22,4,2015,0,24,7312,6812,0,0,0
3,1.0,990,6000,1.0,0,0,3,6,990,0,1943,0,98105,47.6718,-122.267,1250,6000,495000,7,5,2014,0,71,5010,4750,0,0,1
4,3.5,2770,3330,2.0,0,0,3,8,1970,800,2001,0,98052,47.6327,-122.109,2180,3380,748000,2,1,2015,0,14,560,1200,0,1,0
3,1.5,1250,8710,1.0,0,0,4,7,1250,0,1953,0,98004,47.6245,-122.198,1750,9185,888000,2,9,2014,0,61,7460,7435,0,0,0
4,2.5,2250,14440,1.0,0,0,3,7,1550,700,1967,0,98027,47.5221,-122.045,2090,11400,496500,13,11,2014,0,47,12190,9310,0,1,0
3,2.5,1640,5097,2.0,0,0,3,7,1640,0,1969,0,98155,47.7522,-122.278,1880,6000,475000,21,1,2015,0,46,3457,4120,0,0,1
3,1.5,1255,1374,3.0,0,0,3,7,1255,0,2004,0,98125,47.7145,-122.311,1307,1232,312000,27,5,2014,0,10,119,-75,0,0,1
3,1.0,1290,12231,1.0,0,0,3,7,1290,0,1976,0,98072,47.7404,-122.11,1390,11632,323000,24,11,2014,0,38,10941,10242,0,0,0
3,1.75,1300,9079,1.0,0,0,3,7,1300,0,1986,0,98059,47.4834,-122.159,1890,7369,331000,24,11,2014,0,28,7779,5479,0,0,0
3,1.5,1220,1086,3.0,0,0,3,8,1220,0,2007,0,98133,47.7049,-122.353,1220,1422,306000,14,5,2014,0,7,-134,202,0,0,1
4,2.5,2630,4000,3.0,0,0,3,8,2630,0,2002,0,98117,47.6915,-122.381,1640,4000,655000,30,9,2014,0,12,1370,2360,0,0,1
3,1.5,1950,15954,1.0,0,0,4,8,1950,0,1959,0,98003,47.336,-122.319,1940,12667,290000,9,7,2014,0,55,14004,10727,0,0,0
4,3.25,3160,5000,2.0,0,0,5,9,2360,800,1965,0,98105,47.6597,-122.274,2220,4000,1250000,2,8,2014,0,49,1840,1780,0,1,1
3,1.75,1550,4708,1.0,0,0,4,7,860,690,1949,0,98115,47.6759,-122.286,1880,5600,460000,16,6,2014,0,65,3158,3720,0,1,1
4,2.5,1700,6380,1.0,0,0,4,7,850,850,1940,0,98115,47.6988,-122.319,1380,6380,435000,12,9,2014,0,74,4680,5000,0,1,1
4,2.75,2510,11880,1.0,0,0,5,8,1630,880,1978,0,98006,47.5427,-122.181,2390,11211,664000,16,3,2015,0,37,9370,8821,0,1,0
4,1.75,1800,4180,2.0,0,3,4,8,1800,0,1921,0,98102,47.6462,-122.318,2180,4620,865000,29,7,2014,0,93,2380,2440,0,0,1
3,2.25,1870,9315,1.0,0,0,3,7,1350,520,1975,0,98034,47.705,-122.202,2230,9579,497000,18,7,2014,0,39,7445,7349,0,1,0
2,1.0,1010,3000,1.0,0,0,4,7,1010,0,1925,0,98045,47.4965,-121.785,1150,7000,280000,23,6,2014,0,89,1990,5850,0,0,0
2,1.5,1120,17487,1.0,0,0,3,6,1120,0,1924,0,98178,47.5024,-122.271,1690,8056,188000,27,1,2015,0,91,16367,6366,0,0,1
3,1.0,2090,4755,1.0,0,2,3,8,1200,890,1969,0,98136,47.5304,-122.387,1850,5300,478500,30,9,2014,0,45,2665,3450,0,1,1
4,3.5,4370,18361,2.0,0,0,3,11,4370,0,2001,0,98065,47.544,-121.872,4190,13641,1150000,31,7,2014,0,13,13991,9451,0,0,0
3,2.0,1440,7187,1.0,0,0,4,7,970,470,1981,0,98023,47.291,-122.368,1440,7187,222000,15,8,2014,0,33,5747,5747,0,1,0
4,2.5,3190,7399,2.0,0,0,3,10,3190,0,2006,0,98038,47.3558,-122.004,3250,7323,609900,9,6,2014,0,8,4209,4073,0,0,0
4,3.5,2380,5809,2.0,0,0,4,7,1750,630,1995,0,98106,47.5536,-122.359,1620,5775,413000,16,10,2014,0,19,3429,4155,0,1,1
4,1.0,1420,4875,1.5,0,0,3,7,1420,0,1930,0,98115,47.6942,-122.321,1110,5413,400000,13,10,2014,0,84,3455,4303,0,0,1
5,2.75,2990,6768,2.0,0,0,3,9,2990,0,2014,0,98006,47.5462,-122.182,2870,6768,802541,5,1,2015,0,1,3778,3898,0,0,0
3,2.5,2680,7757,2.0,0,0,3,8,2680,0,1990,0,98023,47.2918,-122.346,2430,8231,320000,19,5,2014,0,24,5077,5801,0,0,0
4,2.5,2730,7649,2.0,0,0,3,7,2730,0,2006,0,98065,47.5441,-121.882,2730,6216,507000,11,3,2015,0,9,4919,3486,0,0,0
3,1.0,1220,8329,1.0,0,0,3,6,1220,0,1946,0,98115,47.6982,-122.298,1490,8322,387500,24,9,2014,0,68,7109,6832,0,0,1
3,1.0,1500,12616,1.0,0,0,3,7,1500,0,1967,0,98072,47.7415,-122.101,1820,13950,396000,24,2,2015,0,48,11116,12130,0,0,0
3,1.75,1830,11788,1.0,0,1,3,8,1430,400,1958,0,98055,47.4862,-122.224,2140,11964,373000,21,8,2014,0,56,9958,9824,0,1,0
4,2.25,2470,7698,2.0,0,0,3,8,2470,0,1983,0,98058,47.4406,-122.141,2330,7986,359900,21,7,2014,0,31,5228,5656,0,0,0
2,1.0,800,4342,1.0,0,0,3,6,670,130,1927,0,98115,47.6997,-122.316,1210,4343,410000,4,3,2015,0,88,3542,3133,0,1,1
3,2.0,1410,5760,1.0,0,0,3,7,1410,0,1985,0,98030,47.3702,-122.185,1670,6222,245000,25,6,2014,0,29,4350,4552,0,0,0
4,1.75,1680,9966,1.0,0,0,3,7,1100,580,1977,0,98198,47.3923,-122.311,2400,10369,268000,22,9,2014,0,37,8286,7969,0,1,1
4,2.25,2240,11034,2.0,0,0,3,8,2240,0,1976,0,98004,47.5894,-122.195,2300,11550,980000,9,10,2014,0,38,8794,9250,0,0,0
2,1.0,1380,5000,1.5,0,2,3,5,1380,0,1905,0,98106,47.5708,-122.359,1500,5000,795000,7,4,2015,0,110,3620,3500,0,0,1
2,1.0,820,5100,1.0,0,0,3,6,820,0,1953,0,98118,47.5156,-122.262,1170,5304,195000,4,5,2015,0,62,4280,4134,0,0,1
4,2.0,2180,10575,1.0,0,0,2,6,1730,450,1950,0,98005,47.589,-122.177,2180,12010,480000,3,11,2014,0,64,8395,9830,0,1,0
4,2.0,1400,3600,1.0,0,0,3,7,1100,300,1900,0,98119,47.6385,-122.37,1630,2048,485000,19,12,2014,0,114,2200,418,0,1,1
2,1.0,880,9000,1.0,0,0,3,5,880,0,1928,0,98188,47.4672,-122.291,1410,10000,130000,15,8,2014,0,86,8120,8590,0,0,1
2,1.0,1060,5703,1.0,0,2,4,6,1060,0,1946,0,98198,47.3444,-122.327,2240,4416,325000,4,8,2014,0,68,4643,2176,0,0,1
3,1.75,1530,7245,1.0,0,0,4,7,1530,0,1984,0,98034,47.731,-122.191,1530,7490,440000,13,4,2015,0,31,5715,5960,0,0,0
4,1.75,2480,14782,1.0,0,3,3,8,1460,1020,1958,0,98155,47.7646,-122.271,2910,10800,550000,14,10,2014,0,56,12302,7890,0,1,1
3,1.75,1490,7150,1.0,0,0,5,6,1490,0,1967,0,98059,47.5015,-122.124,1350,9100,310000,5,8,2014,0,47,5660,7750,0,0,0
4,2.5,2340,8548,2.0,0,0,3,8,2340,0,1993,0,98031,47.4206,-122.183,1970,6818,390000,25,6,2014,0,21,6208,4848,0,0,0
3,1.75,1450,12125,1.0,0,0,4,7,1450,0,1981,0,98001,47.3575,-122.28,1210,12125,243000,8,9,2014,0,33,10675,10915,0,0,0
4,2.5,2210,9875,2.0,0,0,3,9,2210,0,1990,0,98074,47.6285,-122.025,2440,8799,639000,22,7,2014,0,24,7665,6359,0,0,0
4,1.0,1130,7400,1.0,0,0,4,7,1130,0,1969,0,98003,47.3437,-122.316,1540,7379,215000,18,9,2014,0,45,6270,5839,0,0,0
5,1.75,1550,10500,1.0,0,0,3,7,1100,450,1961,0,98011,47.7573,-122.22,1420,9823,405000,4,3,2015,0,54,8950,8403,0,1,0
4,1.75,1710,7140,1.0,0,0,5,7,1010,700,1968,0,98032,47.3745,-122.275,1770,8960,250000,22,12,2014,0,46,5430,7190,0,1,0
3,1.5,1010,8108,1.0,0,0,5,7,1010,0,1954,0,98155,47.7359,-122.309,1300,8108,405500,15,7,2014,0,60,7098,6808,0,0,1
6,2.25,2660,13579,2.0,0,0,3,7,2660,0,1937,1990,98125,47.7142,-122.286,1120,8242,452000,28,7,2014,53,77,10919,7122,1,0,1
6,2.25,2660,13579,2.0,0,0,3,7,2660,0,1937,1990,98125,47.7142,-122.286,1120,8242,730000,2,1,2015,53,78,10919,7122,1,0,1
3,2.0,1300,9644,1.0,0,0,3,7,1300,0,1994,0,98010,47.3131,-121.998,1430,9656,267000,14,4,2015,0,21,8344,8226,0,0,0
3,2.5,1670,6186,2.0,0,0,3,7,1670,0,2002,0,98038,47.3668,-122.031,2390,6924,289950,8,8,2014,0,12,4516,4534,0,0,0
2,1.0,960,4080,1.0,0,0,5,7,960,0,1911,0,98103,47.6893,-122.349,1300,4080,565000,28,7,2014,0,103,3120,2780,0,0,1
3,2.5,2140,2770,2.0,0,0,3,8,1770,370,2007,0,98052,47.6664,-122.131,2510,2708,636000,20,4,2015,0,8,630,198,0,1,0
5,3.0,2520,5500,1.0,0,0,3,8,1550,970,2004,0,98178,47.4938,-122.255,1700,8000,350000,18,9,2014,0,10,2980,6300,0,1,1
3,1.5,1650,9380,1.0,0,0,5,7,1130,520,1978,0,98058,47.4525,-122.162,1720,8856,320000,4,6,2014,0,36,7730,7136,0,1,0
2,1.75,1440,5680,1.0,0,0,4,8,1440,0,1978,0,98198,47.3825,-122.319,1320,3547,210000,13,6,2014,0,36,4240,2227,0,0,1
2,1.0,1050,5900,1.0,0,0,3,7,1050,0,1950,0,98126,47.5326,-122.376,1280,5900,245000,10,9,2014,0,64,4850,4620,0,0,1
3,1.75,1470,7650,1.0,0,0,3,7,1130,340,1983,0,98059,47.4818,-122.161,1590,7500,328000,6,11,2014,0,31,6180,5910,0,1,0
3,1.75,1970,7972,1.0,0,3,5,8,1370,600,1976,0,98055,47.4908,-122.225,2460,9796,501000,12,6,2014,0,38,6002,7336,0,1,0
3,2.25,1540,17424,2.0,0,0,3,7,1540,0,1992,0,98045,47.4429,-121.759,1560,11439,315000,17,9,2014,0,22,15884,9879,0,0,0
3,2.75,2090,8354,2.0,0,0,3,8,2090,0,2012,0,98019,47.7336,-121.965,2280,6348,403000,8,5,2014,0,2,6264,4068,0,0,0
4,2.5,2156,3562,2.0,0,0,3,9,2156,0,2012,0,98030,47.3591,-122.201,1708,3539,347500,13,1,2015,0,3,1406,1831,0,0,0
4,2.25,2070,8893,2.0,0,0,4,8,2070,0,1986,0,98058,47.4388,-122.162,2390,7700,365000,6,10,2014,0,28,6823,5310,0,0,0
3,1.0,1910,8167,1.0,0,0,4,8,1270,640,1951,0,98117,47.7004,-122.368,1500,6816,588000,24,2,2015,0,64,6257,5316,0,1,1
3,1.75,1920,7400,1.0,0,0,4,8,1260,660,1977,0,98006,47.5633,-122.131,2360,8048,605000,20,8,2014,0,37,5480,5688,0,1,0
3,3.25,3400,5979,2.0,0,0,4,9,2290,1110,1937,0,98105,47.6585,-122.273,3090,6435,1300000,13,11,2014,0,77,2579,3345,0,1,1
3,2.0,1400,9177,1.0,0,0,3,7,1400,0,1974,0,98001,47.3415,-122.272,2020,8547,233000,19,11,2014,0,40,7777,6527,0,0,0
2,1.75,1170,4887,1.0,0,0,3,6,1020,150,1929,0,98117,47.695,-122.366,1170,5441,459000,15,12,2014,0,85,3717,4271,0,1,1
3,1.0,1160,9750,1.0,0,0,3,7,1160,0,1967,0,98077,47.7422,-122.073,1160,9650,305000,17,9,2014,0,47,8590,8490,0,0,0
3,1.0,1500,4000,1.0,0,0,3,6,900,600,1925,0,98117,47.6921,-122.38,950,4000,395000,20,6,2014,0,89,2500,3050,0,1,1
4,2.5,2940,6000,2.0,0,0,3,8,2940,0,2000,0,98011,47.7533,-122.198,2510,6600,560000,23,1,2015,0,15,3060,4090,0,0,0
4,1.75,2010,5070,1.0,0,1,4,7,1300,710,1963,0,98116,47.5793,-122.402,2180,5400,650000,14,7,2014,0,51,3060,3220,0,1,1
3,2.5,2170,4912,2.0,0,0,3,7,2170,0,2003,0,98028,47.7767,-122.239,2010,4395,449950,5,6,2014,0,11,2742,2385,0,0,0
3,1.5,1430,5200,1.0,0,3,4,7,1250,180,1940,0,98117,47.6988,-122.387,2210,6240,517500,24,2,2015,0,75,3770,4030,0,1,1
4,1.5,1510,6460,1.0,0,0,3,7,1070,440,1970,0,98034,47.7121,-122.214,1450,6630,435000,3,9,2014,0,44,4950,5180,0,1,0
3,1.0,1150,6908,1.0,0,0,3,6,800,350,1952,0,98155,47.7447,-122.313,1150,6908,329999,9,4,2015,0,63,5758,5758,0,1,1
3,1.75,2150,4200,1.0,0,4,5,8,1140,1010,1960,0,98116,47.5671,-122.405,2510,7500,950000,10,12,2014,0,54,2050,4990,0,1,1
3,1.0,1370,6001,1.0,0,0,5,7,1230,140,1944,0,98108,47.5646,-122.317,1370,5520,447000,30,7,2014,0,70,4631,4150,0,1,1
2,2.5,2380,6600,1.0,0,0,3,8,2380,0,2010,0,98053,47.717,-122.02,1870,6600,699800,28,8,2014,0,4,4220,4730,0,0,0
3,1.75,1370,3850,1.0,0,0,5,7,770,600,1911,1988,98112,47.6374,-122.279,1390,3600,850000,3,6,2014,77,103,2480,2210,1,1,1
3,1.75,1600,14250,1.0,0,0,3,7,1070,530,1979,0,98023,47.3272,-122.355,2140,14960,316500,2,9,2014,0,35,12650,12820,0,1,0
5,3.5,3750,9612,1.0,0,2,4,9,2030,1720,1981,0,98006,47.5511,-122.157,3270,9688,942500,15,7,2014,0,33,5862,6418,0,1,0
2,2.25,3950,3938,2.0,0,4,3,10,2910,1040,1991,0,98116,47.5912,-122.384,3220,4500,1310000,21,1,2015,0,24,-12,1280,0,1,1
4,2.25,2400,13430,1.0,0,0,4,9,2400,0,1964,0,98005,47.5987,-122.178,2580,10077,856600,2,2,2015,0,51,11030,7497,0,0,0
5,1.5,2830,4000,2.5,0,0,4,8,2830,0,1918,0,98118,47.5132,-122.262,1480,4000,405600,24,10,2014,0,96,1170,2520,0,0,1
3,2.25,1190,1149,2.0,0,0,3,8,1050,140,2008,0,98116,47.5818,-122.387,1210,1316,400000,11,9,2014,0,6,-41,106,0,1,1
4,2.75,2730,4683,2.0,0,0,3,7,2730,0,2005,0,98038,47.3608,-122.043,2230,4924,374950,27,2,2015,0,10,1953,2694,0,0,0
3,2.75,2390,7939,1.0,0,0,5,7,1610,780,1983,0,98056,47.4987,-122.166,1920,7939,405300,17,12,2014,0,31,5549,6019,0,1,0
4,2.25,2490,9864,1.0,0,0,4,8,1290,1200,1961,0,98004,47.6051,-122.195,2360,9864,824000,24,3,2015,0,54,7374,7504,0,1,0
3,1.75,1100,10968,1.0,0,0,5,7,1100,0,1984,0,98042,47.363,-122.08,1400,7799,260000,16,7,2014,0,30,9868,6399,0,0,0
4,2.5,2430,6099,1.0,0,0,5,8,1470,960,1965,0,98115,47.6777,-122.287,2180,6099,760000,7,1,2015,0,50,3669,3919,0,1,1
3,2.5,3170,12750,2.0,0,0,3,10,2360,810,1995,0,98023,47.3384,-122.336,2970,13125,405000,24,6,2014,0,19,9580,10155,0,1,0
4,2.5,2640,8625,2.0,0,0,3,8,2640,0,1987,0,98058,47.4598,-122.15,2240,8700,429900,19,6,2014,0,27,5985,6460,0,0,0
3,1.5,1130,7223,1.0,0,0,4,7,1130,0,1961,0,98056,47.5089,-122.189,1320,7356,341500,13,11,2014,0,53,6093,6036,0,0,0
5,2.0,1940,7642,1.5,0,0,3,7,1940,0,1957,0,98177,47.7751,-122.38,1940,8724,465250,12,6,2014,0,57,5702,6784,0,0,1
2,2.0,1100,3000,1.5,0,0,3,7,1100,0,1912,2005,98117,47.6797,-122.362,1390,4000,450000,6,5,2014,93,102,1900,2610,1,0,1
3,1.0,1200,10800,1.0,0,0,4,7,1200,0,1955,0,98006,47.5771,-122.144,1370,9950,390000,9,2,2015,0,60,9600,8580,0,0,0
3,2.25,2000,8030,1.0,0,0,4,8,1000,1000,1963,0,98008,47.6188,-122.114,2070,8250,420000,2,5,2014,0,51,6030,6180,0,1,0
3,2.5,1890,4838,2.0,0,0,3,8,1730,160,2002,0,98168,47.4802,-122.279,1910,7409,269950,15,6,2014,0,12,2948,5499,0,1,1
4,2.0,1910,2874,1.0,0,0,3,7,1060,850,1910,0,98122,47.6101,-122.295,1520,2874,493000,16,10,2014,0,104,964,1354,0,1,1
4,2.5,2710,5880,2.0,0,0,3,9,2710,0,1998,0,98092,47.3314,-122.172,2520,6000,370000,15,5,2014,0,16,3170,3480,0,0,0
5,4.25,4860,9453,1.5,0,1,5,10,3100,1760,1905,0,98112,47.6196,-122.286,3150,8557,2250000,12,6,2014,0,109,4593,5407,0,1,1
3,1.75,1590,8219,1.5,0,0,5,6,970,620,1938,0,98034,47.7146,-122.217,2030,7504,400000,12,6,2014,0,76,6629,5474,0,1,0
3,1.5,1240,1221,2.0,0,0,3,8,1050,190,2009,0,98133,47.7073,-122.356,1180,887,320000,18,11,2014,0,5,-19,-293,0,1,1
4,1.0,2000,4800,2.0,0,0,4,7,2000,0,1911,0,98103,47.6583,-122.351,1260,1452,715000,21,1,2015,0,104,2800,192,0,0,1
6,2.75,3610,10003,1.5,0,0,4,8,3610,0,1966,0,98008,47.6261,-122.125,2560,10004,650000,2,12,2014,0,48,6393,7444,0,0,0
5,1.75,1930,8040,1.0,0,0,4,8,1930,0,1966,0,98023,47.3109,-122.376,2370,8000,218000,4,3,2015,0,49,6110,5630,0,0,0
2,1.0,1280,5400,1.0,0,0,3,7,1280,0,1964,0,98117,47.6949,-122.371,1540,5670,500000,15,4,2015,0,51,4120,4130,0,0,1
3,1.5,1940,9887,1.0,0,0,4,7,1140,800,1969,0,98003,47.3289,-122.327,1410,9936,232500,9,7,2014,0,45,7947,8526,0,1,0
3,2.5,1800,5761,2.0,0,0,4,7,1800,0,1990,0,98106,47.5293,-122.363,1800,5952,408200,16,5,2014,0,24,3961,4152,0,0,1
3,1.75,1730,8400,1.0,0,0,4,7,1400,330,1980,0,98052,47.6792,-122.115,1830,8636,522000,11,6,2014,0,34,6670,6806,0,1,0
4,2.5,2810,11120,2.0,0,0,3,9,2810,0,1982,0,98074,47.6337,-122.044,3100,12672,675000,23,6,2014,0,32,8310,9572,0,0,0
4,3.5,3550,11000,1.0,0,2,3,11,2260,1290,1999,0,98006,47.5506,-122.134,4100,10012,1360000,9,7,2014,0,15,7450,5912,0,1,0
4,1.0,1330,7980,1.5,0,0,3,6,1330,0,1952,0,98168,47.492,-122.333,1570,8588,249950,9,10,2014,0,62,6650,7018,0,0,1
4,1.0,1760,7216,1.0,0,0,3,7,1090,670,1947,0,98133,47.7041,-122.355,1180,3844,429950,11,7,2014,0,67,5456,2664,0,1,1
4,2.0,1740,9000,1.0,0,0,5,8,1740,0,1958,0,98033,47.6815,-122.198,1850,7700,710000,26,9,2014,0,56,7260,5850,0,0,0
3,2.5,2100,4700,2.0,0,0,3,8,2100,0,1999,0,98065,47.5341,-121.867,2100,4700,470000,20,10,2014,0,15,2600,2600,0,0,0
3,2.0,1340,2720,1.5,0,0,3,7,1340,0,1913,0,98103,47.6518,-122.335,2030,4590,650000,15,8,2014,0,101,1380,2560,0,0,1
4,2.5,3190,8684,1.0,0,3,5,9,1680,1510,1967,0,98006,47.5619,-122.162,3160,8684,1220000,19,5,2014,0,47,5494,5524,0,1,0
3,2.5,1630,4534,2.0,0,0,3,8,1630,0,1987,0,98034,47.7148,-122.205,1380,4779,422120,15,1,2015,0,28,2904,3399,0,0,0
5,2.5,2990,15085,2.0,0,0,3,9,2990,0,2007,0,98011,47.746,-122.218,3150,13076,625000,7,1,2015,0,8,12095,9926,0,0,0
4,1.0,1550,7740,1.5,0,0,3,6,1550,0,1954,0,98126,47.5222,-122.375,1220,7740,385200,6,6,2014,0,60,6190,6520,0,0,1
3,2.25,1690,4964,2.0,0,0,3,8,1690,0,1989,0,98029,47.5756,-122.01,1800,5036,500000,14,4,2015,0,26,3274,3236,0,0,0
4,2.25,1960,12243,2.0,0,0,3,8,1960,0,1989,0,98042,47.3405,-122.058,1910,12230,308000,18,11,2014,0,25,10283,10320,0,0,0
3,2.75,2390,9966,1.0,0,0,5,8,1360,1030,1977,0,98006,47.5433,-122.185,2140,10713,565000,5,6,2014,0,37,7576,8573,0,1,0
3,2.5,2600,4438,2.0,0,0,3,7,2600,0,2004,0,98053,47.6799,-122.034,2600,4904,581000,8,9,2014,0,10,1838,2304,0,0,0
3,2.0,1950,8698,1.0,0,0,3,8,1950,0,1999,0,98042,47.39,-122.153,2330,7212,361000,6,8,2014,0,15,6748,4882,0,0,0
3,1.0,1250,7210,1.0,0,0,4,7,1250,0,1964,0,98008,47.6329,-122.121,1530,8800,345000,22,1,2015,0,51,5960,7270,0,0,0
2,2.25,1180,1253,2.0,0,0,3,8,840,340,2008,0,98122,47.6124,-122.309,1310,1963,419000,16,10,2014,0,6,73,653,0,1,1
3,2.5,1680,4308,2.0,0,0,3,7,1680,0,2004,0,98056,47.4802,-122.179,2160,4182,347000,12,5,2015,0,11,2628,2022,0,0,0
3,3.25,2660,17852,2.5,0,0,3,8,2660,0,2014,0,98010,47.3077,-122.011,1320,11876,379000,23,12,2014,0,0,15192,10556,0,0,0
3,1.5,1150,3323,2.0,0,0,3,7,1150,0,1988,0,98029,47.5707,-122.017,1150,2980,310000,22,12,2014,0,26,2173,1830,0,0,0
2,2.0,1130,5500,1.0,0,0,4,6,1130,0,1941,0,98030,47.3839,-122.225,1320,6600,250000,13,5,2015,0,74,4370,5280,0,0,0
5,2.75,2760,5000,2.0,0,0,3,9,2760,0,2005,0,98059,47.539,-122.188,2870,5030,682000,14,8,2014,0,9,2240,2160,0,0,0
3,2.0,1430,8919,1.0,0,0,3,7,1430,0,1992,0,98022,47.2118,-121.983,1580,8919,246500,21,7,2014,0,22,7489,7339,0,0,0
4,2.5,2030,4997,2.0,0,0,3,8,2030,0,2004,0,98031,47.393,-122.184,2095,5500,310950,6,8,2014,0,10,2967,3405,0,0,0
3,2.0,3010,5000,2.0,0,2,5,9,1890,1120,1931,0,98199,47.6347,-122.396,2688,5000,1100000,1,9,2014,0,83,1990,2312,0,1,1
3,1.0,1810,7200,1.0,0,0,4,7,1130,680,1954,0,98133,47.7493,-122.351,1810,8100,287500,2,10,2014,0,60,5390,6290,0,1,1
3,1.0,1810,7200,1.0,0,0,4,7,1130,680,1954,0,98133,47.7493,-122.351,1810,8100,431000,18,2,2015,0,61,5390,6290,0,1,1
3,1.0,970,5000,1.0,0,0,3,6,970,0,1968,0,98118,47.5282,-122.279,1290,5875,226000,22,8,2014,0,46,4030,4585,0,0,1
3,1.75,2010,3090,1.5,0,0,5,7,1510,500,1926,0,98103,47.682,-122.348,1600,3150,825000,12,5,2015,0,89,1080,1550,0,1,1
4,1.0,1300,6030,1.5,0,0,3,6,1300,0,1947,0,98168,47.4778,-122.286,1240,6900,175000,11,9,2014,0,67,4730,5660,0,0,1
3,1.5,1260,10350,1.0,0,0,3,7,1260,0,1959,0,98008,47.6357,-122.123,1800,10350,465750,15,5,2014,0,55,9090,8550,0,0,0
3,1.75,1910,5753,1.0,0,3,3,8,1110,800,1941,0,98115,47.6898,-122.327,1630,5580,595000,10,2,2015,0,74,3843,3950,0,1,1
3,2.25,1780,16290,2.0,0,0,4,8,1780,0,1987,0,98058,47.4622,-122.127,1780,8810,350000,26,6,2014,0,27,14510,7030,0,0,0
4,2.25,1900,8600,1.0,0,0,4,8,1900,0,1975,0,98023,47.3102,-122.381,2120,8000,270000,6,6,2014,0,39,6700,5880,0,0,0
3,1.75,1920,11340,1.0,0,0,4,7,1230,690,1977,0,98023,47.3272,-122.362,1980,9638,324500,17,3,2015,0,38,9420,7658,0,1,0
2,1.75,1350,4003,1.0,0,0,3,8,1350,0,2004,0,98053,47.7176,-122.033,1350,4479,430000,18,7,2014,0,10,2653,3129,0,0,0
2,1.75,1350,4003,1.0,0,0,3,8,1350,0,2004,0,98053,47.7176,-122.033,1350,4479,419950,13,5,2015,0,11,2653,3129,0,0,0
4,1.75,2510,7440,1.0,0,2,4,8,1290,1220,1962,0,98032,47.3748,-122.276,1790,8000,285000,28,7,2014,0,52,4930,6210,0,1,0
4,2.5,2470,7780,2.0,0,0,3,8,2470,0,2002,0,98092,47.3337,-122.191,2100,5972,332000,7,1,2015,0,13,5310,3872,0,0,0
4,1.75,1660,10725,1.0,0,0,3,7,960,700,1956,0,98168,47.5033,-122.3,1340,9023,282000,15,12,2014,0,58,9065,7683,0,1,1
3,1.0,1340,5175,1.0,0,0,3,7,940,400,1987,0,98133,47.7321,-122.34,1020,5500,320000,18,11,2014,0,27,3835,4480,0,1,1
4,3.5,2000,2309,3.0,0,0,3,8,2000,0,2008,0,98177,47.7027,-122.361,1440,1548,456500,9,12,2014,0,6,309,108,0,0,1
3,2.25,1640,11050,1.0,0,0,4,8,1640,0,1972,0,98059,47.4723,-122.121,1870,11050,352000,9,5,2014,0,42,9410,9180,0,0,0
4,2.0,1530,4080,1.5,0,0,4,7,1530,0,1912,0,98105,47.6645,-122.325,1860,4080,664000,25,11,2014,0,102,2550,2220,0,0,1
3,1.75,4000,11894,1.0,0,0,3,9,2190,1810,1987,0,98011,47.7738,-122.203,2530,8650,628000,22,7,2014,0,27,7894,6120,0,1,0
3,1.75,1610,12555,1.0,0,0,3,7,1080,530,1977,0,98052,47.6618,-122.136,1780,10374,512000,4,3,2015,0,38,10945,8594,0,1,0
3,2.0,2070,9000,1.0,0,0,4,7,1450,620,1969,0,98023,47.3085,-122.376,1630,7885,254000,11,12,2014,0,45,6930,6255,0,1,0
4,2.5,1900,5790,2.0,0,0,3,8,1900,0,1994,0,98029,47.5691,-121.996,2030,5790,535800,21,5,2014,0,20,3890,3760,0,0,0
3,2.5,1520,1304,2.0,0,0,3,8,1180,340,2006,0,98136,47.5446,-122.385,1270,1718,438000,31,7,2014,0,8,-216,448,0,1,1
5,2.75,2400,8050,2.0,0,0,3,8,2400,0,1998,0,98092,47.2635,-122.209,2400,8050,327000,27,6,2014,0,16,5650,5650,0,0,0
4,2.5,1790,6120,2.0,0,0,3,7,1790,0,2005,0,98059,47.4829,-122.128,1950,5660,370500,12,8,2014,0,9,4330,3710,0,0,0
3,2.5,1720,6271,2.0,0,0,3,7,1720,0,1993,0,98038,47.3898,-122.049,1570,6587,265000,22,10,2014,0,21,4551,5017,0,0,0
4,2.75,2980,13260,1.0,0,0,4,8,1800,1180,1979,0,98056,47.5152,-122.197,1920,10731,450000,10,3,2015,0,36,10280,8811,0,1,0
3,1.75,1150,8690,1.0,0,0,4,7,1150,0,1977,0,98042,47.3729,-122.115,1330,7040,166600,13,11,2014,0,37,7540,5710,0,0,0
1,0.75,380,15000,1.0,0,0,3,5,380,0,1963,0,98168,47.481,-122.323,1170,15000,245000,20,6,2014,0,51,14620,13830,0,0,1
3,1.0,910,5212,1.0,0,0,3,7,910,0,1951,0,98115,47.6742,-122.284,1520,6300,565000,8,5,2015,0,64,4302,4780,0,0,1
3,1.75,1650,10150,1.0,0,0,3,8,1230,420,1976,0,98033,47.6963,-122.169,1930,8958,539900,11,8,2014,0,38,8500,7028,0,1,0
3,3.5,2480,3200,2.0,0,0,3,10,2480,0,2010,0,98144,47.5951,-122.307,1980,3200,910000,3,3,2015,0,5,720,1220,0,0,1
4,2.5,2050,7416,2.0,0,0,3,8,2050,0,1990,0,98092,47.2658,-122.219,2050,7920,280000,4,11,2014,0,24,5366,5870,0,0,0
3,2.25,1420,8549,2.0,0,0,4,7,1420,0,1989,0,98038,47.3576,-122.039,1560,7471,275000,13,3,2015,0,26,7129,5911,0,0,0
3,2.5,3460,6590,2.0,0,0,3,7,3460,0,2001,0,98056,47.4802,-122.188,2490,6312,467000,27,4,2015,0,14,3130,3822,0,0,0
3,2.5,1500,4445,2.0,0,0,3,8,1500,0,1996,0,98029,47.5682,-122.005,1730,4408,457500,31,7,2014,0,18,2945,2678,0,0,0
2,1.0,1320,3090,1.0,0,0,4,7,1320,0,1908,0,98118,47.5517,-122.276,1270,4120,381156,26,12,2014,0,106,1770,2850,0,0,1
5,2.5,2180,8240,1.0,0,0,4,8,1220,960,1977,0,98092,47.3122,-122.191,2050,7590,289999,23,4,2015,0,38,6060,5540,0,1,0
3,1.75,1830,4160,1.0,0,0,3,7,1230,600,1919,0,98144,47.5962,-122.288,1950,4160,642450,22,4,2015,0,96,2330,2210,0,1,1
3,2.25,1620,8701,1.0,0,0,3,7,1220,400,1962,0,98007,47.6071,-122.137,1600,7910,469950,19,9,2014,0,52,7081,6310,0,1,0
3,2.0,2920,13650,1.0,0,2,5,8,1460,1460,1975,0,98033,47.6652,-122.188,2920,10988,795000,5,3,2015,0,40,10730,8068,0,1,0
4,2.5,3300,10514,2.0,0,0,3,10,3300,0,1984,0,98074,47.6323,-122.036,2820,11462,785000,11,2,2015,0,31,7214,8642,0,0,0
3,2.25,3060,12095,2.0,0,0,3,10,3060,0,1983,0,98006,47.5611,-122.106,3060,11455,860000,30,5,2014,0,31,9035,8395,0,0,0
3,1.0,1530,8498,1.0,0,0,3,7,1530,0,1959,0,98031,47.404,-122.203,1380,8498,147500,13,2,2015,0,56,6968,7118,0,0,0
3,2.0,1910,11576,1.0,0,0,3,7,1410,500,1978,0,98011,47.7356,-122.198,2040,8750,390000,25,11,2014,0,36,9666,6710,0,1,0
3,1.0,1020,8100,1.0,0,0,3,7,1020,0,1954,0,98198,47.3586,-122.314,1020,8100,229000,19,12,2014,0,60,7080,7080,0,0,1
3,1.0,1150,8100,1.0,0,0,3,6,1150,0,1932,0,98168,47.494,-122.307,1120,8100,185000,15,5,2014,0,82,6950,6980,0,0,1
3,1.5,1260,9570,1.0,0,0,3,7,870,390,1941,0,98115,47.7004,-122.305,1620,7000,414900,26,8,2014,0,73,8310,5380,0,1,1
4,2.0,1920,4822,1.0,0,0,2,6,920,1000,1914,0,98136,47.5507,-122.381,1120,4822,200000,12,2,2015,0,101,2902,3702,0,1,1
4,2.25,1800,9350,1.0,0,0,3,8,1800,0,1969,0,98092,47.2959,-122.191,2060,8800,225000,21,10,2014,0,45,7550,6740,0,0,0
3,1.75,2040,4000,2.0,0,0,5,7,1360,680,1924,0,98105,47.6675,-122.289,1610,4000,720000,12,9,2014,0,90,1960,2390,0,1,1
4,2.5,2200,4000,2.0,0,0,5,8,1430,770,1908,0,98119,47.6402,-122.37,2100,4000,930000,3,6,2014,0,106,1800,1900,0,1,1
5,3.25,2400,3118,2.0,0,0,4,7,1780,620,1928,0,98122,47.6094,-122.291,2100,3941,700000,11,11,2014,0,86,718,1841,0,1,1
2,1.5,1140,1058,3.0,0,0,3,7,1140,0,2005,0,98103,47.6608,-122.333,1170,1116,466000,15,7,2014,0,9,-82,-54,0,0,1
3,1.5,1330,10640,1.0,0,0,3,7,1330,0,1976,0,98011,47.7364,-122.193,1460,8520,374000,25,8,2014,0,38,9310,7060,0,0,0
3,2.5,1940,10035,2.0,0,0,4,8,1940,0,1994,0,98072,47.7438,-122.172,2810,8333,480000,16,7,2014,0,20,8095,5523,0,0,0
4,1.0,1820,5400,1.5,0,0,3,8,1820,0,1923,2014,98102,47.6476,-122.318,1820,5400,1010000,10,11,2014,91,91,3580,3580,1,0,1
4,2.5,2910,5000,2.0,0,0,3,8,2910,0,2002,0,98042,47.3782,-122.127,2740,5045,395000,30,5,2014,0,12,2090,2305,0,0,0
2,1.0,1090,6771,1.0,0,0,3,6,1090,0,1954,0,98106,47.5185,-122.352,1200,4992,340000,25,7,2014,0,60,5681,3792,0,0,1
3,2.0,1230,1340,2.0,0,0,3,7,1020,210,2003,0,98106,47.526,-122.361,1260,1312,209000,11,8,2014,0,11,110,52,0,1,1
5,2.5,1710,7700,1.5,0,0,3,7,1710,0,1962,0,98007,47.5922,-122.146,1530,7700,431650,14,11,2014,0,52,5990,6170,0,0,0
5,2.5,3160,11470,1.0,0,0,4,9,1780,1380,1971,0,98040,47.5368,-122.216,3260,11470,980000,8,5,2014,0,43,8310,8210,0,1,0
4,2.25,2190,9009,2.0,0,0,4,8,1840,350,1977,0,98033,47.6916,-122.188,2190,10251,730000,11,3,2015,0,38,6819,8061,0,1,0
3,1.75,1260,9600,1.0,0,0,4,7,1260,0,1988,0,98042,47.3592,-122.076,1640,9946,291500,14,4,2015,0,27,8340,8306,0,0,0
4,3.5,2970,14486,2.0,0,0,3,9,2340,630,1997,0,98040,47.5627,-122.215,3680,14486,905000,20,6,2014,0,17,11516,10806,0,1,0
4,3.5,3810,13592,1.0,0,1,3,9,2560,1250,2013,0,98056,47.5134,-122.2,3230,9311,839900,9,5,2014,0,1,9782,6081,0,1,0
1,1.5,1010,1157,2.0,0,0,3,8,950,60,2007,0,98126,47.5492,-122.372,1360,1688,200000,14,7,2014,0,7,147,328,0,1,1
3,2.0,1480,6698,1.0,0,0,4,7,1080,400,1979,0,98058,47.4614,-122.168,1850,7348,300000,18,2,2015,0,36,5218,5498,0,1,0
3,1.75,1250,6041,1.5,0,0,5,7,1250,0,1942,0,98115,47.69,-122.304,1180,6042,530000,3,6,2014,0,72,4791,4862,0,0,1
3,2.25,1654,8479,2.0,0,0,3,7,1654,0,1995,0,98038,47.3627,-122.037,1654,8479,314950,26,3,2015,0,20,6825,6825,0,0,0
3,1.75,1410,9315,1.0,0,0,5,7,1410,0,1960,0,98031,47.3969,-122.198,1630,8250,255000,7,10,2014,0,54,7905,6620,0,0,0
5,2.75,2160,5720,1.0,0,0,5,7,1500,660,1950,0,98144,47.5728,-122.304,2160,4996,550000,16,10,2014,0,64,3560,2836,0,1,1
3,1.0,1400,4800,1.0,0,0,4,6,700,700,1917,0,98136,47.5499,-122.391,1470,6000,435000,6,8,2014,0,97,3400,4530,0,1,1
3,1.75,1420,8738,1.0,0,0,4,7,1420,0,1966,0,98002,47.3113,-122.207,1660,8738,234000,24,11,2014,0,48,7318,7078,0,0,0
4,2.25,2500,10062,1.0,0,0,3,8,1600,900,1975,0,98052,47.639,-122.1,2500,9750,615000,10,10,2014,0,39,7562,7250,0,1,0
3,2.0,1410,8384,1.0,0,0,3,7,1410,0,1985,0,98001,47.3315,-122.263,1410,9205,205000,10,9,2014,0,29,6974,7795,0,0,0
4,1.75,2100,7135,1.0,0,0,4,7,1050,1050,1955,0,98106,47.5353,-122.349,1730,4000,384000,19,9,2014,0,59,5035,2270,0,1,1
3,2.5,1750,7208,2.0,0,0,3,8,1750,0,1994,0,98055,47.4315,-122.192,2050,7524,324000,22,5,2014,0,20,5458,5474,0,0,0
3,1.75,2070,5500,1.0,0,0,4,7,1130,940,1946,0,98115,47.6733,-122.301,1800,4400,645000,22,7,2014,0,68,3430,2600,0,1,1
3,3.25,1570,1777,2.0,0,0,3,8,1260,310,2007,0,98107,47.6655,-122.369,1000,1777,570000,23,10,2014,0,7,207,777,0,1,1
3,2.5,1920,5322,2.0,0,0,3,8,1920,0,1999,0,98031,47.4095,-122.195,1920,5000,324000,10,12,2014,0,15,3402,3080,0,0,0
2,1.0,1000,10320,1.0,0,0,3,6,1000,0,1943,0,98106,47.527,-122.356,1100,5160,270000,28,8,2014,0,71,9320,4060,0,0,1
5,1.5,2120,7700,1.5,0,0,5,7,2120,0,1962,0,98058,47.4599,-122.172,1730,7700,290000,19,5,2014,0,52,5580,5970,0,0,0
3,2.0,1440,9220,1.0,0,0,3,7,1440,0,1965,0,98198,47.3702,-122.317,1390,7830,250000,30,6,2014,0,49,7780,6440,0,0,1
3,1.5,1340,8450,1.0,0,0,4,7,1340,0,1958,0,98188,47.4405,-122.28,1340,8920,255000,18,3,2015,0,57,7110,7580,0,0,1
3,2.25,2380,11824,1.0,0,0,4,9,1450,930,1972,0,98040,47.5371,-122.218,2750,11491,800000,23,6,2014,0,42,9444,8741,0,1,0
3,1.75,1560,4049,1.5,0,2,3,7,1000,560,1926,0,98126,47.5666,-122.375,1430,3738,451000,16,5,2014,0,88,2489,2308,0,1,1
4,2.5,2780,10480,1.0,0,3,3,7,1390,1390,1967,0,98033,47.6597,-122.204,2860,10506,990000,3,12,2014,0,47,7700,7646,0,1,0
4,2.5,1860,6687,1.0,0,0,4,7,1220,640,1983,0,98031,47.4046,-122.186,1860,6117,288400,20,5,2014,0,31,4827,4257,0,1,0
3,1.5,2390,4600,2.0,0,0,3,8,1750,640,1920,1995,98118,47.5383,-122.268,1690,5220,420000,10,3,2015,75,95,2210,3530,1,1,1
2,2.75,1370,1140,2.0,0,0,3,8,1080,290,2009,0,98133,47.7052,-122.343,1370,1090,359000,14,5,2015,0,6,-230,-280,0,1,1
3,2.5,1320,2614,2.0,0,0,3,7,1320,0,2005,0,98118,47.5355,-122.283,1320,2533,300000,2,9,2014,0,9,1294,1213,0,0,1
5,2.5,2520,7863,1.0,0,0,3,7,1500,1020,1981,0,98034,47.7096,-122.199,2030,8580,545000,5,3,2015,0,34,5343,6550,0,1,0
4,2.0,2330,5000,1.5,0,0,5,7,1720,610,1925,0,98117,47.6804,-122.358,2090,5000,891000,17,7,2014,0,89,2670,2910,0,1,1
4,2.5,2790,4650,2.0,0,0,3,8,2790,0,2004,0,98038,47.3556,-122.026,2820,4650,378000,5,2,2015,0,11,1860,1830,0,0,0
2,1.0,1060,7200,1.0,0,0,4,6,1060,0,1951,0,98155,47.7463,-122.315,1850,8291,299995,23,6,2014,0,63,6140,6441,0,0,1
3,2.5,2020,6564,1.0,0,0,3,7,1310,710,1994,0,98042,47.3545,-122.158,1710,5151,253000,7,10,2014,0,20,4544,3441,0,1,0
4,3.0,2020,4300,1.5,0,0,3,6,2020,0,1900,0,98107,47.6653,-122.372,1290,3440,565000,11,3,2015,0,115,2280,2150,0,0,1
2,1.0,970,5665,1.0,0,0,4,6,970,0,1908,0,98118,47.5513,-122.273,1490,4429,315000,12,6,2014,0,106,4695,2939,0,0,1
4,3.0,1490,6766,1.5,0,1,5,7,1490,0,1915,0,98136,47.5446,-122.382,1990,6526,570000,22,10,2014,0,99,5276,4536,0,0,1
5,3.5,4390,10140,2.0,0,0,3,9,3350,1040,2005,0,98125,47.7174,-122.282,2010,8400,971000,11,8,2014,0,9,5750,6390,0,1,1
5,2.5,2750,5589,1.5,0,0,5,9,1840,910,1910,0,98112,47.6364,-122.3,1460,4250,915000,28,8,2014,0,104,2839,2790,0,1,1
4,1.75,1810,7480,1.0,0,0,3,7,1230,580,1977,0,98023,47.3275,-122.361,1870,9594,260000,9,2,2015,0,38,5670,7724,0,1,0
3,3.0,2230,12968,2.0,0,0,3,9,2230,0,1990,0,98004,47.6271,-122.197,2260,10160,1320000,8,4,2015,0,25,10738,7900,0,0,0
3,1.0,2430,10720,1.0,0,0,3,7,2430,0,1977,0,98045,47.4895,-121.787,1660,11560,369950,6,3,2015,0,38,8290,9900,0,0,0
3,2.5,3680,13384,2.0,0,0,3,10,3680,0,1994,0,98006,47.5484,-122.119,3600,11306,1030000,15,10,2014,0,20,9704,7706,0,0,0
5,1.0,1410,6750,1.5,0,0,3,6,1410,0,1929,0,98118,47.5453,-122.278,1360,6750,435000,6,5,2015,0,86,5340,5390,0,0,1
3,1.75,1330,6743,1.0,0,0,3,8,1330,0,1958,2002,98125,47.7012,-122.286,2600,7350,601000,25,3,2015,44,57,5413,4750,1,0,1
3,1.0,1490,10650,1.0,0,0,3,7,1150,340,1963,0,98033,47.663,-122.178,1730,9800,460500,16,7,2014,0,51,9160,8070,0,1,0
3,2.5,2020,1159,3.0,0,3,3,8,2020,0,2000,0,98103,47.6617,-122.356,1920,3600,720000,21,5,2014,0,14,-861,1680,0,0,1
4,2.5,3130,13202,2.0,0,0,3,10,3130,0,1996,0,98075,47.5878,-121.976,2840,10470,851000,21,4,2015,0,19,10072,7630,0,0,0
4,3.0,2670,5000,2.0,0,2,3,7,2670,0,1916,1978,98126,47.5784,-122.377,2300,5000,550000,4,9,2014,62,98,2330,2700,1,0,1
4,1.0,1980,4560,1.5,0,0,3,7,1980,0,1920,0,98103,47.6606,-122.331,1810,3245,700000,23,3,2015,0,95,2580,1435,0,0,1
3,1.0,1350,8581,1.0,0,0,5,6,1350,0,1944,0,98177,47.7612,-122.362,2080,8451,345500,22,9,2014,0,70,7231,6371,0,0,1
4,1.5,2140,7920,1.0,0,0,3,7,1190,950,1959,0,98118,47.5491,-122.272,2140,7238,378000,3,12,2014,0,55,5780,5098,0,1,1
4,2.0,2208,5000,3.0,0,0,5,8,2208,0,1917,0,98116,47.5711,-122.383,1760,5000,650000,12,11,2014,0,97,2792,3240,0,0,1
3,2.0,1010,7380,1.0,0,0,3,7,1010,0,1982,0,98074,47.6273,-122.062,1650,9030,385000,13,4,2015,0,33,6370,7380,0,0,0
2,1.0,970,2970,1.0,0,0,3,7,970,0,1910,0,98102,47.6233,-122.319,1670,3000,425000,16,9,2014,0,104,2000,1330,0,0,1
4,2.0,1520,6174,1.5,0,0,5,6,1520,0,1920,0,98022,47.2105,-121.989,1390,5407,210000,2,12,2014,0,94,4654,4017,0,0,0
3,1.75,1570,7500,1.0,0,1,3,7,1300,270,1953,0,98146,47.4999,-122.368,1590,7660,335000,30,7,2014,0,61,5930,6070,0,1,1
3,1.0,1320,9000,1.0,0,0,3,7,1320,0,1966,0,98001,47.3461,-122.272,1320,9800,196500,25,6,2014,0,48,7680,8480,0,0,0
4,2.75,2550,7636,1.0,0,0,3,8,1440,1110,1986,0,98074,47.6471,-122.06,2290,8223,582800,15,5,2014,0,28,5086,5933,0,1,0
3,1.75,1560,7207,1.0,0,0,3,7,1250,310,1983,0,98034,47.7283,-122.222,1540,7485,440000,23,6,2014,0,31,5647,5945,0,1,0
4,2.25,2360,8616,2.0,0,0,4,8,2360,0,1974,0,98033,47.6495,-122.198,2360,9337,752500,25,8,2014,0,40,6256,6977,0,0,0
3,1.75,1330,5000,2.0,0,0,4,7,1210,120,1909,0,98116,47.5724,-122.384,1500,4000,532500,28,10,2014,0,105,3670,2500,0,1,1
3,1.0,1070,9000,1.0,0,0,4,7,1070,0,1950,0,98198,47.4061,-122.33,1840,12000,265000,6,5,2015,0,65,7930,10160,0,0,1
3,1.25,1510,13737,1.0,0,3,4,6,810,700,1961,0,98125,47.7289,-122.283,2560,10202,397500,2,2,2015,0,54,12227,7642,0,1,1
3,2.5,1710,3469,2.0,0,0,3,8,1710,0,1999,0,98029,47.546,-122.011,2120,3560,524250,24,7,2014,0,15,1759,1440,0,0,0
4,2.75,2790,10819,2.0,0,0,3,10,2790,0,1996,0,98027,47.5515,-122.08,3080,12603,765000,9,5,2014,0,18,8029,9523,0,0,0
4,2.5,2620,5450,2.0,0,0,3,9,2620,0,2001,0,98074,47.6301,-122.019,2590,5371,648000,6,8,2014,0,13,2830,2781,0,0,0
3,1.75,1050,7854,1.0,0,0,4,7,1050,0,1975,0,98023,47.3011,-122.369,1360,7668,237500,24,3,2015,0,40,6804,6308,0,0,0
3,1.0,1280,8712,1.0,0,0,4,7,1280,0,1956,0,98003,47.3298,-122.297,1420,8800,216000,21,1,2015,0,59,7432,7380,0,0,0
3,1.0,1030,8400,1.0,0,0,4,7,1030,0,1963,0,98056,47.5364,-122.173,1270,8400,427200,30,3,2015,0,52,7370,7130,0,0,0
3,2.25,1900,7800,1.0,0,0,4,8,1390,510,1977,0,98055,47.4545,-122.208,1730,7800,280000,11,3,2015,0,38,5900,6070,0,1,0
5,3.0,3070,9804,1.0,0,0,4,9,1740,1330,1968,0,98006,47.5702,-122.128,2550,9689,718000,25,4,2015,0,47,6734,7139,0,1,0
2,2.75,1760,4139,2.0,0,0,3,8,1760,0,2010,0,98065,47.5175,-121.878,1870,3076,420000,10,3,2015,0,5,2379,1206,0,0,0
2,1.0,930,5400,1.0,0,0,3,7,930,0,1952,0,98117,47.6971,-122.372,1050,5400,379000,16,9,2014,0,62,4470,4350,0,0,1
2,1.0,880,7683,1.0,0,0,3,6,880,0,1942,0,98177,47.7145,-122.361,1370,7695,326100,27,5,2014,0,72,6803,6325,0,0,1
3,2.5,1360,1016,3.0,0,0,3,7,1310,50,2003,0,98115,47.6774,-122.324,1365,1156,535000,29,5,2014,0,11,-344,-209,0,1,1
4,2.75,2130,8560,1.0,0,0,3,7,1560,570,1992,0,98022,47.1949,-122.01,2130,8560,283000,1,10,2014,0,22,6430,6430,0,1,0
3,1.0,1480,7469,1.5,0,0,3,6,1120,360,1940,0,98168,47.5048,-122.301,1460,7379,260000,21,8,2014,0,74,5989,5919,0,1,1
4,1.0,1500,6388,1.5,0,0,4,7,1500,0,1951,0,98126,47.5303,-122.378,980,5366,399000,13,4,2015,0,64,4888,4386,0,0,1
3,2.25,1670,5004,2.0,0,0,3,8,1670,0,1987,0,98029,47.5688,-122.017,1850,5276,484950,25,2,2015,0,28,3334,3426,0,0,0
4,1.75,2060,9828,1.0,0,0,4,8,2060,0,1960,0,98005,47.5867,-122.174,2260,9996,640000,13,10,2014,0,54,7768,7736,0,0,0
4,2.5,2160,8158,1.0,0,0,4,8,1660,500,1952,0,98115,47.6948,-122.328,1520,7208,585000,4,3,2015,0,63,5998,5688,0,1,1
4,2.0,2780,11583,1.0,0,3,3,8,1190,1590,1955,0,98125,47.7293,-122.284,2580,10241,645000,8,1,2015,0,60,8803,7661,0,1,1
3,2.0,1490,7651,1.0,0,0,3,7,1490,0,1988,0,98003,47.3211,-122.325,1590,7795,253000,5,5,2015,0,27,6161,6205,0,0,0
2,1.0,740,6460,1.0,0,0,3,6,740,0,1953,0,98146,47.5077,-122.344,1170,6975,178500,21,7,2014,0,61,5720,5805,0,0,1
4,2.5,1860,6325,2.0,0,0,4,7,1860,0,1991,0,98038,47.3492,-122.03,1860,6449,291000,21,8,2014,0,23,4465,4589,0,0,0
2,1.0,850,2340,1.0,0,0,3,7,850,0,1922,0,98105,47.6707,-122.328,1300,3000,553500,4,8,2014,0,92,1490,1700,0,0,1
2,1.0,1030,4188,1.0,0,0,3,8,1030,0,1981,0,98038,47.3738,-122.057,1450,3376,189950,15,4,2015,0,34,3158,1926,0,0,0
3,2.0,1850,9550,1.0,0,0,3,8,1850,0,1988,0,98001,47.3225,-122.273,2250,9550,289000,24,9,2014,0,26,7700,7300,0,0,0
4,2.0,1830,4590,2.0,0,0,3,8,1830,0,1908,0,98105,47.6593,-122.327,1650,4590,700000,27,4,2015,0,107,2760,2940,0,0,1
3,2.0,1560,8853,1.0,0,0,3,7,1560,0,1967,0,98058,47.4312,-122.171,1610,8750,270000,22,10,2014,0,47,7293,7140,0,0,0
4,1.75,1730,8320,1.0,0,0,3,7,1230,500,1977,0,98023,47.327,-122.361,1840,9800,258000,8,5,2014,0,37,6590,7960,0,1,0
3,2.5,1930,7214,2.0,0,0,3,8,1930,0,2005,0,98125,47.7191,-122.309,1930,7266,530000,14,6,2014,0,9,5284,5336,0,0,1
3,2.25,1422,3677,2.0,0,0,3,7,1422,0,2012,0,98092,47.3204,-122.178,1677,3677,245000,18,12,2014,0,2,2255,2000,0,0,0
3,2.0,1380,5000,1.5,0,0,4,7,1380,0,1917,0,98117,47.6807,-122.369,1350,5000,563000,22,4,2015,0,98,3620,3650,0,0,1
3,2.5,2430,4203,2.0,0,0,3,8,2430,0,2001,0,98065,47.5346,-121.875,2500,4798,515000,19,11,2014,0,13,1773,2298,0,0,0
4,2.5,2610,7091,2.0,0,0,3,9,2610,0,1987,0,98023,47.3017,-122.349,2610,7773,325000,17,6,2014,0,27,4481,5163,0,0,0
2,1.0,920,5000,1.0,0,0,4,6,490,430,1949,0,98103,47.7008,-122.338,1500,5000,280300,10,12,2014,0,65,4080,3500,0,1,1
4,1.75,1750,5500,1.5,0,0,5,7,1050,700,1926,0,98117,47.6802,-122.388,1640,5500,460000,9,5,2014,0,88,3750,3860,0,1,1
3,1.75,2020,8970,1.0,0,0,4,7,1180,840,1981,0,98072,47.7571,-122.145,2140,8008,475000,12,12,2014,0,33,6950,5868,0,1,0
4,3.0,1780,7260,1.0,0,0,4,8,1780,0,1964,0,98008,47.627,-122.114,1810,7920,538200,30,12,2014,0,50,5480,6110,0,0,0
2,1.0,1080,3600,1.0,0,0,3,7,1080,0,1922,0,98122,47.6078,-122.291,2230,4500,429000,9,9,2014,0,92,2520,2270,0,0,1
3,1.0,1250,5411,1.0,0,0,3,7,1250,0,1980,0,98178,47.5064,-122.265,1490,6320,164808,25,7,2014,0,34,4161,4830,0,0,1
4,2.25,1870,7700,2.0,0,0,3,7,1870,0,1977,0,98052,47.6937,-122.127,1970,7700,520000,26,1,2015,0,38,5830,5730,0,0,0
3,1.75,1700,8432,1.0,0,0,3,8,1230,470,1977,0,98125,47.7221,-122.317,1800,7842,475000,18,6,2014,0,37,6732,6042,0,1,1
4,2.5,1930,6228,2.0,0,0,3,8,1930,0,2000,0,98030,47.3572,-122.191,1930,6168,321500,31,3,2015,0,15,4298,4238,0,0,0
3,2.25,1370,6000,2.0,0,0,4,7,1370,0,1992,0,98038,47.3484,-122.033,1370,6200,287000,14,4,2015,0,23,4630,4830,0,0,0
3,1.75,960,8106,1.0,0,0,3,7,960,0,1962,0,98052,47.6737,-122.156,1650,8035,375000,5,6,2014,0,52,7146,6385,0,0,0
3,1.75,1260,7128,1.0,0,0,4,7,1260,0,1969,0,98034,47.7263,-122.205,1330,7326,349500,25,8,2014,0,45,5868,5996,0,0,0
3,1.5,1480,7749,1.0,0,0,5,7,1480,0,1960,0,98126,47.5144,-122.379,1140,5320,446450,14,8,2014,0,54,6269,4180,0,0,1
4,2.5,1930,9643,2.0,0,0,4,7,1930,0,1992,0,98031,47.4065,-122.18,1930,7525,315000,10,6,2014,0,22,7713,5595,0,0,0
2,1.0,870,5340,1.5,0,0,2,6,870,0,1906,0,98144,47.5849,-122.302,1190,4440,271310,20,5,2014,0,108,4470,3250,0,0,1
4,1.0,1300,8400,1.5,0,0,4,7,1300,0,1953,0,98133,47.7612,-122.332,1330,8400,315000,22,1,2015,0,62,7100,7070,0,0,1
3,1.75,1490,6930,1.0,0,0,4,7,1490,0,1990,0,98030,47.3682,-122.179,1880,6861,245000,15,5,2014,0,24,5440,4981,0,0,0
2,1.0,1380,5484,1.0,0,0,3,8,1030,350,1947,0,98199,47.6382,-122.399,1380,5347,543115,5,3,2015,0,68,4104,3967,0,1,1
4,2.0,1190,8190,1.5,0,0,3,7,1190,0,1945,0,98117,47.6908,-122.397,1190,1567,900000,20,10,2014,0,69,7000,377,0,0,1
4,4.25,4250,6552,2.0,0,3,4,10,2870,1380,2008,0,98144,47.5747,-122.283,3640,8841,2450000,17,4,2015,0,7,2302,5201,0,1,1
2,2.0,1920,6045,1.0,0,0,3,8,1920,0,2003,0,98053,47.7107,-122.031,1670,5200,554000,29,4,2015,0,12,4125,3530,0,0,0
3,1.75,2080,12522,1.0,0,0,5,6,2080,0,1950,0,98001,47.267,-122.25,1690,11200,249900,17,7,2014,0,64,10442,9510,0,0,0
4,3.0,3680,5854,1.0,0,3,3,10,2060,1620,1967,0,98199,47.6327,-122.395,3140,5000,980000,23,5,2014,0,47,2174,1860,0,1,1
5,2.5,2070,9600,1.0,0,0,3,7,1270,800,1962,0,98146,47.4997,-122.364,1950,7800,395000,20,4,2015,0,53,7530,5850,0,1,1
3,1.75,1480,2200,2.0,0,0,3,7,1480,0,1995,0,98103,47.6969,-122.35,1360,2190,415000,13,4,2015,0,20,720,830,0,0,1
4,2.5,2000,6921,2.0,0,0,3,8,2000,0,2003,0,98038,47.3559,-122.014,2430,6339,380000,20,2,2015,0,12,4921,3909,0,0,0
3,2.5,1560,5259,2.0,0,0,3,8,1560,0,1999,0,98075,47.5985,-122.016,2170,5461,566000,26,2,2015,0,16,3699,3291,0,0,0
2,1.0,1600,8961,1.0,0,0,4,7,1390,210,1949,0,98002,47.3098,-122.21,1502,6798,218500,16,3,2015,0,66,7361,5296,0,1,0
4,2.5,1940,10500,1.0,0,0,4,7,1140,800,1976,0,98052,47.683,-122.114,2200,10500,550000,2,5,2014,0,38,8560,8300,0,1,0
3,1.75,1540,3000,1.0,0,2,3,7,770,770,1920,0,98117,47.6769,-122.36,1420,4200,512031,2,7,2014,0,94,1460,2780,0,1,1
3,2.25,1780,8784,1.0,0,0,3,7,1230,550,1977,0,98033,47.701,-122.172,1780,7704,470000,15,7,2014,0,37,7004,5924,0,1,0
4,2.25,2210,8862,1.0,0,0,4,8,1270,940,1977,0,98011,47.7725,-122.198,2030,8862,465000,18,3,2015,0,38,6652,6832,0,1,0
3,2.25,1920,11500,1.0,0,0,3,8,1920,0,1972,2000,98006,47.5498,-122.188,2260,8866,515000,25,8,2014,28,42,9580,6606,1,0,0
3,1.75,1930,5000,1.0,0,0,3,9,1230,700,1936,0,98105,47.6582,-122.278,2300,6000,716500,6,11,2014,0,78,3070,3700,0,1,1
3,2.0,1700,4250,1.0,0,0,3,6,890,810,1944,0,98199,47.6542,-122.385,1440,4250,410000,17,5,2014,0,70,2550,2810,0,1,1
4,3.25,3450,6500,2.0,0,0,3,8,2450,1000,1994,0,98136,47.5437,-122.388,1750,6500,850000,22,10,2014,0,20,3050,4750,0,1,1
4,2.5,2380,13435,2.0,0,0,3,10,2380,0,1992,0,98075,47.5833,-122.028,2730,9677,648000,9,6,2014,0,22,11055,6947,0,0,0
4,2.25,2400,5350,1.5,0,0,4,7,1460,940,1929,0,98117,47.6763,-122.37,1250,4880,620000,5,6,2014,0,85,2950,3630,0,1,1
3,1.0,1140,10320,1.0,0,0,4,7,1140,0,1963,0,98034,47.7168,-122.196,1140,10412,379000,19,3,2015,0,52,9180,9272,0,0,0
3,1.75,1670,5375,1.0,0,0,3,7,1270,400,1952,0,98199,47.6416,-122.397,1460,6125,699000,16,7,2014,0,62,3705,4665,0,1,1
4,2.25,1910,8005,1.0,0,0,3,8,1280,630,1960,0,98125,47.7259,-122.298,1860,8010,528000,30,12,2014,0,54,6095,6150,0,1,1
3,1.75,1560,9452,1.0,0,0,4,8,1560,0,1974,0,98056,47.5197,-122.18,2200,9985,425000,26,4,2015,0,41,7892,7785,0,0,0
2,1.75,1500,8645,1.0,0,0,4,7,1500,0,1963,0,98042,47.3643,-122.115,1220,8645,249500,23,6,2014,0,51,7145,7425,0,0,0
5,3.25,4475,6642,2.0,0,0,3,9,4475,0,2014,0,98053,47.6849,-122.018,3720,6633,1040000,16,7,2014,0,0,2167,2913,0,0,0
4,2.75,2840,11900,1.0,0,3,4,9,1640,1200,1961,0,98136,47.5271,-122.386,2790,10070,790000,13,8,2014,0,53,9060,7280,0,1,1
3,1.0,1020,18050,1.0,0,0,3,7,1020,0,1969,0,98027,47.5254,-122.043,1750,11640,399950,18,8,2014,0,45,17030,9890,0,0,0
3,1.5,1410,9000,1.0,0,0,3,7,1410,0,1953,0,98133,47.7635,-122.35,1910,7214,275000,21,10,2014,0,61,7590,5304,0,0,1
3,1.0,1520,2500,1.5,0,0,3,8,1520,0,1912,0,98109,47.6347,-122.352,1880,3600,550000,23,1,2015,0,103,980,1720,0,0,1
1,1.0,730,6890,1.0,0,0,4,4,730,0,1926,0,98055,47.467,-122.215,1790,7969,140000,5,11,2014,0,88,6160,6179,0,0,0
3,1.0,1190,6250,1.0,0,0,3,7,990,200,1954,0,98108,47.5658,-122.292,1760,6434,250000,25,7,2014,0,60,5060,4674,0,1,1
3,2.25,1410,8909,2.0,0,2,3,7,1410,0,1988,0,98198,47.3983,-122.31,2050,8909,318000,3,9,2014,0,26,7499,6859,0,0,1
5,2.5,2500,9248,1.0,0,0,3,8,1300,1200,1966,0,98006,47.5415,-122.18,2090,8568,470500,17,4,2015,0,49,6748,6478,0,1,0
3,1.0,1050,9206,1.5,0,0,3,7,1050,0,1954,0,98125,47.7071,-122.301,1380,6384,360000,27,5,2014,0,60,8156,5004,0,0,1
4,2.75,2680,8500,1.0,0,4,4,9,1480,1200,1962,0,98006,47.5634,-122.156,2940,8650,1240000,19,3,2015,0,53,5820,5710,0,1,0
3,2.5,2380,16080,1.0,0,2,4,9,1340,1040,1964,0,98136,47.5262,-122.386,2560,10070,986000,10,4,2015,0,51,13700,7510,0,1,1
2,1.0,1060,4228,1.0,0,0,3,7,860,200,1906,0,98112,47.6231,-122.293,1060,4187,515000,5,2,2015,0,109,3168,3127,0,1,1
4,3.0,2010,7426,1.0,0,0,5,7,1090,920,1951,0,98178,47.5042,-122.265,1470,7426,310000,2,2,2015,0,64,5416,5956,0,1,1
2,1.0,1090,5000,1.0,0,0,4,7,730,360,1942,0,98126,47.5258,-122.378,990,5250,356700,30,5,2014,0,72,3910,4260,0,1,1
4,1.75,2320,5595,1.0,0,0,3,7,1510,810,1956,0,98199,47.6397,-122.388,1840,5596,775000,22,4,2015,0,59,3275,3756,0,1,1
3,1.0,1040,7541,1.0,0,0,3,6,1040,0,1951,0,98133,47.7565,-122.339,1140,6100,325000,21,4,2015,0,64,6501,4960,0,0,1
4,2.75,1810,8677,1.5,0,0,3,7,1810,0,1962,0,98198,47.3668,-122.31,1740,8677,208000,2,10,2014,0,52,6867,6937,0,0,1
2,1.0,1150,12775,1.0,1,4,4,6,1150,0,1908,0,98178,47.502,-122.222,2440,11852,825000,27,8,2014,0,106,11625,9412,0,0,1
3,2.5,2360,11254,1.0,0,2,3,9,2360,0,1990,0,98003,47.3356,-122.333,2390,11254,515000,16,7,2014,0,24,8894,8864,0,0,0
3,1.5,1970,3400,1.5,0,0,4,8,1420,550,1929,0,98122,47.6163,-122.292,1940,4000,490000,27,1,2015,0,86,1430,2060,0,1,1
4,2.5,2080,4080,1.0,0,0,5,7,1040,1040,1962,0,98144,47.572,-122.29,1340,4080,360000,17,7,2014,0,52,2000,2740,0,1,1
4,2.5,2080,4080,1.0,0,0,5,7,1040,1040,1962,0,98144,47.572,-122.29,1340,4080,550000,20,4,2015,0,53,2000,2740,0,1,1
3,1.5,1370,9000,1.0,0,0,3,7,1370,0,1962,0,98168,47.4973,-122.328,1400,9075,225000,25,7,2014,0,52,7630,7675,0,0,1
3,2.75,3410,9360,1.5,0,0,4,8,3410,0,1967,0,98058,47.4497,-122.147,2260,10128,500000,17,3,2015,0,48,5950,7868,0,0,0
4,2.0,1850,11700,1.0,0,0,4,8,1850,0,1969,0,98059,47.4702,-122.12,2110,11700,385000,27,4,2015,0,46,9850,9590,0,0,0
5,2.75,3010,12611,2.0,0,0,3,10,3010,0,1994,0,98052,47.696,-122.102,2890,9456,837700,17,6,2014,0,20,9601,6566,0,0,0
3,2.25,1530,3056,2.0,0,0,3,7,1530,0,2003,0,98053,47.6817,-122.035,1560,3064,448000,10,2,2015,0,12,1526,1504,0,0,0
4,1.5,2810,7140,1.0,0,2,3,8,1490,1320,1954,0,98136,47.5252,-122.382,2240,6825,575000,14,7,2014,0,60,4330,4585,0,1,1
3,1.75,1810,7300,1.0,0,0,4,7,1240,570,1976,0,98034,47.7299,-122.192,1460,7560,430000,18,11,2014,0,38,5490,6100,0,1,0
3,2.5,1560,3987,2.0,0,0,3,7,1560,0,2002,0,98053,47.687,-122.043,1600,3152,435000,14,1,2015,0,13,2427,1552,0,0,0
3,1.0,1010,9611,1.0,0,0,4,6,1010,0,1973,0,98092,47.3006,-122.066,1200,9611,241000,19,12,2014,0,41,8601,8411,0,0,0
2,1.75,1000,1760,1.0,0,0,4,6,600,400,1924,0,98109,47.6261,-122.355,2120,2802,453500,13,5,2015,0,91,760,682,0,1,1
2,1.5,990,1380,3.0,0,0,3,7,990,0,2001,0,98133,47.7218,-122.356,1050,1380,285000,6,4,2015,0,14,390,330,0,0,1
2,1.0,720,4222,1.0,0,0,4,5,720,0,1942,0,98056,47.4965,-122.186,860,4785,151000,28,5,2014,0,72,3502,3925,0,0,0
5,4.5,6070,14731,2.0,0,0,3,11,6070,0,2004,0,98059,47.5306,-122.134,4750,13404,1570000,10,11,2014,0,10,8661,8654,0,0,0
5,2.0,2270,2400,2.0,0,0,3,7,2270,0,1905,0,98122,47.6051,-122.319,1320,2400,631000,5,11,2014,0,109,130,1080,0,0,1
2,2.5,1380,1073,2.0,0,0,3,7,1140,240,2011,0,98126,47.5462,-122.369,1580,2036,285000,2,6,2014,0,3,-307,456,0,1,1
3,1.0,1260,8378,1.0,0,0,4,6,840,420,1959,1977,98023,47.3274,-122.348,1140,8496,195000,20,2,2015,18,56,7118,7356,1,1,0
3,2.0,1810,12825,1.0,0,0,4,7,1810,0,1960,0,98007,47.5953,-122.14,1490,10800,550000,9,1,2015,0,55,11015,9310,0,0,0
4,2.5,3160,8281,2.0,0,0,4,9,3160,0,1995,0,98033,47.6699,-122.195,3000,8281,1130000,3,7,2014,0,19,5121,5281,0,0,0
2,2.75,1910,1369,3.0,0,0,3,9,1910,0,2002,0,98119,47.6544,-122.373,1910,1879,609850,30,12,2014,0,12,-541,-31,0,0,1
3,1.0,1230,4380,1.0,0,0,3,6,1230,0,1947,0,98106,47.5352,-122.361,1525,6026,200000,6,1,2015,0,68,3150,4501,0,0,1
4,2.5,2960,6219,2.0,0,0,3,9,2960,0,2006,0,98038,47.3603,-122.037,2960,5361,367000,6,3,2015,0,9,3259,2401,0,0,0
3,2.25,2200,8375,2.0,0,0,3,8,2200,0,1988,0,98092,47.2626,-122.218,2200,10002,285167,25,8,2014,0,26,6175,7802,0,0,0
4,2.5,2540,12843,2.0,0,0,3,9,2540,0,1992,0,98030,47.3866,-122.169,2410,9383,350900,24,3,2015,0,23,10303,6973,0,0,0
4,3.25,3030,9273,2.0,0,0,5,8,3030,0,1988,0,98029,47.5747,-122.014,2360,7632,660000,20,6,2014,0,26,6243,5272,0,0,0
3,1.75,1520,8835,1.0,0,0,4,7,1520,0,1957,0,98008,47.6054,-122.118,1760,8580,525000,19,8,2014,0,57,7315,6820,0,0,0
4,2.5,1560,7800,2.0,0,0,3,7,1560,0,1997,0,98168,47.514,-122.316,1160,7800,262000,6,2,2015,0,18,6240,6640,0,0,1
2,1.0,970,4560,1.0,0,0,4,7,970,0,1907,0,98103,47.6561,-122.332,1500,4560,690000,23,6,2014,0,107,3590,3060,0,0,1
5,3.75,3570,14648,2.0,0,0,3,9,3570,0,2005,0,98019,47.7377,-121.974,3160,7882,624000,24,3,2015,0,10,11078,4722,0,0,0
3,1.0,1350,7740,1.0,0,0,4,6,860,490,1947,0,98125,47.7098,-122.291,1130,7740,353000,6,5,2014,0,67,6390,6610,0,1,1
4,3.5,3710,10400,2.0,0,0,3,8,2290,1420,2002,0,98056,47.5041,-122.186,1720,4276,552500,11,3,2015,0,13,6690,2556,0,1,0
4,1.0,1430,8355,1.5,0,0,4,7,1430,0,1983,0,98092,47.3178,-122.174,1550,7938,224500,9,5,2014,0,31,6925,6388,0,0,0
3,1.0,940,8571,1.0,0,0,3,6,940,0,1950,0,98146,47.5006,-122.336,1100,8573,239000,27,4,2015,0,65,7631,7473,0,0,1
5,4.5,4300,12250,2.0,0,0,3,10,4300,0,2004,0,98029,47.5557,-122.027,3950,12250,975000,11,7,2014,0,10,7950,8300,0,0,0
4,1.75,3990,13470,2.0,0,0,3,11,3990,0,2006,0,98059,47.5305,-122.131,5790,13709,1200000,25,6,2014,0,8,9480,7919,0,0,0
3,1.0,1380,4000,1.5,0,0,3,7,1380,0,1910,0,98112,47.6261,-122.296,1690,4000,505000,25,3,2015,0,105,2620,2310,0,0,1
4,1.75,2020,7865,1.0,0,0,4,7,1010,1010,1963,0,98059,47.5008,-122.162,1650,7865,302000,15,5,2014,0,51,5845,6215,0,1,0
3,1.0,1480,5670,1.0,0,0,3,6,780,700,1944,0,98106,47.5175,-122.36,760,5040,170000,22,9,2014,0,70,4190,4280,0,1,1
5,1.5,2550,6300,1.0,0,0,4,7,1560,990,1959,0,98056,47.5014,-122.172,1380,6300,272000,9,9,2014,0,55,3750,4920,0,1,0
5,1.5,2550,6300,1.0,0,0,4,7,1560,990,1959,0,98056,47.5014,-122.172,1380,6300,369000,13,2,2015,0,56,3750,4920,0,1,0
3,1.5,1500,6332,1.0,0,0,3,7,1500,0,1953,0,98125,47.7274,-122.312,1500,6337,332500,14,1,2015,0,62,4832,4837,0,0,1
3,2.5,3000,8250,1.0,0,0,4,8,1760,1240,1963,0,98008,47.6191,-122.112,2040,8250,515000,6,5,2015,0,52,5250,6210,0,1,0
3,1.0,1690,4250,1.0,0,0,3,7,1020,670,1967,0,98178,47.4945,-122.258,1820,8865,269000,5,6,2014,0,47,2560,7045,0,1,1
4,4.0,4390,17832,1.0,0,0,4,11,2430,1960,1994,0,98059,47.5283,-122.143,3090,12369,1280000,30,7,2014,0,20,13442,9279,0,1,0
3,2.5,1560,4100,2.0,0,0,3,7,1560,0,1985,0,98055,47.4733,-122.189,1660,4400,303000,6,2,2015,0,30,2540,2740,0,0,0
7,3.0,2940,8624,1.0,0,0,3,8,1690,1250,1977,0,98155,47.7555,-122.307,1850,8031,420000,5,1,2015,0,38,5684,6181,0,1,1
3,1.0,1130,4100,1.0,0,0,3,7,990,140,1941,0,98117,47.6856,-122.385,1800,4100,400000,10,11,2014,0,73,2970,2300,0,1,1
3,1.0,1020,8437,1.0,0,0,5,6,1020,0,1987,0,98022,47.2093,-122.0,1420,8500,225000,4,2,2015,0,28,7417,7080,0,0,0
2,2.0,1310,2550,2.0,0,0,3,6,1310,0,2004,0,98038,47.3496,-122.022,1310,2550,219000,16,9,2014,0,10,1240,1240,0,0,0
3,2.5,2570,9487,2.0,0,3,3,9,2570,0,1989,0,98011,47.7408,-122.216,2490,9898,605000,31,12,2014,0,25,6917,7408,0,0,0
4,2.0,2020,6867,1.0,0,0,5,8,1010,1010,1942,0,98115,47.7,-122.292,1250,6842,625000,14,10,2014,0,72,4847,5592,0,1,1
5,2.0,1680,3240,1.0,0,0,3,5,840,840,1906,0,98144,47.5965,-122.311,1380,1260,380000,24,2,2015,0,109,1560,-120,0,1,1
4,2.0,1770,7700,1.5,0,0,4,7,1770,0,1962,0,98007,47.5916,-122.146,1710,7700,620000,24,4,2015,0,53,5930,5990,0,0,0
4,2.75,3190,10970,2.0,0,0,3,10,3190,0,1994,0,98075,47.5862,-122.029,2850,8416,687500,27,6,2014,0,20,7780,5566,0,0,0
3,2.0,1150,6000,1.0,0,0,5,7,1150,0,1956,0,98178,47.498,-122.263,1980,6360,252500,15,12,2014,0,58,4850,4380,0,0,1
3,2.5,1860,3658,2.0,0,0,3,8,1860,0,1994,0,98029,47.5703,-122.004,1840,3739,510000,29,10,2014,0,20,1798,1899,0,0,0
4,2.5,2430,5203,2.0,0,0,3,8,2430,0,2003,0,98155,47.7402,-122.317,2260,7474,510000,7,5,2014,0,11,2773,5214,0,0,1
3,2.5,1940,4000,1.5,0,0,5,7,1940,0,1906,0,98109,47.6372,-122.352,1440,4000,725000,8,8,2014,0,108,2060,2560,0,0,1
2,1.0,880,2970,1.0,0,0,3,7,880,0,1927,0,98103,47.6868,-122.349,1370,3060,492000,12,3,2015,0,88,2090,1690,0,0,1
4,2.5,1930,14196,1.0,0,0,4,7,1330,600,1977,0,98072,47.7407,-122.097,1470,12852,425000,11,3,2015,0,38,12266,11382,0,1,0
4,2.75,3120,7898,1.0,1,4,4,8,1560,1560,1963,0,98034,47.7165,-122.259,2630,13868,1960000,21,4,2015,0,52,4778,11238,0,1,0
3,2.5,1830,6162,2.0,0,0,3,8,1830,0,1994,0,98092,47.3291,-122.17,1860,7017,298900,9,3,2015,0,21,4332,5157,0,0,0
2,1.0,700,3000,1.0,0,0,4,6,700,0,1918,0,98103,47.6846,-122.346,1560,4500,310000,2,7,2014,0,96,2300,2940,0,0,1
3,1.75,1010,8580,1.0,0,0,3,7,1010,0,1961,0,98033,47.6703,-122.174,1500,8580,350000,22,12,2014,0,53,7570,7080,0,0,0
4,1.75,2460,10061,1.0,1,4,3,7,1410,1050,1961,0,98178,47.5105,-122.238,2300,10061,790000,29,12,2014,0,53,7601,7761,0,1,1
4,2.5,2230,5000,2.0,0,0,3,8,2230,0,2003,0,98031,47.3919,-122.184,2230,6137,305000,29,7,2014,0,11,2770,3907,0,0,0
3,2.5,1570,2865,2.0,0,0,3,7,1570,0,2003,0,98118,47.5412,-122.288,1610,2582,315000,2,10,2014,0,11,1295,972,0,0,1
5,3.5,2390,6600,2.0,0,0,5,7,2390,0,1977,0,98042,47.3737,-122.115,1140,6600,267500,12,8,2014,0,37,4210,5460,0,0,0
4,3.25,3460,7749,2.0,0,1,3,10,3020,440,1950,1998,98115,47.6849,-122.273,3030,8680,1750000,19,8,2014,48,64,4289,5650,1,1,1
6,3.5,2400,8620,2.0,0,0,3,8,1640,760,1987,0,98034,47.7152,-122.162,1940,7350,435000,13,8,2014,0,27,6220,5410,0,1,0
6,4.5,2940,7500,1.5,0,0,4,8,2940,0,1966,0,98034,47.7208,-122.182,2010,7500,482500,5,9,2014,0,48,4560,5490,0,0,0
3,1.75,1570,8400,1.0,0,0,4,7,1570,0,1959,0,98133,47.76,-122.34,1860,8639,439995,28,8,2014,0,55,6830,6779,0,0,1
3,3.0,1520,7500,1.0,0,0,3,7,1180,340,1967,0,98034,47.7276,-122.181,2080,8000,460000,8,5,2015,0,48,5980,5920,0,1,0
3,1.0,1070,6440,1.0,0,0,4,7,1070,0,1971,0,98023,47.3186,-122.373,1190,6532,194000,29,7,2014,0,43,5370,5342,0,0,0
4,2.0,2440,9600,1.0,0,0,5,7,1220,1220,1963,0,98031,47.4142,-122.179,1370,9600,274700,15,7,2014,0,51,7160,8230,0,1,0
4,2.5,2660,3672,2.0,0,0,5,8,1800,860,1910,0,98105,47.6609,-122.324,1510,3825,900000,17,3,2015,0,105,1012,2315,0,1,1
3,2.5,2010,3667,2.0,0,0,3,9,2010,0,2008,0,98027,47.545,-122.015,2350,3600,605000,3,9,2014,0,6,1657,1250,0,0,0
3,2.5,1450,3850,2.0,0,0,3,7,1450,0,2004,0,98065,47.5318,-121.85,1970,3748,359000,9,3,2015,0,11,2400,1778,0,0,0
3,1.75,1400,9900,1.0,0,0,3,7,1400,0,1951,0,98004,47.6272,-122.209,1810,10796,850000,8,10,2014,0,63,8500,8986,0,0,0
3,2.0,1500,2500,2.0,0,0,3,8,1500,0,2002,0,98107,47.6748,-122.385,1550,5000,505000,21,8,2014,0,12,1000,3450,0,0,1
3,2.5,2500,7394,2.0,0,0,3,9,2500,0,1990,0,98072,47.7441,-122.173,2790,7642,565000,9,7,2014,0,24,4894,4852,0,0,0
2,1.75,1280,7110,1.0,0,0,4,7,1000,280,1955,0,98118,47.5569,-122.273,1550,6835,585000,29,4,2015,0,60,5830,5285,0,1,1
4,3.25,3380,7500,2.0,0,3,3,7,2420,960,1990,0,98198,47.4092,-122.33,1920,7500,328000,30,4,2015,0,25,4120,5580,0,1,1
4,2.5,3060,7140,2.0,0,0,3,9,3060,0,2006,0,98027,47.5393,-121.998,3240,6218,826000,26,6,2014,0,8,4080,2978,0,0,0
3,3.5,3250,6000,2.0,0,0,3,10,2500,750,2001,0,98136,47.5533,-122.391,1650,6000,875000,5,6,2014,0,13,2750,4350,0,1,1
4,2.25,2530,9200,1.0,0,0,5,9,1570,960,1976,0,98006,47.5612,-122.152,3030,9400,902000,23,5,2014,0,38,6670,6370,0,1,0
3,1.0,1830,13900,1.0,0,0,3,7,1830,0,1951,0,98133,47.7654,-122.352,1840,10667,423000,1,10,2014,0,63,12070,8827,0,0,1
3,1.0,1170,11100,1.0,0,0,4,6,1170,0,1968,0,98059,47.4954,-122.164,2080,8481,235000,23,6,2014,0,46,9930,6401,0,0,0
2,1.0,1230,7560,1.0,0,0,3,7,1230,0,1961,0,98133,47.7298,-122.34,1270,7560,343000,16,10,2014,0,53,6330,6290,0,0,1
3,2.5,1620,2930,2.0,0,0,3,8,1620,0,2002,0,98058,47.4491,-122.12,1900,2943,334950,24,3,2015,0,13,1310,1043,0,0,0
3,1.75,1760,5355,1.0,0,0,3,7,1160,600,1956,0,98118,47.5368,-122.267,1790,6225,405000,9,9,2014,0,58,3595,4435,0,1,1
4,1.0,1440,8250,1.0,0,0,3,7,1440,0,1959,0,98188,47.4325,-122.291,1440,8466,220000,15,12,2014,0,55,6810,7026,0,0,1
2,1.0,1740,8100,1.0,0,0,3,6,1050,690,1947,0,98168,47.4942,-122.304,960,8100,173000,2,10,2014,0,67,6360,7140,0,1,1
3,1.0,1270,3600,1.5,0,0,3,7,1270,0,1906,0,98119,47.6368,-122.37,1710,3600,655000,7,11,2014,0,108,2330,1890,0,0,1
2,1.0,880,3000,1.0,0,0,3,6,880,0,1924,0,98115,47.6749,-122.323,890,3000,406000,7,1,2015,0,91,2120,2110,0,0,1
6,2.5,2560,8320,1.0,0,0,3,7,1370,1190,1961,0,98125,47.7021,-122.287,2360,7800,632000,17,12,2014,0,53,5760,5440,0,1,1
5,2.75,1540,4000,1.0,0,0,3,7,1140,400,1990,0,98106,47.533,-122.354,1630,4000,357000,26,11,2014,0,24,2460,2370,0,1,1
3,1.75,1150,17585,1.0,0,0,3,7,1150,0,1964,0,98014,47.6503,-121.908,1200,7500,361000,9,12,2014,0,50,16435,6300,0,0,0
2,1.0,770,8149,1.0,0,0,3,6,770,0,1948,0,98155,47.7458,-122.298,1160,8149,277000,8,7,2014,0,66,7379,6989,0,0,1
3,2.5,1850,4597,2.0,0,0,3,8,1850,0,2003,0,98042,47.3755,-122.136,2210,5000,254000,9,5,2014,0,11,2747,2790,0,0,0
3,2.25,1840,8400,1.0,0,0,3,8,1290,550,1961,0,98006,47.5497,-122.172,2110,8400,472800,13,11,2014,0,53,6560,6290,0,1,0
3,1.75,1490,3800,1.0,0,0,3,6,700,790,1913,0,98118,47.5554,-122.27,2180,4000,263000,22,9,2014,0,101,2310,1820,0,1,1
3,1.75,1490,3800,1.0,0,0,3,6,700,790,1913,0,98118,47.5554,-122.27,2180,4000,510000,4,5,2015,0,102,2310,1820,0,1,1
3,1.0,960,10125,1.0,0,0,4,7,960,0,1952,0,98003,47.3335,-122.305,1250,9769,179950,7,11,2014,0,62,9165,8519,0,0,0
4,2.25,1580,7307,1.0,0,0,3,8,1160,420,1973,0,98027,47.569,-122.086,2020,7458,525000,3,12,2014,0,41,5727,5438,0,1,0
3,2.5,1260,889,3.0,0,0,3,8,1260,0,2008,0,98109,47.6277,-122.345,1340,1324,479000,20,5,2014,0,6,-371,-16,0,0,1
3,2.0,1940,6440,1.0,0,2,5,7,970,970,1940,0,98116,47.5664,-122.389,1730,4640,651000,4,9,2014,0,74,4500,2910,0,1,1
4,1.75,2490,7834,1.0,0,3,4,8,1240,1250,1958,0,98033,47.6851,-122.209,3210,7834,949000,11,9,2014,0,56,5344,4624,0,1,0
4,1.75,1760,5356,1.0,0,0,4,7,920,840,1950,0,98115,47.679,-122.288,1680,5184,585000,5,11,2014,0,64,3596,3504,0,1,1
4,2.5,4190,7504,2.0,0,0,3,7,4190,0,2004,0,98058,47.4394,-122.114,2480,6727,460000,12,12,2014,0,10,3314,4247,0,0,0
3,1.0,1170,4400,1.0,0,0,3,7,870,300,1951,0,98199,47.6584,-122.391,1240,4400,470000,13,8,2014,0,63,3230,3160,0,1,1
3,2.5,1600,4271,2.0,0,0,3,7,1600,0,2003,0,98038,47.386,-122.036,1520,3225,245000,6,4,2015,0,12,2671,1705,0,0,0
3,2.5,2090,8653,2.0,0,0,3,8,2090,0,1989,0,98011,47.7498,-122.184,2090,6396,455000,13,11,2014,0,25,6563,4306,0,0,0
4,2.5,2320,3974,2.0,0,0,3,7,2320,0,1999,0,98065,47.532,-121.88,2620,4539,485500,8,4,2015,0,16,1654,1919,0,0,0
5,3.25,4110,7920,2.0,0,3,3,9,3150,960,1921,0,98122,47.617,-122.282,3890,7800,1880000,22,12,2014,0,93,3810,3910,0,1,1
4,3.5,3660,14401,2.0,0,0,3,10,2660,1000,1994,0,98023,47.3076,-122.396,2780,10653,475000,10,10,2014,0,20,10741,7873,0,1,0
4,2.5,2180,7210,1.0,0,0,3,7,1190,990,1972,0,98011,47.7419,-122.181,2070,7210,330000,19,2,2015,0,43,5030,5140,0,1,0
3,1.0,1110,7520,1.0,0,0,4,7,1110,0,1960,0,98033,47.683,-122.176,1440,8400,130000,9,2,2015,0,55,6410,6960,0,0,0
3,2.5,2280,7417,2.0,0,0,3,8,2280,0,1998,0,98001,47.3557,-122.278,2370,6443,320000,23,6,2014,0,16,5137,4073,0,0,0
4,2.5,2820,6180,2.0,0,0,3,9,2050,770,2013,0,98118,47.5529,-122.281,1390,4635,735000,6,6,2014,0,1,3360,3245,0,1,1
4,2.5,1570,9600,1.0,0,0,3,7,800,770,1972,0,98155,47.7757,-122.303,1340,9110,365000,12,3,2015,0,43,8030,7770,0,1,1
3,1.5,1200,11935,1.0,0,0,4,7,1200,0,1968,0,98042,47.3434,-122.082,1350,11935,234000,16,4,2015,0,47,10735,10585,0,0,0
4,2.0,1710,8288,1.5,0,0,3,7,1710,0,1970,0,98031,47.3947,-122.174,1710,7200,211000,27,8,2014,0,44,6578,5490,0,0,0
6,3.5,3000,6320,2.0,0,2,3,8,2400,600,1969,0,98118,47.562,-122.279,1720,6360,680000,30,3,2015,0,46,3320,4640,0,1,1
4,3.0,2800,7845,2.0,0,0,3,8,2800,0,2002,0,98038,47.3544,-122.013,2800,6977,457000,12,11,2014,0,12,5045,4177,0,0,0
3,2.25,1640,7261,2.0,0,0,3,7,1640,0,1989,0,98034,47.7192,-122.176,1640,6789,349000,9,10,2014,0,25,5621,5149,0,0,0
3,2.75,2030,6840,1.0,0,0,3,7,1210,820,1979,0,98108,47.5413,-122.299,1910,6365,360000,24,10,2014,0,35,4810,4455,0,1,1
4,2.5,2530,10155,2.0,0,0,3,8,2530,0,1998,0,98042,47.351,-122.146,2330,7205,350000,14,4,2015,0,17,7625,4875,0,0,0
3,1.0,990,7420,1.0,0,0,5,6,990,0,1960,0,98002,47.2898,-122.221,1010,7420,208000,30,4,2015,0,55,6430,6410,0,0,0
2,1.0,790,11234,1.0,0,0,4,6,790,0,1942,0,98166,47.4413,-122.349,1930,11871,250275,18,6,2014,0,72,10444,9941,0,0,1
2,1.0,790,11234,1.0,0,0,4,6,790,0,1942,0,98166,47.4413,-122.349,1930,11871,435000,28,4,2015,0,73,10444,9941,0,0,1
3,1.75,1800,7763,1.0,0,0,3,6,1470,330,1984,0,98030,47.3766,-122.184,1440,7483,270000,5,12,2014,0,30,5963,6043,0,1,0
3,1.75,1650,12940,1.0,0,0,4,7,1650,0,1961,0,98028,47.7629,-122.268,2830,12600,438000,27,5,2014,0,53,11290,9770,0,0,0
4,2.75,2340,6350,1.0,0,0,4,7,1310,1030,1974,0,98126,47.5559,-122.379,2020,6350,645000,4,5,2015,0,41,4010,4330,0,1,1
4,2.5,2790,5423,2.0,0,0,3,9,2790,0,1999,0,98074,47.6085,-122.017,2450,6453,685100,30,10,2014,0,15,2633,4003,0,0,0
7,3.0,2800,9569,1.0,0,2,3,7,1400,1400,1963,0,98056,47.5102,-122.183,2150,7333,350000,23,6,2014,0,51,6769,5183,0,1,0
4,2.5,3030,3841,3.0,0,0,3,9,3030,0,2005,0,98117,47.6781,-122.369,1080,4922,880000,24,6,2014,0,9,811,3842,0,0,1
4,2.5,1980,5000,2.0,0,0,3,8,1980,0,2008,0,98014,47.6492,-121.908,1400,8500,410500,19,4,2015,0,7,3020,7100,0,0,0
4,2.5,3690,13609,2.0,0,2,3,10,3690,0,1996,0,98075,47.5872,-121.972,3600,13609,780000,23,10,2014,0,18,9919,10009,0,0,0
5,4.5,3732,4426,2.5,0,0,3,10,2932,800,2001,0,98112,47.6189,-122.288,2950,4000,1230000,10,9,2014,0,13,694,1050,0,1,1
2,1.75,1510,6852,1.0,0,0,3,8,1510,0,2005,0,98053,47.7073,-122.012,1510,5912,449000,13,11,2014,0,9,5342,4402,0,0,0
3,1.75,2000,5000,1.0,0,0,4,7,1110,890,1921,0,98117,47.6859,-122.399,1750,5000,546000,14,5,2014,0,93,3000,3250,0,1,1
3,2.0,1760,11410,1.0,0,0,5,7,1060,700,1977,0,98058,47.4528,-122.163,1680,9165,317000,16,5,2014,0,37,9650,7485,0,1,0
3,1.0,1270,7566,1.0,0,0,4,7,1270,0,1958,0,98056,47.5074,-122.175,1780,7520,276900,25,6,2014,0,56,6296,5740,0,0,0
5,2.0,2620,7030,1.0,0,0,3,8,1420,1200,1965,0,98133,47.7338,-122.352,1360,7964,399000,28,10,2014,0,49,4410,6604,0,1,1
5,2.75,2630,10165,1.0,0,0,4,8,1690,940,1976,0,98027,47.5196,-122.049,2440,10165,495000,8,8,2014,0,38,7535,7725,0,1,0
3,1.75,2270,9000,1.0,0,0,4,8,1330,940,1978,0,98023,47.3077,-122.381,2090,8400,258000,8,8,2014,0,36,6730,6310,0,1,0
3,2.75,1120,881,3.0,0,0,3,8,1120,0,1999,0,98103,47.6914,-122.343,1120,1087,265000,17,11,2014,0,15,-239,-33,0,0,1
5,2.75,3030,7000,1.0,0,0,4,7,1540,1490,1978,0,98032,47.3661,-122.28,1790,7330,321000,24,4,2015,0,37,3970,5540,0,1,0
5,2.25,2120,4000,1.5,0,0,4,7,1720,400,1910,0,98109,47.644,-122.353,1960,4000,682000,29,8,2014,0,104,1880,2040,0,1,1
4,2.5,1720,5805,2.0,0,0,3,8,1720,0,2000,0,98092,47.3286,-122.208,2360,7700,295700,14,11,2014,0,14,4085,5340,0,0,0
3,2.25,2010,11817,2.0,0,0,4,8,2010,0,1986,0,98029,47.5665,-122.023,2190,10168,530000,18,8,2014,0,28,9807,7978,0,0,0
5,2.5,3150,5150,2.0,0,0,5,8,1870,1280,1907,2004,98118,47.5506,-122.269,1550,5150,614000,29,12,2014,97,107,2000,3600,1,1,1
3,2.5,1690,6642,2.0,0,0,3,7,1690,0,2004,0,98053,47.6793,-122.033,2120,5080,467000,10,11,2014,0,10,4952,2960,0,0,0
6,2.5,3300,13501,1.0,0,0,3,8,2060,1240,1980,0,98059,47.5116,-122.163,2060,8745,484000,13,8,2014,0,34,10201,6685,0,1,0
3,2.5,1240,1115,3.0,0,0,3,8,1240,0,2003,0,98103,47.6985,-122.34,1410,1355,340000,13,11,2014,0,11,-125,-55,0,0,1
3,2.5,2200,7201,2.0,0,0,3,8,2200,0,1994,0,98030,47.3821,-122.207,2250,7240,302495,23,12,2014,0,20,5001,4990,0,0,0
3,1.75,1620,3360,1.0,0,0,5,7,980,640,1927,0,98117,47.6886,-122.361,1400,3840,532500,25,9,2014,0,87,1740,2440,0,1,1
3,2.5,2420,9592,2.0,0,0,3,8,1780,640,1993,0,98059,47.5093,-122.153,2420,9145,441500,10,9,2014,0,21,7172,6725,0,1,0
4,2.5,2680,8062,1.0,0,3,4,7,1530,1150,1967,0,98198,47.4132,-122.328,1920,8600,470000,24,7,2014,0,47,5382,6680,0,1,1
4,3.25,4250,8570,2.0,0,0,3,9,4250,0,2004,0,98004,47.6154,-122.21,2830,12821,2300000,25,6,2014,0,10,4320,9991,0,0,0
3,1.75,2300,12000,1.0,0,0,3,8,1770,530,1942,0,98133,47.7599,-122.343,2030,6000,320000,29,7,2014,0,72,9700,3970,0,1,1
2,2.0,920,1201,2.0,0,0,3,8,800,120,2009,0,98144,47.5926,-122.295,1150,1161,363000,3,11,2014,0,5,281,11,0,1,1
4,2.25,2350,18600,2.0,0,0,4,9,2350,0,1977,0,98028,47.7473,-122.257,2880,14400,747500,7,7,2014,0,37,16250,11520,0,0,0
2,2.5,2630,7957,2.0,0,0,3,8,2630,0,2003,0,98053,47.7106,-122.023,2305,7220,750000,23,7,2014,0,11,5327,4915,0,0,0
4,3.0,2170,4000,2.0,0,0,4,9,1610,560,1982,2011,98112,47.6196,-122.292,1670,4000,831000,5,5,2014,29,32,1830,2330,1,1,1
3,2.5,1700,4125,2.0,0,0,3,7,1700,0,2004,0,98065,47.5305,-121.854,1970,4105,403000,24,4,2015,0,11,2425,2135,0,0,0
3,2.5,2470,4565,2.0,0,0,3,7,2470,0,2005,0,98056,47.514,-122.189,2470,5064,445000,8,8,2014,0,9,2095,2594,0,0,0
3,3.5,3110,14872,1.0,0,0,3,10,3110,0,2003,0,98004,47.6178,-122.209,3110,12433,2260000,9,2,2015,0,12,11762,9323,0,0,0
3,2.0,1530,8925,1.0,0,0,3,7,1530,0,1977,0,98011,47.736,-122.199,2040,8856,371025,16,6,2014,0,37,7395,6816,0,0,0
2,1.0,960,6250,1.0,0,0,3,6,960,0,1916,0,98136,47.5491,-122.386,1350,6250,355000,30,7,2014,0,98,5290,4900,0,0,1
4,2.75,2440,15349,2.0,0,1,4,7,2440,0,1957,0,98198,47.4117,-122.333,2280,9250,425000,5,6,2014,0,57,12909,6970,0,0,1
3,1.75,2320,7875,1.0,0,0,3,8,1620,700,1967,0,98058,47.4524,-122.146,1990,9720,364808,13,3,2015,0,48,5555,7730,0,1,0
3,2.25,1580,6561,1.0,0,0,3,8,1200,380,1981,0,98058,47.4394,-122.14,1710,7241,320000,13,1,2015,0,34,4981,5531,0,1,0
4,2.5,2963,5797,2.0,0,0,3,9,2963,0,2006,0,98030,47.3831,-122.185,2665,6119,325000,14,10,2014,0,8,2834,3454,0,0,0
3,2.25,2470,10290,2.0,0,0,3,8,2230,240,1984,0,98058,47.4459,-122.124,1970,10150,350000,4,9,2014,0,30,7820,8180,0,1,0
3,1.5,1370,10176,1.0,0,0,3,6,1370,0,1947,0,98168,47.4738,-122.263,1650,10176,170000,19,2,2015,0,68,8806,8526,0,0,1
3,1.0,1130,7500,1.0,0,0,3,7,880,250,1947,0,98117,47.6973,-122.389,2190,5250,550000,10,12,2014,0,67,6370,3060,0,1,1
3,1.0,1150,5120,1.0,0,0,4,6,800,350,1946,0,98116,47.5588,-122.392,1220,5120,420000,10,3,2015,0,69,3970,3900,0,1,1
4,2.5,2190,7350,2.5,0,0,5,8,2190,0,1958,0,98040,47.5786,-122.236,1880,7350,925000,14,5,2014,0,56,5160,5470,0,0,0
2,1.5,1490,4080,1.0,0,0,3,7,930,560,1956,0,98126,47.5344,-122.381,1320,4080,389250,6,6,2014,0,58,2590,2760,0,1,1
3,2.5,2600,10183,1.0,0,0,3,8,1300,1300,2004,0,98033,47.6984,-122.201,1860,10401,748000,1,5,2015,0,11,7583,8541,0,1,0
3,1.75,1530,9600,1.0,0,0,3,7,1200,330,1988,0,98042,47.3594,-122.076,1680,9680,284000,24,3,2015,0,27,8070,8000,0,1,0
4,2.0,1680,5000,1.0,0,0,3,7,980,700,1950,0,98115,47.6858,-122.286,1680,6000,588000,11,6,2014,0,64,3320,4320,0,1,1
3,1.75,1680,8648,1.0,0,0,4,7,1680,0,1963,0,98133,47.7338,-122.332,1290,8147,372500,20,3,2015,0,52,6968,6857,0,0,1
4,3.0,1900,7194,2.0,0,0,4,7,1900,0,1988,0,98042,47.3768,-122.117,1690,7194,285000,18,2,2015,0,27,5294,5504,0,0,0
3,1.0,1570,9467,1.0,0,0,3,7,1570,0,1954,0,98177,47.7683,-122.359,1570,9100,360000,27,5,2014,0,60,7897,7530,0,0,1
2,2.0,1350,4225,1.0,0,0,3,8,1350,0,2003,0,98053,47.7106,-122.03,1660,4225,428000,16,9,2014,0,11,2875,2565,0,0,0
6,2.5,3010,17864,2.0,0,0,3,8,3010,0,1969,0,98177,47.7209,-122.372,2560,11532,847000,25,3,2015,0,46,14854,8972,0,0,1
3,1.0,1010,7838,1.0,0,0,4,6,1010,0,1977,0,98019,47.7422,-121.981,1380,8128,316000,26,9,2014,0,37,6828,6748,0,0,0
3,2.5,2050,7205,2.0,0,0,3,8,2050,0,2000,0,98003,47.3487,-122.304,2050,7264,375000,5,5,2015,0,15,5155,5214,0,0,0
3,1.0,1670,4080,1.0,0,0,3,7,1170,500,1967,0,98115,47.6899,-122.321,1560,4080,533000,8,5,2014,0,47,2410,2520,0,1,1
5,2.5,3840,16905,2.0,0,0,3,11,3840,0,1991,0,98023,47.2996,-122.342,3270,12133,556000,23,5,2014,0,23,13065,8863,0,0,0
4,2.0,2220,14120,1.0,0,0,3,7,1200,1020,1966,0,98042,47.361,-122.116,1300,9709,225000,15,9,2014,0,48,11900,8409,0,1,0
4,2.5,2590,9530,1.0,0,0,4,8,1640,950,1978,0,98155,47.7752,-122.285,2710,10970,537250,30,10,2014,0,36,6940,8260,0,1,1
3,1.0,1180,13650,1.0,0,0,4,7,1180,0,1967,0,98058,47.4551,-122.154,1460,11730,255000,17,12,2014,0,47,12470,10270,0,0,0
4,2.5,2950,4836,2.0,0,0,3,7,2950,0,2006,0,98059,47.479,-122.129,2120,4750,530000,9,4,2015,0,9,1886,2630,0,0,0
4,2.0,2100,8880,1.0,0,0,4,7,2100,0,1958,0,98008,47.6115,-122.124,1280,9102,548000,14,8,2014,0,56,6780,7822,0,0,0
3,1.75,1650,8073,1.0,0,0,3,7,1100,550,1980,0,98092,47.3187,-122.182,1280,8073,234975,20,3,2015,0,35,6423,6793,0,1,0
3,1.75,1620,1325,2.5,0,0,3,9,1430,190,2005,0,98102,47.6498,-122.321,1750,1572,600000,19,8,2014,0,9,-295,-178,0,1,1
4,1.0,1750,12528,1.0,0,0,4,7,1750,0,1967,0,98072,47.743,-122.097,1550,14120,432000,24,3,2015,0,48,10778,12570,0,0,0
3,1.5,1380,6657,2.0,0,0,3,7,1380,0,1986,0,98034,47.7085,-122.217,1420,8187,455000,2,2,2015,0,29,5277,6767,0,0,0
3,1.75,1510,11234,1.0,0,0,3,7,1210,300,1965,0,98155,47.7571,-122.328,2080,9076,279950,24,10,2014,0,49,9724,6996,0,1,1
3,1.5,1600,9072,1.0,0,0,4,7,1600,0,1963,0,98030,47.3737,-122.216,1710,8000,267500,20,10,2014,0,51,7472,6290,0,0,0
2,1.0,830,7590,1.0,0,0,2,6,830,0,1943,0,98166,47.4784,-122.335,980,7590,110000,27,1,2015,0,72,6760,6610,0,0,1
3,3.5,1810,1846,2.0,0,0,4,8,1440,370,2009,0,98122,47.607,-122.305,1480,3600,625000,13,5,2014,0,5,36,2120,0,1,1
2,1.0,910,7000,1.0,0,0,3,7,910,0,1952,0,98115,47.6999,-122.305,1260,7528,389000,29,5,2014,0,62,6090,6268,0,0,1
4,2.0,2120,3360,2.0,0,0,3,9,2120,0,1905,0,98112,47.6227,-122.31,2090,3600,1200000,30,6,2014,0,109,1240,1510,0,0,1
5,2.25,2100,6936,1.0,0,0,3,8,1600,500,1974,0,98033,47.6737,-122.169,2100,8661,567000,25,7,2014,0,40,4836,6561,0,1,0
2,2.25,2690,15000,1.0,0,2,3,8,1870,820,1987,0,98023,47.3361,-122.353,2690,15000,515000,13,1,2015,0,28,12310,12310,0,1,0
4,2.5,2430,11870,1.0,0,0,5,8,1590,840,1968,0,98155,47.7761,-122.285,2430,9600,605000,2,9,2014,0,46,9440,7170,0,1,1
4,3.75,2452,4800,2.0,0,0,3,7,2452,0,1936,1994,98055,47.4744,-122.213,1180,4800,430000,27,10,2014,58,78,2348,3620,1,0,0
2,1.75,1550,6000,1.0,0,1,3,7,1550,0,1920,0,98199,47.6712,-122.409,2360,6000,805000,17,7,2014,0,94,4450,3640,0,0,1
3,2.5,2080,4556,2.0,0,0,3,8,2080,0,1999,0,98074,47.6036,-122.014,1530,5606,567500,13,4,2015,0,16,2476,4076,0,0,0
3,1.75,1290,3870,1.0,0,0,5,7,1290,0,1916,0,98144,47.5873,-122.29,2020,5850,647500,5,6,2014,0,98,2580,3830,0,0,1
2,1.75,1850,2530,2.5,0,0,4,7,1850,0,1903,0,98122,47.6106,-122.31,1500,1795,495000,26,11,2014,0,111,680,295,0,0,1
4,2.5,3370,5000,2.0,0,0,3,9,3370,0,2006,0,98027,47.541,-121.998,3370,5237,825000,4,11,2014,0,8,1630,1867,0,0,0
4,2.25,2730,7506,2.0,0,0,4,8,2730,0,1987,0,98058,47.4627,-122.152,2390,8015,435000,9,3,2015,0,28,4776,5625,0,0,0
3,1.75,1300,7800,1.0,0,0,5,7,1300,0,1968,0,98034,47.7321,-122.195,1520,7344,445950,9,9,2014,0,46,6500,5824,0,0,0
5,2.75,3040,10257,2.0,0,0,3,10,3040,0,1993,0,98006,47.5531,-122.119,2860,9327,960000,3,6,2014,0,21,7217,6467,0,0,0
4,3.0,2440,3600,1.5,0,0,5,8,1480,960,1929,0,98103,47.6853,-122.331,1770,4000,780000,17,9,2014,0,85,1160,2230,0,1,1
3,2.25,1720,9000,1.0,0,0,4,8,1320,400,1969,0,98023,47.3191,-122.383,1930,8000,274500,18,6,2014,0,45,7280,6070,0,1,0
5,3.0,3230,5167,1.5,0,0,4,8,2000,1230,1909,0,98133,47.7053,-122.34,1509,1626,729953,29,4,2015,0,106,1937,117,0,1,1
3,1.5,1200,890,2.0,0,0,3,8,1030,170,2008,0,98109,47.6384,-122.342,1230,2120,464950,28,7,2014,0,6,-310,890,0,1,1
4,1.75,2350,18800,1.0,0,2,3,8,2350,0,1959,0,98005,47.5904,-122.177,3050,14640,620000,12,11,2014,0,55,16450,11590,0,0,0
4,3.5,3100,5600,2.0,0,0,3,9,3100,0,2005,0,98075,47.5968,-121.978,3080,5600,735000,16,1,2015,0,10,2500,2520,0,0,0
4,2.25,2040,9565,1.0,0,0,3,8,1400,640,1959,0,98133,47.7356,-122.335,1890,8580,450000,21,4,2015,0,56,7525,6690,0,1,1
4,1.0,2000,4676,1.5,0,0,3,7,1250,750,1916,1986,98118,47.5529,-122.268,1140,4676,450000,5,6,2014,70,98,2676,3536,1,1,1
4,2.5,2160,5298,2.5,0,0,4,9,2160,0,1902,0,98122,47.6106,-122.31,1720,2283,842500,11,5,2014,0,112,3138,563,0,0,1
3,2.25,1850,7923,1.0,0,0,4,7,1150,700,1977,0,98033,47.7011,-122.171,1780,7420,461000,14,8,2014,0,37,6073,5640,0,1,0
2,1.0,1350,4494,1.0,0,0,3,7,920,430,1949,0,98126,47.5315,-122.38,1470,5225,345000,18,8,2014,0,65,3144,3755,0,1,1
3,2.5,3280,10302,1.0,0,0,3,10,1680,1600,1970,0,98115,47.6948,-122.286,1550,6300,1080000,2,7,2014,0,44,7022,4750,0,1,1
4,2.5,2270,8391,2.0,0,0,3,8,2270,0,1988,0,98029,47.574,-122.013,2420,8391,643000,27,2,2015,0,27,6121,5971,0,0,0
4,2.5,2820,8307,2.0,0,0,3,9,2820,0,1990,0,98074,47.6253,-122.027,2820,8307,690000,29,9,2014,0,24,5487,5487,0,0,0
4,1.0,1200,11111,1.5,0,0,3,7,1200,0,1949,0,98155,47.7529,-122.306,1350,9113,282000,1,4,2015,0,66,9911,7763,0,0,1
3,1.75,2000,6130,1.0,0,0,4,8,1120,880,1951,0,98117,47.6925,-122.388,2140,7150,549000,18,11,2014,0,63,4130,5010,0,1,1
3,2.0,2310,6000,2.0,0,1,4,9,1560,750,1926,0,98199,47.648,-122.395,2000,6000,815000,8,1,2015,0,89,3690,4000,0,1,1
3,2.25,2330,11424,2.0,0,0,4,8,2330,0,1984,0,98052,47.6386,-122.11,2050,11448,700000,13,4,2015,0,31,9094,9398,0,0,0
3,2.5,3940,10360,2.0,0,0,3,9,3110,830,1992,0,98052,47.6468,-122.116,2720,11941,933399,14,7,2014,0,22,6420,9221,0,1,0
3,1.0,1440,11250,1.0,0,0,3,7,1440,0,1967,0,98055,47.4627,-122.213,2200,11250,290000,3,7,2014,0,47,9810,9050,0,0,0
4,1.75,1960,9300,1.0,0,0,5,7,1340,620,1979,0,98045,47.4487,-121.772,1500,9752,372000,24,5,2014,0,35,7340,8252,0,1,0
2,1.75,1250,2890,1.0,0,0,4,7,790,460,1920,0,98103,47.6795,-122.353,1500,3225,450000,19,8,2014,0,94,1640,1725,0,1,1
3,2.5,1981,5700,2.0,0,0,3,8,1981,0,2010,0,98030,47.3668,-122.178,1981,5894,303700,5,9,2014,0,4,3719,3913,0,0,0
4,2.5,2440,10049,2.0,0,0,4,9,2440,0,1989,0,98029,47.5744,-121.993,2820,8484,672000,24,7,2014,0,25,7609,5664,0,0,0
4,1.5,1150,9360,1.5,0,0,3,6,1150,0,1970,0,98034,47.7197,-122.173,1480,8155,334000,23,6,2014,0,44,8210,6675,0,0,0
2,1.0,1120,5650,1.0,0,0,3,6,1120,0,1944,0,98178,47.4979,-122.241,1270,6875,260000,25,6,2014,0,70,4530,5605,0,0,1
3,1.75,1800,5700,1.0,0,0,4,8,1000,800,1941,0,98119,47.6491,-122.367,1680,5350,749950,31,7,2014,0,73,3900,3670,0,1,1
5,3.0,2920,2808,2.0,0,0,3,8,2140,780,1960,1992,98103,47.654,-122.342,1620,1544,830000,28,10,2014,32,54,-112,-76,1,1,1
3,2.25,2790,13791,1.0,0,3,3,8,2790,0,2006,0,98166,47.4389,-122.351,2720,12600,1130000,8,7,2014,0,8,11001,9880,0,0,1
3,1.0,1560,7552,1.0,0,0,4,6,910,650,1948,0,98155,47.7552,-122.327,1200,8152,320000,7,7,2014,0,66,5992,6952,0,1,1
3,2.0,1700,11475,1.0,0,0,5,6,970,730,1945,0,98146,47.4851,-122.338,1560,11475,225000,26,6,2014,0,69,9775,9915,0,1,1
1,1.0,640,6350,1.0,0,0,3,5,640,0,1939,0,98117,47.6976,-122.359,1270,6350,279200,17,9,2014,0,75,5710,5080,0,0,1
4,3.5,2680,10000,2.0,0,0,3,8,2040,640,1942,2014,98125,47.726,-122.296,1530,8000,520000,20,5,2014,72,72,7320,6470,1,1,1
3,2.5,1860,8060,2.0,0,0,4,8,1860,0,1987,0,98029,47.5674,-122.017,1850,4661,505000,25,6,2014,0,27,6200,2811,0,0,0
3,1.75,1490,8366,1.0,0,0,4,7,1010,480,1975,0,98042,47.375,-122.14,1490,7469,234000,6,5,2014,0,39,6876,5979,0,1,0
4,2.5,2470,5044,2.0,0,0,3,9,2470,0,2005,0,98155,47.7728,-122.271,2790,5583,503000,29,9,2014,0,9,2574,2793,0,0,1
4,2.25,2390,8858,1.0,0,0,4,8,1740,650,1979,0,98033,47.6925,-122.184,2240,8858,606000,6,8,2014,0,35,6468,6618,0,1,0
3,1.0,1230,6000,1.0,0,0,4,7,780,450,1937,0,98115,47.6839,-122.281,1570,5000,433500,23,7,2014,0,77,4770,3430,0,1,1
3,1.5,2840,10182,1.0,0,0,3,8,1510,1330,1951,0,98056,47.524,-122.2,2210,9669,250000,23,1,2015,0,64,7342,7459,0,1,0
3,2.5,2120,9307,2.0,0,0,4,9,2120,0,1984,0,98006,47.5477,-122.141,2290,11524,719000,5,8,2014,0,30,7187,9234,0,0,0
3,2.0,1770,14400,1.0,0,0,4,8,1770,0,1959,0,98166,47.415,-122.337,1900,14400,381000,10,12,2014,0,55,12630,12500,0,0,1
3,2.5,2495,4400,2.0,0,0,3,8,2495,0,2007,0,98001,47.288,-122.283,2434,4400,267000,28,5,2014,0,7,1905,1966,0,0,0
4,2.5,2740,7140,2.0,0,0,3,8,2740,0,1993,0,98074,47.6334,-122.021,2260,7035,651000,13,5,2014,0,21,4400,4775,0,0,0
2,1.0,1050,5671,1.0,0,0,3,7,850,200,1949,0,98115,47.6767,-122.286,1850,5243,439000,4,2,2015,0,66,4621,3393,0,1,1
2,1.0,1130,5070,1.0,0,0,4,7,1130,0,1955,0,98146,47.5141,-122.377,860,6300,325000,14,2,2015,0,60,3940,5440,0,0,1
2,1.0,880,6380,1.0,0,0,3,7,880,0,1938,1994,98115,47.6924,-122.322,1340,6380,490000,2,5,2014,56,76,5500,5040,1,0,1
4,2.5,2403,6172,2.0,0,0,3,9,2403,0,1999,0,98028,47.7361,-122.234,2380,6075,519900,7,10,2014,0,15,3769,3695,0,0,0
4,1.75,1900,8250,1.0,0,0,4,7,950,950,1955,0,98006,47.5765,-122.147,1480,8360,542000,14,5,2014,0,59,6350,6880,0,1,0
2,2.0,1200,3900,1.0,0,0,3,8,1200,0,2006,0,98053,47.72,-122.024,1440,5580,408000,31,3,2015,0,9,2700,4140,0,0,0
4,2.5,2060,5950,2.0,0,0,3,8,2060,0,2000,0,98030,47.3631,-122.192,2242,6406,292000,4,12,2014,0,14,3890,4164,0,0,0
3,1.75,1250,10122,1.0,0,0,3,7,1250,0,1994,0,98010,47.3277,-122.001,1980,10175,253000,7,5,2014,0,20,8872,8195,0,0,0
2,1.0,910,4662,1.0,0,0,5,6,910,0,1942,0,98106,47.5232,-122.354,890,6050,280000,5,9,2014,0,72,3752,5160,0,0,1
4,2.25,1920,8910,1.0,0,0,4,8,1200,720,1969,0,98005,47.5897,-122.156,2250,8800,635000,16,12,2014,0,45,6990,6550,0,1,0
4,2.25,2240,8300,2.0,0,0,3,8,2240,0,1978,0,98011,47.7746,-122.197,2340,8500,439000,9,10,2014,0,36,6060,6160,0,0,0
3,2.5,1260,3855,2.0,0,0,3,8,1260,0,1999,0,98059,47.4908,-122.154,1310,3344,300000,6,8,2014,0,15,2595,2034,0,0,0
3,1.5,1360,13496,1.0,0,0,4,8,1360,0,1960,0,98198,47.4032,-122.314,1900,10538,345000,5,2,2015,0,55,12136,8638,0,0,1
4,2.25,2100,8050,2.0,0,0,3,8,2100,0,1978,0,98055,47.4391,-122.193,2190,7700,283500,12,8,2014,0,36,5950,5510,0,0,0
2,1.0,2110,4920,1.5,0,0,3,7,1460,650,1911,0,98103,47.6872,-122.339,1390,4732,425000,24,9,2014,0,103,2810,3342,0,1,1
3,1.75,2210,8955,1.0,0,1,3,8,1560,650,1974,0,98033,47.6621,-122.189,2210,8976,685000,19,3,2015,0,41,6745,6766,0,1,0
3,2.5,2360,12987,2.0,0,0,3,8,2360,0,1983,0,98006,47.5471,-122.149,2480,11665,750000,21,4,2015,0,32,10627,9185,0,0,0
4,1.5,1280,8000,1.0,0,0,3,6,1280,0,1960,0,98178,47.4949,-122.255,1420,8211,245000,16,4,2015,0,55,6720,6791,0,0,1
6,3.75,2740,6924,1.0,0,2,3,7,1640,1100,1962,0,98144,47.5816,-122.296,1940,6000,585444,3,4,2015,0,53,4184,4060,0,1,1
4,2.5,2740,7571,2.0,0,0,3,9,2740,0,2009,0,98033,47.6962,-122.179,2880,7203,706000,17,9,2014,0,5,4831,4323,0,0,0
4,2.0,2630,9099,1.5,0,0,3,7,1830,800,1944,2009,98146,47.5067,-122.361,1430,6825,445000,1,8,2014,65,70,6469,5395,1,1,1
3,2.0,1650,6000,1.0,0,0,3,7,1650,0,1990,0,98023,47.2904,-122.353,1870,6000,241000,19,2,2015,0,25,4350,4130,0,0,0
2,2.5,1770,7155,2.0,1,4,3,8,1770,0,1957,2004,98155,47.7345,-122.285,2410,10476,1180000,3,5,2015,47,58,5385,8066,1,0,1
3,1.0,1500,5750,1.5,0,0,4,7,1050,450,1927,0,98126,47.5677,-122.376,1500,5060,530000,6,2,2015,0,88,4250,3560,0,1,1
3,1.5,1430,12199,1.0,0,0,3,7,1130,300,1948,0,98133,47.7352,-122.33,1490,8196,350000,2,3,2015,0,67,10769,6706,0,1,1
4,3.75,3190,17186,2.0,1,4,3,10,3190,0,1999,0,98178,47.5115,-122.246,2290,13496,1700000,15,4,2015,0,16,13996,11206,0,0,1
3,1.0,1280,9630,1.0,0,0,3,7,1280,0,1968,0,98072,47.7677,-122.163,1300,9453,389000,28,4,2015,0,47,8350,8153,0,0,0
4,2.75,2390,6820,2.0,0,0,4,7,2140,250,1945,0,98115,47.6788,-122.27,1980,6820,799000,5,11,2014,0,69,4430,4840,0,1,1
4,2.5,4040,9630,1.0,0,3,4,9,2020,2020,1951,0,98199,47.6408,-122.41,3160,8025,1400000,4,8,2014,0,63,5590,4865,0,1,1
2,1.0,920,8612,1.0,0,0,5,7,920,0,1947,0,98155,47.734,-122.301,1500,7956,340895,29,12,2014,0,67,7692,6456,0,0,1
4,2.5,2730,10281,2.0,0,2,3,9,2730,0,1996,0,98074,47.6227,-122.029,2750,7220,780000,5,5,2014,0,18,7551,4470,0,0,0
3,2.5,2620,4874,2.0,0,0,3,7,2620,0,1999,0,98065,47.5328,-121.879,2360,4231,470000,17,2,2015,0,16,2254,1871,0,0,0
4,2.5,2900,4762,2.0,0,0,3,8,2900,0,2005,0,98042,47.3663,-122.129,2900,5173,354000,23,9,2014,0,9,1862,2273,0,0,0
5,2.0,1900,6000,1.5,0,0,4,6,1900,0,1920,0,98033,47.6831,-122.186,2110,8400,470000,26,2,2015,0,95,4100,6290,0,0,0
3,2.0,1760,5400,1.0,0,0,5,7,1160,600,1927,0,98103,47.6558,-122.331,1640,5400,715000,30,7,2014,0,87,3640,3760,0,1,1
2,1.0,760,4000,1.0,0,0,4,6,760,0,1950,0,98108,47.5466,-122.304,1640,4500,265000,7,10,2014,0,64,3240,2860,0,0,1
3,1.0,1530,4944,1.0,0,0,3,7,1530,0,1950,0,98103,47.6857,-122.341,1500,4944,640000,15,8,2014,0,64,3414,3444,0,0,1
4,1.75,1990,18900,2.0,0,0,4,7,1870,120,1929,0,98168,47.5131,-122.313,1710,12400,290000,20,11,2014,0,85,16910,10690,0,1,1
3,2.0,2040,5600,1.0,0,1,5,7,1120,920,1954,0,98144,47.5959,-122.293,2120,4958,535000,26,8,2014,0,60,3560,2838,0,1,1
3,1.75,2170,12220,1.0,0,0,5,8,2170,0,1965,0,98033,47.6537,-122.195,1980,9000,907000,29,8,2014,0,49,10050,7020,0,0,0
3,1.75,1620,7330,1.0,0,0,4,7,1090,530,1974,0,98034,47.7148,-122.213,1380,7191,459000,1,6,2014,0,40,5710,5811,0,1,0
3,1.5,1470,11599,1.0,0,0,3,7,1070,400,1967,0,98030,47.3632,-122.188,1580,9760,264950,5,3,2015,0,48,10129,8180,0,1,0
3,1.0,1760,3000,1.5,0,0,1,6,1760,0,1900,0,98103,47.6598,-122.348,1320,1266,352950,7,11,2014,0,114,1240,-54,0,0,1
3,2.25,2230,13100,1.0,0,0,4,8,1510,720,1974,0,98006,47.5413,-122.174,2010,10650,491500,22,8,2014,0,40,10870,8640,0,1,0
3,1.0,1200,9194,1.0,0,0,4,7,1200,0,1952,0,98155,47.7362,-122.319,1330,8650,369500,6,4,2015,0,63,7994,7320,0,0,1
3,2.5,2090,6294,2.0,0,0,3,9,2090,0,2004,0,98052,47.686,-122.095,2520,5735,566000,18,3,2015,0,11,4204,3215,0,0,0
3,2.25,1500,7308,1.0,0,0,4,7,1210,290,1968,0,98055,47.4621,-122.187,1480,7400,290000,25,8,2014,0,46,5808,5920,0,1,0
3,1.0,870,5330,1.0,0,0,3,6,870,0,1969,2014,98042,47.369,-122.077,840,5200,180000,22,5,2014,45,45,4460,4360,1,0,0
2,1.0,1010,6000,1.0,0,0,4,6,1010,0,1944,0,98133,47.771,-122.353,1610,7313,215000,12,8,2014,0,70,4990,5703,0,0,1
2,1.0,1010,6000,1.0,0,0,4,6,1010,0,1944,0,98133,47.771,-122.353,1610,7313,302000,12,2,2015,0,71,4990,5703,0,0,1
3,1.75,1860,7881,1.0,0,0,3,7,1160,700,1986,0,98198,47.3855,-122.322,1490,7527,352500,10,4,2015,0,29,6021,6037,0,1,1
4,2.0,1330,5926,1.0,0,0,4,5,1330,0,1942,0,98056,47.496,-122.19,1150,5485,235867,26,6,2014,0,72,4596,4335,0,0,0
3,2.25,1760,11946,2.0,0,0,3,8,1760,0,1978,0,98074,47.624,-122.05,2080,12068,500000,17,7,2014,0,36,10186,9988,0,0,0
3,2.25,1800,4500,2.0,0,0,3,7,1800,0,1995,0,98019,47.7462,-121.98,1760,6589,382000,26,3,2015,0,20,2700,4829,0,0,0
5,2.5,1690,2402,1.5,0,0,3,7,990,700,1930,0,98117,47.6903,-122.38,1200,4005,515000,22,4,2015,0,85,712,2805,0,1,1
1,1.0,660,2600,1.0,0,0,3,6,660,0,1919,0,98144,47.5723,-122.304,1560,5445,250000,1,5,2015,0,96,1940,3885,0,0,1
3,2.25,2400,5300,1.5,0,0,4,7,1250,1150,1939,0,98117,47.6876,-122.384,1540,4800,672500,27,6,2014,0,75,2900,3260,0,1,1
3,2.25,3020,13031,2.0,0,0,3,9,3020,0,1989,0,98052,47.6897,-122.098,2480,10204,755000,22,10,2014,0,25,10011,7724,0,0,0
3,1.0,1500,2555,2.0,0,2,3,7,1500,0,1910,0,98109,47.627,-122.353,1820,2555,707500,20,3,2015,0,105,1055,735,0,0,1
4,2.0,1560,3840,1.0,0,0,4,6,960,600,1924,0,98117,47.6882,-122.365,1560,4800,459000,26,8,2014,0,90,2280,3240,0,1,1
3,1.0,1090,10620,1.5,0,0,3,7,1090,0,1959,0,98032,47.3748,-122.294,1380,10620,140000,4,2,2015,0,56,9530,9240,0,0,0
2,1.0,970,4284,1.0,0,0,3,7,970,0,1905,0,98103,47.6667,-122.333,2050,4284,495000,11,8,2014,0,109,3314,2234,0,0,1
3,3.25,3190,5283,2.0,0,0,3,9,3190,0,2007,0,98029,47.5534,-122.002,2950,5198,757000,13,5,2014,0,7,2093,2248,0,0,0
3,3.25,3190,5283,2.0,0,0,3,9,3190,0,2007,0,98029,47.5534,-122.002,2950,5198,765000,7,1,2015,0,8,2093,2248,0,0,0
4,1.5,1890,6052,1.0,0,0,4,7,1890,0,1955,0,98125,47.7055,-122.3,1510,6072,359000,19,9,2014,0,59,4162,4562,0,0,1
3,1.0,1050,7500,1.0,0,0,3,6,1050,0,1900,0,98136,47.5473,-122.396,1380,7500,440000,5,6,2014,0,114,6450,6120,0,0,1
4,1.5,1390,7200,1.0,0,0,3,7,1140,250,1965,0,98133,47.7224,-122.332,1630,7702,400000,29,5,2014,0,49,5810,6072,0,1,1
3,2.0,1700,4080,1.0,0,0,4,7,850,850,1941,0,98117,47.6785,-122.393,1480,5100,652000,25,3,2015,0,74,2380,3620,0,1,1
3,1.75,1050,5850,1.0,0,0,3,7,1050,0,1980,0,98166,47.4574,-122.358,1220,8880,260000,30,5,2014,0,34,4800,7660,0,0,1
5,3.0,3340,10796,1.0,0,2,3,9,2120,1220,1964,1990,98040,47.5421,-122.229,3290,12955,1330000,20,4,2015,26,51,7456,9665,1,1,0
4,2.0,1540,17859,1.0,0,0,3,6,1540,0,1964,0,98027,47.5326,-122.032,1390,9688,519500,20,2,2015,0,51,16319,8298,0,0,0
3,1.0,1710,5992,1.5,0,0,4,7,1560,150,1928,0,98103,47.6861,-122.354,1240,3001,650000,27,10,2014,0,86,4282,1761,0,1,1
4,2.25,2100,8075,2.0,0,0,3,8,2100,0,1978,0,98003,47.3251,-122.329,2100,7464,280000,24,3,2015,0,37,5975,5364,0,0,0
4,1.75,1730,7980,1.0,0,0,4,8,1730,0,1965,0,98007,47.6219,-122.138,2080,8400,515000,10,9,2014,0,49,6250,6320,0,0,0
3,2.25,1500,2692,2.0,0,0,3,7,1500,0,1986,0,98034,47.7159,-122.203,1470,2418,400000,18,3,2015,0,29,1192,948,0,0,0
3,2.5,2380,5017,2.0,0,0,3,9,2380,0,2003,0,98074,47.6297,-122.021,2670,6066,652100,14,4,2015,0,12,2637,3396,0,0,0
6,3.0,2180,7956,2.0,0,0,3,7,2180,0,1980,0,98003,47.3054,-122.305,2214,7684,235000,23,6,2014,0,34,5776,5470,0,0,0
4,1.5,1840,10080,2.0,0,0,3,8,1840,0,1907,0,98118,47.5575,-122.279,1830,5040,701000,8,4,2015,0,108,8240,3210,0,0,1
4,2.5,2341,9594,2.0,0,0,3,9,2341,0,1997,0,98052,47.6993,-122.115,2850,9421,640000,24,6,2014,0,17,7253,6571,0,0,0
3,2.5,1690,4584,2.0,0,0,3,7,1690,0,2002,0,98053,47.6866,-122.043,1600,3164,455800,28,7,2014,0,12,2894,1564,0,0,0
2,1.0,1030,8786,1.0,0,0,3,6,1030,0,1956,0,98146,47.4814,-122.341,1480,8121,250000,11,7,2014,0,58,7756,6641,0,0,1
5,2.75,2000,5885,1.0,0,0,3,7,1260,740,1994,0,98023,47.3155,-122.347,1960,6514,229950,24,9,2014,0,20,3885,4554,0,1,0
4,3.5,4210,9414,2.0,0,0,3,9,4210,0,2001,0,98074,47.6067,-122.022,3950,8880,884744,23,7,2014,0,13,5204,4930,0,0,0
3,1.5,1610,9964,1.0,0,0,3,7,1080,530,1977,0,98052,47.6681,-122.143,1610,9964,514000,1,4,2015,0,38,8354,8354,0,1,0
4,2.5,2660,5539,2.0,0,0,3,8,2660,0,2004,0,98059,47.4981,-122.162,2380,5539,423000,11,9,2014,0,10,2879,3159,0,0,0
2,1.0,820,4025,1.0,0,2,5,6,820,0,1922,0,98126,47.5649,-122.38,1410,5750,420000,26,8,2014,0,92,3205,4340,0,0,1
3,1.75,1730,18250,1.0,0,0,3,8,1730,0,1988,0,98011,47.737,-122.201,2180,10027,521000,10,11,2014,0,26,16520,7847,0,0,0
4,2.25,2360,7490,2.0,0,0,3,8,2360,0,1979,0,98033,47.6988,-122.169,2360,7490,577000,5,2,2015,0,36,5130,5130,0,0,0
3,1.0,970,8040,1.0,0,0,3,7,970,0,1956,0,98007,47.603,-122.132,1250,7000,425000,29,9,2014,0,58,7070,5750,0,0,0
4,2.5,2460,4862,2.0,0,0,3,8,2460,0,2004,0,98028,47.7719,-122.235,2900,4895,495000,31,10,2014,0,10,2402,1995,0,0,0
3,2.5,2690,8577,2.0,0,0,3,9,2690,0,1987,0,98023,47.3026,-122.351,2570,8066,340000,1,10,2014,0,27,5887,5496,0,0,0
3,3.5,1820,1991,2.0,0,0,3,8,1430,390,2014,0,98144,47.596,-122.298,1550,1460,499950,23,9,2014,0,0,171,-90,0,1,1
4,3.0,3470,4750,2.0,0,2,3,9,2370,1100,2014,0,98116,47.5917,-122.386,2420,4761,1220000,16,3,2015,0,1,1280,2341,0,1,1
4,2.75,3370,7634,1.0,0,2,5,8,2110,1260,1977,0,98056,47.5259,-122.204,2460,7634,720000,27,2,2015,0,38,4264,5174,0,1,0
3,1.5,1700,8247,1.0,0,0,3,7,1010,690,1970,0,98031,47.4216,-122.174,1440,8400,249000,12,3,2015,0,45,6547,6960,0,1,0
3,1.0,1340,11070,1.0,0,0,4,7,1340,0,1978,0,98030,47.3527,-122.178,1650,7630,206135,13,6,2014,0,36,9730,5980,0,0,0
5,2.75,2000,9276,2.0,0,0,4,7,2000,0,1968,0,98055,47.444,-122.19,1240,8270,300000,6,10,2014,0,46,7276,7030,0,0,0
6,3.0,3840,14040,1.5,0,3,3,8,2460,1380,1949,0,98178,47.506,-122.241,2170,6765,612000,18,3,2015,0,66,10200,4595,0,1,1
4,2.0,1220,9100,1.5,0,0,4,7,1220,0,1970,0,98023,47.2964,-122.376,1160,7700,230000,24,2,2015,0,45,7880,6540,0,0,0
3,1.0,2280,4600,1.0,0,2,3,8,1250,1030,1936,0,98119,47.6378,-122.372,1910,4000,850000,4,5,2015,0,79,2320,2090,0,1,1
4,2.5,2770,7000,1.0,0,0,4,7,1940,830,1979,0,98001,47.3396,-122.256,2140,7684,355000,25,9,2014,0,35,4230,5544,0,1,0
4,2.5,2520,7253,2.0,0,0,3,9,2520,0,1990,0,98059,47.5148,-122.159,2570,8359,442000,23,6,2014,0,24,4733,5789,0,0,0
4,3.0,3060,5000,2.0,0,0,3,8,3060,0,2001,0,98042,47.3786,-122.126,3060,5668,399000,26,6,2014,0,13,1940,2608,0,0,0
4,2.5,2390,7115,2.0,0,0,3,9,2390,0,1999,0,98092,47.2593,-122.222,2600,7916,360000,6,11,2014,0,15,4725,5316,0,0,0
3,1.75,1320,7725,1.0,0,0,3,8,1320,0,1978,0,98058,47.4425,-122.133,2020,7210,390000,13,2,2015,0,37,6405,5190,0,0,0
5,2.5,2900,8711,1.0,0,0,3,8,1650,1250,1977,0,98011,47.7752,-122.197,2340,8869,413000,18,3,2015,0,38,5811,6529,0,1,0
2,1.0,700,9500,1.0,0,0,3,6,700,0,1951,0,98118,47.5294,-122.276,1020,5617,190000,11,2,2015,0,64,8800,4597,0,0,1
3,2.5,2210,9226,2.0,0,0,3,8,2210,0,1998,0,98045,47.4849,-121.782,2430,8902,432900,13,10,2014,0,16,7016,6472,0,0,0
3,2.25,2180,7741,2.0,0,0,3,9,2180,0,1986,0,98074,47.6482,-122.072,2300,8581,621138,28,5,2014,0,28,5561,6281,0,0,0
3,2.25,2080,4252,1.5,0,0,3,7,1550,530,2003,0,98042,47.4203,-122.157,2080,2275,270000,4,6,2014,0,11,2172,195,0,1,0
3,2.0,1720,5525,1.0,0,2,5,7,960,760,1941,0,98108,47.559,-122.298,1760,5525,500000,2,6,2014,0,73,3805,3765,0,1,1
3,1.75,1650,3200,1.5,0,0,3,8,1650,0,1901,0,98102,47.6209,-122.317,1500,2400,550000,28,8,2014,0,113,1550,900,0,0,1
3,2.0,1690,9087,1.0,0,0,3,8,1690,0,1997,0,98042,47.3724,-122.108,2090,8100,337000,15,10,2014,0,17,7397,6010,0,0,0
3,1.0,970,8710,1.0,0,0,4,6,970,0,1962,0,98198,47.4167,-122.302,1280,11805,170000,13,5,2015,0,53,7740,10525,0,0,1
4,2.5,2030,9095,1.0,0,0,4,7,1130,900,1972,0,98034,47.7321,-122.185,1940,8000,405000,29,8,2014,0,42,7065,6060,0,1,0
3,2.25,1570,7475,1.0,0,0,4,7,1200,370,1983,0,98034,47.7223,-122.174,1700,7230,425000,25,8,2014,0,31,5905,5530,0,1,0
5,2.75,2580,9242,2.0,0,2,4,8,1720,860,1967,0,98007,47.5943,-122.133,2240,9316,713000,22,9,2014,0,47,6662,7076,0,1,0
5,2.5,2090,8712,1.0,0,0,3,8,1420,670,1966,0,98008,47.5968,-122.127,2490,8712,555000,3,11,2014,0,48,6622,6222,0,1,0
4,2.5,3260,5608,2.0,0,0,3,9,3260,0,2003,0,98029,47.5453,-121.995,3010,5608,810000,6,5,2015,0,12,2348,2598,0,0,0
3,3.5,2130,6150,2.0,0,2,5,8,1530,600,1908,0,98199,47.6491,-122.405,2040,5381,819000,24,6,2014,0,106,4020,3341,0,1,1
3,2.5,1690,1200,2.0,0,0,3,8,1410,280,2013,0,98106,47.5389,-122.367,1690,1760,409900,27,3,2015,0,2,-490,70,0,1,1
2,2.5,1780,2067,2.0,0,0,5,9,1780,0,1974,0,98004,47.6132,-122.21,2320,2067,935000,30,6,2014,0,40,287,-253,0,0,0
4,1.75,1620,7560,1.0,0,3,4,7,1380,240,1947,0,98117,47.6981,-122.4,2170,8650,657500,20,4,2015,0,68,5940,6480,0,1,1
6,3.75,4210,6105,2.0,0,0,3,9,3280,930,2008,0,98059,47.5211,-122.157,3820,6368,900000,28,4,2015,0,7,1895,2548,0,1,0
5,3.25,2980,7095,2.5,0,0,3,9,2980,0,1998,2007,98115,47.6919,-122.294,1670,7140,932800,2,4,2015,9,17,4115,5470,1,0,1
3,2.0,1490,9000,1.0,0,0,4,8,1490,0,1977,0,98006,47.5455,-122.184,2190,9000,391000,20,4,2015,0,38,7510,6810,0,0,0
4,2.5,2110,9825,2.0,0,0,3,8,2110,0,2000,0,98059,47.4979,-122.153,1650,9900,420000,30,12,2014,0,14,7715,8250,0,0,0
3,1.5,1510,16800,1.0,0,0,5,8,1510,0,1956,0,98133,47.751,-122.338,1560,7276,415000,9,4,2015,0,59,15290,5716,0,0,1
3,1.75,1830,9425,1.0,0,0,3,8,1590,240,1946,0,98146,47.5038,-122.379,1670,8430,350000,25,2,2015,0,69,7595,6760,0,1,1
2,1.0,1230,1820,2.0,0,0,4,7,830,400,1948,0,98107,47.6684,-122.401,1660,3056,375000,21,6,2014,0,66,590,1396,0,1,1
3,1.75,2180,14135,1.0,0,2,5,8,1300,880,1947,0,98033,47.673,-122.187,3540,10318,860000,17,11,2014,0,67,11955,6778,0,1,0
4,2.25,2220,8872,1.0,0,0,4,8,1110,1110,1961,0,98006,47.5491,-122.17,2220,9106,495000,3,6,2014,0,53,6652,6886,0,1,0
4,2.25,1730,8400,1.0,0,0,3,7,1730,0,1962,0,98001,47.3386,-122.288,1550,7920,250000,14,4,2015,0,53,6670,6370,0,0,0
3,2.75,1540,6760,1.0,0,0,5,7,1210,330,1980,0,98034,47.7163,-122.212,1540,7416,503000,7,5,2014,0,34,5220,5876,0,1,0
2,1.0,1100,7200,1.0,0,0,4,6,1100,0,1944,0,98058,47.4752,-122.172,1390,7200,150000,25,3,2015,0,71,6100,5810,0,0,0
4,1.75,1640,1480,1.0,0,0,4,7,820,820,1912,0,98105,47.6684,-122.314,1420,2342,450000,8,10,2014,0,102,-160,922,0,1,1
4,3.0,2590,7213,2.0,0,0,3,8,2590,0,2001,0,98001,47.2609,-122.289,2550,6800,355000,8,12,2014,0,13,4623,4250,0,0,0
3,2.0,1450,9333,2.0,0,0,4,7,1450,0,1972,0,98003,47.346,-122.315,1910,7701,245000,18,10,2014,0,42,7883,5791,0,0,0
3,2.0,1180,7793,1.0,0,0,4,7,1180,0,1992,0,98031,47.4053,-122.181,1720,7793,265900,3,7,2014,0,22,6613,6073,0,0,0
4,2.5,1820,7575,1.0,0,0,3,7,1220,600,1975,0,98058,47.4339,-122.167,1840,7650,299000,25,11,2014,0,39,5755,5810,0,1,0
4,2.25,2360,11523,2.0,0,0,4,10,2360,0,1968,0,98040,47.5318,-122.224,2850,11362,957500,9,4,2015,0,47,9163,8512,0,0,0
3,1.0,1120,7250,1.0,0,0,4,7,1120,0,1972,0,98034,47.7143,-122.211,1340,7302,343000,8,9,2014,0,42,6130,5962,0,0,0
3,2.25,1646,7364,2.0,0,0,3,7,1646,0,1994,0,98038,47.3646,-122.037,1975,9161,307500,27,10,2014,0,20,5718,7186,0,0,0
5,3.75,4210,14599,2.0,0,3,3,10,4210,0,2004,0,98065,47.5364,-121.858,3950,13591,937500,5,1,2015,0,11,10389,9641,0,0,0
3,1.5,1590,7080,1.0,0,2,3,8,1310,280,1952,0,98136,47.5244,-122.386,2080,7200,720000,17,9,2014,0,62,5490,5120,0,1,1
4,2.0,2130,2620,1.5,0,0,5,7,1650,480,1919,0,98103,47.6515,-122.346,1330,2719,610000,16,10,2014,0,95,490,1389,0,1,1
3,1.75,1650,7965,1.0,0,0,4,7,1650,0,1967,0,98034,47.7335,-122.193,1560,7350,434500,31,3,2015,0,48,6315,5790,0,0,0
4,2.5,2180,4000,2.0,0,0,3,8,1700,480,2002,0,98118,47.5553,-122.269,2180,4000,607010,18,11,2014,0,12,1820,1820,0,1,1
3,1.0,1800,5750,1.0,0,0,3,7,1040,760,1947,0,98117,47.686,-122.395,1320,5625,610000,4,2,2015,0,68,3950,4305,0,1,1
3,1.0,1100,8560,1.0,0,0,3,6,1100,0,1961,0,98023,47.329,-122.338,1120,8470,199990,7,7,2014,0,53,7460,7350,0,0,0
3,1.75,1530,9362,1.0,0,0,3,7,1530,0,1987,0,98038,47.3643,-122.049,1480,8125,294000,1,4,2015,0,28,7832,6645,0,0,0
4,2.5,3010,6100,2.0,0,0,3,9,3010,0,2005,0,98052,47.6647,-122.08,2890,5176,789500,12,6,2014,0,9,3090,2286,0,0,0
3,3.5,3500,9473,2.0,0,0,3,10,3500,0,2008,0,98075,47.5807,-121.972,3510,7833,797000,12,2,2015,0,7,5973,4323,0,0,0
5,3.0,3100,5250,2.0,0,0,3,7,3100,0,2006,0,98065,47.5369,-121.888,2460,5250,539950,18,8,2014,0,8,2150,2790,0,0,0
4,1.5,2000,6778,1.0,0,0,4,7,1170,830,1962,0,98198,47.3708,-122.311,1940,7531,284950,23,3,2015,0,53,4778,5591,0,1,1
4,1.5,2290,10372,1.0,0,0,3,7,1510,780,1965,1987,98033,47.6888,-122.199,1900,8109,776500,29,4,2015,22,50,8082,6209,1,1,0
4,2.5,2400,10070,1.0,0,0,3,7,1510,890,1967,0,98034,47.7104,-122.24,2030,9964,525000,24,4,2015,0,48,7670,7934,0,1,0
3,2.5,1850,4957,2.0,0,0,3,8,1850,0,1999,0,98092,47.3311,-122.17,2400,6367,303000,25,4,2015,0,16,3107,3967,0,0,0
3,3.25,3680,7650,2.0,0,0,3,9,2340,1340,1988,0,98074,47.6272,-122.033,2280,8515,722080,10,3,2015,0,27,3970,6235,0,1,0
3,1.0,1060,7473,1.0,0,0,3,7,1060,0,1959,0,98198,47.3699,-122.309,1320,7912,140000,27,6,2014,0,55,6413,6592,0,0,1
3,1.0,1060,7473,1.0,0,0,3,7,1060,0,1959,0,98198,47.3699,-122.309,1320,7912,235000,1,4,2015,0,56,6413,6592,0,0,1
3,1.0,1610,5500,1.5,0,0,3,7,1610,0,1903,1973,98103,47.698,-122.351,1200,5701,440000,20,11,2014,70,111,3890,4501,1,0,1
3,1.75,2330,6000,1.5,0,0,4,7,1630,700,1940,0,98126,47.5765,-122.378,1600,4000,605000,18,7,2014,0,74,3670,2400,0,1,1
2,1.0,1210,4800,1.0,0,0,3,8,1060,150,1950,0,98108,47.5625,-122.316,1380,4800,380000,2,6,2014,0,64,3590,3420,0,1,1
4,1.0,1530,8890,1.0,0,0,3,7,980,550,1925,0,98106,47.5308,-122.35,1100,5203,352000,25,6,2014,0,89,7360,4103,0,1,1
4,2.25,2270,12000,1.0,0,0,4,7,1360,910,1979,0,98072,47.7559,-122.148,2500,10120,420000,13,4,2015,0,36,9730,7620,0,1,0
4,2.0,2590,7220,2.0,0,2,4,10,2590,0,1930,0,98199,47.647,-122.41,2530,6380,1180000,30,4,2015,0,85,4630,3850,0,0,1
3,1.5,1850,10572,1.0,0,0,4,8,1850,0,1953,0,98004,47.6194,-122.208,3030,12752,1380000,22,10,2014,0,61,8722,9722,0,0,0
3,1.5,1500,14750,1.5,0,0,4,6,1500,0,1933,0,98168,47.495,-122.318,1270,15100,300000,26,9,2014,0,81,13250,13830,0,0,1
2,1.5,1710,4189,1.0,0,1,5,7,1160,550,1951,0,98136,47.5286,-122.383,1530,5608,453500,13,10,2014,0,63,2479,4078,0,1,1
3,2.0,1920,7598,1.0,0,0,4,8,1920,0,1972,0,98177,47.7735,-122.363,2220,7598,443500,14,10,2014,0,42,5678,5378,0,0,1
2,1.0,1150,8138,1.0,0,0,3,7,1150,0,1954,0,98155,47.737,-122.325,1300,8139,332000,26,3,2015,0,61,6988,6839,0,0,1
3,2.5,2320,4721,2.0,0,0,3,8,2320,0,2004,0,98075,47.591,-122.017,2250,4356,655000,27,3,2015,0,11,2401,2106,0,0,0
4,1.0,1420,6000,1.5,0,0,3,7,1420,0,1950,0,98115,47.6844,-122.302,1420,6180,475000,3,9,2014,0,64,4580,4760,0,0,1
4,2.5,2920,7200,1.0,0,3,3,8,1470,1450,1921,2006,98144,47.5947,-122.288,3210,6825,1050000,27,5,2014,85,93,4280,3615,1,1,1
3,1.75,1620,4200,1.0,0,0,5,7,830,790,1945,0,98115,47.6743,-122.285,1580,5000,500000,3,6,2014,0,69,2580,3420,0,1,1
3,1.0,1070,7140,1.0,0,0,3,7,1070,0,1989,0,98118,47.5427,-122.288,1390,2374,327500,4,6,2014,0,25,6070,984,0,0,1
3,1.75,1790,7123,1.0,0,0,3,7,1790,0,1913,1995,98019,47.7429,-121.981,1660,8128,390000,6,4,2015,82,102,5333,6468,1,0,0
2,1.5,1510,1962,2.0,0,0,4,8,1510,0,1985,0,98007,47.6214,-122.153,1510,2182,451101,13,1,2015,0,30,452,672,0,0,0
4,1.0,1340,5800,1.5,0,2,3,7,1340,0,1914,0,98116,47.5658,-122.389,1900,5800,455000,14,10,2014,0,100,4460,3900,0,0,1
3,2.5,2500,7746,2.0,0,0,4,10,1910,590,1993,0,98112,47.6393,-122.311,2480,5099,895000,6,8,2014,0,21,5246,2619,0,1,1
4,2.25,2350,10664,1.0,0,1,2,7,1510,840,1952,0,98040,47.5743,-122.238,2350,10140,800000,26,3,2015,0,63,8314,7790,0,1,0
4,2.25,2550,12918,2.0,0,0,3,9,2550,0,1987,0,98006,47.5623,-122.109,2550,11036,703770,13,11,2014,0,27,10368,8486,0,0,0
3,1.75,1320,10454,1.0,0,0,4,7,1320,0,1968,0,98002,47.2844,-122.216,1680,10183,249950,14,8,2014,0,46,9134,8503,0,0,0
2,2.0,1270,3881,1.0,0,0,4,6,610,660,1926,0,98105,47.6694,-122.298,1370,5000,512000,28,4,2015,0,89,2611,3630,0,1,1
3,2.25,2820,11625,2.0,0,0,3,8,2820,0,1986,0,98092,47.2621,-122.218,2290,8488,336000,16,7,2014,0,28,8805,6198,0,0,0
3,2.0,2110,6900,1.5,0,0,5,6,1220,890,1955,0,98178,47.504,-122.26,1350,7683,285000,22,8,2014,0,59,4790,6333,0,1,1
3,1.75,1100,7224,1.0,0,0,3,7,1100,0,1981,0,98032,47.3717,-122.277,1700,8447,229900,21,10,2014,0,33,6124,6747,0,0,0
4,3.0,1920,4000,1.5,0,0,4,8,1540,380,1931,0,98116,47.5718,-122.385,1660,4000,667500,15,4,2015,0,84,2080,2340,0,1,1
4,2.5,1890,12236,1.0,0,0,3,7,1230,660,1978,0,98045,47.4491,-121.78,1390,11360,378000,20,6,2014,0,36,10346,9970,0,1,0
4,2.5,2550,4630,2.0,0,0,3,7,2550,0,2005,0,98075,47.5928,-122.004,2550,5151,537500,8,5,2014,0,9,2080,2601,0,0,0
3,1.0,1550,4160,1.5,0,0,4,6,1550,0,1926,0,98118,47.5387,-122.265,1590,5000,425000,3,9,2014,0,88,2610,3410,0,0,1
3,2.0,1760,6600,1.0,0,0,3,7,1760,0,1998,0,98030,47.3836,-122.184,2590,6600,290000,24,11,2014,0,16,4840,4010,0,0,0
3,2.0,1270,3600,1.0,0,0,3,7,1270,0,1963,0,98122,47.6099,-122.297,1660,3600,349500,1,7,2014,0,51,2330,1940,0,0,1
3,2.75,1250,1655,2.0,0,0,3,7,830,420,2006,0,98136,47.5554,-122.382,1520,3001,370000,2,12,2014,0,8,405,1481,0,1,1
3,1.75,1620,8438,1.0,0,0,4,8,1620,0,1961,0,98125,47.703,-122.281,2040,9450,549500,9,3,2015,0,54,6818,7410,0,0,1
2,1.0,710,6322,1.0,0,0,3,6,710,0,1942,0,98126,47.5165,-122.376,740,6720,245000,30,1,2015,0,73,5612,5980,0,0,1
3,1.75,1070,7200,1.0,0,0,3,7,1070,0,1994,0,98010,47.3134,-122.023,1480,7200,208000,29,7,2014,0,20,6130,5720,0,0,0
4,2.25,2320,8760,1.0,0,0,4,8,1160,1160,1966,0,98032,47.3627,-122.285,1970,8690,248000,20,12,2014,0,48,6440,6720,0,1,0
4,2.5,1670,5116,2.0,0,0,3,8,1670,0,1999,0,98155,47.7667,-122.33,1910,7210,550000,1,4,2015,0,16,3446,5300,0,0,1
2,1.75,1340,7380,1.0,0,0,3,6,1340,0,1940,0,98055,47.4785,-122.229,1980,9600,192000,30,10,2014,0,74,6040,7620,0,0,0
2,1.0,790,4000,1.0,0,2,3,7,790,0,1908,0,98112,47.6248,-122.301,1700,4200,169317,18,2,2015,0,107,3210,2500,0,0,1
4,3.5,3400,3850,2.5,0,0,3,10,2790,610,2008,0,98112,47.6258,-122.302,2030,4000,1200000,1,7,2014,0,6,450,1970,0,1,1
2,1.0,1530,6350,1.5,0,0,4,7,1530,0,1923,0,98112,47.6325,-122.303,2640,6350,880000,29,10,2014,0,91,4820,3710,0,0,1
1,1.0,930,7129,1.0,0,0,3,6,930,0,1948,0,98133,47.7234,-122.333,1300,8075,210000,17,6,2014,0,66,6199,6775,0,0,1
3,1.5,1540,9800,1.0,0,0,3,7,1010,530,1973,0,98058,47.4676,-122.184,1600,8250,180500,7,1,2015,0,42,8260,6650,0,1,0
3,1.5,1220,6000,1.0,0,0,3,7,1220,0,1968,0,98055,47.4904,-122.222,1660,6000,177500,26,6,2014,0,46,4780,4340,0,0,0
3,1.75,2380,5650,1.0,0,2,4,8,1190,1190,1956,0,98118,47.5119,-122.255,2350,6554,415000,5,11,2014,0,58,3270,4204,0,1,1
4,2.5,2020,7200,1.0,0,0,5,7,1010,1010,1968,0,98034,47.7289,-122.201,1620,7275,495000,9,9,2014,0,46,5180,5655,0,1,0
3,2.25,1890,9646,1.0,0,0,3,8,1890,0,1966,0,98168,47.4838,-122.299,1580,9488,325000,4,3,2015,0,49,7756,7908,0,0,1
2,1.75,1330,4903,1.0,0,0,3,7,1330,0,1985,0,98052,47.6819,-122.161,1470,2735,440000,20,2,2015,0,30,3573,1265,0,0,0
3,1.75,1490,9844,1.0,0,0,4,7,1190,300,1959,0,98155,47.7626,-122.297,1840,10150,411000,23,7,2014,0,55,8354,8310,0,1,1
5,3.5,3550,9600,2.0,0,0,3,9,2550,1000,1998,0,98118,47.5484,-122.269,2030,9600,810000,29,10,2014,0,16,6050,7570,0,1,1
5,1.75,2040,8996,1.0,0,2,4,7,1020,1020,1962,0,98008,47.588,-122.118,1950,8270,561750,16,10,2014,0,52,6956,6320,0,1,0
4,2.5,2380,12573,1.0,0,0,4,9,2380,0,1963,0,98005,47.5984,-122.176,2900,10700,835100,22,7,2014,0,51,10193,7800,0,0,0
3,2.25,1780,9969,1.0,0,0,3,8,1450,330,1985,0,98034,47.7286,-122.168,1950,7974,450000,1,9,2014,0,29,8189,6024,0,1,0
3,2.5,1650,2807,2.0,0,0,3,7,1650,0,2004,0,98055,47.4328,-122.196,1460,1875,238000,4,11,2014,0,10,1157,415,0,0,0
2,1.0,1100,6240,1.0,0,0,4,7,1100,0,1941,0,98199,47.6446,-122.403,1250,6240,570000,17,10,2014,0,73,5140,4990,0,0,1
3,1.75,2190,12626,2.0,0,0,4,8,2190,0,1978,0,98042,47.3845,-122.154,3110,14592,340000,4,6,2014,0,36,10436,11482,0,0,0
2,1.75,1760,2275,1.5,0,0,3,6,1040,720,1912,0,98116,47.5803,-122.393,1380,3750,450000,29,4,2015,0,103,515,2370,0,1,1
4,1.5,1800,8786,1.0,0,0,3,7,1330,470,1966,0,98146,47.4982,-122.345,1780,8664,272750,10,9,2014,0,48,6986,6884,0,1,1
4,2.0,2000,6380,2.0,0,0,4,6,1860,140,1949,0,98115,47.6956,-122.303,1600,6380,520000,24,7,2014,0,65,4380,4780,0,1,1
3,1.0,990,10723,1.0,0,0,5,7,990,0,1960,0,98059,47.4887,-122.133,1460,10723,284950,18,6,2014,0,54,9733,9263,0,0,0
2,1.5,1480,9660,1.0,0,0,3,7,1480,0,1949,0,98188,47.4577,-122.289,1990,9660,255000,24,4,2015,0,66,8180,7670,0,0,1
2,1.0,1200,9488,1.0,0,0,5,7,1200,0,1941,0,98168,47.4832,-122.299,1200,9488,231500,12,11,2014,0,73,8288,8288,0,0,1
4,2.5,3504,6000,2.0,0,0,3,7,3504,0,2006,0,98001,47.3012,-122.285,2790,5231,330000,5,1,2015,0,9,2496,2441,0,0,0
3,1.5,1300,12240,1.0,0,0,3,7,1300,0,1963,0,98028,47.737,-122.243,2040,9326,365000,28,5,2014,0,51,10940,7286,0,0,0
4,2.0,1330,9188,1.5,0,0,3,7,1330,0,1928,2004,98198,47.401,-122.319,1770,10419,425000,7,10,2014,76,86,7858,8649,1,0,1
4,1.75,1850,6480,1.0,0,0,4,7,1120,730,1958,0,98108,47.5525,-122.313,1610,5040,400000,4,11,2014,0,56,4630,3430,0,1,1
4,2.5,2240,9701,2.0,0,0,3,9,2240,0,1989,0,98023,47.3086,-122.392,2240,9410,335000,22,9,2014,0,25,7461,7170,0,0,0
3,3.0,1260,1251,2.0,0,0,3,7,1040,220,2003,0,98144,47.5943,-122.296,1780,7715,342000,30,9,2014,0,11,-9,5935,0,1,1
8,5.0,2800,2580,2.0,0,0,3,8,1880,920,1997,0,98122,47.6086,-122.303,1800,2580,490000,4,12,2014,0,17,-220,780,0,1,1
4,1.75,1820,14319,1.0,0,0,4,7,1820,0,1969,0,98059,47.4757,-122.148,1440,10018,331500,6,11,2014,0,45,12499,8578,0,0,0
3,2.5,3370,6550,2.0,0,2,4,8,2840,530,1912,2001,98126,47.5442,-122.38,1500,6550,830000,20,8,2014,89,102,3180,5050,1,1,1
3,1.75,1240,3600,1.5,0,0,5,7,1240,0,1926,0,98116,47.5797,-122.405,1660,3600,662990,23,5,2014,0,88,2360,1940,0,0,1
4,2.0,2340,10507,1.5,0,0,4,6,2340,0,1959,0,98030,47.3578,-122.178,990,10507,220000,30,3,2015,0,56,8167,9517,0,0,0
5,2.0,1880,4179,1.0,0,0,3,7,940,940,1952,2000,98118,47.5536,-122.283,1350,5150,349950,8,1,2015,48,63,2299,3800,1,1,1
3,2.0,1810,2159,1.0,0,0,3,7,1010,800,1922,0,98109,47.6273,-122.345,1810,2159,550000,7,1,2015,0,93,349,349,0,1,1
3,1.75,2340,5668,1.0,0,0,4,6,1200,1140,1941,0,98106,47.5588,-122.364,860,4800,396000,15,9,2014,0,73,3328,3940,0,1,1
4,1.5,2820,4000,2.0,0,0,3,7,2820,0,1911,0,98103,47.6638,-122.348,1470,1627,635000,16,1,2015,0,104,1180,157,0,0,1
3,1.0,1020,7650,1.0,0,0,3,7,1020,0,1940,0,98133,47.7198,-122.352,1440,7650,293000,18,11,2014,0,74,6630,6210,0,0,1
3,2.25,2090,10120,1.0,0,0,4,7,1290,800,1979,0,98058,47.4654,-122.174,1820,7983,339000,11,7,2014,0,35,8030,6163,0,1,0
4,2.25,1830,8734,2.0,0,0,4,7,1830,0,1991,0,98030,47.3679,-122.179,1870,7212,285000,30,6,2014,0,23,6904,5342,0,0,0
6,2.75,2980,5000,1.5,0,0,3,7,2480,500,1916,0,98103,47.6684,-122.331,1470,5000,775000,10,7,2014,0,98,2020,3530,0,1,1
4,1.5,1600,9289,1.0,0,0,4,7,1600,0,1959,0,98002,47.3107,-122.212,1540,9918,224000,26,6,2014,0,55,7689,8378,0,0,0
4,3.5,4440,8125,2.0,0,3,5,10,3140,1300,1922,0,98144,47.5744,-122.283,3990,8505,2250000,29,10,2014,0,92,3685,4515,0,1,1
3,1.0,1200,8514,1.0,0,0,3,7,1200,0,1959,0,98022,47.2043,-122.008,1210,8985,165050,1,7,2014,0,55,7314,7775,0,0,0
3,1.25,1230,4500,1.5,0,0,4,7,1230,0,1913,0,98118,47.5301,-122.271,1310,5000,275000,27,10,2014,0,101,3270,3690,0,0,1
5,3.0,2930,5500,1.0,0,0,3,7,1750,1180,1951,0,98118,47.5572,-122.281,1400,5500,445000,11,9,2014,0,63,2570,4100,0,1,1
3,1.5,1610,13500,1.0,0,0,3,7,1060,550,1970,0,98155,47.7674,-122.31,1540,11479,390000,29,10,2014,0,44,11890,9939,0,1,1
3,2.25,2350,10450,1.0,0,0,3,8,1390,960,1977,0,98028,47.7433,-122.259,2250,10450,460000,13,5,2014,0,37,8100,8200,0,1,0
3,1.75,2000,14733,1.0,0,0,4,8,2000,0,1958,0,98005,47.6001,-122.178,2620,14733,700000,27,3,2015,0,57,12733,12113,0,0,0
4,3.5,3530,14406,2.0,0,1,3,10,2570,960,1987,0,98034,47.7073,-122.244,3170,15181,874150,22,6,2014,0,27,10876,12011,0,1,0
3,2.25,2220,9800,2.0,0,0,3,8,2220,0,1987,0,98155,47.7635,-122.286,2420,10232,470000,31,7,2014,0,27,7580,7812,0,0,1
3,1.75,2000,9416,1.0,0,0,4,6,2000,0,1961,0,98033,47.697,-122.175,1440,9555,374000,21,5,2014,0,53,7416,8115,0,0,0
2,2.5,1140,1181,3.0,0,0,3,8,1140,0,2007,0,98107,47.6713,-122.383,1220,1189,467000,11,7,2014,0,7,41,-31,0,0,1
3,2.0,1560,7352,1.0,0,0,3,6,1560,0,1992,0,98001,47.2804,-122.251,1120,7950,196440,30,5,2014,0,22,5792,6830,0,0,0
2,1.0,930,2600,1.0,0,0,3,7,930,0,1981,0,98034,47.7242,-122.161,1370,3488,281000,8,4,2015,0,34,1670,2118,0,0,0
3,2.5,1782,1577,3.0,0,0,3,7,1782,0,2000,0,98125,47.7114,-122.301,1550,1744,326000,12,8,2014,0,14,-205,194,0,0,1
4,1.0,1230,8316,1.5,0,0,3,7,1230,0,1963,0,98034,47.7269,-122.24,1490,8316,340000,27,2,2015,0,52,7086,6826,0,0,0
3,2.0,2000,7000,2.0,0,0,3,7,2000,0,1916,1986,98136,47.5452,-122.393,1840,7000,561000,6,5,2014,70,98,5000,5160,1,0,1
3,2.25,1520,7930,1.0,0,0,3,7,1160,360,1988,0,98038,47.3605,-122.049,1530,7930,270000,31,10,2014,0,26,6410,6400,0,1,0
2,1.0,1040,3600,1.0,0,0,4,7,1040,0,1919,1980,98112,47.619,-122.311,2250,4800,600000,20,6,2014,61,95,2560,2550,1,0,1
4,1.5,1120,5427,1.0,0,0,3,6,1120,0,1969,2014,98042,47.3628,-122.087,1150,5304,219900,5,5,2014,45,45,4307,4154,1,0,0
3,2.25,1820,8446,2.0,0,0,3,8,1820,0,1978,0,98034,47.7208,-122.236,1850,8437,469000,4,9,2014,0,36,6626,6587,0,0,0
4,3.0,3130,2646,2.5,0,0,5,9,2290,840,1906,0,98102,47.6272,-122.316,2920,4500,1270000,22,4,2015,0,109,-484,1580,0,1,1
3,1.5,1640,8301,1.0,0,0,3,7,1290,350,1958,0,98155,47.7443,-122.327,1640,8955,365000,5,8,2014,0,56,6661,7315,0,1,1
4,2.5,2650,9301,2.0,0,0,3,9,2650,0,2001,0,98001,47.3477,-122.271,2730,8688,429000,12,12,2014,0,13,6651,5958,0,0,0
4,2.5,2850,6809,2.0,0,0,3,9,2850,0,2003,0,98019,47.7353,-121.973,2820,7500,550000,8,12,2014,0,11,3959,4680,0,0,0
3,1.5,1180,7000,1.0,0,0,4,7,1180,0,1977,0,98023,47.2966,-122.374,1180,7370,187500,17,6,2014,0,37,5820,6190,0,0,0
6,2.5,1880,14350,1.0,0,0,5,7,1640,240,1955,0,98133,47.7556,-122.352,1510,9840,520500,15,4,2015,0,60,12470,8330,0,1,1
3,1.75,1280,12776,1.0,0,0,4,7,1280,0,1977,0,98031,47.4212,-122.199,1680,11704,300000,4,2,2015,0,38,11496,10024,0,0,0
4,3.25,3120,5000,2.0,0,0,3,9,2370,750,2005,0,98115,47.69,-122.299,2520,6000,799000,16,5,2014,0,9,1880,3480,0,1,1
3,2.5,2470,4948,2.0,0,0,3,8,2470,0,2003,0,98038,47.3438,-122.039,2500,4993,338000,3,2,2015,0,12,2478,2493,0,0,0
3,1.0,1700,4400,1.5,0,0,4,8,1700,0,1906,0,98122,47.612,-122.292,1610,4180,800000,14,5,2014,0,108,2700,2570,0,0,1
2,2.0,1180,3200,1.0,0,1,4,6,590,590,1945,0,98136,47.5275,-122.383,1350,4000,360000,25,8,2014,0,69,2020,2650,0,1,1
6,2.5,2800,10490,1.0,0,0,3,7,1400,1400,1968,0,98177,47.7735,-122.378,2290,8716,442500,28,7,2014,0,46,7690,6426,0,1,1
5,3.0,3040,9601,1.0,0,0,5,9,1970,1070,1968,0,98040,47.5562,-122.22,3180,12390,830000,8,5,2014,0,46,6561,9210,0,1,0
3,2.5,1630,11592,2.0,0,0,3,8,1630,0,1987,0,98011,47.7574,-122.228,1700,8850,360400,18,11,2014,0,27,9962,7150,0,0,0
3,1.0,1340,9339,1.0,0,0,5,7,1340,0,1960,0,98056,47.5407,-122.177,1310,9350,345000,21,11,2014,0,54,7999,8040,0,0,0
3,1.0,1240,10800,1.0,0,0,5,7,1240,0,1959,0,98056,47.5233,-122.185,1810,10800,350000,4,9,2014,0,55,9560,8990,0,0,0
3,1.75,1760,7482,1.0,0,0,4,8,1760,0,1966,0,98023,47.3129,-122.369,2000,7500,264000,23,6,2014,0,48,5722,5500,0,0,0
3,2.0,2660,16677,1.0,0,0,3,9,2210,450,1990,0,98038,47.3689,-122.055,2660,11355,435000,12,3,2015,0,25,14017,8695,0,1,0
3,1.5,2060,15837,1.5,0,0,3,6,2060,0,1903,0,98055,47.4819,-122.223,2190,8549,200000,4,6,2014,0,111,13777,6359,0,0,0
5,2.5,2540,3832,2.0,0,0,5,8,1760,780,1929,0,98117,47.6848,-122.398,2000,5289,620000,14,5,2014,0,85,1292,3289,0,1,1
5,4.25,4830,11466,2.0,0,0,3,10,3720,1110,2014,0,98040,47.5774,-122.222,2180,11017,1680000,20,11,2014,0,0,6636,8837,0,1,0
3,1.75,1400,6000,1.0,0,0,4,7,700,700,1919,0,98108,47.5283,-122.321,1030,6000,337000,9,12,2014,0,95,4600,4970,0,1,1
4,2.5,2230,10414,1.0,0,0,5,7,1450,780,1974,0,98075,47.5816,-122.0,1960,10240,544500,28,5,2014,0,40,8184,8280,0,1,0
1,1.0,680,1638,1.0,0,4,1,6,680,0,1910,1992,98116,47.5832,-122.399,1010,3621,252000,2,1,2015,82,105,958,2611,1,0,1
4,2.5,2340,3784,2.0,0,0,3,8,2340,0,2008,0,98106,47.535,-122.348,1730,4000,445000,5,6,2014,0,6,1444,2270,0,0,1
3,2.25,2070,14196,2.0,0,0,3,7,2070,0,1989,0,98059,47.4617,-122.07,1550,13860,379500,25,7,2014,0,25,12126,12310,0,0,0
4,2.0,1910,4225,1.0,0,0,4,6,910,1000,1919,0,98001,47.3084,-122.234,1060,4800,189950,11,3,2015,0,96,2315,3740,0,1,0
3,1.0,950,4250,1.5,0,0,5,6,950,0,1948,0,98122,47.609,-122.307,2130,5120,469000,2,6,2014,0,66,3300,2990,0,0,1
4,2.75,2610,8967,2.0,0,0,4,8,2610,0,1990,0,98042,47.3747,-122.124,2390,7852,372000,10,2,2015,0,25,6357,5462,0,0,0
5,3.0,3880,7180,2.0,0,0,3,7,3880,0,2004,0,98056,47.4797,-122.179,2160,4793,445000,25,2,2015,0,11,3300,2633,0,0,0
5,1.5,1940,4800,2.0,0,0,3,8,1940,0,1905,0,98103,47.6845,-122.332,1750,4800,780000,18,3,2015,0,110,2860,3050,0,0,1
4,2.25,2510,9800,2.0,0,0,3,9,2510,0,1978,0,98072,47.753,-122.145,2440,11000,541100,16,3,2015,0,37,7290,8560,0,0,0
4,2.5,2660,5608,2.0,0,0,3,9,2660,0,2003,0,98029,47.5449,-121.995,3010,5608,729000,5,1,2015,0,12,2948,2598,0,0,0
2,1.0,1320,4520,1.0,0,1,3,6,1320,0,1912,1971,98116,47.5655,-122.394,1420,4560,451555,15,5,2014,59,102,3200,3140,1,0,1
2,1.0,960,8153,1.0,0,0,3,6,960,0,1947,0,98155,47.7341,-122.3,1160,8199,300000,30,6,2014,0,67,7193,7039,0,0,1
3,2.5,1790,11542,1.0,0,0,5,7,1190,600,1969,0,98059,47.5124,-122.16,1790,9131,416000,7,4,2015,0,46,9752,7341,0,1,0
2,1.0,950,3060,1.0,0,0,3,6,810,140,1925,0,98105,47.6698,-122.323,1510,3780,490000,21,10,2014,0,89,2110,2270,0,1,1
6,3.75,2940,5054,2.0,0,0,3,7,2940,0,1942,2003,98146,47.5122,-122.385,1530,5320,480000,29,1,2015,61,73,2114,3790,1,0,1
2,2.0,930,1662,1.0,0,0,3,7,670,260,2002,0,98199,47.6518,-122.4,1780,2343,368000,3,2,2015,0,13,732,563,0,1,1
3,2.5,4570,10615,2.0,0,0,3,12,4570,0,1991,0,98027,47.5533,-122.097,3860,11576,1040000,18,9,2014,0,23,6045,7716,0,0,0
3,2.5,2370,9000,1.0,0,3,4,8,1570,800,1952,0,98146,47.4922,-122.365,2120,9500,545000,20,1,2015,0,63,6630,7380,0,1,1
5,2.75,3430,15119,2.0,0,0,3,10,3430,0,1998,0,98075,47.5678,-122.032,3430,12045,850000,23,3,2015,0,17,11689,8615,0,0,0
4,3.5,3540,4750,2.0,0,0,3,10,3540,0,2003,0,98055,47.473,-122.193,3310,5655,550000,4,12,2014,0,11,1210,2345,0,0,0
3,2.25,2240,9314,2.0,0,0,3,9,2240,0,1984,0,98074,47.6216,-122.032,2240,9314,600000,17,2,2015,0,31,7074,7074,0,0,0
4,2.5,2710,12138,1.0,0,0,3,8,1700,1010,1968,0,98155,47.7657,-122.29,2390,10052,535000,27,8,2014,0,46,9428,7662,0,1,1
3,2.5,2660,4975,2.0,0,0,3,8,2660,0,2014,0,98118,47.5487,-122.272,1840,6653,599950,20,5,2014,0,0,2315,4813,0,0,1
5,2.75,2540,5022,1.0,0,0,4,8,1540,1000,1955,0,98108,47.5593,-122.3,2510,5182,531000,18,7,2014,0,59,2482,2672,0,1,1
4,2.25,2210,7665,2.0,0,0,4,8,2210,0,1968,0,98006,47.5424,-122.168,1960,7903,530000,5,6,2014,0,46,5455,5943,0,0,0
4,4.0,3570,8250,2.0,0,0,3,10,2860,710,2015,0,98040,47.5784,-122.226,2230,10000,597326,25,6,2014,0,-1,4680,7770,0,1,0
4,1.75,2330,8364,1.0,0,0,4,8,2330,0,1968,0,98058,47.4568,-122.146,2180,9630,390000,27,10,2014,0,46,6034,7450,0,0,0
4,2.0,1690,3250,1.5,0,0,3,7,1550,140,1901,0,98103,47.6637,-122.346,1620,3250,487250,19,5,2014,0,113,1560,1630,0,1,1
3,1.5,1030,8414,1.0,0,0,4,7,1030,0,1967,0,98155,47.7654,-122.297,1750,8414,301000,9,9,2014,0,47,7384,6664,0,0,1
5,2.75,2560,5618,1.5,0,2,3,8,2220,340,1923,0,98109,47.6416,-122.355,2740,4000,1180000,5,2,2015,0,92,3058,1260,0,1,1
4,2.5,1950,3000,2.0,0,0,3,7,1950,0,2002,0,98178,47.4977,-122.226,1170,6000,299000,26,9,2014,0,12,1050,4830,0,0,1
4,2.5,2350,3904,2.5,0,0,3,7,2350,0,1999,0,98106,47.5305,-122.351,1120,4000,400000,14,10,2014,0,15,1554,2880,0,0,1
4,2.5,3160,7210,1.0,0,0,4,7,1880,1280,1969,0,98034,47.7368,-122.183,2070,7560,467500,1,12,2014,0,45,4050,5490,0,1,0
4,2.5,2430,9103,2.0,0,0,3,8,2430,0,1990,0,98023,47.2939,-122.368,2260,8090,305000,20,2,2015,0,25,6673,5830,0,0,0
3,1.0,1010,10168,1.0,0,0,3,6,1010,0,1979,0,98014,47.6453,-121.912,1180,10318,300000,28,4,2015,0,36,9158,9138,0,0,0
3,2.25,1770,8755,1.0,0,0,3,8,1330,440,1981,0,98058,47.4464,-122.123,1910,8710,327500,8,9,2014,0,33,6985,6800,0,1,0
3,2.0,1210,7136,1.0,0,0,3,7,1210,0,2003,0,98031,47.3996,-122.203,1210,5765,269000,5,8,2014,0,11,5926,4555,0,0,0
4,3.25,3330,17533,1.0,0,2,3,9,1750,1580,1969,0,98033,47.652,-122.2,3340,12798,975000,31,3,2015,0,46,14203,9458,0,1,0
3,1.0,1240,5400,1.0,0,0,4,7,1060,180,1940,0,98133,47.7115,-122.355,1429,5400,355000,10,12,2014,0,74,4160,3971,0,1,1
3,1.0,1250,4620,1.5,0,0,4,7,1150,100,1900,0,98103,47.651,-122.341,1900,4400,712000,8,5,2014,0,114,3370,2500,0,1,1
2,1.0,840,12252,1.0,0,0,3,6,840,0,1994,0,98010,47.3069,-122.013,1010,11876,190000,15,8,2014,0,20,11412,10866,0,0,0
3,1.75,1530,8028,1.0,0,0,3,7,1200,330,1967,0,98177,47.7768,-122.361,1530,8028,443000,6,4,2015,0,48,6498,6498,0,1,1
4,3.0,3750,11025,2.0,0,0,3,10,3750,0,1976,0,98074,47.6367,-122.059,2930,12835,920000,9,5,2014,0,38,7275,9905,0,0,0
4,2.25,2150,8250,1.0,0,0,4,7,1240,910,1978,0,98023,47.3045,-122.378,2050,7875,285000,22,12,2014,0,36,6100,5825,0,1,0
4,3.25,1560,4080,1.0,0,0,3,7,1560,0,1916,0,98126,47.5347,-122.38,1370,4080,901000,23,4,2015,0,99,2520,2710,0,0,1
3,1.75,2040,5775,1.0,0,0,3,7,1410,630,1958,0,98199,47.6592,-122.393,1360,4400,552500,5,3,2015,0,57,3735,3040,0,1,1
2,1.0,860,5000,1.0,0,0,3,6,860,0,1915,1945,98146,47.5133,-122.356,1220,5000,256000,3,3,2015,30,100,4140,3780,1,0,1
3,1.5,1720,7119,1.5,0,0,4,7,1720,0,1952,0,98155,47.7535,-122.314,1590,7616,341000,12,5,2014,0,62,5399,6026,0,0,1
4,2.25,2090,8941,2.0,0,0,3,7,2090,0,1975,0,98058,47.4332,-122.167,1890,7946,279000,26,3,2015,0,40,6851,6056,0,0,0
4,2.25,2130,10650,2.0,0,0,4,8,2130,0,1977,0,98006,47.5567,-122.159,3380,10050,686000,26,7,2014,0,37,8520,6670,0,0,0
2,1.0,1300,11867,1.5,0,0,4,6,1300,0,1975,0,98010,47.3221,-121.903,820,11867,225000,23,5,2014,0,39,10567,11047,0,0,0
4,3.0,2420,4800,1.5,0,0,3,7,1520,900,1919,0,98119,47.6453,-122.358,1090,3800,950000,14,4,2015,0,96,2380,2710,0,1,1
3,2.5,2610,7567,2.0,0,0,3,9,2610,0,1997,0,98052,47.6654,-122.137,2610,8458,780000,22,1,2015,0,18,4957,5848,0,0,0
4,2.0,1880,7500,1.0,0,0,5,6,980,900,1946,0,98178,47.495,-122.266,1670,14350,212000,23,2,2015,0,69,5620,12680,0,1,1
4,2.75,2330,6703,1.5,0,0,3,7,1710,620,1983,0,98177,47.7066,-122.359,2060,7500,580000,29,7,2014,0,31,4373,5440,0,1,1
4,2.5,2200,3141,2.0,0,0,3,7,2060,140,1994,0,98144,47.5726,-122.305,1660,3175,465000,11,11,2014,0,20,941,1515,0,1,1
4,2.0,1720,7560,1.0,0,0,3,7,1720,0,1959,0,98001,47.2845,-122.25,1750,7988,206000,19,11,2014,0,55,5840,6238,0,0,0
3,2.5,2250,10171,2.0,0,0,3,9,2250,0,1987,0,98006,47.5613,-122.11,2440,13390,615000,23,2,2015,0,28,7921,10950,0,0,0
4,1.0,1640,6305,1.5,0,0,5,6,1640,0,1907,0,98118,47.5563,-122.28,1590,4816,519000,19,7,2014,0,107,4665,3226,0,0,1
4,3.25,4130,11444,2.0,0,0,3,11,4130,0,2001,0,98059,47.5208,-122.15,3720,11431,1140000,23,4,2015,0,14,7314,7711,0,0,0
5,2.5,2600,3839,2.0,0,0,3,7,2600,0,2005,0,98058,47.4324,-122.145,2180,4800,330000,8,8,2014,0,9,1239,2620,0,0,0
4,1.5,1920,7973,1.0,0,0,3,8,1920,0,1955,0,98178,47.4961,-122.235,2020,8840,240000,6,5,2015,0,60,6053,6820,0,0,1
3,2.0,2060,7000,1.0,0,0,4,9,2060,0,1988,0,98029,47.5644,-122.012,2110,7000,574000,7,11,2014,0,26,4940,4890,0,0,0
3,1.5,1490,7275,1.0,0,0,3,7,1090,400,1974,0,98034,47.7148,-122.213,1420,7330,415000,12,12,2014,0,40,5785,5910,0,1,0
3,2.5,2360,9005,1.0,0,0,5,7,1340,1020,1929,0,98133,47.7076,-122.337,1520,9005,480000,18,11,2014,0,85,6645,7485,0,1,1
5,1.0,1940,8875,1.0,0,0,3,7,1940,0,1957,0,98188,47.4407,-122.275,1380,8875,300000,21,7,2014,0,57,6935,7495,0,0,1
4,2.25,2570,9503,2.0,0,0,3,8,2570,0,1980,0,98011,47.764,-122.167,1950,9600,439000,8,7,2014,0,34,6933,7650,0,0,0
3,2.25,1260,3000,2.0,0,0,3,7,1260,0,2003,0,98029,47.5459,-121.997,1630,3023,477000,7,4,2015,0,12,1740,1393,0,0,0
4,2.25,1780,6120,1.0,0,0,3,8,1310,470,1951,0,98115,47.6955,-122.287,1780,6120,587500,24,9,2014,0,63,4340,4340,0,1,1
4,2.25,3180,6105,2.0,0,0,3,10,3180,0,1905,0,98112,47.6255,-122.314,3180,6029,1320000,24,9,2014,0,109,2925,2849,0,0,1
4,2.25,2690,15000,2.0,0,0,3,9,1890,800,1978,0,98074,47.612,-122.064,2670,15030,700000,13,4,2015,0,37,12310,12360,0,1,0
2,1.0,1180,6552,1.0,0,0,4,6,1180,0,1949,0,98133,47.7477,-122.342,1070,7200,275000,23,6,2014,0,65,5372,6130,0,0,1
3,1.0,1660,11783,1.0,0,0,4,7,1160,500,1978,0,98077,47.7563,-122.075,1320,10541,367500,24,6,2014,0,36,10123,9221,0,1,0
4,2.5,2260,6300,2.0,0,0,3,7,2260,0,2001,0,98019,47.7235,-121.958,2300,6300,453250,5,5,2015,0,14,4040,4000,0,0,0
5,1.75,1910,5428,1.0,0,0,3,8,1390,520,1954,0,98136,47.5333,-122.392,1820,5900,607000,17,4,2015,0,61,3518,4080,0,1,1
4,2.0,2430,8960,1.0,0,0,3,7,1430,1000,1960,0,98178,47.4979,-122.232,2430,8960,255000,2,7,2014,0,54,6530,6530,0,1,1
2,2.0,1300,2500,1.0,0,0,4,7,770,530,1926,0,98117,47.6831,-122.373,1160,5000,501000,1,5,2015,0,89,1200,3840,0,1,1
3,1.0,1060,4650,1.0,0,0,3,7,910,150,1950,0,98116,47.5784,-122.393,1480,4750,450000,31,3,2015,0,65,3590,3270,0,1,1
3,2.25,2200,8000,2.0,0,0,3,8,2200,0,1981,0,98055,47.4522,-122.208,2170,8000,360000,20,8,2014,0,33,5800,5830,0,0,0
4,1.75,1720,3050,1.5,0,0,5,7,1040,680,1929,0,98116,47.5654,-122.384,1570,6100,460000,14,11,2014,0,85,1330,4530,0,1,1
3,1.75,2360,8290,1.0,0,0,4,7,1180,1180,1950,0,98115,47.6738,-122.281,1880,7670,753000,3,3,2015,0,65,5930,5790,0,1,1
2,1.0,820,4234,1.0,0,1,3,6,820,0,1951,0,98136,47.5294,-122.386,1550,4236,389950,6,5,2015,0,64,3414,2686,0,0,1
2,1.0,1030,4400,1.0,0,0,3,7,1030,0,1924,0,98117,47.681,-122.361,1400,4200,469000,6,5,2014,0,90,3370,2800,0,0,1
4,1.75,2030,5688,2.0,0,4,4,9,1730,300,1939,0,98146,47.5071,-122.387,2320,11107,550000,12,9,2014,0,75,3658,8787,0,1,1
5,3.5,2700,11675,1.5,0,2,4,6,1950,750,1948,0,98133,47.7172,-122.349,2160,8114,565000,4,9,2014,0,66,8975,5954,0,1,1
2,1.75,1100,7600,1.0,0,0,3,6,1100,0,1980,0,98198,47.4136,-122.318,1230,7350,189650,21,5,2014,0,34,6500,6120,0,0,1
4,3.25,3620,5131,2.0,0,3,4,11,2350,1270,1927,0,98119,47.6499,-122.37,2550,5174,1530000,19,6,2014,0,87,1511,2624,0,1,1
3,1.75,1340,8000,1.0,0,0,3,7,1340,0,1980,0,98038,47.3651,-122.044,1690,8000,260000,20,8,2014,0,34,6660,6310,0,0,0
3,1.75,1790,12000,1.0,0,0,3,7,1040,750,1960,0,98198,47.3945,-122.313,1840,12000,243000,1,6,2014,0,54,10210,10160,0,1,1
4,2.5,3830,13800,1.0,0,4,4,9,2030,1800,1969,0,98006,47.5671,-122.157,3460,9875,1100000,1,12,2014,0,45,9970,6415,0,1,0
3,1.5,1580,7200,1.0,0,0,4,7,1080,500,1976,0,98092,47.2761,-122.152,1580,7470,249000,20,8,2014,0,38,5620,5890,0,1,0
2,1.0,2020,7200,1.0,0,3,4,7,1700,320,1947,0,98146,47.506,-122.384,2020,7200,720000,16,5,2014,0,67,5180,5180,0,1,1
4,2.5,3330,9557,2.0,0,0,3,10,3330,0,1995,0,98006,47.5526,-122.102,3360,9755,905000,25,3,2015,0,20,6227,6395,0,0,0
4,2.5,2610,3500,1.5,0,0,5,7,1610,1000,1927,0,98115,47.6848,-122.326,1820,3900,824500,23,4,2015,0,88,890,2080,0,1,1
4,2.75,2610,8760,1.0,0,0,4,8,1760,850,1978,0,98040,47.5875,-122.229,2550,10376,762500,24,6,2014,0,36,6150,7826,0,1,0
3,2.5,1740,1280,3.0,0,2,3,8,1740,0,2008,0,98116,47.589,-122.387,1740,1308,580000,13,4,2015,0,7,-460,-432,0,0,1
3,2.0,1840,8580,1.0,0,0,3,8,1840,0,1990,0,98058,47.4626,-122.132,2190,8580,380000,18,8,2014,0,24,6740,6390,0,0,0
3,1.75,1080,3200,1.0,0,0,4,7,880,200,1926,0,98103,47.6503,-122.338,1780,5200,805000,1,4,2015,0,89,2120,3420,0,1,1
4,1.75,1240,4532,1.5,0,0,4,7,1240,0,1944,0,98117,47.6892,-122.378,1260,4468,520000,16,7,2014,0,70,3292,3208,0,0,1
5,4.5,5620,5800,3.0,0,3,3,11,4700,920,1999,0,98199,47.6482,-122.412,2360,5800,1570000,3,2,2015,0,16,180,3440,0,1,1
2,1.0,1170,8925,1.0,0,2,3,6,1170,0,1911,0,98198,47.4017,-122.321,1380,7440,175000,14,5,2014,0,103,7755,6060,0,0,1
4,2.25,1760,9602,2.0,0,0,3,7,1760,0,1987,0,98058,47.4248,-122.158,1860,9656,353500,16,6,2014,0,27,7842,7796,0,0,0
3,1.75,1520,7350,1.0,0,0,4,7,1140,380,1972,0,98034,47.7167,-122.17,1380,7350,386500,11,2,2015,0,43,5830,5970,0,1,0
2,1.0,1450,4750,1.0,0,0,3,7,850,600,1950,0,98118,47.5293,-122.272,1190,5000,210000,16,7,2014,0,64,3300,3810,0,1,1
3,2.5,1600,6510,1.0,0,0,3,7,940,660,1983,0,98155,47.7679,-122.308,1600,10507,439500,23,4,2015,0,32,4910,8907,0,1,1
5,2.5,3220,5751,2.0,0,0,3,8,3220,0,2002,0,98042,47.3717,-122.104,2740,5500,315000,13,8,2014,0,12,2531,2760,0,0,0
4,2.5,1830,8601,2.0,0,0,3,7,1830,0,2003,0,98038,47.3576,-122.016,1830,5184,339000,19,5,2014,0,11,6771,3354,0,0,0
4,2.25,2200,9163,1.0,0,0,4,8,1430,770,1971,0,98006,47.5653,-122.146,2420,9163,655000,24,9,2014,0,43,6963,6743,0,1,0
2,2.5,2170,8678,1.0,0,0,3,8,2170,0,2008,0,98053,47.7161,-122.014,2170,5890,740000,28,8,2014,0,6,6508,3720,0,0,0
5,2.5,1900,7843,2.0,0,0,5,7,1900,0,1966,0,98008,47.6273,-122.123,1900,7350,685000,6,3,2015,0,49,5943,5450,0,0,0
5,2.5,2960,9877,1.0,0,0,4,7,1480,1480,1960,0,98005,47.5866,-122.171,1900,9877,550000,10,3,2015,0,55,6917,7977,0,1,0
2,1.75,1710,4234,2.0,0,0,3,7,1330,380,1920,1979,98136,47.5319,-122.386,1530,4556,405000,2,6,2014,59,94,2524,3026,1,1,1
3,2.0,2140,3600,2.0,0,0,3,8,1680,460,1911,1997,98116,47.5846,-122.383,2340,5400,625000,4,3,2015,86,104,1460,3060,1,1,1
3,2.5,1460,4961,1.0,0,0,4,8,1150,310,1988,0,98033,47.6955,-122.183,1550,5449,475000,2,12,2014,0,26,3501,3899,0,1,0
2,1.0,990,8250,1.0,0,0,3,7,990,0,1955,0,98133,47.7252,-122.331,1080,8168,365000,29,8,2014,0,59,7260,7088,0,0,1
4,2.25,2190,6800,1.0,0,0,5,7,1340,850,1969,0,98011,47.7367,-122.195,1560,7611,411800,22,12,2014,0,45,4610,6051,0,1,0
3,2.5,2340,3630,2.0,0,0,3,9,2340,0,1998,0,98122,47.6059,-122.307,1820,5120,618000,11,9,2014,0,16,1290,3300,0,0,1
4,2.0,2460,5921,1.0,0,0,4,7,1230,1230,1948,0,98002,47.308,-122.209,1260,6648,247500,26,12,2014,0,66,3461,5388,0,1,0
5,3.0,2080,6150,1.0,0,0,3,7,1040,1040,1950,0,98116,47.5707,-122.394,1420,6150,345000,30,7,2014,0,64,4070,4730,0,1,1
3,2.0,1700,8400,2.0,0,2,3,7,1700,0,1927,0,98033,47.6825,-122.19,1820,9000,616300,11,3,2015,0,88,6700,7180,0,0,0
3,1.5,1330,6768,1.0,0,0,4,7,1330,0,1952,0,98155,47.7366,-122.319,1320,6910,348000,16,1,2015,0,63,5438,5590,0,0,1
3,2.5,1630,10762,1.0,0,0,3,7,1630,0,1994,0,98011,47.7508,-122.175,1770,10762,425000,2,12,2014,0,20,9132,8992,0,0,0
5,2.75,2920,11880,1.0,0,0,5,8,1660,1260,1968,0,98027,47.5133,-122.031,3910,14491,850000,14,6,2014,0,46,8960,10581,0,1,0
5,2.75,2830,6137,2.0,0,0,3,9,2830,0,2010,0,98074,47.5932,-122.058,3170,6285,820000,17,7,2014,0,4,3307,3115,0,0,0
3,1.75,1490,3840,2.0,0,0,3,8,1490,0,1984,2014,98033,47.6916,-122.214,3450,8500,835000,3,12,2014,30,30,2350,5050,1,0,0
3,2.5,1630,3425,2.0,0,0,3,8,1630,0,1999,0,98059,47.4913,-122.154,1420,3425,350000,10,4,2015,0,16,1795,2005,0,0,0
4,2.5,2280,4096,2.0,0,0,3,7,2280,0,2003,0,98056,47.4834,-122.182,2280,3600,349000,22,7,2014,0,11,1816,1320,0,0,0
6,3.75,3010,4360,2.0,0,0,3,9,2000,1010,2014,0,98103,47.6873,-122.333,1600,5160,1130000,13,6,2014,0,0,1350,3560,0,1,1
3,2.5,1590,3480,2.0,0,0,3,7,1590,0,2004,0,98056,47.4805,-122.178,1680,3480,320000,9,3,2015,0,11,1890,1800,0,0,0
3,1.0,1250,7210,1.0,0,0,4,7,1250,0,1968,0,98031,47.4169,-122.168,1010,7210,150000,5,3,2015,0,47,5960,6200,0,0,0
3,1.0,1710,10190,1.0,0,0,3,6,1310,400,1949,0,98168,47.506,-122.331,1200,6251,340000,25,11,2014,0,65,8480,5051,0,1,1
4,4.0,3280,8448,2.0,0,0,3,10,3280,0,2007,0,98075,47.5818,-121.973,3730,8030,785500,13,10,2014,0,7,5168,4300,0,0,0
4,2.5,3362,8601,2.0,0,0,3,8,3362,0,2004,0,98003,47.2592,-122.304,2770,8601,410500,17,2,2015,0,11,5239,5831,0,0,0
3,2.5,2200,11000,2.0,0,2,3,9,2200,0,1978,0,98008,47.5916,-122.112,2200,12851,580000,1,7,2014,0,36,8800,10651,0,0,0
2,1.5,830,920,2.0,0,0,3,7,830,0,2005,0,98144,47.5998,-122.306,830,1200,345000,21,4,2015,0,10,90,370,0,0,1
4,3.0,2580,7299,2.0,0,0,3,8,2580,0,1998,0,98058,47.4646,-122.15,2250,6165,449500,21,10,2014,0,16,4719,3915,0,0,0
3,1.0,2150,7007,1.0,0,0,3,6,2150,0,1954,0,98177,47.7615,-122.362,1720,9000,300000,24,6,2014,0,60,4857,7280,0,0,1
4,3.75,3810,9916,2.0,0,0,3,11,3810,0,1989,0,98040,47.5739,-122.234,3040,11250,1580000,27,1,2015,0,26,6106,8210,0,0,0
4,2.75,2020,2750,1.0,0,0,3,8,1010,1010,1917,2014,98122,47.6053,-122.291,1840,4000,599000,28,5,2014,97,97,730,2160,1,1,1
4,2.5,2120,10202,1.0,0,0,4,7,1620,500,1960,0,98005,47.5858,-122.17,1570,10762,755000,5,5,2014,0,54,8082,9192,0,1,0
3,1.0,1250,7157,1.0,0,0,3,7,1250,0,1944,2010,98125,47.7323,-122.304,1300,6796,400000,2,4,2015,66,71,5907,5496,1,0,1
3,1.0,980,9115,1.0,0,0,3,7,980,0,1968,0,98198,47.3737,-122.312,1470,8716,133000,30,3,2015,0,47,8135,7246,0,0,1
4,1.5,1250,8400,1.0,0,0,3,7,960,290,1951,0,98155,47.7505,-122.315,1560,8400,330000,16,1,2015,0,64,7150,6840,0,1,1
4,1.0,1100,5000,1.5,0,0,5,6,1100,0,1904,0,98055,47.4868,-122.204,1560,4838,330000,18,2,2015,0,111,3900,3278,0,0,0
3,1.75,1330,9417,1.0,0,0,5,6,710,620,1936,0,98125,47.7231,-122.301,1690,7937,375000,5,9,2014,0,78,8087,6247,0,1,1
4,2.75,2560,8956,1.0,0,0,4,7,1500,1060,1968,0,98034,47.7278,-122.177,2280,9234,485000,11,12,2014,0,46,6396,6954,0,1,0
4,2.5,1850,11250,1.5,0,0,3,7,1210,640,1981,0,98074,47.6264,-122.062,1650,7623,470000,22,7,2014,0,33,9400,5973,0,1,0
4,3.0,2790,3600,2.0,0,0,3,8,1880,910,1905,2013,98119,47.6362,-122.363,1360,3600,1050000,21,12,2014,108,109,810,2240,1,1,1
4,1.0,1660,4704,1.5,0,0,3,7,1260,400,1930,0,98115,47.6918,-122.32,1360,5413,548800,7,7,2014,0,84,3044,4053,0,1,1
2,1.0,1080,2674,1.0,0,0,4,6,720,360,1919,0,98108,47.5595,-122.317,1250,5000,315000,8,7,2014,0,95,1594,3750,0,1,1
3,2.0,3030,9374,1.0,0,1,4,7,2100,930,1959,0,98136,47.5289,-122.391,1990,6012,590000,19,9,2014,0,55,6344,4022,0,1,1
4,2.5,2380,12067,2.0,0,0,3,7,2380,0,2002,0,98059,47.4873,-122.144,2330,8621,439950,23,5,2014,0,12,9687,6291,0,0,0
2,1.0,880,5111,1.0,0,0,3,6,880,0,1931,0,98115,47.6997,-122.314,1370,5111,400000,8,12,2014,0,83,4231,3741,0,0,1
4,2.5,2770,10051,2.0,0,0,3,10,2770,0,1987,0,98074,47.6288,-122.043,2730,10675,685000,11,12,2014,0,27,7281,7945,0,0,0
3,2.0,1340,10200,1.5,0,0,3,7,1340,0,1953,0,98133,47.7756,-122.351,1420,10200,339950,18,9,2014,0,61,8860,8780,0,0,1
3,1.75,1660,8160,1.0,0,0,4,7,1660,0,1951,0,98166,47.4608,-122.358,1490,8100,315000,23,10,2014,0,63,6500,6610,0,0,1
3,2.5,1710,3795,2.0,0,0,3,7,1710,0,2009,0,98053,47.6968,-122.024,1600,3821,411753,11,2,2015,0,6,2085,2221,0,0,0
2,1.75,1620,4879,1.0,0,0,3,7,1040,580,1924,2011,98116,47.5703,-122.385,1500,5000,577000,28,8,2014,87,90,3259,3500,1,1,1
3,1.75,1530,8829,1.0,0,0,5,8,1530,0,1972,0,98006,47.545,-122.171,2060,9226,500000,17,10,2014,0,42,7299,7166,0,0,0
3,2.0,1440,10111,1.0,0,0,3,7,1440,0,1963,0,98001,47.345,-122.283,1580,10200,210000,2,12,2014,0,51,8671,8620,0,0,0
4,1.75,1870,8663,1.0,0,0,5,7,1870,0,1949,0,98133,47.7366,-122.35,1560,7800,460000,17,4,2015,0,66,6793,6240,0,0,1
2,1.0,620,4760,1.0,0,0,3,6,620,0,1941,0,98126,47.5286,-122.376,620,4760,265000,18,2,2015,0,74,4140,4140,0,0,1
3,1.0,1240,6195,1.0,0,0,3,6,1240,0,1948,0,98028,47.7681,-122.266,1760,11080,230000,18,7,2014,0,66,4955,9320,0,0,0
3,1.75,1890,10661,1.0,0,0,5,7,1460,430,1978,0,98038,47.3583,-122.056,1680,9604,315000,17,2,2015,0,37,8771,7924,0,1,0
3,2.5,1530,3984,2.0,0,0,3,8,1530,0,1995,0,98029,47.569,-122.007,1720,4005,467000,3,2,2015,0,20,2454,2285,0,0,0
5,3.75,2800,9900,1.0,0,0,3,7,2800,0,1964,0,98023,47.319,-122.344,1700,13200,255000,25,9,2014,0,50,7100,11500,0,0,0
3,1.75,1460,6360,1.0,0,2,3,7,1010,450,1979,0,98106,47.5311,-122.353,1400,4240,316500,8,4,2015,0,36,4900,2840,0,1,1
4,2.0,1580,6250,1.0,0,0,3,7,860,720,1977,0,98155,47.7659,-122.31,1580,6250,190000,3,4,2015,0,38,4670,4670,0,1,1
3,2.0,1450,2400,1.5,0,0,3,8,1450,0,1900,2003,98107,47.6726,-122.381,1450,4275,490000,16,5,2014,103,114,950,2825,1,0,1
5,3.0,1980,3868,1.0,0,0,3,7,1220,760,1990,0,98118,47.5173,-122.275,1970,3868,333800,2,9,2014,0,24,1888,1898,0,1,1
4,2.5,2920,9904,2.0,0,0,4,9,2920,0,1990,0,98029,47.5759,-121.995,1810,5617,690000,29,5,2014,0,24,6984,3807,0,0,0
4,1.75,1660,6200,1.0,0,0,4,6,830,830,1948,0,98108,47.56,-122.316,1780,5968,320000,21,10,2014,0,66,4540,4188,0,1,1
4,3.5,3190,6000,1.5,0,3,4,9,2410,780,1912,0,98144,47.5846,-122.29,2840,4000,1250000,14,4,2015,0,103,2810,1160,0,1,1
3,1.5,1560,9600,1.0,0,0,4,7,1560,0,1961,0,98033,47.6918,-122.163,1520,10000,335000,21,7,2014,0,53,8040,8480,0,0,0
3,2.5,2260,4165,2.0,0,0,3,7,2260,0,2005,0,98075,47.5922,-122.008,2770,4566,550000,9,6,2014,0,9,1905,1796,0,0,0
3,1.0,1260,7920,1.0,0,0,3,7,1260,0,1966,0,98003,47.3452,-122.308,1300,7920,240000,22,4,2015,0,49,6660,6620,0,0,0
3,2.25,3370,11757,2.0,0,2,4,9,3370,0,1980,0,98006,47.5573,-122.16,2690,10500,998000,14,4,2015,0,35,8387,7810,0,0,0
3,1.75,1490,8000,1.0,0,0,3,8,1490,0,1978,0,98030,47.3817,-122.166,1740,8165,275000,29,8,2014,0,36,6510,6425,0,0,0
3,2.5,1570,9292,1.0,0,0,3,7,1110,460,1977,0,98001,47.3386,-122.272,1470,9222,284200,24,4,2015,0,38,7722,7752,0,1,0
4,3.75,4490,7623,2.0,0,0,4,10,3090,1400,1941,0,98112,47.6315,-122.29,3760,7653,1720000,24,7,2014,0,73,3133,3893,0,1,1
4,3.0,2900,10400,1.0,0,3,5,8,1530,1370,1959,0,98008,47.5854,-122.114,2820,10400,930000,29,7,2014,0,55,7500,7580,0,1,0
4,1.5,1430,8775,1.0,0,0,3,7,1030,400,1979,0,98023,47.3034,-122.383,1390,7800,215000,28,8,2014,0,35,7345,6410,0,1,0
2,1.75,1480,5120,1.0,0,0,4,6,840,640,1951,0,98116,47.558,-122.392,1090,5120,483945,20,5,2014,0,63,3640,4030,0,1,1
3,1.75,1240,8050,1.0,0,0,4,7,1240,0,1978,0,98074,47.6108,-122.044,1370,9856,347000,9,6,2014,0,36,6810,8486,0,0,0
3,2.0,1370,9760,1.0,0,0,4,7,1110,260,1979,0,98023,47.3009,-122.384,1640,9040,232500,30,3,2015,0,36,8390,7400,0,1,0
3,2.25,2160,15360,1.0,0,0,3,8,1410,750,1965,2000,98007,47.6232,-122.138,2180,8480,550000,18,9,2014,35,49,13200,6300,1,1,0
4,2.5,2340,8971,2.0,0,0,3,9,2340,0,1987,0,98029,47.5679,-122.011,2510,9219,590000,12,8,2014,0,27,6631,6709,0,0,0
4,2.5,2280,8190,1.0,0,3,3,7,1390,890,1983,0,98188,47.4414,-122.272,1990,9000,345000,5,2,2015,0,32,5910,7010,0,1,1
3,2.0,1970,7000,1.0,0,0,3,8,1970,0,1986,0,98038,47.3744,-122.043,1970,7365,429800,27,2,2015,0,29,5030,5395,0,0,0
4,1.75,1530,17664,1.5,0,0,3,7,1530,0,1968,0,98058,47.4549,-122.155,1530,11625,302000,26,6,2014,0,46,16134,10095,0,0,0
4,1.5,1790,3952,1.5,0,0,4,8,1790,0,1932,0,98103,47.689,-122.352,1200,3876,800000,4,11,2014,0,82,2162,2676,0,0,1
3,2.5,1700,6000,2.0,0,0,3,8,1700,0,1997,0,98092,47.2615,-122.221,1940,6626,250000,15,12,2014,0,17,4300,4686,0,0,0
3,2.0,2660,4500,1.0,0,0,4,7,1330,1330,1922,0,98199,47.6391,-122.403,1790,5000,605000,29,7,2014,0,92,1840,3210,0,1,1
3,2.0,1340,5670,2.0,0,0,3,6,1340,0,1994,0,98055,47.4498,-122.194,1290,4892,252000,12,11,2014,0,20,4330,3602,0,0,0
3,1.0,1130,12500,1.5,0,0,3,7,1130,0,1954,0,98118,47.5491,-122.268,2280,8750,375000,19,9,2014,0,60,11370,6470,0,0,1
2,1.75,1950,2719,1.0,0,0,5,7,1010,940,1919,0,98103,47.6513,-122.346,1360,1256,725000,10,7,2014,0,95,769,-104,0,1,1
5,3.5,3790,8200,1.0,0,1,3,8,2120,1670,2001,0,98056,47.4891,-122.19,1740,8676,471750,13,10,2014,0,13,4410,6936,0,1,0
2,1.0,800,5100,1.0,0,0,3,7,800,0,1945,0,98117,47.6775,-122.388,1330,5100,439000,1,10,2014,0,69,4300,3770,0,0,1
4,2.0,1770,8890,1.0,0,0,5,6,1770,0,1949,0,98166,47.4589,-122.353,1010,7620,355000,22,8,2014,0,65,7120,6610,0,0,1
4,2.25,2260,16188,1.0,0,0,3,10,2260,0,1984,0,98006,47.5637,-122.112,2840,10158,780000,26,3,2015,0,31,13928,7318,0,0,0
2,1.0,890,3271,1.0,0,0,4,6,890,0,1918,0,98116,47.5631,-122.381,1190,5175,409000,5,11,2014,0,96,2381,3985,0,0,1
2,1.0,860,3880,1.0,0,0,4,6,860,0,1916,0,98117,47.6862,-122.391,1230,4260,420000,10,6,2014,0,98,3020,3030,0,0,1
1,0.75,680,9600,1.0,0,0,3,5,680,0,1947,0,98115,47.6964,-122.306,1580,6624,200000,13,11,2014,0,67,8920,5044,0,0,1
3,2.5,2390,4555,2.0,0,0,3,9,2390,0,2006,0,98074,47.6199,-122.025,2540,4500,695000,29,5,2014,0,8,2165,1960,0,0,0
4,2.75,3488,9614,2.0,0,0,3,10,3488,0,1998,0,98074,47.6055,-122.013,3600,10891,815000,21,5,2014,0,16,6126,7291,0,0,0
3,1.75,1260,6223,1.0,0,0,3,7,820,440,1983,0,98042,47.3574,-122.158,1260,6553,210000,13,11,2014,0,31,4963,5293,0,1,0
3,1.75,2940,6000,1.0,0,2,4,8,1590,1350,1957,0,98177,47.7235,-122.369,2880,8100,635000,15,9,2014,0,57,3060,5220,0,1,1
4,2.5,2440,7322,2.0,0,0,3,9,2440,0,1991,0,98056,47.5357,-122.179,2590,9927,562500,21,7,2014,0,23,4882,7337,0,0,0
4,2.5,2600,11951,2.0,0,0,3,10,2600,0,1988,0,98023,47.3053,-122.34,2820,12093,402500,9,5,2014,0,26,9351,9273,0,0,0
3,2.0,2080,7020,1.0,0,0,4,7,1040,1040,1951,0,98115,47.6768,-122.285,1920,7000,555000,19,12,2014,0,63,4940,5080,0,1,1
3,1.0,1990,7173,1.0,0,0,3,7,1990,0,1972,0,98034,47.7116,-122.213,1320,7245,310000,9,9,2014,0,42,5183,5925,0,0,0
6,3.0,2630,8800,1.0,0,0,3,7,1610,1020,1959,0,98125,47.7166,-122.293,1220,1173,430000,23,7,2014,0,55,6170,-47,0,1,1
3,4.25,2820,7200,2.0,0,0,4,10,2460,360,1930,0,98112,47.6298,-122.29,3300,7522,1600000,28,6,2014,0,84,4380,4222,0,1,1
4,1.0,1560,4080,1.5,0,0,3,7,1560,0,1923,0,98103,47.6711,-122.331,1890,4080,627500,1,10,2014,0,91,2520,2190,0,0,1
4,2.5,2330,7050,2.0,0,0,3,8,2330,0,1998,0,98178,47.5001,-122.231,1810,5424,335000,24,11,2014,0,16,4720,3614,0,0,1
3,1.75,1730,14270,1.0,0,0,3,7,1730,0,1959,0,98065,47.5318,-121.833,1600,11232,299000,25,7,2014,0,55,12540,9632,0,0,0
4,2.5,3110,5868,2.0,0,0,3,8,3110,0,2001,0,98042,47.3781,-122.126,2950,5924,399950,14,4,2015,0,14,2758,2974,0,0,0
3,1.0,1230,9660,1.0,0,0,3,7,1230,0,1968,0,98053,47.6829,-122.06,1380,10125,322000,25,3,2015,0,47,8430,8745,0,0,0
2,1.5,950,4625,1.0,0,0,4,7,950,0,1949,0,98103,47.6912,-122.34,1440,4625,430000,23,6,2014,0,65,3675,3185,0,0,1
3,1.75,1890,13860,1.0,0,0,5,7,1890,0,1966,0,98042,47.4156,-122.149,1500,14536,307000,8,5,2014,0,48,11970,13036,0,0,0
3,1.5,1010,5000,1.0,0,0,3,6,1010,0,1943,0,98178,47.4925,-122.278,980,5000,194000,5,11,2014,0,71,3990,4020,0,0,1
3,1.0,1010,8581,1.0,0,0,4,6,1010,0,1920,0,98002,47.3043,-122.216,1060,10354,180000,14,11,2014,0,94,7571,9294,0,0,0
4,2.25,2340,13383,1.0,0,0,3,8,1170,1170,1983,0,98074,47.6211,-122.037,1810,12532,465000,18,7,2014,0,31,11043,10722,0,1,0
4,2.5,2460,9296,2.0,0,0,3,9,2460,0,1978,0,98007,47.6125,-122.152,2730,9900,722500,23,3,2015,0,37,6836,7170,0,0,0
2,1.0,1010,3400,1.0,0,0,3,7,1010,0,1921,0,98103,47.6711,-122.329,1800,3600,470450,24,9,2014,0,93,2390,1800,0,0,1
3,2.5,1650,6000,2.0,0,0,3,7,1650,0,1990,0,98030,47.36,-122.194,1750,6000,280000,27,1,2015,0,25,4350,4250,0,0,0
4,2.0,1440,6702,1.0,0,0,4,7,1440,0,1966,0,98002,47.3056,-122.217,1030,6702,176250,10,4,2015,0,49,5262,5672,0,0,0
5,1.0,1710,9100,1.5,0,0,4,7,1320,390,1926,0,98126,47.5379,-122.378,1880,9100,560000,17,6,2014,0,88,7390,7220,0,1,1
3,2.5,2760,11287,2.0,0,3,3,10,2000,760,1991,0,98028,47.739,-122.264,2760,13719,830000,22,10,2014,0,23,8527,10959,0,1,0
2,1.0,1350,10096,1.0,0,2,4,7,1350,0,1952,0,98045,47.4967,-121.778,1280,10095,276900,11,6,2014,0,62,8746,8815,0,0,0
3,1.75,1660,4800,2.0,0,0,3,7,1660,0,1906,2014,98112,47.6296,-122.308,1660,4800,625000,1,10,2014,108,108,3140,3140,1,0,1
4,2.5,2960,4760,2.0,0,0,3,8,2160,800,1900,0,98102,47.6367,-122.318,1600,4760,1020000,4,3,2015,0,115,1800,3160,0,1,1
1,1.0,1090,8750,1.0,0,0,4,6,1090,0,1924,0,98118,47.54,-122.269,1830,5000,463500,30,9,2014,0,90,7660,3170,0,0,1
3,2.5,3110,9015,2.0,0,0,3,9,3110,0,1990,0,98058,47.4369,-122.147,2650,8960,485000,5,9,2014,0,24,5905,6310,0,0,0
3,2.0,1380,7476,1.0,0,0,3,7,1380,0,1989,0,98001,47.3336,-122.272,1600,7227,272000,17,6,2014,0,25,6096,5627,0,0,0
2,1.0,1290,3140,2.0,0,0,3,7,1290,0,2008,0,98053,47.6971,-122.026,1290,2628,305000,17,12,2014,0,6,1850,1338,0,0,0
3,2.5,1980,13964,1.0,0,0,5,7,1980,0,1959,0,98040,47.571,-122.227,2040,13964,760000,26,6,2014,0,55,11984,11924,0,0,0
2,1.0,870,6126,1.0,0,0,4,7,870,0,1938,0,98125,47.7024,-122.322,1620,6126,387500,13,2,2015,0,77,5256,4506,0,0,1
4,2.5,2470,5015,2.0,0,0,3,8,2470,0,2004,0,98038,47.3457,-122.041,2470,5100,352000,8,9,2014,0,10,2545,2630,0,0,0
3,1.0,770,9750,1.0,0,0,3,6,770,0,1941,0,98188,47.4509,-122.275,1560,10707,156000,18,7,2014,0,73,8980,9147,0,0,1
3,3.25,1490,857,3.0,0,0,3,8,1220,270,2001,0,98102,47.6357,-122.324,1550,1092,580000,18,11,2014,0,13,-633,-458,0,1,1
5,1.5,1950,9000,1.0,0,0,3,7,1130,820,1964,0,98146,47.4882,-122.339,1680,9526,275000,18,12,2014,0,50,7050,7846,0,1,1
4,2.5,2380,7850,2.0,0,0,3,8,2380,0,1995,0,98055,47.4356,-122.201,1940,7334,340000,5,12,2014,0,19,5470,5394,0,0,0
2,1.0,720,6687,1.0,0,0,3,6,720,0,1942,0,98117,47.7001,-122.362,840,6687,329350,6,5,2014,0,72,5967,5847,0,0,1
3,2.25,2190,2416,3.0,0,0,3,8,2190,0,2014,0,98117,47.6758,-122.38,1510,3615,719950,18,11,2014,0,0,226,2105,0,0,1
1,1.0,810,2451,1.0,0,0,5,7,810,0,1941,0,98126,47.5188,-122.376,980,1198,235000,12,5,2014,0,73,1641,218,0,0,1
3,1.5,2440,5750,1.0,0,0,3,8,1320,1120,1939,0,98115,47.6991,-122.296,2160,6820,875000,31,3,2015,0,76,3310,4660,0,1,1
4,1.75,1740,9150,1.0,0,0,3,7,1740,0,1974,0,98188,47.4498,-122.28,1540,9147,380000,21,4,2015,0,41,7410,7607,0,0,1
1,1.0,900,4368,1.0,0,0,5,6,900,0,1915,1950,98022,47.2107,-121.99,1290,5000,152900,24,3,2015,35,100,3468,3710,1,0,0
2,2.0,1190,7570,1.0,0,0,3,6,1190,0,1939,0,98146,47.5113,-122.338,1190,7635,210000,5,8,2014,0,75,6380,6445,0,0,1
4,1.0,1010,6000,1.0,0,0,3,6,750,260,1925,0,98136,47.5518,-122.383,1450,6000,350000,26,9,2014,0,89,4990,4550,0,1,1
4,2.25,2020,8424,1.0,0,0,4,7,1380,640,1979,0,98034,47.7262,-122.233,2030,7236,464900,27,6,2014,0,35,6404,5206,0,1,0
3,2.0,2520,5980,1.0,0,0,3,8,1790,730,1957,0,98116,47.5767,-122.383,1590,5750,650000,22,9,2014,0,57,3460,4160,0,1,1
2,2.75,1370,1140,2.0,0,0,3,8,1080,290,2009,0,98133,47.7053,-122.342,1370,1090,369950,4,5,2015,0,6,-230,-280,0,1,1
3,2.5,1530,2890,2.0,0,0,3,7,1530,0,2001,0,98108,47.5434,-122.293,1540,2890,250000,28,7,2014,0,13,1360,1350,0,0,1
3,2.5,1530,2890,2.0,0,0,3,7,1530,0,2001,0,98108,47.5434,-122.293,1540,2890,320000,29,4,2015,0,14,1360,1350,0,0,1
4,4.25,5040,16048,1.0,0,3,3,10,3420,1620,1950,0,98105,47.6702,-122.26,3960,14000,2530000,25,3,2015,0,65,11008,10040,0,1,1
2,1.5,1010,1968,1.5,0,0,5,5,1010,0,1906,0,98107,47.6757,-122.385,1760,4200,440000,19,5,2014,0,108,958,2440,0,0,1
3,1.0,1200,7727,1.0,0,0,4,7,1200,0,1959,0,98022,47.2021,-121.999,1300,7718,219950,2,4,2015,0,56,6527,6418,0,0,0
4,3.0,2720,11740,1.0,0,0,5,9,2720,0,1957,0,98040,47.5833,-122.242,2640,11740,940000,15,9,2014,0,57,9020,9100,0,0,0
4,1.5,1850,6125,1.5,0,0,3,6,1110,740,1945,0,98126,47.5352,-122.37,990,6125,399950,22,7,2014,0,69,4275,5135,0,1,1
3,2.75,2340,8828,1.0,0,0,4,9,2340,0,1954,0,98112,47.632,-122.289,3480,8526,1570000,2,1,2015,0,61,6488,5046,0,0,1
4,1.75,1860,9750,1.0,0,0,3,7,1460,400,1969,0,98034,47.7097,-122.202,1900,8913,528000,1,4,2015,0,46,7890,7013,0,1,0
4,1.75,1940,8990,1.0,0,0,4,8,1560,380,1956,0,98034,47.7021,-122.241,2310,11745,545000,28,8,2014,0,58,7050,9435,0,1,0
2,2.0,1680,6194,1.0,0,0,3,8,1680,0,2004,0,98053,47.7136,-122.03,1900,5850,575000,27,4,2015,0,11,4514,3950,0,0,0
4,2.75,1770,10184,1.0,0,0,3,8,1250,520,1979,0,98023,47.3074,-122.385,2070,8320,235000,4,11,2014,0,35,8414,6250,0,1,0
3,2.5,1790,6371,2.0,0,0,3,8,1790,0,1998,0,98092,47.3291,-122.168,1850,6371,272000,23,7,2014,0,16,4581,4521,0,0,0
4,1.75,1720,9600,1.0,0,0,4,8,1720,0,1969,0,98059,47.4764,-122.155,1660,10720,380000,28,4,2015,0,46,7880,9060,0,0,0
3,1.0,1280,6967,1.5,0,0,3,7,1280,0,1949,0,98155,47.7512,-122.329,1280,7245,195000,26,4,2015,0,66,5687,5965,0,0,1
3,2.5,1690,4988,2.0,0,0,3,7,1690,0,2002,0,98038,47.3561,-122.015,1830,4733,297000,14,10,2014,0,12,3298,2903,0,0,0
4,2.5,2190,7294,2.0,0,0,3,8,2190,0,2003,0,98023,47.2923,-122.357,2240,7379,349000,15,4,2015,0,12,5104,5139,0,0,0
2,1.0,710,5200,1.0,0,2,4,6,710,0,1942,0,98126,47.5376,-122.371,1610,5200,320000,29,9,2014,0,72,4490,3590,0,0,1
4,1.5,1890,10707,1.0,0,0,3,7,1890,0,1962,0,98148,47.428,-122.326,1610,8827,319990,25,7,2014,0,52,8817,7217,0,0,1
2,2.0,1410,12282,1.5,0,0,5,8,1410,0,1909,1988,98024,47.5242,-121.926,1410,8931,439900,2,6,2014,79,105,10872,7521,1,0,0
3,3.25,2210,3600,2.0,0,0,3,8,1820,390,1995,0,98125,47.7031,-122.279,2010,6690,429000,11,8,2014,0,19,1390,4680,0,1,1
3,2.0,1540,6250,1.0,0,0,3,7,1540,0,1998,0,98038,47.3539,-122.025,2070,6250,272500,30,7,2014,0,16,4710,4180,0,0,0
4,2.0,1350,7255,1.0,0,0,4,7,1350,0,1959,0,98125,47.7287,-122.31,1050,7288,400000,16,9,2014,0,55,5905,6238,0,0,1
5,2.0,1380,4300,1.5,0,0,3,7,1380,0,1916,0,98103,47.6647,-122.337,1830,3800,462000,2,4,2015,0,99,2920,1970,0,0,1
2,1.0,890,6095,1.0,0,0,3,7,890,0,1947,0,98115,47.6823,-122.298,1450,5985,510000,10,3,2015,0,68,5205,4535,0,0,1
3,2.5,1900,3255,2.0,0,0,3,8,1900,0,1988,2000,98007,47.6075,-122.147,1880,3350,550000,23,6,2014,12,26,1355,1470,1,0,0
3,1.0,1240,5200,1.0,0,0,3,6,1240,0,1969,0,98042,47.3701,-122.079,870,5200,150000,25,4,2015,0,46,3960,4330,0,0,0
3,2.5,1730,8490,1.0,0,0,3,7,1210,520,1969,0,98034,47.7187,-122.219,1870,7400,460000,26,6,2014,0,45,6760,5530,0,1,0
4,2.5,2090,10306,2.0,0,0,3,10,2090,0,1986,0,98074,47.6304,-122.051,2660,11481,632500,20,6,2014,0,28,8216,8821,0,0,0
3,1.75,1650,11220,1.0,0,0,4,7,1650,0,1969,0,98077,47.7567,-122.071,1340,10129,361000,25,9,2014,0,45,9570,8789,0,0,0
3,2.25,1130,1221,2.0,0,0,3,8,1030,100,2004,0,98117,47.6799,-122.375,1300,5000,437000,1,8,2014,0,10,91,3700,0,1,1
6,2.75,3240,5750,1.0,0,0,4,6,2160,1080,1950,0,98002,47.3054,-122.221,1230,5750,370000,5,5,2015,0,65,2510,4520,0,1,0
4,2.5,3840,12151,2.0,0,0,3,10,3840,0,1998,0,98075,47.5953,-121.986,3560,11044,884250,17,4,2015,0,17,8311,7484,0,0,0
3,1.0,1200,9936,1.0,0,0,4,6,1200,0,1969,0,98038,47.3609,-122.029,1200,10189,225000,3,6,2014,0,45,8736,8989,0,0,0
2,1.0,870,5000,1.0,0,0,3,6,870,0,1949,0,98126,47.5186,-122.375,820,5000,235000,5,8,2014,0,65,4130,4180,0,0,1
6,3.5,2410,6000,2.0,0,4,3,9,2220,190,1916,1990,98136,47.54,-122.382,1980,6000,767500,20,7,2014,74,98,3590,4020,1,1,1
4,2.25,2300,7700,1.0,0,0,3,7,1380,920,1959,0,98125,47.7137,-122.322,2010,8820,417000,27,6,2014,0,55,5400,6810,0,1,1
3,1.0,1390,12145,1.0,0,0,4,7,1390,0,1964,0,98042,47.4225,-122.15,1030,10800,199000,18,7,2014,0,50,10755,9770,0,0,0
5,2.5,2920,5568,2.0,0,0,3,8,2320,600,1906,0,98112,47.6265,-122.312,2970,5568,875000,5,6,2014,0,108,2648,2598,0,1,1
4,1.5,1370,3708,1.5,0,0,3,7,1370,0,1926,0,98117,47.6849,-122.363,2030,3708,545000,10,11,2014,0,88,2338,1678,0,0,1
2,1.0,950,7692,1.0,0,0,3,6,950,0,1926,0,98168,47.4909,-122.298,1820,8221,192500,20,5,2014,0,88,6742,6401,0,0,1
3,2.5,3090,7708,2.0,0,0,3,10,3090,0,1999,0,98052,47.6868,-122.108,3140,8592,822500,10,2,2015,0,16,4618,5452,0,0,0
4,2.5,2390,10000,1.0,0,0,3,9,1590,800,1975,0,98040,47.5801,-122.229,1900,9752,800000,8,12,2014,0,39,7610,7852,0,1,0
3,2.5,2070,4944,2.0,0,0,3,9,2070,0,1930,0,98112,47.6256,-122.284,3300,6179,1250000,15,12,2014,0,84,2874,2879,0,0,1
3,2.5,1460,7936,2.0,0,0,3,7,1460,0,1995,0,98038,47.3673,-122.017,1830,7936,295000,1,10,2014,0,19,6476,6106,0,0,0
2,1.75,1510,4980,1.0,0,0,3,8,1510,0,2006,0,98053,47.7191,-122.023,1350,4157,419000,30,6,2014,0,8,3470,2807,0,0,0
4,2.75,3430,13907,2.0,0,0,3,11,3430,0,1995,0,98075,47.5879,-121.993,3250,13851,750000,22,12,2014,0,19,10477,10601,0,0,0
4,1.5,1700,8400,1.0,0,0,3,7,1700,0,1953,0,98177,47.7677,-122.359,1750,8475,502000,28,4,2015,0,62,6700,6725,0,0,1
3,1.75,2640,8000,1.0,0,3,4,9,1320,1320,1960,0,98040,47.5826,-122.246,2740,6000,1030000,4,6,2014,0,54,5360,3260,0,1,0
3,1.0,1200,15960,1.5,0,0,3,6,1200,0,1945,0,98125,47.7163,-122.299,1120,7800,398500,13,3,2015,0,70,14760,6680,0,0,1
2,1.5,1850,4945,1.5,0,2,4,7,1850,0,1907,1969,98126,47.5742,-122.379,1850,4950,700000,14,4,2015,62,108,3095,3100,1,0,1
5,1.5,1510,9078,1.0,0,0,4,7,1510,0,1959,0,98168,47.4852,-122.305,1480,9078,248000,11,6,2014,0,55,7568,7598,0,0,1
4,2.0,2130,2800,1.0,0,0,5,7,1070,1060,1922,0,98103,47.6545,-122.333,1990,3990,800000,26,8,2014,0,92,670,2000,0,1,1
4,2.5,2640,8055,2.0,0,0,3,9,2640,0,2004,0,98092,47.315,-122.193,1650,8055,383000,21,1,2015,0,11,5415,6405,0,0,0
4,3.0,3000,4000,1.5,0,3,3,8,1970,1030,1913,2014,98144,47.5744,-122.307,1900,4000,688000,27,5,2014,101,101,1000,2100,1,1,1
3,2.0,1870,5455,1.0,0,0,5,7,1060,810,1926,0,98125,47.7029,-122.297,1870,7435,521000,8,10,2014,0,88,3585,5565,0,1,1
2,1.0,990,9223,1.0,0,0,3,7,990,0,1949,0,98125,47.72,-122.32,1230,7244,365000,5,11,2014,0,65,8233,6014,0,0,1
3,2.0,2005,7000,1.0,0,0,3,7,1605,400,1980,0,98122,47.6039,-122.298,1750,4500,491000,7,10,2014,0,34,4995,2750,0,1,1
3,2.75,2030,7700,1.0,0,0,5,8,1400,630,1965,0,98008,47.626,-122.112,1780,8160,643000,22,11,2014,0,49,5670,6380,0,1,0
3,2.5,1500,7350,1.0,0,0,2,7,1060,440,1979,0,98023,47.3025,-122.382,1390,7770,279000,2,2,2015,0,36,5850,6380,0,1,0
4,1.0,1530,3900,1.5,0,0,4,7,1530,0,1908,0,98107,47.6748,-122.379,1300,3900,583500,2,2,2015,0,107,2370,2600,0,0,1
3,2.5,1990,3600,2.0,0,0,3,7,1990,0,2004,0,98038,47.3841,-122.041,1790,3600,310000,23,7,2014,0,10,1610,1810,0,0,0
3,1.75,1420,7650,1.0,0,0,4,7,1100,320,1984,0,98056,47.4892,-122.182,1810,7650,310000,10,6,2014,0,30,6230,5840,0,1,0
3,1.0,1400,13975,1.0,0,0,4,6,1400,0,1956,0,98198,47.4195,-122.33,1260,7500,280000,23,3,2015,0,59,12575,6240,0,0,1
4,2.5,1870,5692,2.0,0,0,3,7,1870,0,2004,0,98058,47.4334,-122.148,2390,5293,272000,17,11,2014,0,10,3822,2903,0,0,0
3,2.0,1790,7259,1.0,0,0,3,7,1390,400,1980,0,98058,47.4643,-122.171,1790,7700,307000,18,11,2014,0,34,5469,5910,0,1,0
2,1.5,1590,4500,1.0,0,0,4,7,920,670,1946,0,98116,47.5831,-122.392,1900,4450,490000,17,7,2014,0,68,2910,2550,0,1,1
3,2.0,2050,9396,1.0,0,0,5,7,1170,880,1960,0,98155,47.7447,-122.328,1680,9391,399950,8,10,2014,0,54,7346,7711,0,1,1
5,4.5,4030,13474,2.0,0,0,3,11,4030,0,2000,0,98075,47.5812,-121.995,3860,12438,989000,9,7,2014,0,14,9444,8578,0,0,0
4,1.75,1770,9011,1.0,0,0,5,7,1050,720,1983,0,98042,47.3646,-122.076,1410,8530,264950,18,6,2014,0,31,7241,7120,0,1,0
4,2.75,2100,7236,1.0,0,0,3,8,1400,700,1979,0,98034,47.7267,-122.232,1900,7519,491500,25,7,2014,0,35,5136,5619,0,1,0
3,2.25,2120,15003,2.0,0,0,3,7,2120,0,1984,0,98059,47.4745,-122.12,2070,15203,345000,14,5,2014,0,30,12883,13133,0,0,0
4,1.75,2600,18042,1.0,0,0,4,8,2020,580,1969,0,98092,47.2969,-122.189,2200,9408,339900,19,1,2015,0,46,15442,7208,0,1,0
3,3.0,2400,4000,2.0,0,0,3,7,1860,540,1905,0,98102,47.6288,-122.321,1750,3940,852000,27,4,2015,0,110,1600,2190,0,1,1
4,2.0,2790,8793,1.0,0,0,4,8,1640,1150,1977,0,98006,47.5509,-122.16,2400,9286,723000,11,2,2015,0,38,6003,6886,0,1,0
2,1.5,1370,4102,2.0,0,0,4,7,1370,0,1987,0,98033,47.6943,-122.184,1380,3211,405000,1,12,2014,0,27,2732,1831,0,0,0
2,1.0,1740,5719,1.0,0,0,3,8,1740,0,1955,0,98103,47.6729,-122.335,1980,5000,800000,25,6,2014,0,59,3979,3020,0,0,1
3,2.5,1800,8518,2.0,0,0,3,7,1800,0,1996,0,98030,47.3643,-122.185,1770,7570,180500,15,10,2014,0,18,6718,5800,0,0,0
3,2.5,1800,8518,2.0,0,0,3,7,1800,0,1996,0,98030,47.3643,-122.185,1770,7570,325000,28,4,2015,0,19,6718,5800,0,0,0
3,1.75,1190,7280,1.0,0,0,4,7,1190,0,1968,0,98092,47.3151,-122.19,1250,7800,235000,17,6,2014,0,46,6090,6550,0,0,0
2,1.0,860,8308,1.0,0,0,4,7,860,0,1948,0,98146,47.5075,-122.377,1310,8308,330000,20,5,2014,0,66,7448,6998,0,0,1
3,2.0,2460,6600,1.0,0,2,4,8,1370,1090,1952,0,98136,47.5215,-122.383,2150,6600,678500,12,6,2014,0,62,4140,4450,0,1,1
4,2.5,1980,6660,2.0,0,0,4,7,1980,0,1974,0,98034,47.7158,-122.167,1980,7150,463000,9,7,2014,0,40,4680,5170,0,0,0
2,1.0,670,4640,1.0,0,0,3,6,670,0,1943,0,98106,47.53,-122.351,870,4501,250000,12,9,2014,0,71,3970,3631,0,0,1
3,2.0,1410,4800,1.5,0,0,4,8,1410,0,1927,0,98118,47.5597,-122.267,1820,7200,655000,16,7,2014,0,87,3390,5380,0,0,1
4,2.25,1860,7000,1.0,0,0,3,8,1120,740,1979,0,98023,47.3127,-122.339,1990,8937,239900,16,5,2014,0,35,5140,6947,0,1,0
3,1.0,980,9135,1.0,0,0,3,7,980,0,1955,0,98001,47.3496,-122.289,1780,9135,185000,17,11,2014,0,59,8155,7355,0,0,0
4,2.25,3040,5000,2.0,0,3,4,9,2080,960,1926,0,98105,47.6565,-122.278,2870,5000,1740000,16,6,2014,0,88,1960,2130,0,1,1
3,2.25,1810,11800,1.0,0,0,3,7,1240,570,1977,0,98178,47.4997,-122.231,1810,5641,251700,5,9,2014,0,37,9990,3831,0,1,1
4,2.0,1560,8250,1.0,0,0,3,8,1320,240,1964,0,98177,47.7565,-122.358,1870,8258,400000,9,2,2015,0,51,6690,6388,0,1,1
4,1.75,2100,7960,1.0,0,0,3,8,1340,760,1955,0,98004,47.6079,-122.195,2060,7960,735000,4,9,2014,0,59,5860,5900,0,1,0
4,4.0,3010,7221,2.0,0,0,3,10,3010,0,2004,0,98075,47.5833,-121.97,3490,7518,765000,8,7,2014,0,10,4211,4028,0,0,0
4,1.75,2140,8162,1.0,0,0,3,7,1420,720,1968,0,98023,47.3096,-122.377,2040,7632,292500,23,9,2014,0,46,6022,5592,0,1,0
3,2.25,2390,7000,1.0,0,0,4,7,1990,400,1970,0,98058,47.4568,-122.169,1610,7000,270000,25,3,2015,0,45,4610,5390,0,1,0
2,1.0,1510,6807,1.0,0,0,3,7,1090,420,1939,0,98133,47.711,-122.353,1460,6807,415000,24,12,2014,0,75,5297,5347,0,1,1
4,1.75,2210,19025,1.0,0,0,4,7,1460,750,1952,0,98004,47.5927,-122.203,2640,14999,950000,24,11,2014,0,62,16815,12359,0,1,0
3,2.75,2170,8396,2.0,0,0,3,7,2170,0,1995,0,98038,47.3812,-122.023,2170,8378,353000,16,9,2014,0,19,6226,6208,0,0,0
3,2.5,1790,2375,3.0,0,0,3,8,1790,0,2007,0,98107,47.6726,-122.38,1450,2400,670950,10,12,2014,0,7,585,950,0,0,1
3,1.75,1390,8700,1.0,0,3,4,7,840,550,1912,0,98055,47.4725,-122.202,1390,10875,280950,9,5,2014,0,102,7310,9485,0,1,0
3,1.75,1850,7735,1.0,0,0,4,8,1850,0,1983,0,98027,47.5608,-122.082,2220,7639,585000,27,5,2014,0,31,5885,5419,0,0,0
3,1.75,1850,8823,1.0,0,0,4,8,1370,480,1973,0,98008,47.6379,-122.112,1880,7580,605000,1,8,2014,0,41,6973,5700,0,1,0
4,3.5,3350,3752,2.0,0,0,3,9,2550,800,2007,0,98117,47.6782,-122.365,1050,4960,1010000,19,11,2014,0,7,402,3910,0,1,1
3,1.0,1040,8410,1.0,0,0,3,7,1040,0,1942,2014,98188,47.453,-122.289,1350,8410,245990,26,9,2014,72,72,7370,7060,1,0,1
1,1.5,1010,5750,1.0,0,0,3,7,1010,0,1911,1948,98136,47.5411,-122.392,1230,5750,410000,30,6,2014,37,103,4740,4520,1,0,1
3,2.5,2250,7752,2.0,0,0,4,8,2250,0,1988,0,98011,47.7489,-122.185,2080,7033,550000,24,4,2015,0,27,5502,4953,0,0,0
3,1.75,1800,8000,1.0,0,0,3,8,1800,0,1972,0,98008,47.6357,-122.119,1950,8500,665000,11,9,2014,0,42,6200,6550,0,0,0
3,1.0,2400,17239,1.0,0,0,4,7,1890,510,1940,0,98028,47.75,-122.245,2390,7350,455000,27,4,2015,0,75,14839,4960,0,1,0
4,1.0,1780,4000,1.5,0,0,3,7,1780,0,1922,0,98103,47.6624,-122.354,1750,4000,440000,26,8,2014,0,92,2220,2250,0,0,1
3,2.25,2120,14915,1.0,0,0,3,9,1720,400,1979,0,98001,47.3524,-122.285,2320,13100,332000,8,7,2014,0,35,12795,10780,0,1,0
3,2.5,1860,6607,2.0,0,0,3,7,1860,0,1989,0,98023,47.2891,-122.351,1760,6766,280000,11,6,2014,0,25,4747,5006,0,0,0
3,3.5,1460,1021,2.0,0,0,3,8,1150,310,2006,0,98122,47.6169,-122.309,1460,1245,570000,15,9,2014,0,8,-439,-215,0,1,1
3,1.0,1230,10350,1.0,0,0,4,7,1230,0,1957,0,98055,47.428,-122.199,1510,10427,250000,15,5,2014,0,57,9120,8917,0,0,0
2,1.0,1088,8453,1.0,0,0,3,6,1088,0,1952,2009,98001,47.2685,-122.231,1088,8016,238000,1,5,2015,57,63,7365,6928,1,0,0
3,1.0,800,5760,1.0,0,0,3,6,700,100,1949,0,98155,47.7505,-122.317,1060,6628,265000,3,11,2014,0,65,4960,5568,0,1,1
3,1.0,1190,10350,1.0,0,0,4,7,1190,0,1959,0,98028,47.7428,-122.244,1850,10500,306000,5,3,2015,0,56,9160,8650,0,0,0
5,2.75,1940,4182,1.0,0,0,3,7,1240,700,2002,0,98056,47.4911,-122.17,1950,4182,345000,7,5,2015,0,13,2242,2232,0,1,0
4,2.5,3300,10764,1.0,0,0,4,9,1720,1580,1971,0,98177,47.7119,-122.365,2290,10975,765000,4,9,2014,0,43,7464,8685,0,1,1
4,2.5,2590,11018,2.0,0,0,3,8,2590,0,1998,0,98092,47.2634,-122.211,2400,8042,346300,30,4,2015,0,17,8428,5642,0,0,0
3,2.0,2080,11375,1.0,0,0,3,8,2080,0,2002,0,98022,47.214,-121.993,1080,12899,342500,12,6,2014,0,12,9295,11819,0,0,0
4,2.25,2680,5439,2.0,0,0,3,7,2680,0,2000,0,98011,47.7534,-122.218,2460,4473,501000,24,4,2015,0,15,2759,2013,0,0,0
3,2.5,1670,8364,1.0,0,0,4,7,1300,370,1990,0,98042,47.369,-122.084,1490,8143,270000,25,6,2014,0,24,6694,6653,0,1,0
3,1.0,1830,4400,1.5,0,0,4,8,1720,110,1930,0,98122,47.6052,-122.3,1650,4400,638000,22,4,2015,0,85,2570,2750,0,1,1
3,1.75,1400,2003,1.0,0,0,4,8,700,700,1908,2006,98119,47.6508,-122.368,1370,1281,460000,12,9,2014,98,106,603,-89,1,1,1
4,1.75,2770,8521,1.0,0,0,4,7,1470,1300,1953,0,98004,47.6255,-122.199,1910,9380,760000,15,10,2014,0,61,5751,7470,0,1,0
3,2.5,3630,11019,1.0,0,0,4,9,2150,1480,1972,0,98040,47.561,-122.226,3150,13555,1090000,16,3,2015,0,43,7389,10405,0,1,0
3,1.0,1040,8128,1.0,0,0,3,6,1040,0,1983,0,98019,47.7425,-121.981,1520,7500,234000,28,6,2014,0,31,7088,5980,0,0,0
3,2.75,2690,8890,2.0,1,4,4,10,2690,0,1975,1991,98006,47.5487,-122.197,2940,8890,1650000,2,3,2015,16,40,6200,5950,1,0,0
5,2.0,2020,5000,1.5,0,0,4,7,2020,0,1938,0,98117,47.6949,-122.37,1510,6600,488000,6,5,2014,0,76,2980,5090,0,0,1
4,3.0,2030,12675,2.0,0,0,3,7,2030,0,1982,0,98177,47.7689,-122.379,1990,7705,499000,27,3,2015,0,33,10645,5715,0,0,1
3,1.0,1450,6776,1.0,0,0,3,7,1450,0,1952,0,98178,47.5056,-122.244,1680,7200,150000,4,9,2014,0,62,5326,5520,0,0,1
4,2.5,2400,7270,2.0,0,0,3,8,2400,0,1993,0,98003,47.2697,-122.312,2150,6584,333000,26,3,2015,0,22,4870,4434,0,0,0
4,2.75,2870,8625,1.0,0,1,4,8,1860,1010,1959,0,98155,47.7425,-122.289,2430,8479,700000,18,2,2015,0,56,5755,6049,0,1,1
3,2.5,1680,11312,1.0,0,0,3,7,1080,600,1959,0,98146,47.5051,-122.344,1390,10700,330000,1,7,2014,0,55,9632,9310,0,1,1
4,2.0,1850,8827,1.0,0,0,3,7,1850,0,1969,0,98155,47.7406,-122.313,1310,6901,360000,24,11,2014,0,45,6977,5591,0,0,1
3,1.0,1220,8040,1.5,0,0,3,7,1220,0,1965,0,98125,47.7133,-122.308,1360,8040,467000,11,5,2015,0,50,6820,6680,0,0,1
5,2.25,3220,9603,2.0,0,0,3,8,3220,0,1972,0,98052,47.6474,-122.11,2260,10093,605000,3,11,2014,0,42,6383,7833,0,0,0
4,2.75,3190,9023,2.0,0,0,3,9,3190,0,2005,0,98075,47.5898,-121.989,3159,5615,750000,2,10,2014,0,9,5833,2456,0,0,0
3,1.75,2050,10519,1.0,0,0,3,7,1240,810,1979,0,98058,47.4257,-122.146,1770,9605,265000,4,8,2014,0,35,8469,7835,0,1,0
3,1.75,1720,12540,1.0,0,0,4,7,1720,0,1956,0,98006,47.5699,-122.177,1440,11850,490000,18,7,2014,0,58,10820,10410,0,0,0
4,2.5,2850,4650,2.0,0,0,3,8,2850,0,2004,0,98038,47.3552,-122.026,2850,4650,360000,19,6,2014,0,10,1800,1800,0,0,0
3,2.25,1880,12473,1.0,0,0,3,8,1420,460,1958,0,98028,47.7623,-122.256,2300,10469,399000,3,10,2014,0,56,10593,8169,0,1,0
4,2.5,2770,9751,2.0,0,0,3,8,2770,0,1989,0,98042,47.3739,-122.126,2370,6950,347000,25,7,2014,0,25,6981,4580,0,0,0
4,2.5,3110,6479,2.0,0,0,3,9,3110,0,2005,0,98065,47.5408,-121.861,3110,7075,585000,3,9,2014,0,9,3369,3965,0,0,0
4,2.5,2360,7475,2.0,0,0,3,8,2360,0,1992,0,98031,47.4052,-122.17,2280,7570,340000,12,9,2014,0,22,5115,5290,0,0,0
3,2.5,2180,5496,2.0,0,0,3,8,2180,0,1994,0,98029,47.5723,-122.007,2120,5496,612000,15,4,2015,0,21,3316,3376,0,0,0
2,1.75,1910,3376,2.0,0,0,3,8,1910,0,1980,0,98038,47.3733,-122.057,1470,3623,230000,28,6,2014,0,34,1466,2153,0,0,0
4,2.5,2260,7753,2.0,0,0,3,9,2260,0,1989,0,98029,47.5752,-121.995,2690,8924,604000,9,5,2014,0,25,5493,6234,0,0,0
3,1.75,1770,8868,1.0,0,0,4,7,1770,0,1959,0,98002,47.3188,-122.212,1630,9706,250000,3,7,2014,0,55,7098,8076,0,0,0
3,2.0,1460,7930,1.0,0,0,3,7,1460,0,1989,0,98038,47.359,-122.049,1630,7930,258500,9,3,2015,0,26,6470,6300,0,0,0
4,2.75,2080,5000,1.0,0,0,5,8,1470,610,1940,0,98199,47.6422,-122.403,1970,5000,783000,24,3,2015,0,75,2920,3030,0,1,1
5,2.25,2960,7680,1.0,0,2,5,8,1550,1410,1958,0,98199,47.6456,-122.389,2860,7680,1050000,30,10,2014,0,56,4720,4820,0,1,1
4,2.5,3220,4031,2.0,0,0,3,9,3220,0,2002,0,98033,47.688,-122.163,3150,5083,760000,18,3,2015,0,13,811,1933,0,0,0
3,1.0,1140,5000,1.0,0,0,3,7,1140,0,1960,0,98106,47.5535,-122.362,1140,5000,276000,26,5,2014,0,54,3860,3860,0,0,1
4,2.0,1660,12377,1.0,0,0,3,8,1660,0,1966,0,98008,47.6231,-122.102,1820,8968,550000,23,3,2015,0,49,10717,7148,0,0,0
4,1.0,1430,6240,1.5,0,0,5,7,1430,0,1953,0,98125,47.7272,-122.311,1410,6240,398000,28,4,2015,0,62,4810,4830,0,0,1
3,3.0,1820,4300,1.5,0,0,4,8,1620,200,1914,1983,98107,47.6711,-122.364,1440,4300,775000,13,3,2015,69,101,2480,2860,1,1,1
4,3.0,3540,10202,2.0,0,0,3,8,2720,820,1988,0,98006,47.5471,-122.155,2780,10714,1030000,9,4,2015,0,27,6662,7934,0,1,0
4,1.0,1620,6000,1.5,0,0,5,7,1620,0,1905,0,98055,47.4763,-122.206,1310,6000,327000,23,10,2014,0,109,4380,4690,0,0,0
4,2.75,3100,14568,2.0,0,0,3,8,3100,0,1995,0,98019,47.7302,-121.974,2860,14396,564500,21,4,2015,0,20,11468,11536,0,0,0
4,1.75,1500,6820,1.5,0,0,5,7,1500,0,1905,0,98117,47.6794,-122.37,1360,4125,782000,17,10,2014,0,109,5320,2765,0,0,1
4,2.5,2820,5510,2.0,0,0,3,9,2820,0,2005,0,98038,47.3477,-122.024,2820,5510,398000,28,1,2015,0,10,2690,2690,0,0,0
3,1.75,1850,10920,1.5,0,0,3,6,1850,0,1915,0,98034,47.7244,-122.222,1510,7871,257000,30,1,2015,0,100,9070,6361,0,0,0
4,2.0,1570,9415,2.0,0,0,4,7,1570,0,1984,0,98092,47.3168,-122.174,1550,8978,235000,25,6,2014,0,30,7845,7428,0,0,0
2,1.0,920,9000,1.0,0,0,1,6,920,0,1954,0,98033,47.6831,-122.189,1760,8400,535000,16,3,2015,0,61,8080,6640,0,0,0
3,2.5,1600,7000,2.0,0,0,4,8,1600,0,1993,0,98038,47.3534,-122.057,1700,7000,275000,7,5,2014,0,21,5400,5300,0,0,0
3,2.5,2630,10047,2.0,0,0,3,9,2630,0,1996,0,98027,47.5515,-122.083,2640,10620,665000,15,9,2014,0,18,7417,7980,0,0,0
4,2.75,3020,13530,1.0,0,0,4,8,1540,1480,1977,0,98052,47.6299,-122.099,2230,11896,670000,6,8,2014,0,37,10510,9666,0,1,0
3,1.75,1490,10757,1.0,0,0,3,7,1060,430,1966,0,98034,47.72,-122.229,1490,10609,465000,27,4,2015,0,49,9267,9119,0,1,0
3,1.5,1160,5200,1.0,0,0,5,7,1160,0,1970,0,98042,47.364,-122.094,1170,5200,210000,23,10,2014,0,44,4040,4030,0,0,0
4,2.5,2040,4443,2.0,0,0,3,8,2040,0,2001,0,98092,47.3182,-122.189,2040,4637,265000,4,12,2014,0,13,2403,2597,0,0,0
2,2.5,1550,2657,2.0,0,0,4,8,1550,0,1987,0,98033,47.7034,-122.188,1570,2442,426000,13,4,2015,0,28,1107,872,0,0,0
4,2.25,1990,7610,1.0,0,0,4,8,1290,700,1966,0,98008,47.6236,-122.103,1820,8198,529219,29,10,2014,0,48,5620,6378,0,1,0
5,3.5,3840,8279,2.0,0,0,3,9,3840,0,2001,0,98074,47.6039,-122.059,3570,8279,875000,1,7,2014,0,13,4439,4709,0,0,0
4,3.0,2400,7680,1.0,0,0,3,7,1200,1200,1956,0,98199,47.6466,-122.389,2670,6342,608000,6,1,2015,0,59,5280,3672,0,1,1
3,2.0,2030,17120,1.0,0,2,4,8,1890,140,1966,0,98092,47.2953,-122.185,1870,13662,295450,18,8,2014,0,48,15090,11792,0,1,0
2,1.0,840,5087,1.0,0,0,3,7,840,0,1925,0,98118,47.5557,-122.278,1590,5087,315000,11,11,2014,0,89,4247,3497,0,0,1
4,2.0,1450,8175,1.0,0,0,4,7,1450,0,1967,0,98031,47.3933,-122.195,1570,9024,205000,13,2,2015,0,48,6725,7454,0,0,0
3,1.5,1460,9908,1.0,0,0,3,7,1460,0,1952,0,98148,47.4275,-122.331,1420,9582,310000,9,7,2014,0,62,8448,8162,0,0,1
5,1.0,2010,5210,1.5,0,0,3,9,1890,120,1927,0,98119,47.6501,-122.37,2330,5000,1000000,3,5,2015,0,88,3200,2670,0,1,1
4,2.5,2910,7631,2.0,0,2,3,9,2910,0,2006,0,98038,47.3552,-122.001,3190,5552,525000,2,6,2014,0,8,4721,2362,0,0,0
4,1.75,1880,8800,1.0,0,0,3,7,1130,750,1960,0,98168,47.5137,-122.333,1340,8733,284000,9,7,2014,0,54,6920,7393,0,1,1
2,1.0,1260,4377,1.0,0,0,4,7,1260,0,1947,0,98103,47.6988,-122.354,1420,6376,405000,19,6,2014,0,67,3117,4956,0,0,1
3,2.5,1970,9153,2.0,0,0,3,8,1970,0,2007,0,98028,47.7698,-122.268,1800,9800,509950,16,9,2014,0,7,7183,8000,0,0,0
4,3.75,3450,4940,2.0,0,0,3,10,2570,880,2006,0,98103,47.692,-122.338,1880,5387,990000,23,4,2015,0,9,1490,3507,0,1,1
3,1.5,1130,7200,1.0,0,0,3,7,1130,0,1954,0,98178,47.5041,-122.253,1130,7200,280005,14,4,2015,0,61,6070,6070,0,0,1
3,1.75,2600,7668,1.0,0,0,4,8,1300,1300,1968,0,98010,47.3402,-122.046,1980,13664,700000,3,9,2014,0,46,5068,11684,0,1,0
3,1.0,1030,7620,1.0,0,0,3,7,1030,0,1953,0,98126,47.5281,-122.375,1030,7560,330000,4,8,2014,0,61,6590,6530,0,0,1
2,1.0,1700,6718,1.0,0,2,3,7,1230,470,1956,0,98198,47.4131,-122.331,2040,7500,340000,23,2,2015,0,59,5018,5460,0,1,1
2,2.5,1480,2167,2.0,0,0,3,8,1390,90,2007,0,98052,47.6658,-122.132,2130,2556,468000,18,8,2014,0,7,687,426,0,1,0
4,2.0,1870,8750,1.0,0,2,3,7,1870,0,1977,0,98022,47.1985,-122.001,1770,8207,245000,12,11,2014,0,37,6880,6437,0,0,0
3,2.5,1440,7741,1.0,0,0,4,7,1000,440,1983,0,98031,47.4042,-122.194,1680,7316,265000,27,5,2014,0,31,6301,5636,0,1,0
3,2.5,2720,11937,2.0,0,0,3,9,2720,0,1990,0,98031,47.4185,-122.212,2590,9683,372400,17,3,2015,0,25,9217,7093,0,0,0
3,1.5,1240,8410,1.0,0,0,5,6,1240,0,1948,0,98155,47.753,-122.328,1630,8410,390000,4,5,2015,0,67,7170,6780,0,0,1
3,1.0,1020,6120,1.0,0,0,4,7,1020,0,1967,0,98002,47.278,-122.205,1370,8000,208000,3,2,2015,0,48,5100,6630,0,0,0
2,0.5,1180,7750,1.0,0,0,4,6,590,590,1945,0,98155,47.769,-122.316,1380,8976,273000,3,10,2014,0,69,6570,7596,0,1,1
5,3.5,3080,7759,2.0,0,0,3,8,2310,770,2003,0,98019,47.7454,-121.977,2980,8223,455000,9,10,2014,0,11,4679,5243,0,1,0
4,2.5,1750,6397,2.0,0,0,3,7,1750,0,1988,0,98023,47.3082,-122.358,1940,6502,270000,30,3,2015,0,27,4647,4562,0,0,0
4,2.25,2530,8736,1.0,0,0,4,7,1210,1320,1958,0,98008,47.6049,-122.126,1720,8500,618000,30,7,2014,0,56,6206,6780,0,1,0
3,2.5,1580,8541,2.0,0,0,3,7,1580,0,1990,0,98001,47.3334,-122.289,1640,7542,213550,21,10,2014,0,24,6961,5902,0,0,0
5,1.75,2340,9148,2.0,0,0,3,7,2340,0,1957,0,98198,47.4232,-122.324,1390,10019,210000,29,7,2014,0,57,6808,8629,0,0,1
4,2.75,2400,3844,1.0,0,0,5,7,1200,1200,1974,0,98133,47.7027,-122.347,1100,3844,403500,15,12,2014,0,40,1444,2744,0,1,1
3,1.5,1300,7600,1.0,0,0,4,7,1300,0,1963,0,98022,47.2083,-122.005,1570,7600,235000,25,2,2015,0,52,6300,6030,0,0,0
3,2.0,1760,7147,1.0,0,0,4,6,880,880,1936,0,98055,47.4799,-122.232,1720,7147,287500,21,4,2015,0,79,5387,5427,0,1,0
4,1.5,1520,5910,1.0,0,0,3,7,1020,500,1946,0,98115,47.6904,-122.295,1710,5910,546800,29,9,2014,0,68,4390,4200,0,1,1
3,1.75,1070,8100,1.0,0,0,4,6,1070,0,1957,0,98002,47.2853,-122.22,1260,8100,183000,16,6,2014,0,57,7030,6840,0,0,0
3,1.0,1280,6726,1.0,0,0,3,6,1280,0,1958,0,98144,47.5724,-122.301,1630,5000,299500,5,12,2014,0,56,5446,3370,0,0,1
4,2.25,1660,7350,1.0,0,0,3,8,1660,0,1965,2014,98008,47.6263,-122.124,1790,7455,610000,27,10,2014,49,49,5690,5665,1,0,0
3,1.5,1860,7963,1.0,0,0,3,7,1200,660,1963,0,98188,47.4513,-122.268,1800,10400,288350,9,6,2014,0,51,6103,8600,0,1,1
2,1.0,950,4500,1.0,0,2,3,7,850,100,1926,0,98103,47.6562,-122.354,1670,4000,500000,1,7,2014,0,88,3550,2330,0,1,1
4,2.75,2140,4000,1.0,0,0,3,7,1190,950,1951,0,98115,47.6792,-122.287,2140,4770,625000,5,12,2014,0,63,1860,2630,0,1,1
2,1.5,1480,1349,2.0,0,0,3,7,1240,240,2007,0,98136,47.5439,-122.386,1550,1349,418000,29,4,2015,0,8,-131,-201,0,1,1
3,3.0,2260,1825,2.0,0,0,3,8,1660,600,2002,0,98122,47.6108,-122.308,2260,1834,660000,25,8,2014,0,12,-435,-426,0,1,1
4,2.5,2300,6158,2.0,0,0,3,9,2300,0,1999,0,98115,47.6943,-122.299,2170,6434,775000,23,6,2014,0,15,3858,4264,0,0,1
3,2.75,1650,7272,1.0,0,0,4,7,1230,420,1972,0,98034,47.7232,-122.174,1770,7272,429500,23,1,2015,0,43,5622,5502,0,1,0
3,2.0,1990,3000,1.5,0,0,3,7,1230,760,1908,1970,98112,47.6272,-122.29,1600,4080,569000,24,11,2014,62,106,1010,2480,1,1,1
4,2.0,1960,7560,1.0,0,0,5,7,1160,800,1978,0,98031,47.4081,-122.178,1950,7560,250000,20,5,2014,0,36,5600,5610,0,1,0
3,1.5,1310,10491,1.0,0,0,4,7,1310,0,1969,0,98042,47.3682,-122.148,1430,9664,225000,9,12,2014,0,45,9181,8234,0,0,0
4,2.75,2450,15002,1.0,0,0,5,9,2450,0,1974,0,98166,47.4268,-122.343,2650,15055,530000,14,5,2014,0,40,12552,12405,0,0,1
3,1.0,910,8658,1.0,0,0,3,7,910,0,1955,0,98155,47.7586,-122.303,1170,10200,306000,5,9,2014,0,59,7748,9030,0,0,1
3,1.75,1580,9719,1.0,0,0,5,7,1580,0,1962,0,98056,47.5396,-122.18,1760,8539,517100,13,4,2015,0,53,8139,6779,0,0,0
3,1.75,1780,9689,1.0,0,0,3,7,1130,650,1976,0,98072,47.7628,-122.163,1660,9786,354950,22,8,2014,0,38,7909,8126,0,1,0
3,1.5,1040,1824,1.0,0,0,3,6,1040,0,1925,0,98115,47.6793,-122.3,1010,5100,348000,14,4,2015,0,90,784,4090,0,0,1
3,2.5,1720,8755,1.0,0,0,3,8,1000,720,1983,0,98023,47.3186,-122.391,1720,8690,275000,4,6,2014,0,31,7035,6970,0,1,0
3,1.5,1600,10440,1.0,0,0,3,7,1600,0,1954,0,98125,47.7109,-122.311,1600,8816,390000,18,12,2014,0,60,8840,7216,0,0,1
3,1.5,1320,9750,1.0,0,0,3,7,1320,0,1954,0,98148,47.4267,-122.331,1530,9750,260000,10,9,2014,0,60,8430,8220,0,0,1
5,2.75,2350,4178,1.5,0,0,3,8,1520,830,1922,2015,98112,47.6388,-122.3,1920,4178,585000,28,7,2014,93,92,1828,2258,1,1,1
5,2.75,2740,5616,1.5,0,0,5,7,1670,1070,1925,0,98115,47.6866,-122.317,1600,4592,605000,3,6,2014,0,89,2876,2992,0,1,1
4,2.5,2300,6448,2.0,0,0,3,8,2300,0,2001,0,98030,47.3813,-122.204,1860,5872,342000,3,7,2014,0,13,4148,4012,0,0,0
3,1.75,1430,7700,1.0,0,0,4,7,980,450,1981,0,98031,47.3993,-122.183,1430,8625,252000,30,3,2015,0,34,6270,7195,0,1,0
3,1.75,2400,14012,1.0,0,0,3,9,2400,0,1971,0,98003,47.3371,-122.325,2800,13988,357000,19,2,2015,0,44,11612,11188,0,0,0
3,1.0,940,7910,1.0,0,0,4,6,940,0,1959,0,98008,47.6181,-122.117,1000,7700,370000,24,12,2014,0,55,6970,6700,0,0,0
3,1.0,1020,13504,1.0,0,0,5,7,1020,0,1959,0,98056,47.5121,-122.17,1110,11158,322500,6,4,2015,0,56,12484,10048,0,0,0
2,2.0,1680,5756,2.0,0,0,4,7,1680,0,1910,0,98002,47.3065,-122.222,1340,5447,210000,20,6,2014,0,104,4076,4107,0,0,0
2,1.0,1340,9840,1.0,0,0,3,7,1340,0,1949,0,98133,47.7202,-122.339,1610,8949,290000,8,12,2014,0,65,8500,7339,0,0,1
4,3.25,3960,7012,2.0,0,0,3,10,3960,0,2005,0,98075,47.5854,-122.08,3680,8522,860000,12,6,2014,0,9,3052,4842,0,0,0
6,2.0,2650,4621,1.5,0,0,3,8,2650,0,1911,0,98118,47.5543,-122.275,1640,4879,302000,25,2,2015,0,104,1971,3239,0,0,1
4,2.25,2120,9680,2.0,0,2,4,8,2120,0,1965,0,98003,47.3367,-122.332,2360,9647,369160,21,8,2014,0,49,7560,7287,0,0,0
4,2.75,2850,3000,2.5,0,0,3,9,2530,320,2003,0,98112,47.6406,-122.304,2083,4500,1190000,7,5,2015,0,12,150,2417,0,1,1
4,2.0,2850,14810,2.0,0,0,5,8,2490,360,1954,0,98004,47.5892,-122.203,2430,10454,993000,2,9,2014,0,60,11960,8024,0,1,0
6,2.0,1870,6969,1.0,0,0,4,7,1870,0,1968,0,98027,47.5342,-122.036,1500,6969,380000,14,11,2014,0,46,5099,5469,0,0,0
4,2.0,2660,8160,1.0,0,0,4,7,1380,1280,1949,0,98177,47.7229,-122.359,1660,8160,635000,10,9,2014,0,65,5500,6500,0,1,1
3,1.0,1190,11120,1.0,0,0,3,6,1190,0,1947,0,98024,47.5687,-121.898,1230,12720,260000,30,10,2014,0,67,9930,11490,0,0,0
2,1.0,1770,5522,1.5,0,0,4,7,960,810,1943,0,98178,47.4974,-122.231,1830,7378,243000,20,5,2014,0,71,3752,5548,0,1,1
4,2.5,2770,8879,2.0,0,0,3,9,2770,0,2001,0,98004,47.5831,-122.193,2770,8882,1400000,2,4,2015,0,14,6109,6112,0,0,0
4,2.5,2080,8100,1.0,0,2,5,8,1220,860,1952,0,98177,47.7228,-122.369,2090,8100,665000,15,9,2014,0,62,6020,6010,0,1,1
5,2.25,2700,9000,2.0,0,0,5,9,2700,0,1987,0,98007,47.6599,-122.146,2630,9000,898000,9,9,2014,0,27,6300,6370,0,0,0
4,2.75,2200,9453,1.0,0,0,5,8,1100,1100,1955,0,98144,47.5744,-122.305,1390,5355,583000,25,7,2014,0,59,7253,3965,0,1,1
4,1.75,2160,7700,2.0,0,0,2,8,2160,0,1977,0,98033,47.6976,-122.169,2080,7700,429000,4,12,2014,0,37,5540,5620,0,0,0
3,2.5,2010,4059,2.0,0,0,3,8,2010,0,1998,0,98034,47.7317,-122.197,2010,5779,471000,16,12,2014,0,16,2049,3769,0,0,0
3,3.5,3780,8295,2.0,0,0,3,9,2430,1350,1951,0,98112,47.6394,-122.29,3780,9127,1810000,12,3,2015,0,64,4515,5347,0,1,1
3,1.0,1430,5000,1.0,0,0,3,7,1430,0,1949,0,98117,47.6895,-122.37,1210,5000,552500,8,4,2015,0,66,3570,3790,0,0,1
4,1.75,1700,10642,1.0,0,0,4,7,850,850,1954,0,98006,47.5674,-122.142,1610,11200,437000,17,2,2015,0,61,8942,9590,0,1,0
4,2.0,1830,5220,1.5,0,0,3,7,1830,0,1951,0,98118,47.5331,-122.278,1760,5757,270000,9,1,2015,0,64,3390,3997,0,0,1
3,1.5,1410,8800,1.0,0,0,4,7,1410,0,1965,0,98092,47.2927,-122.183,2180,10108,226740,16,7,2014,0,49,7390,7928,0,0,0
4,2.5,3060,7920,1.0,0,0,3,8,1810,1250,1974,0,98028,47.7675,-122.261,2690,7767,446500,18,2,2015,0,41,4860,5077,0,1,0
3,2.0,1820,15068,2.0,0,2,3,7,1520,300,1920,2014,98022,47.2103,-121.999,1490,9589,283000,25,11,2014,94,94,13248,8099,1,1,0
4,1.75,2430,13211,1.5,0,0,4,7,2430,0,1909,1978,98024,47.5245,-121.926,1330,10500,445000,15,7,2014,69,105,10781,9170,1,0,0
2,1.0,740,6840,1.0,0,0,5,6,740,0,1942,0,98126,47.5172,-122.375,740,6840,250000,16,8,2014,0,72,6100,6100,0,0,1
3,1.0,770,6552,1.0,0,0,3,6,670,100,1942,0,98146,47.5133,-122.372,920,7200,307000,9,3,2015,0,73,5782,6280,0,1,1
4,2.75,2200,8580,1.0,0,0,3,8,1860,340,1991,0,98023,47.295,-122.37,2290,7816,315000,21,7,2014,0,23,6380,5526,0,1,0
4,2.5,2040,7000,1.0,0,0,3,7,1250,790,1979,0,98031,47.4056,-122.176,1900,7378,264900,24,4,2015,0,36,4960,5478,0,1,0
3,2.0,1600,4510,1.0,0,0,3,7,990,610,1978,0,98103,47.6939,-122.34,1580,4561,510000,22,9,2014,0,36,2910,2981,0,1,1
4,2.5,1990,3980,2.0,0,0,3,7,1990,0,2002,0,98058,47.4445,-122.17,1990,4373,328000,14,8,2014,0,12,1990,2383,0,0,0
4,2.5,1830,7308,2.0,0,0,3,7,1830,0,2002,0,98038,47.3565,-122.015,1830,5692,358000,4,5,2015,0,13,5478,3862,0,0,0
3,2.5,2540,4260,2.0,0,0,3,7,2540,0,2005,0,98042,47.3989,-122.164,2190,4260,325000,21,4,2015,0,10,1720,2070,0,0,0
2,3.25,2700,3444,3.0,1,3,3,9,2700,0,1990,0,98075,47.5684,-122.06,2710,3444,1370000,14,7,2014,0,24,744,734,0,0,0
4,2.0,1440,10800,1.0,0,0,4,7,1440,0,1967,0,98001,47.3417,-122.283,1190,7380,230000,5,3,2015,0,48,9360,6190,0,0,0
3,2.0,1550,4000,1.0,0,0,3,7,940,610,1955,0,98199,47.6379,-122.387,1880,4000,545000,23,4,2015,0,60,2450,2120,0,1,1
3,2.5,2490,4343,2.0,0,0,3,9,2490,0,2003,0,98029,47.5493,-121.993,2130,4106,705380,5,5,2014,0,11,1853,1976,0,0,0
5,2.5,2650,12987,1.0,0,0,4,7,1350,1300,1979,0,98028,47.7482,-122.244,2160,12726,459000,20,8,2014,0,35,10337,10566,0,1,0
4,2.25,2000,3800,2.0,0,0,3,8,2000,0,2001,0,98115,47.6852,-122.311,1610,3800,815000,28,5,2014,0,13,1800,2190,0,0,1
6,5.0,3440,4500,2.0,0,0,3,8,3280,160,2007,0,98055,47.4871,-122.219,1400,5500,495000,11,6,2014,0,7,1060,4100,0,1,0
2,1.5,1320,1194,3.0,0,0,3,7,1320,0,2001,0,98107,47.6704,-122.39,1320,1250,430000,17,12,2014,0,13,-126,-70,0,0,1
4,2.5,2070,7800,2.0,0,0,3,8,2070,0,1989,0,98003,47.3487,-122.315,1950,7815,255000,15,5,2014,0,25,5730,5865,0,0,0
3,2.0,1860,4777,2.0,0,0,5,7,1860,0,1908,0,98115,47.6892,-122.311,1580,3822,588000,7,7,2014,0,106,2917,2242,0,0,1
3,1.0,940,7811,1.0,0,0,3,6,940,0,1959,0,98008,47.6195,-122.118,1180,7490,350000,10,11,2014,0,55,6871,6310,0,0,0
3,2.0,1830,3500,1.5,0,0,5,7,1290,540,1909,0,98116,47.573,-122.383,1530,4000,554000,25,8,2014,0,105,1670,2470,0,1,1
4,2.5,3090,7112,2.0,0,0,3,9,3090,0,2001,0,98052,47.705,-122.118,3050,6000,775000,28,7,2014,0,13,4022,2950,0,0,0
3,2.75,3200,12682,2.0,0,1,3,9,3200,0,1977,0,98028,47.7443,-122.26,2880,10432,618000,28,10,2014,0,37,9482,7552,0,0,0
4,1.0,1560,8450,1.5,0,0,4,6,1560,0,1954,0,98166,47.4552,-122.354,1380,8100,305000,29,9,2014,0,60,6890,6720,0,0,1
3,2.0,1280,13356,1.0,0,0,3,7,1280,0,1994,0,98042,47.3715,-122.074,1590,8071,232000,5,12,2014,0,20,12076,6481,0,0,0
4,2.5,2020,6236,2.0,0,0,3,7,2020,0,2002,0,98001,47.2796,-122.247,1940,5076,262000,8,5,2014,0,12,4216,3136,0,0,0
3,1.0,1040,8122,1.0,0,0,5,7,1040,0,1971,0,98198,47.3731,-122.312,1470,8676,234000,25,3,2015,0,44,7082,7206,0,0,1
4,2.75,2260,7209,1.0,0,3,3,7,1330,930,2002,0,98125,47.7088,-122.302,1790,10860,500000,2,4,2015,0,13,4949,9070,0,1,1
3,1.0,860,7632,1.0,0,0,3,6,860,0,1920,0,98166,47.4623,-122.345,890,7632,278000,27,8,2014,0,94,6772,6742,0,0,1
5,1.0,1920,19040,1.0,0,0,3,7,1160,760,1961,0,98168,47.4756,-122.294,1920,11520,230000,4,9,2014,0,53,17120,9600,0,1,1
4,1.75,2290,9215,1.0,0,0,5,8,1270,1020,1969,0,98027,47.5328,-122.051,2290,10200,500000,22,9,2014,0,45,6925,7910,0,1,0
4,2.75,2070,9300,1.0,0,0,5,7,1120,950,1945,0,98155,47.7416,-122.32,1010,8308,366500,19,5,2014,0,69,7230,7298,0,1,1
6,3.0,4250,4400,2.5,0,0,4,7,3020,1230,1902,0,98118,47.5584,-122.283,1520,4950,665000,11,6,2014,0,112,150,3430,0,1,1
3,1.5,2220,4830,2.0,0,3,3,9,1790,430,1928,2010,98116,47.5825,-122.4,1670,4830,1100000,16,3,2015,82,87,2610,3160,1,1,1
2,1.75,1840,4076,1.0,0,0,3,8,1140,700,1957,0,98117,47.6875,-122.393,1540,4076,575000,1,12,2014,0,57,2236,2536,0,1,1
4,2.5,2590,9753,2.0,0,0,3,10,2590,0,1993,0,98075,47.5848,-122.027,2800,9917,674750,3,11,2014,0,21,7163,7117,0,0,0
5,2.0,3110,6131,1.0,0,0,5,7,1560,1550,1940,0,98118,47.5615,-122.279,1720,6600,719000,16,9,2014,0,74,3021,4880,0,1,1
2,1.0,1060,8187,1.0,0,0,4,6,1060,0,1952,0,98133,47.7508,-122.349,1260,8188,254000,28,5,2014,0,62,7127,6928,0,0,1
3,1.75,1250,3880,1.0,0,0,4,7,750,500,1944,0,98117,47.6869,-122.392,1240,3880,443725,19,8,2014,0,70,2630,2640,0,1,1
3,2.25,2070,9957,1.0,0,0,3,8,1440,630,1977,0,98155,47.7766,-122.277,2070,10158,469000,27,1,2015,0,38,7887,8088,0,1,1
5,2.0,2190,8316,1.0,0,0,3,7,1390,800,1961,0,98108,47.5488,-122.298,2010,8316,437000,9,9,2014,0,53,6126,6306,0,1,1
4,3.0,2760,13113,1.0,0,0,4,8,1760,1000,1974,0,98028,47.7669,-122.268,1900,13113,550000,20,8,2014,0,40,10353,11213,0,1,0
3,2.25,1710,7134,1.0,0,0,4,7,1130,580,1979,0,98031,47.3911,-122.191,1790,7455,172040,20,4,2015,0,36,5424,5665,0,1,0
3,2.0,1750,7000,1.0,0,0,3,8,1750,0,1993,0,98038,47.3693,-122.041,1840,6969,363000,24,12,2014,0,21,5250,5129,0,0,0
3,2.25,1552,3600,2.0,0,0,3,7,1552,0,2012,0,98092,47.3198,-122.178,1677,3600,282000,30,4,2015,0,3,2048,1923,0,0,0
6,2.0,2350,6554,2.0,0,1,3,8,2000,350,1905,0,98178,47.5115,-122.256,1560,6554,400000,14,8,2014,0,109,4204,4994,0,1,1
5,3.5,5110,10018,2.0,0,0,3,10,3850,1260,2003,0,98034,47.7261,-122.17,1790,10018,650000,24,9,2014,0,11,4908,8228,0,1,0
4,2.5,1960,7230,2.0,0,0,3,8,1960,0,2002,0,98023,47.2855,-122.36,1850,7208,269950,24,10,2014,0,12,5270,5358,0,0,0
3,1.5,1180,7000,1.0,0,0,4,7,1180,0,1977,0,98023,47.2959,-122.373,1630,7500,193000,24,10,2014,0,37,5820,5870,0,0,0
4,2.25,2230,6791,2.0,0,0,3,8,2230,0,2005,0,98038,47.3769,-122.028,2420,6297,340000,25,7,2014,0,9,4561,3877,0,0,0
3,2.5,2150,8361,2.0,0,0,3,8,2150,0,1991,0,98058,47.4627,-122.129,2150,9368,371000,21,10,2014,0,23,6211,7218,0,0,0
3,2.5,1830,12750,2.0,0,0,3,7,1830,0,1991,0,98168,47.5003,-122.328,1610,10000,300000,15,8,2014,0,23,10920,8390,0,0,1
4,3.0,2800,6977,2.0,0,0,3,8,2800,0,2003,0,98038,47.3542,-122.014,2800,6600,449950,27,8,2014,0,11,4177,3800,0,0,0
3,2.5,2090,7163,2.0,0,0,3,8,2090,0,1989,0,98003,47.2735,-122.295,2320,8634,299500,22,10,2014,0,25,5073,6314,0,0,0
4,2.25,2340,13406,1.0,0,0,4,9,2340,0,1963,0,98040,47.5377,-122.221,2340,10743,995000,26,3,2015,0,52,11066,8403,0,0,0
4,1.75,1670,9472,1.0,0,0,3,7,1100,570,1960,0,98106,47.5299,-122.357,1080,5195,335000,23,9,2014,0,54,7802,4115,0,1,1
4,2.25,1990,7350,1.0,0,0,4,8,1180,810,1978,0,98003,47.3258,-122.328,2030,7210,280000,10,11,2014,0,36,5360,5180,0,1,0
4,2.25,2270,7800,1.0,0,0,3,7,1290,980,1977,0,98034,47.7278,-122.192,1480,7280,446000,16,5,2014,0,37,5530,5800,0,1,0
4,2.75,4910,15139,1.0,0,0,4,10,2560,2350,1964,0,98004,47.6444,-122.22,3980,15139,1540000,27,9,2014,0,50,10229,11159,0,1,0
3,1.0,950,4500,1.0,0,0,4,6,950,0,1943,0,98118,47.5273,-122.265,1140,4500,325000,7,4,2015,0,72,3550,3360,0,0,1
3,1.75,1610,11200,1.0,0,0,3,7,1610,0,1955,0,98033,47.6641,-122.176,1610,11200,450000,19,6,2014,0,59,9590,9590,0,0,0
4,2.5,1940,7107,2.0,0,0,3,7,1940,0,2000,0,98038,47.3843,-122.032,1850,5705,322500,27,10,2014,0,14,5167,3855,0,0,0
3,1.0,1210,9473,1.0,0,0,5,7,1210,0,1955,0,98006,47.5637,-122.139,1700,11465,453000,15,9,2014,0,59,8263,9765,0,0,0
4,2.5,2570,4412,2.0,0,0,3,9,2570,0,2001,0,98034,47.7076,-122.232,2460,5470,655000,8,10,2014,0,13,1842,3010,0,0,0
3,2.25,1700,2800,2.0,0,0,5,7,1150,550,1926,0,98115,47.6819,-122.311,1500,3400,603000,4,5,2015,0,89,1100,1900,0,1,1
4,3.5,4120,7304,2.0,0,0,3,11,3070,1050,2006,0,98033,47.681,-122.167,2470,9600,968933,28,7,2014,0,8,3184,7130,0,1,0
3,3.5,2880,11340,1.0,0,0,3,8,1690,1190,1980,2013,98074,47.6113,-122.058,2530,11340,1020000,14,11,2014,33,34,8460,8810,1,1,0
4,2.25,1990,8548,2.0,0,0,3,8,1990,0,1973,0,98033,47.667,-122.178,2320,8926,435000,3,12,2014,0,41,6558,6606,0,0,0
3,2.0,1260,8092,1.0,0,0,3,7,1260,0,1986,0,98038,47.3635,-122.054,1950,8092,242000,18,6,2014,0,28,6832,6142,0,0,0
4,2.75,3010,10450,2.0,0,0,3,9,3010,0,1996,0,98052,47.6979,-122.112,3010,10530,810000,1,8,2014,0,18,7440,7520,0,0,0
3,1.5,1280,7742,1.0,0,0,3,7,1280,0,1973,0,98001,47.3323,-122.276,1566,7696,165000,23,10,2014,0,41,6462,6130,0,0,0
3,1.0,2320,6750,1.0,0,0,3,7,1160,1160,1960,0,98118,47.5327,-122.276,1230,6075,335000,27,4,2015,0,55,4430,4845,0,1,1
3,1.0,1220,6600,1.0,0,0,3,6,1220,0,1958,0,98065,47.5297,-121.827,1100,6600,286700,24,7,2014,0,56,5380,5500,0,0,0
2,1.5,1400,4050,1.0,0,0,4,8,1400,0,1954,0,98115,47.6768,-122.269,1900,5940,699000,24,4,2015,0,61,2650,4040,0,0,1
3,1.75,1590,7280,1.0,0,0,3,7,1140,450,1974,0,98058,47.4288,-122.153,1590,9634,280000,27,3,2015,0,41,5690,8044,0,1,0
4,2.5,2220,7064,2.0,0,0,3,8,2220,0,1988,0,98029,47.5716,-122.022,2220,7451,580000,2,6,2014,0,26,4844,5231,0,0,0
2,2.5,2770,7781,2.0,0,0,3,8,2770,0,2006,0,98053,47.7072,-122.017,1870,5984,754800,20,6,2014,0,8,5011,4114,0,0,0
4,2.5,2303,16801,2.0,0,0,3,8,2303,0,1995,0,98019,47.7266,-121.966,2080,14013,525000,10,2,2015,0,20,14498,11933,0,0,0
3,1.75,1600,10530,1.0,0,2,3,8,1600,0,1962,0,98155,47.7437,-122.291,2590,8274,562000,17,2,2015,0,53,8930,5684,0,0,1
4,1.75,1280,6060,1.0,0,0,3,7,860,420,1926,0,98117,47.6805,-122.364,1490,4680,575000,20,5,2014,0,88,4780,3190,0,1,1
5,2.5,2900,5901,2.0,0,0,3,9,2900,0,2006,0,98027,47.5396,-121.998,3200,5775,808900,11,7,2014,0,8,3001,2575,0,0,0
3,2.5,1700,6698,2.0,0,0,3,7,1700,0,1997,0,98038,47.3826,-122.028,2190,7346,335000,19,9,2014,0,17,4998,5156,0,0,0
3,2.75,1050,7200,1.0,0,0,3,7,1050,0,1985,0,98125,47.7163,-122.303,1860,9000,473000,26,12,2014,0,29,6150,7140,0,0,1
4,2.75,2990,11210,1.0,0,1,4,8,1880,1110,1977,0,98023,47.3357,-122.336,2790,9858,350000,25,3,2015,0,38,8220,7068,0,1,0
5,2.5,3100,5374,2.5,0,0,4,9,3100,0,1906,0,98122,47.6154,-122.283,2180,5800,1600000,24,4,2015,0,109,2274,3620,0,0,1
3,1.0,1240,6090,1.0,0,0,4,7,1240,0,1950,0,98155,47.7542,-122.307,1550,9096,305500,17,12,2014,0,64,4850,7546,0,0,1
2,2.25,850,1656,2.0,0,0,3,8,850,0,2001,0,98133,47.7064,-122.344,850,1312,233000,2,12,2014,0,13,806,462,0,0,1
3,1.75,1540,9000,1.0,0,0,3,8,1540,0,1971,0,98125,47.7152,-122.322,1710,7488,490000,31,3,2015,0,44,7460,5778,0,0,1
3,2.25,2550,9674,1.0,0,0,3,7,1850,700,1959,0,98178,47.4856,-122.247,2240,9674,355000,20,11,2014,0,55,7124,7434,0,1,1
2,2.0,1770,7607,1.0,0,0,4,8,1770,0,1987,0,98058,47.4287,-122.163,2090,7109,360000,2,4,2015,0,28,5837,5019,0,0,0
3,1.75,2320,10900,2.0,0,0,3,7,2320,0,1935,1974,98115,47.6877,-122.283,1610,5800,737500,9,7,2014,39,79,8580,4190,1,0,1
3,3.5,2600,11920,2.0,0,0,5,8,2600,0,1969,0,98004,47.582,-122.194,2430,10050,985000,15,12,2014,0,45,9320,7620,0,0,0
2,3.25,1570,2031,2.0,0,0,3,8,1310,260,2006,0,98126,47.548,-122.375,1570,2039,349950,6,8,2014,0,8,461,469,0,1,1
4,2.5,3060,7161,2.0,0,0,3,8,2860,200,2005,0,98065,47.5383,-121.879,2950,6822,520000,20,2,2015,0,10,4101,3872,0,1,0
4,2.5,1960,8540,1.0,0,0,3,7,1220,740,1955,0,98177,47.7654,-122.359,1910,9120,355950,17,12,2014,0,59,6580,7210,0,1,1
5,2.5,3270,6129,2.0,0,0,3,9,3270,0,2004,0,98055,47.4461,-122.208,2980,5928,485000,29,12,2014,0,10,2859,2948,0,0,0
3,1.0,1090,3315,1.0,0,0,4,6,1090,0,1969,0,98092,47.3159,-122.183,960,3120,143000,12,12,2014,0,45,2225,2160,0,0,0
2,1.75,6840,10000,2.5,1,4,3,11,4350,2490,2001,0,98008,47.6042,-122.112,3120,12300,3280000,10,12,2014,0,13,3160,9180,0,1,0
3,1.0,940,8512,1.0,0,0,4,7,940,0,1967,0,98033,47.7002,-122.191,1060,8512,355000,23,7,2014,0,47,7572,7452,0,0,0
5,3.5,3880,13885,2.0,0,3,4,9,2540,1340,1979,0,98006,47.5696,-122.156,3690,13885,1130000,4,6,2014,0,35,10005,10195,0,1,0
5,1.75,1770,15525,1.0,0,0,4,7,1770,0,1959,0,98059,47.5025,-122.142,1370,10395,200000,18,8,2014,0,55,13755,9025,0,0,0
4,2.5,3640,10576,2.0,0,0,3,11,3640,0,1999,0,98075,47.5899,-121.979,3370,10351,913000,18,6,2014,0,15,6936,6981,0,0,0
3,2.5,3160,12824,1.0,0,2,4,9,1820,1340,1966,0,98004,47.6151,-122.216,3390,11985,1600000,22,5,2014,0,48,9664,8595,0,1,0
2,2.5,1590,1845,2.0,0,0,3,9,1590,0,1997,0,98033,47.6897,-122.175,2320,3174,409900,25,6,2014,0,17,255,854,0,0,0
4,1.0,1290,6034,1.0,0,0,3,6,1050,240,1950,0,98118,47.5223,-122.286,1060,6034,265000,1,5,2015,0,65,4744,4974,0,1,1
4,2.5,2490,8124,2.0,0,0,3,7,2490,0,2001,0,98092,47.3347,-122.17,2760,6300,306000,12,6,2014,0,13,5634,3540,0,0,0
3,2.5,1470,3999,2.0,0,0,3,7,1470,0,2003,0,98065,47.5328,-121.871,1960,4444,381000,7,10,2014,0,11,2529,2484,0,0,0
3,3.25,3960,6132,2.0,0,3,3,10,2600,1360,1933,0,98199,47.6396,-122.409,2730,5221,1220000,5,5,2015,0,82,2172,2491,0,1,1
2,1.0,810,7440,1.0,0,0,5,6,810,0,1948,0,98133,47.7346,-122.352,830,7500,408000,3,9,2014,0,66,6630,6670,0,0,1
5,2.5,2980,5377,2.0,0,0,3,9,2980,0,2006,0,98052,47.7074,-122.101,3150,6593,739900,25,6,2014,0,8,2397,3443,0,0,0
2,1.0,1340,8100,1.0,0,0,4,7,1340,0,1953,0,98177,47.7218,-122.37,1700,8100,438400,11,9,2014,0,61,6760,6400,0,0,1
5,5.0,4930,14649,2.0,0,3,3,11,4160,770,2000,0,98040,47.5829,-122.247,3030,8479,1700000,30,12,2014,0,14,9719,5449,0,1,0
3,2.0,1360,5980,1.5,0,0,3,8,1360,0,1945,2008,98116,47.5852,-122.388,1520,4440,703000,19,6,2014,63,69,4620,2920,1,0,1
3,1.75,1320,6530,1.0,0,0,4,7,1320,0,1989,0,98023,47.2871,-122.354,1620,6817,262000,29,12,2014,0,25,5210,5197,0,0,0
4,2.5,1940,7607,2.0,0,0,3,8,1940,0,1995,0,98052,47.685,-122.158,2250,7600,500000,14,1,2015,0,20,5667,5350,0,0,0
4,2.5,3160,4620,1.5,0,4,3,9,2020,1140,1917,2005,98116,47.5875,-122.382,2790,5308,1280000,6,7,2014,88,97,1460,2518,1,1,1
4,2.5,1980,6566,2.0,0,0,3,8,1980,0,2004,0,98042,47.3809,-122.097,2590,6999,332000,8,4,2015,0,11,4586,4409,0,0,0
4,2.5,2320,14240,1.0,0,0,4,9,1620,700,1974,0,98008,47.6269,-122.09,2810,13200,824000,21,8,2014,0,40,11920,10390,0,1,0
4,2.0,1660,4788,1.0,0,0,3,7,1660,0,1968,0,98144,47.5878,-122.312,1150,5000,290000,20,2,2015,0,47,3128,3850,0,0,1
3,2.5,1660,1545,2.0,0,2,3,9,1400,260,2002,0,98109,47.6268,-122.353,1820,2570,700000,27,6,2014,0,12,-115,750,0,1,1
2,1.0,1080,3420,1.0,0,0,4,7,780,300,1922,0,98107,47.6715,-122.393,1380,3656,550000,6,10,2014,0,92,2340,2276,0,1,1
2,1.0,1510,11165,1.5,0,0,4,7,1510,0,1921,0,98133,47.7212,-122.331,2210,8851,549000,3,9,2014,0,93,9655,6641,0,0,1
4,2.25,3070,13720,2.0,0,0,3,9,3070,0,1978,0,98007,47.6133,-122.152,3010,9657,858000,2,3,2015,0,37,10650,6647,0,0,0
2,1.0,970,10423,1.0,0,0,3,7,970,0,1947,0,98133,47.7252,-122.331,1200,7857,345000,30,10,2014,0,67,9453,6657,0,0,1
4,1.75,2140,11651,2.5,0,0,3,8,2140,0,1930,2001,98022,47.196,-122.006,2030,10978,340000,4,11,2014,71,84,9511,8948,1,0,0
4,2.25,2570,9600,2.5,0,0,4,9,2570,0,1962,0,98040,47.5791,-122.241,2570,13200,1220000,25,4,2015,0,53,7030,10630,0,0,0
3,2.25,1260,1488,3.0,0,0,3,7,1260,0,2009,0,98133,47.7071,-122.336,1190,1095,275000,11,12,2014,0,5,228,-95,0,0,1
3,1.0,1220,7771,1.0,0,0,3,7,1220,0,1963,0,98008,47.6326,-122.119,1420,7674,405000,27,8,2014,0,51,6551,6254,0,0,0
3,2.0,1720,8145,2.0,0,0,5,7,1720,0,1949,0,98155,47.7393,-122.325,1400,8138,432500,16,1,2015,0,66,6425,6738,0,0,1
4,1.0,2140,4217,1.5,0,0,3,6,1320,820,1925,0,98118,47.5484,-122.287,1720,5413,236500,12,1,2015,0,90,2077,3693,0,1,1
4,1.5,1420,4923,1.5,0,0,4,8,1420,0,1928,0,98103,47.6901,-122.339,1470,4923,679000,18,7,2014,0,86,3503,3453,0,0,1
4,2.5,2060,8451,2.0,0,0,3,8,2060,0,1995,0,98133,47.7168,-122.333,2060,9460,543000,31,10,2014,0,19,6391,7400,0,0,1
3,1.0,1320,9520,1.0,0,0,3,7,990,330,1953,0,98178,47.4857,-122.253,1460,10610,294000,26,9,2014,0,61,8200,9150,0,1,1
3,1.75,1810,10463,1.0,0,0,4,7,1810,0,1969,0,98058,47.4581,-122.162,1620,8551,340500,3,4,2015,0,46,8653,6931,0,0,0
4,2.5,2980,16263,2.0,0,0,3,9,2980,0,1989,0,98006,47.5457,-122.153,2730,10018,1010000,3,7,2014,0,25,13283,7288,0,0,0
2,2.0,1350,2560,1.0,0,0,3,8,1350,0,1976,0,98052,47.6344,-122.107,1790,2560,335000,2,5,2014,0,38,1210,770,0,0,0
3,2.0,1540,8011,1.0,0,0,3,7,1540,0,1988,0,98011,47.7342,-122.202,1630,7141,425000,23,7,2014,0,26,6471,5511,0,0,0
3,2.5,2510,9240,2.0,0,0,4,8,2510,0,2001,0,98022,47.1896,-122.013,2690,9240,353000,10,2,2015,0,14,6730,6550,0,0,0
3,2.5,1670,5146,2.0,0,0,3,8,1670,0,1991,0,98029,47.5707,-121.999,1940,5146,540000,4,5,2015,0,24,3476,3206,0,0,0
5,3.5,3690,11928,2.0,0,0,3,9,2540,1150,2006,0,98074,47.6108,-122.06,2640,11928,640000,12,6,2014,0,8,8238,9288,0,1,0
3,1.0,1320,11457,1.0,0,0,3,8,1320,0,1959,0,98028,47.7738,-122.261,1900,9800,339950,22,7,2014,0,55,10137,7900,0,0,0
3,1.75,1510,8400,1.0,0,0,2,7,980,530,1979,0,98045,47.4476,-121.771,1500,10125,195000,7,11,2014,0,35,6890,8625,0,1,0
3,1.75,1510,8400,1.0,0,0,2,7,980,530,1979,0,98045,47.4476,-121.771,1500,10125,322000,26,2,2015,0,36,6890,8625,0,1,0
4,1.75,1870,10450,1.0,0,0,3,8,1620,250,1978,0,98005,47.5938,-122.154,2060,10450,660000,1,4,2015,0,37,8580,8390,0,1,0
6,3.0,2400,9373,2.0,0,0,3,7,2400,0,1991,0,98002,47.3262,-122.214,2060,7316,280000,16,9,2014,0,23,6973,5256,0,0,0
6,3.0,2400,9373,2.0,0,0,3,7,2400,0,1991,0,98002,47.3262,-122.214,2060,7316,300000,22,4,2015,0,24,6973,5256,0,0,0
3,1.0,1170,8816,1.0,0,0,4,6,1170,0,1966,0,98023,47.3059,-122.368,1200,9108,207500,15,8,2014,0,48,7646,7908,0,0,0
3,1.5,1190,8726,1.0,0,0,3,7,1190,0,1956,0,98146,47.4887,-122.343,1390,8741,195000,25,8,2014,0,58,7536,7351,0,0,1
3,2.0,2080,3880,1.0,0,0,5,7,1160,920,1954,0,98117,47.686,-122.391,1330,3880,700000,10,6,2014,0,60,1800,2550,0,1,1
4,1.75,2150,8555,1.0,0,2,4,7,1460,690,1982,0,98106,47.5344,-122.345,1480,7405,560000,17,4,2015,0,33,6405,5925,0,1,1
3,1.75,1580,7344,1.0,0,0,5,7,1580,0,1911,0,98126,47.5256,-122.38,1580,6207,260000,20,8,2014,0,103,5764,4627,0,0,1
3,1.75,1580,7344,1.0,0,0,5,7,1580,0,1911,0,98126,47.5256,-122.38,1580,6207,575000,25,2,2015,0,104,5764,4627,0,0,1
3,2.5,2370,3239,2.0,0,0,3,8,1950,420,2006,0,98072,47.7515,-122.174,2520,3431,475000,17,4,2015,0,9,869,911,0,1,0
3,1.75,1840,8601,1.0,0,0,3,7,920,920,1905,2014,98118,47.5359,-122.276,1390,7452,285000,13,6,2014,109,109,6761,6062,1,1,1
4,2.5,2660,5500,2.0,0,2,3,9,2660,0,2003,0,98029,47.5439,-121.996,3620,5500,753888,8,5,2014,0,11,2840,1880,0,0,0
3,2.5,2190,3600,2.0,0,0,3,9,2190,0,2003,0,98029,47.5506,-121.993,2300,3600,650000,10,4,2015,0,12,1410,1300,0,0,0
3,2.25,1660,3478,1.5,0,0,4,7,1100,560,1929,0,98117,47.6773,-122.372,1610,3478,620000,7,8,2014,0,85,1818,1868,0,1,1
2,1.0,700,5200,1.0,0,0,5,6,700,0,1952,0,98056,47.4924,-122.175,1030,5200,155000,14,5,2014,0,62,4500,4170,0,0,0
4,2.0,1570,11200,1.0,0,0,3,7,1120,450,1959,0,98011,47.7573,-122.217,1570,11200,342000,27,8,2014,0,55,9630,9630,0,1,0
4,2.5,2690,4736,2.0,0,0,3,7,2690,0,2001,0,98053,47.6869,-122.036,2690,4791,608000,25,6,2014,0,13,2046,2101,0,0,0
2,1.0,680,6400,1.0,0,0,3,6,680,0,1943,0,98168,47.5136,-122.316,1240,7800,179900,16,9,2014,0,71,5720,6560,0,0,1
6,3.25,3750,14150,2.0,0,2,5,9,2750,1000,1936,1968,98117,47.6999,-122.393,2140,7968,1250000,4,9,2014,32,78,10400,5828,1,1,1
3,1.0,1010,11675,1.0,0,0,3,7,1010,0,1957,0,98168,47.4849,-122.301,1370,10042,166000,30,4,2015,0,58,10665,8672,0,0,1
3,1.5,1710,4500,1.5,0,0,3,8,1410,300,1928,0,98118,47.5366,-122.268,1860,6000,462000,19,5,2014,0,86,2790,4140,0,1,1
4,2.5,2090,6023,2.0,0,0,3,8,2090,0,1990,0,98029,47.5713,-121.997,2090,6023,545000,22,6,2014,0,24,3933,3933,0,0,0
3,1.0,1560,4500,1.5,0,0,3,7,1560,0,1903,0,98122,47.6118,-122.306,1660,4500,415000,16,1,2015,0,112,2940,2840,0,0,1
3,2.5,1560,4200,2.0,0,0,3,7,1560,0,2003,0,98038,47.3838,-122.026,1560,4200,269000,10,6,2014,0,11,2640,2640,0,0,0
4,2.5,2570,11473,2.0,0,0,3,8,2570,0,2008,0,98003,47.2809,-122.296,2430,5997,356500,12,12,2014,0,6,8903,3567,0,0,0
3,1.0,1010,7633,1.0,0,0,4,6,1010,0,1961,0,98198,47.3781,-122.314,1190,8386,225000,23,12,2014,0,53,6623,7196,0,0,1
2,1.0,1020,5130,1.0,0,0,4,6,1020,0,1948,0,98002,47.301,-122.226,1200,6497,175000,20,6,2014,0,66,4110,5297,0,0,0
5,2.5,1710,9720,2.0,0,0,4,8,1710,0,1974,0,98005,47.5903,-122.157,2270,9672,549000,1,8,2014,0,40,8010,7402,0,0,0
3,2.75,2300,12197,2.0,0,0,3,8,2300,0,1989,0,98166,47.4369,-122.338,1710,11220,535000,15,4,2015,0,26,9897,9510,0,0,1
4,2.25,1990,7712,1.0,0,0,3,8,1210,780,1973,0,98027,47.5688,-122.087,1720,7393,627000,5,5,2014,0,41,5722,5673,0,1,0
3,2.0,2730,15677,2.5,0,3,3,9,2730,0,1976,0,98166,47.4612,-122.365,2040,12209,565000,22,8,2014,0,38,12947,10169,0,0,1
4,2.0,2195,2681,1.0,0,0,3,7,1060,1135,1912,0,98103,47.6965,-122.342,1710,1280,392450,12,11,2014,0,102,486,-430,0,1,1
2,2.0,1560,4675,1.0,0,0,3,8,1560,0,2006,0,98053,47.7086,-122.019,1870,6361,509000,23,9,2014,0,8,3115,4491,0,0,0
3,2.5,1400,4800,1.0,0,0,3,7,1200,200,1921,0,98117,47.6865,-122.379,1440,3840,340000,12,9,2014,0,93,3400,2400,0,1,1
3,2.5,1400,4800,1.0,0,0,3,7,1200,200,1921,0,98117,47.6865,-122.379,1440,3840,537000,26,3,2015,0,94,3400,2400,0,1,1
4,3.0,3690,9892,2.0,0,0,3,10,3690,0,1998,0,98075,47.5937,-121.982,3430,11294,865000,5,5,2014,0,16,6202,7864,0,0,0
2,1.0,1140,8340,1.0,0,0,3,7,1140,0,1948,0,98155,47.7448,-122.3,1030,8149,358000,14,12,2014,0,66,7200,7119,0,0,1
4,2.25,1920,3225,1.5,0,0,5,7,1300,620,1923,0,98116,47.5848,-122.384,1960,3750,595000,19,9,2014,0,91,1305,1790,0,1,1
4,2.5,2496,8058,2.0,0,0,3,9,2496,0,1998,0,98052,47.6791,-122.149,2496,7757,661000,19,6,2014,0,16,5562,5261,0,0,0
3,2.25,2280,8500,1.0,0,0,4,7,1680,600,1977,0,98034,47.7211,-122.166,1890,7700,419950,16,9,2014,0,37,6220,5810,0,1,0
4,3.5,3200,6420,2.0,0,0,3,9,3200,0,2006,0,98038,47.3545,-122.001,3200,6291,490000,16,4,2015,0,9,3220,3091,0,0,0
2,1.0,880,4000,1.0,0,0,3,7,880,0,1940,0,98117,47.6847,-122.387,1310,4000,525000,18,9,2014,0,74,3120,2690,0,0,1
3,2.0,1320,1298,3.0,0,0,3,7,1320,0,1995,0,98117,47.6959,-122.376,1380,1503,350000,13,8,2014,0,19,-22,123,0,0,1
3,2.5,2450,3582,2.0,0,0,3,9,2450,0,2008,0,98072,47.7749,-122.159,2490,5449,552500,11,5,2015,0,7,1132,2959,0,0,0
3,1.0,1040,8970,1.0,0,0,4,6,1040,0,1961,0,98023,47.3283,-122.337,1040,8450,210000,27,3,2015,0,54,7930,7410,0,0,0
5,1.75,1830,16650,1.5,0,0,3,7,1610,220,1958,0,98155,47.7734,-122.315,1790,12743,336800,29,1,2015,0,57,14820,10953,0,1,1
3,2.5,1440,4473,2.0,0,0,3,7,1440,0,2003,0,98053,47.6825,-122.036,1650,3322,465000,3,3,2015,0,12,3033,1672,0,0,0
4,2.5,1580,3632,2.0,0,0,3,7,1580,0,2011,0,98038,47.3672,-122.019,1950,3800,299900,18,12,2014,0,3,2052,1850,0,0,0
3,3.25,3230,5000,2.0,0,0,3,9,3230,0,2006,0,98029,47.5558,-122.002,2670,3977,715000,18,7,2014,0,8,1770,1307,0,0,0
3,2.5,2495,4400,2.0,0,0,3,8,2495,0,2007,0,98001,47.2877,-122.283,2434,4400,276000,10,12,2014,0,7,1905,1966,0,0,0
4,1.5,1740,12728,1.0,0,0,4,7,1180,560,1964,0,98003,47.2808,-122.3,1830,11125,265000,12,1,2015,0,51,10988,9295,0,1,0
3,1.75,1680,3000,1.0,0,2,4,6,840,840,1900,0,98103,47.686,-122.346,1540,3700,425000,30,5,2014,0,114,1320,2160,0,1,1
4,2.5,2460,10320,2.0,0,0,3,8,2460,0,1993,0,98092,47.2599,-122.215,2210,9024,313000,5,1,2015,0,22,7860,6814,0,0,0
3,2.5,3050,6000,1.0,0,3,3,8,1720,1330,1984,0,98177,47.7701,-122.389,2340,7200,715000,9,4,2015,0,31,2950,4860,0,1,1
3,2.25,1630,10969,2.0,0,0,3,7,1630,0,1991,0,98001,47.3305,-122.285,1410,7920,265000,12,12,2014,0,23,9339,6510,0,0,0
3,2.75,2460,6413,2.0,0,0,3,9,2460,0,2004,0,98028,47.7497,-122.245,2440,6092,646000,24,3,2015,0,11,3953,3652,0,0,0
3,1.0,1030,6600,1.0,0,0,3,7,1030,0,1954,0,98146,47.4941,-122.34,1220,9040,175000,21,7,2014,0,60,5570,7820,0,0,1
3,2.5,3410,13809,1.0,0,3,4,10,2450,960,1973,0,98003,47.3424,-122.326,3410,14245,649000,31,7,2014,0,41,10399,10835,0,1,0
3,2.75,2310,5200,1.0,0,0,4,7,1520,790,1940,0,98199,47.6357,-122.397,2310,5200,785000,23,4,2015,0,75,2890,2890,0,1,1
4,2.75,2610,4400,1.0,0,0,5,8,1260,1350,1920,0,98122,47.6158,-122.293,1770,4400,890000,22,9,2014,0,94,1790,2630,0,1,1
3,3.0,2330,10327,1.0,0,0,3,9,2330,0,1998,0,98034,47.7239,-122.164,2200,4629,612000,26,11,2014,0,16,7997,2429,0,0,0
4,2.5,2980,5674,2.0,0,0,3,8,2980,0,2003,0,98023,47.277,-122.347,2610,5495,330000,5,12,2014,0,11,2694,2885,0,0,0
3,2.25,1790,11393,1.0,0,0,3,8,1790,0,1978,0,98052,47.6297,-122.099,2290,11894,493000,12,11,2014,0,36,9603,9604,0,0,0
4,2.25,2940,5735,1.0,0,0,3,9,1470,1470,1957,0,98112,47.6381,-122.304,2230,5659,1600000,3,4,2015,0,58,2795,3429,0,1,1
4,3.0,3900,9750,1.0,0,4,5,10,2520,1380,1972,0,98006,47.5605,-122.158,3410,9450,1620000,27,6,2014,0,42,5850,6040,0,1,0
4,3.0,3900,9750,1.0,0,4,5,10,2520,1380,1972,0,98006,47.5605,-122.158,3410,9450,1650000,11,2,2015,0,43,5850,6040,0,1,0
3,2.5,1750,2150,2.5,0,0,3,7,1230,520,1900,2014,98122,47.6037,-122.311,1410,3300,499000,26,9,2014,114,114,400,1890,1,1,1
6,2.75,2660,8400,1.0,0,0,5,8,1550,1110,1962,0,98006,47.549,-122.173,2280,8400,603500,23,6,2014,0,52,5740,6120,0,1,0
2,1.5,1580,3680,1.0,0,2,3,8,1280,300,1941,0,98126,47.5762,-122.377,1730,3680,530000,24,6,2014,0,73,2100,1950,0,1,1
5,2.5,2350,14197,1.0,0,0,4,8,1220,1130,1962,0,98004,47.6005,-122.204,2470,11629,895000,6,4,2015,0,53,11847,9159,0,1,0
4,2.25,2510,8165,1.0,0,0,4,7,1610,900,1972,0,98023,47.3092,-122.372,1940,8250,267345,13,5,2014,0,42,5655,6310,0,1,0
3,2.25,1470,4653,2.0,0,0,4,7,1470,0,1985,0,98029,47.5667,-122.018,1560,4119,455000,20,6,2014,0,29,3183,2559,0,0,0
3,1.75,1540,6930,1.0,0,0,3,7,1250,290,1944,0,98115,47.6782,-122.278,1760,6930,630000,13,1,2015,0,71,5390,5170,0,1,1
3,2.5,2820,5001,2.0,0,0,3,9,2820,0,2004,0,98029,47.5533,-121.992,2660,5001,690000,3,11,2014,0,10,2181,2341,0,0,0
4,1.75,1250,12705,1.0,0,0,4,7,1250,0,1971,0,98023,47.302,-122.382,1390,8550,212000,26,8,2014,0,43,11455,7160,0,0,0
4,2.25,2080,7526,1.0,0,0,4,7,1280,800,1985,0,98030,47.3762,-122.183,1200,7500,231500,13,8,2014,0,29,5446,6300,0,1,0
2,1.0,1140,3990,1.0,0,0,3,7,1140,0,1924,0,98103,47.6554,-122.333,1800,5700,695000,5,5,2015,0,91,2850,3900,0,0,1
3,1.75,1710,5913,1.0,0,0,4,8,1120,590,1941,0,98199,47.6481,-122.406,2920,5922,675000,4,2,2015,0,74,4203,3002,0,1,1
3,1.5,1340,6500,1.0,0,0,3,7,1340,0,1972,0,98034,47.7168,-122.192,1620,7107,387000,27,10,2014,0,42,5160,5487,0,0,0
4,2.75,2290,7000,2.0,0,0,3,8,2290,0,1977,0,98058,47.4442,-122.129,2000,7200,347500,30,3,2015,0,38,4710,5200,0,0,0
3,2.0,1860,7400,1.0,0,0,3,8,930,930,1922,2004,98166,47.4598,-122.352,1640,8461,385000,11,7,2014,82,92,5540,6821,1,1,1
3,1.0,1080,4930,1.0,0,0,3,6,1080,0,1950,0,98126,47.5209,-122.374,1100,5950,265000,4,12,2014,0,64,3850,4850,0,0,1
3,1.0,960,5264,1.0,0,0,3,7,960,0,1953,0,98115,47.6805,-122.301,1140,5150,406000,22,4,2015,0,62,4304,4010,0,0,1
2,1.5,980,5000,2.0,0,0,3,7,980,0,1922,2003,98014,47.7076,-121.359,1040,5000,134000,8,5,2014,81,92,4020,3960,1,0,0
3,1.0,1500,3399,2.0,0,0,5,7,1300,200,1926,0,98103,47.6838,-122.352,1360,3588,415000,20,10,2014,0,88,1899,2228,0,1,1
3,1.75,1440,8775,1.0,0,0,3,7,1440,0,1973,0,98034,47.7231,-122.17,1790,7865,375000,27,5,2014,0,41,7335,6075,0,0,0
4,2.5,2580,7465,2.0,0,0,3,8,2580,0,1993,0,98074,47.6319,-122.022,2350,7596,620000,10,12,2014,0,21,4885,5246,0,0,0
5,2.5,2070,4698,2.0,0,0,3,7,2070,0,1999,0,98038,47.3539,-122.024,2010,4698,337500,28,10,2014,0,15,2628,2688,0,0,0
3,2.5,1880,12368,1.0,0,0,4,7,1260,620,1967,0,98005,47.5901,-122.167,1950,11551,565000,22,9,2014,0,47,10488,9601,0,1,0
3,1.75,2420,12676,2.0,0,0,3,7,2420,0,1911,1986,98045,47.4943,-121.789,1210,6769,399500,23,5,2014,75,103,10256,5559,1,0,0
2,1.75,1890,9466,2.0,0,0,3,8,1890,0,1987,0,98004,47.6144,-122.211,2180,12825,1070000,21,5,2014,0,27,7576,10645,0,0,0
3,2.0,1870,5909,1.0,0,0,3,7,1270,600,1986,0,98030,47.3665,-122.183,1870,7887,259000,17,6,2014,0,28,4039,6017,0,1,0
2,1.0,900,7620,1.0,0,0,3,7,900,0,1971,0,98106,47.5268,-122.343,1520,7620,320000,15,4,2015,0,44,6720,6100,0,0,1
3,2.5,2160,9888,2.0,0,0,4,9,2160,0,1989,0,98052,47.6712,-122.142,3060,7829,733000,11,8,2014,0,25,7728,4769,0,0,0
2,1.0,900,2910,1.0,0,0,5,7,900,0,1924,0,98115,47.6859,-122.322,1320,2910,381500,25,6,2014,0,90,2010,1590,0,0,1
2,1.0,1180,9261,1.0,0,0,4,7,940,240,1957,0,98118,47.5492,-122.274,1700,6325,343000,2,12,2014,0,57,8081,4625,0,1,1
2,1.0,900,6400,1.0,0,0,5,6,900,0,1938,0,98022,47.2113,-121.992,1320,6400,205500,18,8,2014,0,76,5500,5080,0,0,0
3,1.75,1500,8352,1.0,0,2,5,6,750,750,1943,0,98056,47.4883,-122.191,1500,8447,300000,19,3,2015,0,72,6852,6947,0,1,0
4,2.5,2570,5250,2.0,0,0,3,8,2570,0,1990,0,98029,47.5763,-122.0,2260,5392,561000,9,7,2014,0,24,2680,3132,0,0,0
3,1.0,1210,4000,1.5,0,0,3,7,1090,120,1928,0,98144,47.5934,-122.308,1210,4000,450000,24,2,2015,0,87,2790,2790,0,1,1
4,2.5,1850,7850,2.0,0,0,3,8,1850,0,1985,0,98052,47.6914,-122.103,1830,8140,540000,14,8,2014,0,29,6000,6310,0,0,0
3,1.0,1300,14000,1.0,0,0,4,7,1300,0,1958,0,98198,47.4213,-122.322,1390,8750,230000,24,7,2014,0,56,12700,7360,0,0,1
5,2.5,3220,5806,2.0,0,0,3,8,3220,0,2002,0,98042,47.3714,-122.103,2760,5813,355000,7,5,2015,0,13,2586,3053,0,0,0
4,2.25,2160,9593,1.0,0,0,3,8,2160,0,1969,0,98008,47.5883,-122.112,2820,9628,580000,19,6,2014,0,45,7433,6808,0,0,0
3,2.0,2130,4299,1.5,0,0,4,7,1680,450,1922,0,98144,47.5779,-122.294,2040,4548,700000,27,4,2015,0,93,2169,2508,0,1,1
3,1.75,1580,8151,1.0,0,1,4,7,1100,480,1962,0,98198,47.3672,-122.312,1650,8151,279900,6,5,2014,0,52,6571,6501,0,1,1
3,1.0,1200,7500,1.0,0,0,3,6,1200,0,1905,1989,98178,47.4921,-122.275,1010,7000,210000,13,11,2014,84,109,6300,5990,1,0,1
3,3.0,3790,5001,2.0,0,0,3,10,2810,980,1989,0,98122,47.6035,-122.285,2500,6286,1170000,30,6,2014,0,25,1211,3786,0,1,1
2,1.0,860,3874,1.0,0,0,4,6,860,0,1931,0,98055,47.4836,-122.204,1400,5106,290300,11,6,2014,0,83,3014,3706,0,0,0
3,1.0,1600,6380,1.5,0,0,3,7,1400,200,1939,0,98125,47.7015,-122.317,1760,6380,490000,16,4,2015,0,76,4780,4620,0,1,1
4,2.5,2110,13850,2.0,0,0,3,9,2110,0,1987,0,98027,47.5497,-122.077,2520,10194,606000,6,5,2014,0,27,11740,7674,0,0,0
3,1.0,1400,4980,1.0,0,0,3,6,950,450,1943,0,98133,47.7041,-122.34,990,4980,359950,14,7,2014,0,71,3580,3990,0,1,1
3,2.0,2110,9199,1.0,0,0,3,10,2110,0,1993,0,98074,47.6496,-122.083,3130,8841,677100,12,2,2015,0,22,7089,5711,0,0,0
3,2.0,1430,7125,1.0,0,0,4,7,1430,0,1984,0,98074,47.6256,-122.059,1570,8075,465000,21,2,2015,0,31,5695,6505,0,0,0
2,1.0,980,5000,1.0,0,0,4,7,980,0,1950,0,98155,47.7518,-122.279,1600,5965,455000,3,5,2015,0,65,4020,4365,0,0,1
6,2.0,2570,4240,1.5,0,0,4,7,1970,600,1911,0,98115,47.6754,-122.307,2030,4240,705000,18,8,2014,0,103,1670,2210,0,1,1
3,2.5,2060,7020,1.0,0,0,4,8,1460,600,1967,0,98177,47.7575,-122.364,2150,8400,420000,12,8,2014,0,47,4960,6250,0,1,1
3,1.0,1300,8284,1.0,0,0,3,7,1300,0,1968,0,98003,47.3327,-122.306,1360,7848,169575,5,10,2014,0,46,6984,6488,0,0,0
3,1.0,1300,8284,1.0,0,0,3,7,1300,0,1968,0,98003,47.3327,-122.306,1360,7848,250000,25,2,2015,0,47,6984,6488,0,0,0
3,2.25,1680,7262,1.0,0,0,5,7,1180,500,1973,0,98034,47.713,-122.225,1910,7405,530000,12,3,2015,0,42,5582,5495,0,1,0
3,1.75,1530,14087,1.0,0,0,3,7,1070,460,1979,0,98042,47.3146,-122.043,1770,13660,257500,23,9,2014,0,35,12557,11890,0,1,0
3,1.0,1170,6700,1.0,0,0,3,8,1170,0,1957,0,98125,47.7122,-122.29,2410,7620,415000,26,6,2014,0,57,5530,5210,0,0,1
3,1.75,1580,3764,1.5,0,0,3,7,1280,300,1945,0,98107,47.672,-122.397,1560,3764,536000,10,10,2014,0,69,2184,2204,0,1,1
3,1.5,1270,11600,1.0,0,0,4,7,1270,0,1964,0,98031,47.4075,-122.196,1380,9945,246500,29,5,2014,0,50,10330,8565,0,0,0
3,1.75,1480,7700,1.0,0,0,3,8,1480,0,1975,0,98034,47.7225,-122.202,1930,8560,395000,6,7,2014,0,39,6220,6630,0,0,0
3,2.25,2220,10530,1.0,0,0,4,8,1700,520,1974,0,98052,47.6383,-122.098,2500,10014,739000,11,5,2015,0,41,8310,7514,0,1,0
3,1.0,910,10575,1.0,0,0,4,7,910,0,1968,0,98003,47.2741,-122.301,1470,10425,190000,8,7,2014,0,46,9665,8955,0,0,0
3,1.5,1480,9086,1.0,0,0,3,7,1480,0,1962,0,98168,47.4717,-122.323,1540,9750,305000,10,4,2015,0,53,7606,8210,0,0,1
4,4.25,3770,13058,2.0,0,0,4,8,3770,0,1983,0,98028,47.7517,-122.225,2200,12255,925000,20,4,2015,0,32,9288,10055,0,0,0
4,3.0,3500,13444,2.0,0,0,3,10,2360,1140,1977,0,98040,47.5468,-122.231,3140,12935,895000,21,8,2014,0,37,9944,9795,0,1,0
3,1.75,1480,7475,1.5,0,0,3,8,1480,0,1943,0,98115,47.6732,-122.272,2120,7216,656000,17,7,2014,0,71,5995,5096,0,0,1
4,1.0,1660,4690,1.5,0,0,3,7,1260,400,1945,0,98117,47.6829,-122.378,1400,3876,560000,19,5,2014,0,69,3030,2476,0,1,1
5,2.25,2520,11700,2.0,0,0,3,9,2520,0,1977,0,98074,47.6322,-122.053,2530,12000,610000,20,10,2014,0,37,9180,9470,0,0,0
3,2.5,2153,4400,2.0,0,0,3,8,2153,0,2007,0,98001,47.2872,-122.283,2434,4400,259000,10,4,2015,0,8,2247,1966,0,0,0
4,2.5,3780,10962,2.0,0,0,3,10,3780,0,1990,0,98033,47.6533,-122.183,3310,11651,980000,18,8,2014,0,24,7182,8341,0,0,0
4,4.0,3770,9750,1.0,0,0,4,9,1940,1830,1967,0,98177,47.7159,-122.367,2260,9878,872000,23,7,2014,0,47,5980,7618,0,1,1
6,2.75,3600,9675,1.0,0,2,4,9,1940,1660,1977,0,98040,47.5726,-122.213,2990,9675,1000000,5,8,2014,0,37,6075,6685,0,1,0
3,2.75,2980,12600,1.5,0,0,3,8,1590,1390,1941,2012,98033,47.674,-122.196,1520,9660,900000,10,9,2014,71,73,9620,8140,1,1,0
4,1.5,2320,5534,1.5,0,0,4,7,1540,780,1915,0,98103,47.6944,-122.355,1670,5913,475000,28,4,2015,0,100,3214,4243,0,1,1
5,2.75,2980,13482,1.0,0,0,4,8,1730,1250,1975,0,98042,47.3774,-122.16,2900,14800,350000,7,1,2015,0,40,10502,11900,0,1,0
4,1.75,2930,11562,1.0,0,3,3,9,1670,1260,1947,0,98117,47.6765,-122.404,2530,6517,840000,15,5,2014,0,67,8632,3987,0,1,1
4,2.5,2040,8400,1.0,0,0,3,8,1420,620,1963,0,98006,47.5512,-122.17,2540,8925,500000,22,6,2014,0,51,6360,6385,0,1,0
3,1.5,1510,9898,1.0,0,0,3,7,1110,400,1954,0,98148,47.4303,-122.334,1420,9250,202500,6,4,2015,0,61,8388,7830,0,1,1
3,2.5,1740,10050,2.0,0,0,3,7,1740,0,1989,0,98001,47.2671,-122.236,1300,10125,225000,3,12,2014,0,25,8310,8825,0,0,0
3,2.25,2240,9542,1.0,0,1,3,7,1190,1050,1980,0,98198,47.3995,-122.318,2080,9542,418200,9,3,2015,0,35,7302,7462,0,1,1
4,1.75,1570,9670,1.0,0,0,3,7,1170,400,1959,0,98028,47.7432,-122.248,2080,9100,356500,5,12,2014,0,55,8100,7020,0,1,0
4,3.0,2500,5000,1.5,0,0,4,7,1460,1040,1926,0,98103,47.6895,-122.331,1720,4500,670000,16,7,2014,0,88,2500,2780,0,1,1
3,2.25,1750,12408,1.0,0,0,5,7,1150,600,1962,0,98155,47.7509,-122.3,1820,12977,456150,4,12,2014,0,52,10658,11157,0,1,1
4,2.5,3030,9687,2.0,0,0,3,8,2020,1010,1998,0,98045,47.485,-121.799,2050,10193,471000,3,6,2014,0,16,6657,8143,0,1,0
3,2.5,1680,934,3.0,0,0,3,8,1680,0,2008,0,98116,47.5891,-122.387,1740,1280,558000,9,4,2015,0,7,-746,-460,0,0,1
6,4.5,5740,10312,2.0,0,2,3,11,3610,2130,2000,0,98006,47.5533,-122.11,4350,11917,1380000,5,3,2015,0,15,4572,7567,0,1,0
3,1.0,1220,6000,1.0,0,0,5,7,1220,0,1961,0,98002,47.2811,-122.214,1420,13137,161500,12,12,2014,0,53,4780,11717,0,0,0
3,1.0,1310,8370,1.5,0,0,3,7,1310,0,1962,0,98034,47.7284,-122.241,1310,8370,311000,10,10,2014,0,52,7060,7060,0,0,0
6,1.75,2490,8732,1.5,0,0,4,8,2490,0,1966,0,98034,47.7252,-122.187,1840,8024,470000,24,2,2015,0,49,6242,6184,0,0,0
3,3.25,2220,8227,1.5,0,0,5,8,1770,450,1929,0,98108,47.5665,-122.316,1750,4800,569000,9,7,2014,0,85,6007,3050,0,1,1
4,2.5,2240,7350,2.0,0,0,3,9,2240,0,1989,0,98029,47.5652,-122.013,2200,8017,689000,18,3,2015,0,26,5110,5817,0,0,0
3,1.75,1890,11875,1.0,0,0,3,7,1230,660,1979,0,98045,47.4472,-121.774,1580,10920,271900,15,7,2014,0,35,9985,9340,0,1,0
4,2.5,1850,6037,2.0,0,0,3,7,1850,0,1991,0,98030,47.359,-122.191,1860,6037,278000,10,12,2014,0,23,4187,4177,0,0,0
2,2.5,2210,4440,2.0,0,0,4,8,1440,770,1931,0,98112,47.6305,-122.3,1560,4920,820000,23,7,2014,0,83,2230,3360,0,1,1
3,1.75,1410,7700,1.0,0,0,4,7,1410,0,1967,0,98056,47.5375,-122.176,1560,7700,399500,25,2,2015,0,48,6290,6140,0,0,0
3,2.75,1890,2614,2.0,0,0,4,9,1890,0,1979,0,98008,47.6102,-122.114,1800,2769,462000,5,11,2014,0,35,724,969,0,0,0
3,1.0,1830,12036,1.0,0,0,3,7,1550,280,1977,0,98042,47.3126,-122.043,1810,12036,347500,13,4,2015,0,38,10206,10226,0,1,0
2,0.75,1440,3700,1.0,0,0,3,7,1200,240,1914,0,98107,47.6707,-122.364,1440,4300,562100,25,6,2014,0,100,2260,2860,0,1,1
2,1.0,950,7560,1.0,0,0,3,6,950,0,1958,0,98058,47.4499,-122.176,1160,7560,230000,29,5,2014,0,56,6610,6400,0,0,0
4,2.5,2370,10083,2.0,0,0,5,8,2370,0,1966,0,98033,47.6715,-122.166,2370,10133,687000,22,6,2014,0,48,7713,7763,0,0,0
4,2.5,3070,5762,2.0,0,0,3,10,3070,0,2000,0,98075,47.5847,-122.08,3630,6500,725786,9,12,2014,0,14,2692,2870,0,0,0
3,1.0,1300,12600,1.0,0,0,4,7,1300,0,1969,0,98072,47.7422,-122.1,1480,13530,315500,26,1,2015,0,46,11300,12050,0,0,0
4,2.0,1300,7054,1.0,0,0,3,7,1300,0,1950,2013,98146,47.5071,-122.369,1560,7100,312000,6,5,2014,63,64,5754,5540,1,0,1
3,3.25,1210,1173,2.0,0,0,3,8,1000,210,2002,0,98133,47.7114,-122.356,1650,1493,343000,6,11,2014,0,12,-37,-157,0,1,1
1,1.0,710,6000,1.5,0,0,3,6,710,0,2015,0,98144,47.5756,-122.316,1440,4800,385195,29,10,2014,0,-1,5290,3360,0,0,1
4,2.25,2240,12650,1.0,0,0,4,8,1730,510,1981,0,98059,47.4777,-122.142,2150,12650,415000,29,8,2014,0,33,10410,10500,0,1,0
3,1.75,3600,8666,2.0,0,0,4,6,2400,1200,1948,0,98033,47.6893,-122.167,2290,8200,461000,30,6,2014,0,66,5066,5910,0,1,0
4,2.5,1960,7133,2.0,0,0,3,7,1960,0,2002,0,98056,47.4941,-122.19,1960,6705,369990,10,6,2014,0,12,5173,4745,0,0,0
4,2.5,1820,3134,2.0,0,0,3,7,1820,0,1999,0,98019,47.7351,-121.985,1820,3751,349950,29,9,2014,0,15,1314,1931,0,0,0
3,2.25,1960,17126,1.0,0,0,3,8,1400,560,1966,0,98055,47.4436,-122.21,2060,11466,285750,12,4,2015,0,49,15166,9406,0,1,0
4,2.25,1750,10160,1.0,0,0,3,8,1320,430,1972,0,98005,47.5909,-122.158,2170,11165,542500,20,4,2015,0,43,8410,8995,0,1,0
5,3.5,3700,5400,2.0,0,0,3,9,2890,810,2011,0,98053,47.7085,-122.117,3620,5460,830000,11,11,2014,0,3,1700,1840,0,1,0
2,1.0,1270,5000,1.0,0,0,3,8,1090,180,1949,0,98117,47.6828,-122.393,1640,5000,615000,24,6,2014,0,65,3730,3360,0,1,1
2,1.0,720,5880,1.0,0,0,3,6,720,0,1940,0,98178,47.5056,-122.27,1440,7200,184500,29,1,2015,0,75,5160,5760,0,0,1
2,1.0,1040,5120,1.0,0,0,3,7,1040,0,1901,0,98122,47.6048,-122.312,1250,4000,412000,1,10,2014,0,113,4080,2750,0,0,1
3,1.5,2210,11111,1.5,0,0,3,7,2210,0,1934,0,98168,47.492,-122.309,1250,8422,250000,15,12,2014,0,80,8901,7172,0,0,1
5,2.0,2060,6000,2.0,0,0,3,7,2060,0,1903,0,98105,47.6685,-122.305,1770,5000,580000,12,6,2014,0,111,3940,3230,0,0,1
2,1.0,780,6000,1.0,0,0,5,6,780,0,1923,0,98055,47.4759,-122.208,1080,6000,220000,12,3,2015,0,92,5220,4920,0,0,0
4,2.75,2240,8937,1.0,0,0,4,8,1460,780,1976,0,98033,47.6495,-122.194,2360,9038,675000,16,9,2014,0,38,6697,6678,0,1,0
2,1.0,800,3330,1.0,0,0,3,7,800,0,1918,0,98107,47.6566,-122.358,1300,4320,373500,22,5,2014,0,96,2530,3020,0,0,1
2,1.5,2440,6900,2.0,0,0,3,7,1590,850,1910,0,98118,47.5568,-122.271,1770,6900,662700,2,4,2015,0,105,4460,5130,0,1,1
5,1.0,1460,6032,2.0,0,0,4,6,1460,0,1941,0,98168,47.487,-122.282,1060,10300,239950,16,5,2014,0,73,4572,9240,0,0,1
3,1.0,1150,10196,1.0,0,0,4,7,1150,0,1957,0,98052,47.6788,-122.162,1410,8925,383000,25,9,2014,0,57,9046,7515,0,0,0
3,2.75,2650,12350,1.0,0,0,4,7,1470,1180,1975,0,98028,47.7669,-122.268,1950,14075,485000,29,1,2015,0,40,9700,12125,0,1,0
6,1.75,1820,6250,1.0,0,0,3,7,1130,690,1954,0,98116,47.579,-122.39,1820,5750,545000,8,8,2014,0,60,4430,3930,0,1,1
2,2.5,2560,2500,2.0,0,0,5,8,1690,870,1901,0,98112,47.6233,-122.3,1890,5000,780000,8,7,2014,0,113,-60,3110,0,1,1
3,2.5,1714,3240,2.0,0,0,3,8,1714,0,2005,0,98055,47.4288,-122.19,1714,3240,305000,24,4,2015,0,10,1526,1526,0,0,0
3,1.0,1330,15678,1.0,0,0,3,7,900,430,1984,0,98074,47.6355,-122.037,1330,12696,405000,12,6,2014,0,30,14348,11366,0,1,0
5,3.5,7350,12231,2.0,0,4,3,11,4750,2600,2001,0,98065,47.5373,-121.865,5380,12587,1110000,30,7,2014,0,13,4881,7207,0,1,0
3,1.75,2050,9045,2.0,0,0,4,6,2050,0,1959,0,98058,47.4572,-122.18,1200,9045,273000,2,4,2015,0,56,6995,7845,0,0,0
3,1.0,1810,12375,2.0,0,0,3,7,1810,0,1970,0,98072,47.7427,-122.172,1420,9357,326500,27,5,2014,0,44,10565,7937,0,0,0
3,1.75,1380,9134,1.0,0,0,5,7,880,500,1981,0,98056,47.5087,-122.193,1400,8190,365000,24,4,2015,0,34,7754,6790,0,1,0
3,2.75,3070,10739,2.0,0,0,3,10,2440,630,1987,0,98004,47.6444,-122.191,3490,11913,1000000,8,4,2015,0,28,7669,8423,0,1,0
2,1.0,800,4046,1.0,0,0,3,7,800,0,1940,0,98117,47.6895,-122.382,1400,4046,422500,25,3,2015,0,75,3246,2646,0,0,1
4,2.75,2140,9920,2.0,0,0,3,8,2140,0,1993,0,98001,47.3529,-122.274,2130,9920,354450,24,3,2015,0,22,7780,7790,0,0,0
3,1.0,1330,9540,1.0,0,0,4,7,1330,0,1971,0,98077,47.758,-122.075,1250,10350,320000,4,12,2014,0,43,8210,9100,0,0,0
3,1.0,1030,9120,1.0,0,0,3,7,1030,0,1961,0,98032,47.3607,-122.291,1470,10220,223000,3,6,2014,0,53,8090,8750,0,0,0
3,2.5,1740,4948,2.0,0,0,3,7,1740,0,2008,0,98053,47.6966,-122.025,1290,3383,410000,24,7,2014,0,6,3208,2093,0,0,0
3,1.0,1200,4000,1.5,0,0,4,6,1200,0,1923,0,98144,47.5881,-122.299,1390,4000,438000,29,8,2014,0,91,2800,2610,0,0,1
3,3.0,1490,2944,2.0,0,0,3,7,960,530,1993,0,98199,47.6506,-122.384,1590,1600,390000,6,11,2014,0,21,1454,10,0,1,1
4,2.5,1890,5954,2.0,0,0,3,7,1890,0,2004,0,98092,47.3293,-122.194,2030,5880,298500,19,2,2015,0,11,4064,3850,0,0,0
5,2.25,3060,13630,2.0,0,0,3,10,3060,0,1989,0,98006,47.5585,-122.117,3430,10700,749999,5,9,2014,0,25,10570,7270,0,0,0
6,2.5,3250,12000,1.0,0,1,3,8,1800,1450,1966,0,98115,47.6935,-122.28,3490,10320,779000,29,8,2014,0,48,8750,6830,0,1,1
3,2.75,2730,11936,2.0,0,2,3,8,1530,1200,1978,0,98034,47.6987,-122.231,2810,12333,570000,14,1,2015,0,37,9206,9523,0,1,0
3,1.0,810,4600,1.0,0,0,3,6,810,0,1918,0,98144,47.5712,-122.316,1520,4800,385000,12,5,2015,0,97,3790,3280,0,0,1
4,2.0,2240,11040,1.0,0,0,5,8,1120,1120,1961,0,98033,47.693,-122.168,1790,11040,649000,18,8,2014,0,53,8800,9250,0,1,0
3,1.0,1740,5247,1.0,0,0,3,7,1270,470,1947,0,98168,47.5049,-122.329,1070,5636,283000,1,10,2014,0,67,3507,4566,0,1,1
4,2.25,2380,16236,1.0,0,0,3,7,1540,840,1961,0,98008,47.6126,-122.12,2230,8925,699900,22,9,2014,0,53,13856,6695,0,1,0
4,1.0,1540,8400,1.0,0,0,3,7,770,770,1971,0,98058,47.4278,-122.152,1520,9891,278500,20,2,2015,0,44,6860,8371,0,1,0
4,1.75,2340,9100,1.0,0,0,3,8,1610,730,1975,0,98052,47.6401,-122.108,2470,11000,700000,15,11,2014,0,39,6760,8530,0,1,0
3,1.75,1310,18400,1.0,0,0,3,7,870,440,1954,0,98168,47.5035,-122.302,1840,10790,234500,23,9,2014,0,60,17090,8950,0,1,1
3,1.75,1390,9585,1.0,0,0,4,7,1390,0,1973,0,98133,47.752,-122.35,1240,8188,374150,6,8,2014,0,41,8195,6948,0,0,1
4,2.5,2201,9542,2.0,0,0,3,8,2201,0,2006,0,98198,47.4002,-122.317,1990,9542,397000,17,3,2015,0,9,7341,7552,0,0,1
3,2.25,1960,10385,1.0,0,0,3,8,1960,0,1988,0,98008,47.5736,-122.109,2800,12632,613000,18,9,2014,0,26,8425,9832,0,0,0
3,2.5,2850,10474,1.0,0,0,4,8,1730,1120,1954,0,98004,47.6218,-122.209,2820,10474,1150000,9,6,2014,0,60,7624,7654,0,1,0
4,1.75,1880,4080,1.0,0,0,3,7,940,940,1924,0,98115,47.6754,-122.327,1410,4080,595000,27,3,2015,0,91,2200,2670,0,1,1
5,2.75,2440,6858,2.0,0,0,3,8,2440,0,2003,0,98030,47.3655,-122.174,2300,6858,340000,10,9,2014,0,11,4418,4558,0,0,0
4,2.5,2560,5800,2.0,0,0,3,9,2560,0,2005,0,98038,47.3474,-122.025,3040,5800,388000,8,1,2015,0,10,3240,2760,0,0,0
3,2.0,2870,6360,1.5,0,1,4,8,1790,1080,1946,0,98115,47.6813,-122.275,2310,6466,810000,29,8,2014,0,68,3490,4156,0,1,1
4,2.5,2620,9359,2.0,0,0,3,9,2620,0,1987,0,98058,47.438,-122.152,2580,7433,405000,3,4,2015,0,28,6739,4853,0,0,0
5,3.0,2970,10335,2.0,0,0,3,9,2970,0,2000,0,98075,47.598,-122.019,2970,10335,726000,14,7,2014,0,14,7365,7365,0,0,0
3,2.5,1780,7214,1.0,0,0,4,7,1400,380,1986,0,98030,47.3667,-122.182,1520,7228,266000,14,5,2014,0,28,5434,5708,0,1,0
5,2.25,3700,7207,1.0,0,1,5,8,1850,1850,1970,0,98177,47.7736,-122.371,2340,7900,722500,22,12,2014,0,44,3507,5560,0,1,1
4,1.5,1240,8158,1.0,0,0,4,7,1110,130,1961,0,98198,47.3716,-122.31,1520,8147,265000,19,3,2015,0,54,6918,6627,0,1,1
3,2.5,2160,3920,2.0,0,0,3,9,2160,0,2014,0,98116,47.5762,-122.415,1500,4920,856000,6,2,2015,0,1,1760,3420,0,0,1
3,2.5,2040,4348,2.0,0,0,4,8,2040,0,2006,0,98038,47.3517,-121.999,2380,4348,346950,24,7,2014,0,8,2308,1968,0,0,0
5,3.5,3130,4797,2.0,0,0,3,9,2570,560,2014,0,98006,47.5664,-122.129,3440,5439,866059,17,6,2014,0,0,1667,1999,0,1,0
3,2.5,2350,4456,2.0,0,0,3,7,2350,0,2004,0,98065,47.5314,-121.854,2350,4456,410000,29,1,2015,0,11,2106,2106,0,0,0
2,2.0,1520,5010,1.0,0,0,3,7,1520,0,1999,0,98117,47.6948,-122.364,1110,5040,400000,10,10,2014,0,15,3490,3930,0,0,1
3,1.0,1350,9680,1.0,0,0,4,7,820,530,1959,0,98023,47.3274,-122.346,1320,9225,172000,11,3,2015,0,56,8330,7905,0,1,0
3,1.75,1950,8480,1.0,0,0,4,8,1250,700,1962,0,98007,47.5893,-122.15,1740,8480,615000,14,7,2014,0,52,6530,6740,0,1,0
4,3.5,3950,9600,2.0,0,0,3,10,3950,0,1998,0,98075,47.5945,-121.981,3110,10213,860000,7,4,2015,0,17,5650,7103,0,0,0
3,1.75,2040,6000,1.0,0,0,5,7,1120,920,1958,0,98116,47.5688,-122.397,1530,6250,555000,18,6,2014,0,56,3960,4720,0,1,1
3,2.5,1990,4040,1.5,0,0,5,8,1390,600,1926,0,98103,47.6867,-122.354,1180,3030,579000,21,7,2014,0,88,2050,1850,0,1,1
3,1.75,1300,7030,1.0,0,0,3,7,1300,0,1968,0,98034,47.721,-122.179,1450,7650,385000,30,6,2014,0,46,5730,6200,0,0,0
4,2.25,2030,12000,2.0,0,0,3,7,2030,0,1977,0,98011,47.7699,-122.168,2190,9900,420000,14,4,2015,0,38,9970,7710,0,0,0
3,1.75,2340,6750,1.5,0,0,5,7,1620,720,1914,0,98103,47.6956,-122.335,1410,3388,645000,16,7,2014,0,100,4410,1978,0,1,1
3,2.5,2160,6288,2.0,0,0,3,8,2160,0,1996,0,98133,47.7655,-122.35,1830,7600,549950,28,4,2015,0,19,4128,5770,0,0,1
3,2.75,2770,10000,1.0,0,1,5,8,1640,1130,1962,0,98033,47.7011,-122.206,2450,10000,678000,23,9,2014,0,52,7230,7550,0,1,0
4,2.0,2030,8120,2.0,0,0,3,7,2030,0,1950,0,98178,47.4994,-122.261,1520,9440,199000,21,5,2014,0,64,6090,7920,0,0,1
3,1.0,1440,13824,1.0,0,0,4,7,1440,0,1957,0,98040,47.5872,-122.241,2540,12092,604000,18,2,2015,0,58,12384,9552,0,0,0
5,1.75,1730,10368,1.0,0,0,5,7,1010,720,1963,0,98059,47.5008,-122.162,1730,7728,268000,3,4,2015,0,52,8638,5998,0,1,0
3,2.5,2100,7600,1.0,0,0,4,7,1450,650,1980,0,98052,47.6968,-122.127,2010,7600,509250,18,2,2015,0,35,5500,5590,0,1,0
3,2.5,1800,5372,2.0,0,0,3,8,1800,0,1987,0,98034,47.7188,-122.177,1650,6014,416000,18,11,2014,0,27,3572,4364,0,0,0
3,1.0,1090,8520,1.0,0,0,3,7,1090,0,1967,0,98003,47.3364,-122.307,1190,8520,190000,15,5,2014,0,47,7430,7330,0,0,0
3,2.5,2040,9765,2.0,0,0,3,8,2040,0,1985,0,98023,47.309,-122.349,2350,10150,325900,29,10,2014,0,29,7725,7800,0,0,0
3,3.5,2270,4088,2.0,0,0,3,8,1880,390,1996,0,98136,47.5356,-122.384,1760,5425,560000,1,8,2014,0,18,1818,3665,0,1,1
3,2.5,1730,5799,2.0,0,0,4,7,1730,0,1987,0,98030,47.3499,-122.177,1710,6490,275000,24,9,2014,0,27,4069,4780,0,0,0
4,2.5,2480,15411,2.0,0,2,3,8,2480,0,1994,0,98059,47.5379,-122.16,2940,14679,665000,9,3,2015,0,21,12931,11739,0,0,0
4,3.5,3480,7232,2.0,0,0,3,9,2580,900,1926,2010,98144,47.5859,-122.291,2380,5642,1510000,1,6,2014,84,88,3752,3262,1,1,1
4,2.0,1720,2410,1.0,0,0,3,7,970,750,1930,2006,98106,47.5252,-122.361,1160,1404,375000,3,12,2014,76,84,690,244,1,1,1
3,1.75,1570,6975,1.0,0,0,3,7,1040,530,1979,0,98126,47.5137,-122.37,1280,7813,359950,9,9,2014,0,35,5405,6533,0,1,1
4,2.75,3527,7200,2.0,0,0,3,7,3527,0,2005,0,98198,47.3823,-122.3,2490,7200,340000,23,1,2015,0,10,3673,4710,0,0,1
2,1.0,840,8100,1.0,0,0,4,7,840,0,1948,0,98177,47.7019,-122.366,1100,8220,401000,31,10,2014,0,66,7260,7120,0,0,1
2,1.75,1950,10766,1.0,0,3,4,6,1160,790,1952,0,98166,47.4504,-122.377,1780,11721,669000,26,6,2014,0,62,8816,9941,0,1,1
4,2.5,1980,6568,2.0,0,0,3,8,1980,0,2004,0,98052,47.704,-122.101,2310,6496,638500,29,4,2015,0,11,4588,4186,0,0,0
2,1.5,1620,3760,2.0,0,0,5,7,1170,450,1924,0,98144,47.6012,-122.291,2130,4000,545000,23,3,2015,0,91,2140,1870,0,1,1
4,1.0,1980,7015,1.0,0,0,3,7,1260,720,1973,0,98034,47.7204,-122.18,1570,7626,524000,26,12,2014,0,41,5035,6056,0,1,0
5,3.75,3530,13260,2.0,0,0,3,10,3530,0,2013,0,98040,47.5761,-122.205,3340,13260,1610000,8,11,2014,0,1,9730,9920,0,0,0
2,1.0,1260,4800,1.0,0,0,3,6,1100,160,1947,0,98126,47.5196,-122.376,1260,2435,280000,9,9,2014,0,67,3540,1175,0,1,1
4,2.5,2120,10841,1.0,0,0,4,8,1500,620,1979,0,98006,47.556,-122.156,3130,10950,828000,25,8,2014,0,35,8721,7820,0,1,0
3,1.75,1360,10573,1.0,0,0,4,7,1360,0,1984,0,98023,47.2983,-122.374,1580,8280,223000,17,10,2014,0,30,9213,6700,0,0,0
4,3.5,3100,2261,2.0,0,2,3,9,2250,850,1981,0,98033,47.6512,-122.202,2660,2000,1290000,2,1,2015,0,34,-839,-660,0,1,0
2,1.0,1460,9207,1.0,0,0,3,7,1210,250,1947,0,98125,47.7195,-122.287,1500,6898,430000,17,4,2015,0,68,7747,5398,0,1,1
4,1.75,1980,10800,1.0,0,0,5,6,990,990,1948,0,98040,47.5768,-122.222,2180,10800,711000,18,6,2014,0,66,8820,8620,0,1,0
4,2.5,1930,7014,2.0,0,0,3,8,1930,0,1994,0,98042,47.3921,-122.163,1990,7920,310000,4,12,2014,0,20,5084,5930,0,0,0
5,1.75,3700,9140,1.0,0,0,3,8,1850,1850,1957,0,98178,47.5086,-122.258,2190,6720,415000,26,12,2014,0,57,5440,4530,0,1,1
4,2.5,1970,6600,2.0,0,0,3,7,1970,0,1987,0,98030,47.3491,-122.168,1970,7682,274900,1,7,2014,0,27,4630,5712,0,0,0
3,1.0,1280,2580,1.5,0,0,3,8,1280,0,1910,2014,98115,47.6727,-122.32,1410,3150,478000,23,5,2014,104,104,1300,1740,1,0,1
3,1.75,1380,7350,1.0,0,0,3,7,990,390,1981,0,98042,47.369,-122.093,1660,8400,195000,21,5,2014,0,33,5970,6740,0,1,0
4,3.0,2740,10925,1.0,0,0,3,8,1670,1070,1980,0,98058,47.4538,-122.125,2330,9940,385000,5,3,2015,0,35,8185,7610,0,1,0
3,2.75,2020,9505,1.0,0,0,3,7,1260,760,1969,0,98011,47.7399,-122.197,2080,11901,401000,1,12,2014,0,45,7485,9821,0,1,0
4,2.5,2835,6598,2.0,0,0,3,8,2835,0,2002,0,98038,47.3878,-122.034,2770,6969,522000,26,9,2014,0,12,3763,4199,0,0,0
4,1.75,1520,14417,1.0,0,0,4,7,1520,0,1968,0,98065,47.526,-121.809,1600,10716,330000,24,2,2015,0,47,12897,9116,0,0,0
3,2.5,2190,4882,2.0,0,0,3,9,2190,0,1999,0,98155,47.7641,-122.306,2190,7055,503000,3,6,2014,0,15,2692,4865,0,0,1
5,1.75,1680,8400,1.0,0,0,4,7,1680,0,1979,0,98003,47.3035,-122.307,1800,8550,175000,12,2,2015,0,36,6720,6750,0,0,0
4,3.5,3915,6364,2.0,0,0,3,9,3915,0,2014,0,98053,47.6844,-122.016,3830,6507,963990,20,3,2015,0,1,2449,2677,0,0,0
5,2.0,1720,9972,1.0,0,0,4,8,1720,0,1951,0,98004,47.6368,-122.218,2700,9023,845000,29,9,2014,0,63,8252,6323,0,0,0
2,1.0,670,4500,1.0,0,0,3,5,670,0,1905,0,98108,47.5271,-122.326,1210,4500,157500,22,1,2015,0,110,3830,3290,0,0,1
2,3.0,1790,1709,2.0,0,0,3,7,1400,390,2001,0,98144,47.5926,-122.296,1460,1462,450000,5,12,2014,0,13,-81,2,0,1,1
4,1.75,2440,11793,1.0,0,4,3,8,1420,1020,1950,0,98115,47.6807,-122.267,2500,8028,925000,18,9,2014,0,64,9353,5528,0,1,1
2,1.0,920,5029,1.0,0,0,4,7,920,0,1938,0,98115,47.6726,-122.265,1230,5029,600000,5,1,2015,0,77,4109,3799,0,0,1
4,1.0,1680,4087,1.5,0,0,3,7,1680,0,1911,0,98103,47.6667,-122.337,1740,3745,709000,18,9,2014,0,103,2407,2005,0,0,1
5,3.75,3290,6480,2.0,0,0,5,10,2190,1100,1938,0,98199,47.653,-122.415,2010,7639,1390000,10,11,2014,0,76,3190,5629,0,1,1
3,2.5,2120,6840,1.0,0,0,3,7,1220,900,1984,0,98092,47.278,-122.145,1820,8200,248000,11,9,2014,0,30,4720,6380,0,1,0
3,1.0,910,6630,1.0,0,0,4,6,910,0,1912,0,98103,47.6947,-122.346,950,5100,245000,11,5,2015,0,103,5720,4150,0,0,1
2,1.0,1000,4776,1.0,0,0,4,6,1000,0,1942,0,98108,47.5619,-122.315,1500,4800,332000,30,5,2014,0,72,3776,3300,0,0,1
3,2.5,2340,4273,2.0,0,0,3,7,2340,0,2002,0,98065,47.5362,-121.878,2400,4624,459950,13,3,2015,0,13,1933,2224,0,0,0
3,2.0,1180,1800,2.0,0,2,3,8,1180,0,1994,0,98122,47.6168,-122.301,1500,1948,425000,10,4,2015,0,21,620,448,0,0,1
6,2.5,3760,12978,1.0,0,0,3,9,2360,1400,1967,0,98117,47.6976,-122.381,2300,7362,838300,4,9,2014,0,47,9218,5062,0,1,1
3,2.5,1480,7200,2.0,0,0,5,7,1480,0,1995,0,98010,47.3126,-122.023,1350,7200,256000,11,11,2014,0,19,5720,5850,0,0,0
3,2.75,3060,13554,2.0,0,0,3,10,3060,0,1984,0,98006,47.5609,-122.106,3060,11455,864000,20,1,2015,0,31,10494,8395,0,0,0
4,3.5,3070,4440,2.0,0,0,3,9,2030,1040,1922,2007,98116,47.5732,-122.411,1780,4800,900000,5,3,2015,85,93,1370,3020,1,1,1
3,1.0,1170,7560,1.0,0,0,3,6,1170,0,1958,0,98058,47.4514,-122.178,1170,7560,145600,1,4,2015,0,57,6390,6390,0,0,0
5,3.0,2900,6730,1.0,0,0,5,8,1830,1070,1977,0,98115,47.6784,-122.285,2370,6283,865000,21,8,2014,0,37,3830,3913,0,1,1
3,2.25,2210,8000,2.0,0,0,4,8,2210,0,1969,0,98023,47.3085,-122.381,1990,8000,250250,9,6,2014,0,45,5790,6010,0,0,0
4,2.0,1440,7641,1.0,0,0,4,5,1440,0,1943,0,98056,47.508,-122.183,1440,7750,162000,19,9,2014,0,71,6201,6310,0,0,0
4,1.75,1980,7350,1.0,0,0,3,7,1430,550,1973,0,98034,47.7088,-122.202,1870,7920,450000,31,7,2014,0,41,5370,6050,0,1,0
3,2.25,2420,5304,1.5,0,0,5,7,1640,780,1947,0,98115,47.6765,-122.285,1560,5304,697000,3,11,2014,0,67,2884,3744,0,1,1
3,3.25,3440,4080,2.0,0,0,3,9,2560,880,2005,0,98105,47.6644,-122.28,3110,4080,1320000,11,11,2014,0,9,640,970,0,1,1
3,1.75,1600,16510,1.0,0,0,3,8,1600,0,1984,0,98052,47.6601,-122.135,1510,10407,490000,1,12,2014,0,30,14910,8897,0,0,0
3,2.25,2210,5742,1.0,0,0,3,8,1460,750,1951,0,98115,47.6891,-122.318,1900,4590,590000,21,10,2014,0,63,3532,2690,0,1,1
2,1.0,1680,6500,1.0,0,0,4,7,1140,540,1941,0,98136,47.55,-122.388,1610,6500,515000,23,5,2014,0,73,4820,4890,0,1,1
3,1.0,1140,5395,1.0,0,0,4,7,1010,130,1909,0,98115,47.6782,-122.306,1700,5376,576000,14,7,2014,0,105,4255,3676,0,1,1
3,1.75,1430,10574,2.0,0,0,3,7,1430,0,1981,0,98011,47.7668,-122.218,1900,10450,375000,20,11,2014,0,33,9144,8550,0,0,0
3,1.0,1440,7107,1.0,0,0,4,7,1000,440,1980,0,98052,47.6968,-122.124,1540,7140,478000,20,3,2015,0,35,5667,5600,0,1,0
3,1.0,1670,5200,1.0,0,0,5,7,1030,640,1977,0,98042,47.3659,-122.092,1620,6696,282000,28,1,2015,0,38,3530,5076,0,1,0
4,4.5,3080,10550,2.0,0,3,3,8,1940,1140,1976,2007,98040,47.5806,-122.244,2780,10550,1400000,31,10,2014,31,38,7470,7770,1,1,0
3,1.75,1560,7500,1.0,0,0,4,8,1560,0,1966,0,98056,47.489,-122.18,1600,7904,306000,29,8,2014,0,48,5940,6304,0,0,0
4,1.75,1920,7665,1.0,0,0,4,8,1500,420,1975,0,98058,47.4476,-122.128,2100,7344,341000,9,6,2014,0,39,5745,5244,0,1,0
3,2.5,1400,4400,1.0,0,0,3,7,1400,0,1930,2014,98106,47.553,-122.365,1060,4400,399950,3,11,2014,84,84,3000,3340,1,0,1
5,2.0,2280,3600,2.0,0,0,3,7,2280,0,1992,0,98122,47.6056,-122.305,1740,1800,534000,20,11,2014,0,22,1320,60,0,0,1
6,2.5,3880,5700,2.0,0,0,3,7,3880,0,2003,0,98053,47.6816,-122.038,2620,5070,635000,21,7,2014,0,11,1820,2450,0,0,0
2,1.0,1350,3880,1.0,0,0,3,6,950,400,1927,0,98103,47.6842,-122.344,1670,3920,350000,24,3,2015,0,88,2530,2250,0,1,1
3,1.5,1480,2700,1.5,0,0,3,7,1480,0,1928,0,98112,47.623,-122.304,1970,4200,856000,17,2,2015,0,87,1220,2230,0,0,1
4,3.0,1670,1189,3.0,0,0,3,8,1427,243,2000,0,98122,47.6182,-122.302,1700,1401,582000,23,9,2014,0,14,-481,-299,0,1,1
4,2.5,3400,6742,2.0,0,0,3,9,3400,0,2004,0,98052,47.7067,-122.129,2970,6909,799000,29,7,2014,0,10,3342,3939,0,0,0
3,2.5,2070,3986,2.0,0,0,3,8,2070,0,1999,0,98065,47.5348,-121.877,2090,3986,423700,8,9,2014,0,15,1916,1896,0,0,0
2,1.0,1130,5413,1.0,0,0,3,7,880,250,1939,0,98115,47.6971,-122.315,1250,5413,443000,1,12,2014,0,75,4283,4163,0,1,1
3,1.75,1510,7700,1.0,0,0,3,7,1510,0,1968,0,98034,47.7283,-122.194,1440,7416,441500,24,4,2015,0,47,6190,5976,0,0,0
3,3.25,5020,12431,2.0,1,4,3,10,3420,1600,1941,2002,98144,47.5925,-122.287,3680,12620,3600000,18,11,2014,61,73,7411,8940,1,1,1
2,1.0,740,5100,1.0,0,0,4,7,740,0,1947,0,98115,47.6787,-122.301,920,5100,450000,27,4,2015,0,68,4360,4180,0,0,1
3,2.25,1630,10500,1.0,0,0,3,7,1100,530,1974,0,98034,47.7176,-122.236,1640,9794,425000,8,9,2014,0,40,8870,8154,0,1,0
4,1.75,2780,9900,2.0,0,0,4,10,2780,0,1978,0,98074,47.6348,-122.06,2600,12000,660000,1,6,2014,0,36,7120,9400,0,0,0
3,1.75,1990,5560,1.0,0,0,4,7,1100,890,1939,0,98105,47.664,-122.287,1460,3706,763101,16,6,2014,0,75,3570,2246,0,1,1
4,2.75,2250,14149,2.0,0,0,3,9,2250,0,1992,0,98019,47.7353,-121.962,2450,14027,499000,7,4,2015,0,23,11899,11577,0,0,0
4,2.25,2360,6260,2.0,0,0,3,7,2360,0,1998,0,98038,47.3882,-122.053,2144,6773,293000,8,4,2015,0,17,3900,4629,0,0,0
3,2.25,1530,4580,2.0,0,0,3,7,1530,0,2011,0,98019,47.7342,-121.968,2110,4094,335000,12,7,2014,0,3,3050,1984,0,0,0
2,1.0,1450,3090,2.0,0,0,3,7,1450,0,1919,1987,98103,47.6853,-122.356,1450,4635,499000,15,12,2014,68,95,1640,3185,1,0,1
3,1.75,2040,5000,1.5,0,0,3,7,1780,260,1924,0,98115,47.6756,-122.299,1690,5000,600000,5,5,2015,0,91,2960,3310,0,1,1
4,1.75,2620,11041,1.5,0,0,4,9,2620,0,1962,0,98005,47.5975,-122.174,2230,11041,720000,16,9,2014,0,52,8421,8811,0,0,0
2,2.0,1180,2553,2.0,0,0,3,6,1180,0,2005,0,98038,47.3501,-122.02,1310,2687,195000,25,2,2015,0,10,1373,1377,0,0,0
3,1.0,1110,8423,1.0,0,0,3,7,1110,0,1952,0,98166,47.4718,-122.342,1140,9083,249000,7,5,2014,0,62,7313,7943,0,0,1
3,2.25,1840,9781,2.0,0,0,3,7,1840,0,1989,0,98019,47.7347,-121.976,1490,10101,334000,2,2,2015,0,26,7941,8611,0,0,0
4,1.75,2720,7810,1.0,0,0,3,8,1510,1210,1952,0,98115,47.6788,-122.283,2120,7315,599950,7,11,2014,0,62,5090,5195,0,1,1
2,1.75,1090,1950,1.0,0,0,4,8,1090,0,1982,0,98198,47.3782,-122.319,1360,3426,149900,17,2,2015,0,33,860,2066,0,0,1
4,1.75,1730,6500,1.0,0,0,3,7,1250,480,1945,0,98115,47.6982,-122.282,1910,8100,700000,25,11,2014,0,69,4770,6190,0,1,1
4,1.5,1170,6240,1.0,0,0,4,6,1170,0,1960,0,98040,47.5495,-122.232,2380,8846,525000,7,8,2014,0,54,5070,6466,0,0,0
3,2.5,1960,8000,1.0,0,0,4,7,1290,670,1977,0,98034,47.7249,-122.178,1960,8000,402000,8,5,2014,0,37,6040,6040,0,1,0
3,2.0,1430,3480,1.0,0,0,3,7,980,450,1947,0,98103,47.6874,-122.336,1450,4650,450000,20,6,2014,0,67,2050,3200,0,1,1
3,1.75,1420,6980,1.0,0,0,5,7,820,600,1980,0,98023,47.2873,-122.367,1470,7319,205000,4,12,2014,0,34,5560,5849,0,1,0
3,1.0,1220,9600,1.0,0,0,5,7,1220,0,1958,0,98001,47.2622,-122.282,1310,9600,210500,4,3,2015,0,57,8380,8290,0,0,0
2,1.0,1070,6100,1.0,0,0,3,6,1070,0,1940,0,98126,47.5698,-122.377,1770,5695,406650,12,8,2014,0,74,5030,3925,0,0,1
4,1.75,1820,6000,1.0,0,0,3,7,930,890,1942,0,98115,47.6872,-122.296,1590,6000,425000,23,4,2015,0,73,4180,4410,0,1,1
3,3.5,3590,6402,2.0,0,0,3,10,3590,0,1999,0,98074,47.6336,-122.063,3230,7305,798000,5,6,2014,0,15,2812,4075,0,0,0
3,1.0,1960,9583,2.0,0,0,2,5,1960,0,1908,0,98056,47.505,-122.171,1850,8324,180000,1,12,2014,0,106,7623,6474,0,0,0
5,3.25,3160,13238,2.0,0,0,5,8,3160,0,1972,0,98040,47.5373,-122.224,2360,12042,1250000,2,6,2014,0,42,10078,9682,0,0,0
4,2.0,2030,4033,2.0,0,0,4,7,1630,400,1925,0,98133,47.7056,-122.342,1350,1340,435000,3,3,2015,0,90,2003,-10,0,1,1
3,1.5,1240,15867,1.0,0,0,3,7,1240,0,1962,0,98034,47.7167,-122.202,1570,9600,355000,26,11,2014,0,52,14627,8030,0,0,0
5,3.25,5370,14091,2.0,0,0,3,10,3850,1520,1918,2008,98004,47.6499,-122.216,2410,12047,3000000,2,2,2015,90,97,8721,9637,1,1,0
5,2.5,2670,14455,2.0,0,0,5,9,2670,0,1958,0,98155,47.7565,-122.284,1810,14455,685000,24,7,2014,0,56,11785,12645,0,0,1
3,1.0,1640,12060,1.0,0,0,4,7,1640,0,1960,0,98059,47.4941,-122.151,1680,9147,311000,25,7,2014,0,54,10420,7467,0,0,0
4,2.25,2130,9600,1.0,0,0,4,7,2130,0,1966,0,98031,47.4119,-122.211,1710,9600,305000,11,9,2014,0,48,7470,7890,0,0,0
3,2.5,2550,4954,1.5,0,0,4,7,1850,700,1924,0,98144,47.5758,-122.287,1700,4954,675000,25,7,2014,0,90,2404,3254,0,1,1
4,2.75,3630,15405,1.0,0,2,4,8,1850,1780,1968,0,98040,47.566,-122.225,3380,11184,769000,29,8,2014,0,46,11775,7804,0,1,0
3,1.5,1690,9708,1.5,0,0,5,7,1690,0,1954,0,98006,47.5732,-122.136,1570,9858,430000,5,8,2014,0,60,8018,8288,0,0,0
6,2.0,2390,8660,1.5,0,0,4,7,2390,0,1925,0,98011,47.7589,-122.216,2250,12942,516250,23,9,2014,0,89,6270,10692,0,0,0
3,3.5,2350,10739,1.0,0,2,5,7,1340,1010,1940,0,98125,47.7288,-122.284,2580,11026,760000,12,12,2014,0,74,8389,8446,0,1,1
3,3.5,1420,1217,2.0,0,0,3,8,1180,240,2003,0,98115,47.6827,-122.324,1494,1264,579950,7,10,2014,0,11,-203,-230,0,1,1
3,2.25,1570,7187,1.0,0,0,4,8,1170,400,1980,0,98133,47.7604,-122.356,1660,8775,476000,11,2,2015,0,35,5617,7115,0,1,1
2,1.0,720,5040,1.0,0,0,3,6,720,0,1955,0,98106,47.5267,-122.36,1357,5120,205000,8,5,2014,0,59,4320,3763,0,0,1
3,1.0,1470,7350,1.0,0,0,3,7,1470,0,1969,0,98032,47.3616,-122.286,1720,8050,240000,7,10,2014,0,45,5880,6330,0,0,0
3,1.75,1720,8102,1.0,0,0,5,6,860,860,1940,0,98125,47.7336,-122.29,1440,8106,420000,28,7,2014,0,74,6382,6666,0,1,1
3,1.75,1300,9600,1.0,0,0,4,7,1300,0,1969,0,98052,47.6388,-122.103,2070,9775,455000,14,11,2014,0,45,8300,7705,0,0,0
4,1.0,2520,5500,1.5,0,0,5,8,1820,700,1912,0,98144,47.5785,-122.292,2350,5000,765000,15,9,2014,0,102,2980,2650,0,1,1
4,1.5,1780,7914,1.5,0,0,4,7,1780,0,1962,0,98059,47.5142,-122.163,1350,8069,372000,5,12,2014,0,52,6134,6719,0,0,0
3,1.0,1200,8360,1.0,0,0,2,6,1200,0,1948,0,98118,47.5414,-122.281,1570,6823,160000,4,12,2014,0,66,7160,5253,0,0,1
4,2.5,2990,9643,2.0,0,0,3,9,2990,0,2003,0,98074,47.6292,-122.024,2990,8666,772000,15,8,2014,0,11,6653,5676,0,0,0
5,1.75,1910,5640,2.0,0,0,4,9,1910,0,1906,0,98112,47.6249,-122.311,2050,5400,1130000,11,11,2014,0,108,3730,3350,0,0,1
3,1.0,1370,3000,1.5,0,0,3,7,1370,0,1924,0,98103,47.6619,-122.351,1510,2151,479000,24,5,2014,0,90,1630,641,0,0,1
3,2.5,1910,4941,2.0,0,0,3,8,1910,0,1999,0,98075,47.5989,-122.016,1910,4941,570000,5,5,2015,0,16,3031,3031,0,0,0
4,1.0,1170,8147,1.5,0,0,3,6,1170,0,1959,0,98125,47.7281,-122.289,1260,8147,350000,10,7,2014,0,55,6977,6887,0,0,1
3,2.5,1250,864,3.0,0,0,3,8,1250,0,2004,0,98115,47.6978,-122.318,1330,2298,353000,1,11,2014,0,10,-386,968,0,0,1
3,2.0,1380,8536,2.0,0,0,4,7,1380,0,1955,0,98148,47.4374,-122.335,1260,8750,265000,30,7,2014,0,59,7156,7490,0,0,1
1,1.0,780,10235,1.5,0,0,3,6,780,0,1989,0,98014,47.713,-121.315,930,10165,167000,30,4,2015,0,26,9455,9235,0,0,0
4,2.25,2080,8000,1.0,0,0,3,8,1390,690,1964,0,98008,47.6264,-122.113,1800,7700,500000,20,10,2014,0,50,5920,5900,0,1,0
3,1.0,1410,7200,2.0,0,0,4,6,1410,0,1901,0,98144,47.5924,-122.302,1640,7200,700000,9,7,2014,0,113,5790,5560,0,0,1
1,1.0,520,5600,1.0,0,0,3,6,520,0,1918,0,98116,47.5579,-122.395,1030,5265,295000,4,11,2014,0,96,5080,4235,0,0,1
4,3.5,3500,4080,2.0,0,2,3,9,2590,910,2004,0,98115,47.6834,-122.292,2430,5100,1010000,11,3,2015,0,11,580,2670,0,1,1
2,1.0,840,5265,1.0,0,0,5,6,840,0,1969,0,98042,47.3644,-122.082,920,5100,209000,8,5,2015,0,46,4425,4180,0,0,0
3,1.75,2240,9200,1.0,0,0,4,7,1440,800,1968,0,98001,47.2635,-122.284,1740,9600,276000,28,1,2015,0,47,6960,7860,0,1,0
4,2.5,2100,5857,2.0,0,0,3,8,2100,0,2002,0,98059,47.4956,-122.163,2090,7779,380000,22,1,2015,0,13,3757,5689,0,0,0
3,1.5,1750,12500,1.0,0,0,3,7,1150,600,1954,0,98024,47.5666,-121.902,1680,13000,315000,6,6,2014,0,60,10750,11320,0,1,0
3,2.0,1440,5600,1.0,0,0,4,6,720,720,1942,2007,98056,47.4947,-122.185,1120,5700,230000,3,6,2014,65,72,4160,4580,1,1,0
3,3.0,1430,1249,3.0,0,0,3,8,1430,0,2003,0,98103,47.6971,-122.34,1020,1112,335000,17,7,2014,0,11,-181,92,0,0,1
4,2.5,2170,9600,1.0,0,0,3,7,1460,710,1980,0,98052,47.6789,-122.116,1940,8400,550000,3,6,2014,0,34,7430,6460,0,1,0
3,1.0,1150,8050,1.5,0,0,4,7,1150,0,1956,0,98032,47.374,-122.296,1360,8050,123300,26,12,2014,0,58,6900,6690,0,0,0
4,2.75,2170,9658,1.5,0,0,3,7,2170,0,1966,0,98030,47.3741,-122.189,1490,9731,275436,2,9,2014,0,48,7488,8241,0,0,0
4,3.5,2630,3435,1.5,0,3,3,7,1640,990,1984,0,98188,47.4355,-122.272,1920,2435,325000,25,5,2014,0,30,805,515,0,1,1
3,1.75,1710,5000,1.0,0,0,4,7,1110,600,1944,0,98107,47.6689,-122.37,920,5000,513000,23,4,2015,0,71,3290,4080,0,1,1
3,1.0,940,9272,1.0,0,0,3,7,940,0,1954,0,98148,47.4353,-122.335,1270,9375,225000,29,4,2015,0,61,8332,8105,0,0,1
3,1.0,1400,9460,1.0,0,0,3,7,1060,340,1961,0,98168,47.5119,-122.321,1570,7700,265000,22,9,2014,0,53,8060,6130,0,1,1
4,1.75,1630,3000,1.0,0,0,3,7,930,700,1978,0,98144,47.5961,-122.305,1630,3000,313000,14,10,2014,0,36,1370,1370,0,1,1
2,1.0,1370,8400,1.0,0,0,3,7,1370,0,1948,0,98133,47.7344,-122.336,1330,8396,296000,14,4,2015,0,67,7030,7066,0,0,1
4,2.75,2380,15800,1.0,0,0,3,8,1680,700,1957,2001,98007,47.5929,-122.133,1950,11751,655500,20,10,2014,44,57,13420,9801,1,1,0
5,1.75,2140,12058,1.0,0,0,4,8,2140,0,1951,0,98002,47.3167,-122.214,1640,10125,250750,10,12,2014,0,63,9918,8485,0,0,0
4,2.5,1970,8545,2.0,0,0,3,8,1970,0,2004,0,98059,47.4893,-122.138,2590,7200,438000,4,9,2014,0,10,6575,4610,0,0,0
3,1.0,1080,5250,1.0,0,0,4,7,1080,0,1947,0,98133,47.7309,-122.336,1100,5250,329500,6,10,2014,0,67,4170,4150,0,0,1
3,2.25,3070,9645,2.0,0,0,3,10,2110,960,1987,0,98006,47.5522,-122.144,3130,9450,1200000,16,3,2015,0,28,6575,6320,0,1,0
2,1.0,1470,6000,1.0,0,0,3,6,900,570,1944,0,98199,47.6527,-122.386,1670,6000,415000,20,3,2015,0,71,4530,4330,0,1,1
3,1.0,1320,3625,2.0,0,0,3,7,1320,0,1900,0,98122,47.6049,-122.288,1660,5438,464000,19,6,2014,0,114,2305,3778,0,0,1
3,1.0,1210,7649,1.0,0,0,4,7,1210,0,1956,0,98155,47.7693,-122.32,1210,6760,310000,8,12,2014,0,58,6439,5550,0,0,1
3,1.5,1860,7190,2.0,0,1,5,7,1860,0,1952,0,98177,47.7716,-122.392,1670,5525,580000,18,9,2014,0,62,5330,3855,0,0,1
2,1.0,810,6480,1.0,0,0,5,6,810,0,1942,0,98199,47.6493,-122.398,1920,6000,510000,17,3,2015,0,73,5670,4080,0,0,1
3,1.5,1630,7475,1.0,0,1,3,7,1160,470,1940,0,98115,47.6725,-122.272,2320,7475,650000,6,5,2014,0,74,5845,5155,0,1,1
4,1.75,1660,11664,1.0,0,0,3,6,1010,650,1952,0,98168,47.4943,-122.331,1670,9975,220000,22,8,2014,0,62,10004,8305,0,1,1
3,2.25,3440,10628,2.0,0,2,3,10,3440,0,1985,0,98006,47.5647,-122.108,3170,11434,855000,8,10,2014,0,29,7188,8264,0,0,0
3,1.75,2110,10454,1.0,0,0,4,8,1440,670,1978,0,98028,47.7344,-122.246,1990,10890,483000,29,8,2014,0,36,8344,8900,0,1,0
3,1.0,1060,12000,1.0,0,0,3,7,1060,0,1952,0,98133,47.7703,-122.35,1550,10500,400000,7,4,2015,0,63,10940,8950,0,0,1
3,2.5,1900,7984,2.0,0,0,3,8,1900,0,1993,0,98011,47.7433,-122.194,2650,9352,435000,2,7,2014,0,21,6084,6702,0,0,0
1,1.0,820,1060,1.0,0,0,3,8,760,60,2007,0,98126,47.5473,-122.371,1770,1924,219500,30,9,2014,0,7,240,154,0,1,1
3,2.5,2050,3218,3.0,0,0,3,7,2050,0,2008,0,98133,47.7612,-122.344,2050,7200,427000,16,9,2014,0,6,1168,5150,0,0,1
2,1.5,1090,4013,1.5,0,0,3,7,1090,0,1900,0,98103,47.6652,-122.338,1390,4013,430000,1,12,2014,0,114,2923,2623,0,0,1
2,1.5,1090,4013,1.5,0,0,3,7,1090,0,1900,0,98103,47.6652,-122.338,1390,4013,685000,12,5,2015,0,115,2923,2623,0,0,1
2,1.5,1920,6250,1.0,0,0,3,7,1060,860,1937,0,98199,47.6497,-122.393,2070,6250,495000,3,9,2014,0,77,4330,4180,0,1,1
3,2.5,1870,7942,2.0,0,0,3,7,1870,0,1990,0,98001,47.342,-122.279,1870,7392,299950,25,6,2014,0,24,6072,5522,0,0,0
3,1.75,2160,5863,1.5,0,0,4,7,1260,900,1928,0,98144,47.5729,-122.315,1590,3000,385000,12,8,2014,0,86,3703,1410,0,1,1
4,2.5,3000,10392,2.0,0,0,3,9,3000,0,1995,0,98027,47.535,-122.049,3140,9213,740000,25,6,2014,0,19,7392,6073,0,0,0
4,3.0,2290,2350,2.0,0,1,3,9,1610,680,1924,2011,98116,47.574,-122.415,1610,3820,991700,23,7,2014,87,90,60,2210,1,1,1
3,2.75,2250,9600,2.5,0,0,4,9,1830,420,1909,1991,98122,47.6033,-122.287,2060,4980,765000,13,8,2014,82,105,7350,2920,1,1,1
4,2.25,2130,8734,2.0,0,2,4,8,2130,0,1961,0,98006,47.5672,-122.161,2550,8800,802000,4,9,2014,0,53,6604,6250,0,0,0
4,2.5,1920,9000,2.0,0,0,2,7,1920,0,1989,0,98126,47.5153,-122.37,1530,10474,425000,10,4,2015,0,26,7080,8944,0,0,1
5,1.75,2440,15143,1.5,0,4,4,8,1740,700,1944,0,98146,47.4948,-122.37,2390,10907,765000,22,7,2014,0,70,12703,8517,0,1,1
3,2.25,1440,3488,2.0,0,0,4,7,1440,0,1983,0,98034,47.7257,-122.162,1390,3488,313500,7,8,2014,0,31,2048,2098,0,0,0
3,1.0,1780,6840,2.0,0,0,4,6,1780,0,1947,0,98125,47.727,-122.3,1410,7200,320000,20,8,2014,0,67,5060,5790,0,0,1
4,1.75,1490,4485,1.0,0,0,3,8,1350,140,1960,0,98199,47.6388,-122.399,1380,4846,604000,10,2,2015,0,55,2995,3466,0,1,1
3,2.0,1400,1657,2.0,0,0,3,8,1060,340,2004,0,98112,47.6196,-122.298,1540,2275,570000,12,2,2015,0,11,257,735,0,1,1
4,2.5,2150,12028,2.0,0,0,4,8,2150,0,1982,0,98052,47.7224,-122.101,1800,11777,639000,20,5,2014,0,32,9878,9977,0,0,0
4,1.75,2660,3520,2.0,0,0,4,8,2080,580,1917,0,98115,47.6743,-122.308,2100,4080,896000,14,10,2014,0,97,860,1980,0,1,1
3,1.75,1650,12349,1.0,0,0,3,7,1650,0,1957,0,98188,47.442,-122.282,1470,10763,259500,27,6,2014,0,57,10699,9293,0,0,1
3,2.0,1980,6000,1.0,0,0,4,7,1380,600,1958,0,98115,47.6921,-122.283,1260,6000,637000,7,8,2014,0,56,4020,4740,0,1,1
4,2.75,2690,8874,1.0,0,0,3,8,1370,1320,1980,0,98023,47.3078,-122.383,1990,7875,307450,6,5,2015,0,35,6184,5885,0,1,0
3,1.75,1380,3561,1.0,0,0,4,7,860,520,1925,0,98117,47.6822,-122.399,1820,4593,535000,25,8,2014,0,89,2181,2773,0,1,1
4,2.25,2500,4046,1.5,0,0,4,7,1520,980,1940,0,98117,47.6882,-122.382,1410,4046,669500,30,6,2014,0,74,1546,2636,0,1,1
3,1.75,1590,7148,1.0,0,0,3,7,1590,0,1952,0,98166,47.4713,-122.344,1150,7280,259000,28,10,2014,0,62,5558,6130,0,0,1
4,1.5,1100,3300,1.0,0,0,1,7,1100,0,1919,0,98122,47.6033,-122.295,2020,4000,441000,31,12,2014,0,95,2200,1980,0,0,1
4,2.5,1470,1612,2.0,0,0,3,7,980,490,2003,0,98118,47.5275,-122.271,1460,5027,228800,12,5,2015,0,12,142,3567,0,1,1
2,2.0,1680,4950,1.0,0,0,3,8,1680,0,2006,0,98053,47.7194,-122.022,1570,4800,530000,13,5,2014,0,8,3270,3230,0,0,0
2,2.0,1450,2272,1.0,0,0,4,6,750,700,1924,0,98112,47.633,-122.282,2170,4370,524000,28,7,2014,0,90,822,2200,0,1,1
4,2.25,2020,4840,1.5,0,0,5,8,1200,820,1925,0,98126,47.5576,-122.376,1410,4840,430000,11,12,2014,0,89,2820,3430,0,1,1
4,3.25,2470,4760,1.5,0,0,5,9,1890,580,1906,0,98112,47.6331,-122.31,2470,4760,1330000,1,10,2014,0,108,2290,2290,0,1,1
3,1.0,1230,12201,1.0,0,0,3,7,1230,0,1969,0,98042,47.3285,-122.134,1230,10780,210000,3,11,2014,0,45,10971,9550,0,0,0
4,2.5,1850,5040,1.0,0,0,3,7,1230,620,1930,2013,98126,47.5386,-122.373,1010,5040,449000,23,6,2014,83,84,3190,4030,1,1,1
2,2.5,2540,7089,2.0,0,0,3,9,2540,0,2004,0,98116,47.5747,-122.414,1330,7089,945000,19,6,2014,0,10,4549,5759,0,0,1
3,1.0,970,9130,1.0,0,0,3,6,970,0,1957,0,98188,47.4369,-122.272,1000,8886,200450,18,3,2015,0,58,8160,7886,0,0,1
3,1.5,1070,6601,1.0,0,0,3,6,1070,0,1985,0,98002,47.3115,-122.209,1030,6614,219950,17,4,2015,0,30,5531,5584,0,0,0
4,2.75,2110,8190,1.5,0,0,5,8,2110,0,1966,0,98008,47.6269,-122.1,2420,8400,746000,26,11,2014,0,48,6080,5980,0,0,0
3,1.75,2110,7129,1.0,0,0,3,8,1280,830,1982,0,98052,47.7219,-122.102,1810,8674,540000,31,3,2015,0,33,5019,6864,0,1,0
5,2.0,1910,5508,1.0,0,0,3,7,1020,890,1968,0,98133,47.7074,-122.349,1030,7440,485000,10,9,2014,0,46,3598,6410,0,1,1
2,1.0,670,7844,1.0,0,0,3,6,670,0,1942,0,98126,47.5165,-122.372,740,7218,202000,27,1,2015,0,73,7174,6478,0,0,1
3,2.75,2010,11200,1.0,0,0,3,8,1360,650,1979,0,98028,47.7728,-122.253,2200,10640,502000,1,4,2015,0,36,9190,8440,0,1,0
3,1.0,1340,4120,1.0,0,0,4,7,1040,300,1921,0,98103,47.6916,-122.352,1270,4635,409500,17,11,2014,0,93,2780,3365,0,1,1
3,2.0,1660,15050,1.0,0,0,3,7,1260,400,1983,0,98034,47.7203,-122.194,1660,7320,453000,2,7,2014,0,31,13390,5660,0,1,0
4,1.0,1820,5500,1.5,0,0,3,6,1820,0,1947,0,98106,47.5185,-122.363,1140,5500,367000,27,2,2015,0,68,3680,4360,0,0,1
3,2.5,2510,5400,2.0,0,0,3,9,2510,0,1992,0,98056,47.5204,-122.206,1840,5400,550000,23,5,2014,0,22,2890,3560,0,0,0
3,1.5,1560,8314,1.0,0,0,3,7,1560,0,1962,0,98031,47.4117,-122.209,1820,8925,273500,27,1,2015,0,53,6754,7105,0,0,0
4,3.0,2280,7400,1.0,0,0,3,7,1340,940,1978,0,98125,47.711,-122.306,1540,7500,505000,7,10,2014,0,36,5120,5960,0,1,1
4,2.25,2470,7447,2.0,0,0,3,8,2470,0,1984,0,98155,47.7514,-122.286,2270,7400,565000,9,5,2014,0,30,4977,5130,0,0,1
3,0.75,1270,10092,1.0,0,0,5,7,1270,0,1971,0,98077,47.7567,-122.073,1300,10375,316000,20,8,2014,0,43,8822,9075,0,0,0
4,1.0,1520,7298,1.5,0,0,3,7,1520,0,1960,0,98198,47.3706,-122.31,1520,7298,160000,25,9,2014,0,54,5778,5778,0,0,1
3,1.0,1310,9529,1.0,0,0,3,7,1310,0,1956,0,98198,47.4105,-122.295,1330,9529,170000,27,10,2014,0,58,8219,8199,0,0,1
3,1.0,1310,9529,1.0,0,0,3,7,1310,0,1956,0,98198,47.4105,-122.295,1330,9529,235000,19,3,2015,0,59,8219,8199,0,0,1
3,1.0,990,7050,1.0,0,0,3,7,990,0,1967,0,98034,47.7274,-122.202,1200,8125,310000,18,9,2014,0,47,6060,6925,0,0,0
4,1.75,2080,13629,1.0,0,0,4,7,1040,1040,1955,0,98178,47.4866,-122.232,1780,14659,285000,19,5,2014,0,59,11549,12879,0,1,1
2,1.0,960,4920,1.0,0,0,3,6,960,0,1942,0,98117,47.6946,-122.362,1010,5040,280000,4,6,2014,0,72,3960,4030,0,0,1
4,4.25,4070,13860,2.0,0,3,3,10,4070,0,2004,0,98040,47.59,-122.229,3430,9240,2300000,18,2,2015,0,11,9790,5810,0,0,0
4,2.5,2750,16139,2.0,0,0,3,9,2750,0,1989,0,98075,47.5843,-122.06,2810,13093,763776,14,8,2014,0,25,13389,10283,0,0,0
2,1.0,990,4920,1.0,0,0,3,6,990,0,1931,0,98117,47.6939,-122.368,990,4960,430000,25,7,2014,0,83,3930,3970,0,0,1
3,1.0,1290,3880,1.5,0,0,4,7,1290,0,1919,0,98117,47.6879,-122.392,1290,4850,456500,25,7,2014,0,95,2590,3560,0,0,1
4,2.5,2170,5257,2.0,0,0,3,7,2170,0,1989,0,98115,47.6999,-122.305,1430,7528,445000,11,9,2014,0,25,3087,6098,0,0,1
3,1.0,1330,10500,1.0,0,0,3,7,960,370,1963,0,98034,47.7204,-122.196,1460,11550,386900,10,3,2015,0,52,9170,10090,0,1,0
3,1.0,1340,13750,1.0,0,0,4,7,1340,0,1955,0,98006,47.5771,-122.151,1430,11400,479000,8,7,2014,0,59,12410,9970,0,0,0
3,2.5,2200,4544,2.0,0,0,3,8,2200,0,2000,0,98065,47.5319,-121.867,2400,5431,525000,13,3,2015,0,15,2344,3031,0,0,0
4,1.75,2520,10890,1.0,0,0,3,7,1260,1260,1979,0,98023,47.3224,-122.343,2090,12375,272000,6,1,2015,0,36,8370,10285,0,1,0
4,1.0,1180,13500,1.5,0,0,3,7,1180,0,1950,0,98125,47.7165,-122.308,1580,8976,517000,26,2,2015,0,65,12320,7396,0,0,1
3,1.75,2660,7800,1.0,0,0,4,8,1330,1330,1951,0,98117,47.6993,-122.378,1950,6240,615000,26,2,2015,0,64,5140,4290,0,1,1
3,1.75,1250,7030,1.0,0,0,3,7,1250,0,1965,0,98008,47.6285,-122.118,1460,7210,439000,28,8,2014,0,49,5780,5750,0,0,0
3,2.5,2270,7866,1.0,0,0,4,10,2270,0,1988,0,98029,47.5622,-122.022,2580,8132,716000,24,7,2014,0,26,5596,5552,0,0,0
2,1.0,1080,6250,1.0,0,2,4,7,1080,0,1942,1968,98118,47.5128,-122.251,2100,6875,308000,28,10,2014,26,72,5170,4775,1,0,1
3,2.25,1620,4500,2.0,0,0,4,8,1620,0,1926,0,98119,47.643,-122.361,1210,4320,800000,10,6,2014,0,88,2880,3110,0,0,1
3,2.0,940,5000,1.0,0,0,3,7,880,60,1941,0,98117,47.6771,-122.398,1420,5000,575000,5,5,2015,0,74,4060,3580,0,1,1
3,1.5,1620,9310,1.0,0,0,4,7,1620,0,1967,0,98042,47.3665,-122.107,1610,10640,219950,1,7,2014,0,47,7690,9030,0,0,0
4,2.5,2350,8001,2.0,0,0,4,8,2350,0,1987,0,98006,47.5478,-122.153,2460,8001,770000,22,5,2014,0,27,5651,5541,0,0,0
3,1.75,2090,7505,1.0,0,0,3,7,2090,0,1967,0,98034,47.7326,-122.194,1510,7416,424950,30,12,2014,0,47,5415,5906,0,0,0
4,1.75,2050,10920,1.0,0,3,3,8,1450,600,1974,0,98155,47.7431,-122.286,2440,10920,790000,20,6,2014,0,40,8870,8480,0,1,1
2,1.0,600,4000,1.0,0,0,3,5,600,0,1933,0,98146,47.5065,-122.339,1290,6973,156000,28,1,2015,0,82,3400,5683,0,0,1
2,1.0,2540,7000,1.0,0,0,5,8,1320,1220,1942,0,98118,47.5259,-122.261,2160,6000,580000,5,5,2014,0,72,4460,3840,0,1,1
5,3.25,2700,3650,2.0,0,2,3,9,2070,630,1926,2014,98144,47.5959,-122.291,1940,4000,950000,16,7,2014,88,88,950,2060,1,1,1
2,2.5,1410,1281,2.0,0,0,3,8,1090,320,2008,0,98126,47.5659,-122.37,1410,2550,400000,13,2,2015,0,7,-129,1140,0,1,1
2,2.5,1170,1638,2.0,0,0,3,8,1170,0,2008,0,98133,47.7041,-122.351,1350,1407,325000,13,5,2015,0,7,468,57,0,0,1
4,2.5,2540,6688,2.0,0,0,3,9,2540,0,2002,0,98092,47.3314,-122.18,2810,6776,365000,29,9,2014,0,12,4148,3966,0,0,0
3,1.75,2190,6000,1.5,0,0,4,7,2190,0,1920,0,98002,47.3063,-122.223,1610,6000,255000,7,4,2015,0,95,3810,4390,0,0,0
5,3.5,3890,13261,2.0,0,1,3,9,2870,1020,1984,0,98125,47.7246,-122.284,3080,13261,985000,23,3,2015,0,31,9371,10181,0,1,1
4,2.5,2030,10722,1.0,0,0,3,7,1100,930,1967,0,98115,47.6955,-122.301,1610,9134,595000,23,4,2015,0,48,8692,7524,0,1,1
3,1.0,1350,7085,1.0,0,0,5,7,1350,0,1944,0,98125,47.7318,-122.305,1350,7085,427500,16,7,2014,0,70,5735,5735,0,0,1
3,1.5,1940,4000,1.5,0,0,3,8,1310,630,1915,0,98112,47.6205,-122.291,1940,4000,728000,16,10,2014,0,99,2060,2060,0,1,1
2,1.0,1260,4000,1.0,0,0,3,7,1000,260,1940,0,98117,47.6898,-122.384,1780,4000,549950,10,9,2014,0,74,2740,2220,0,1,1
3,2.0,2800,10501,1.0,0,0,3,7,1400,1400,1954,0,98125,47.7055,-122.315,2260,6534,650000,8,12,2014,0,60,7701,4274,0,1,1
5,3.25,3080,13394,1.0,0,2,4,9,2230,850,1968,0,98033,47.6651,-122.19,2810,10720,1130000,20,3,2015,0,47,10314,7910,0,1,0
3,1.0,840,6500,1.0,0,0,5,6,840,0,1969,0,98042,47.3637,-122.083,920,4680,203000,4,5,2015,0,46,5660,3760,0,0,0
2,1.0,860,3300,1.0,0,0,5,6,860,0,1903,0,98118,47.5496,-122.279,1380,4400,311000,7,8,2014,0,111,2440,3020,0,0,1
6,2.0,2400,7684,1.0,0,0,3,6,1200,1200,1932,2005,98028,47.7705,-122.269,1290,9800,387500,28,4,2015,73,83,5284,8510,1,1,0
4,2.0,1640,7200,1.0,0,0,3,7,1640,0,1963,0,98155,47.7471,-122.324,1500,9000,370000,18,3,2015,0,52,5560,7500,0,0,1
2,1.0,1060,6100,1.0,0,0,3,6,1060,0,1951,0,98125,47.7317,-122.296,1550,9150,228000,24,7,2014,0,63,5040,7600,0,0,1
2,1.75,2080,4800,1.0,0,0,5,7,1080,1000,1923,0,98117,47.6896,-122.362,1310,4800,740000,28,5,2014,0,91,2720,3490,0,1,1
4,2.0,2090,6630,1.0,0,0,3,7,1070,1020,1974,0,98178,47.5077,-122.268,1550,7980,200000,10,7,2014,0,40,4540,6430,0,1,1
3,1.0,1240,3500,1.0,0,0,4,7,1240,0,1927,0,98103,47.6835,-122.347,1650,3360,660000,9,7,2014,0,87,2260,1710,0,0,1
4,2.0,2030,8426,2.0,0,0,3,7,2030,0,1944,0,98168,47.4806,-122.287,1190,7007,275000,9,7,2014,0,70,6396,5817,0,0,1
2,1.0,1120,5250,1.0,0,0,3,7,950,170,1938,0,98199,47.6496,-122.392,1510,5250,708000,29,4,2015,0,77,4130,3740,0,1,1
3,2.5,1270,9675,2.0,0,0,3,8,1270,0,1993,0,98045,47.4639,-121.744,1270,11700,280000,19,5,2014,0,21,8405,10430,0,0,0
4,2.5,2260,5702,2.0,0,0,3,8,2260,0,2002,0,98042,47.3488,-122.151,2450,6381,325000,6,1,2015,0,13,3442,3931,0,0,0
2,2.0,1780,3810,1.5,0,0,3,7,980,800,1922,0,98119,47.6474,-122.362,1690,3810,691000,22,9,2014,0,92,2030,2120,0,1,1
3,2.5,2060,7458,2.0,0,0,3,9,2060,0,1989,0,98023,47.3045,-122.351,2480,7743,348000,5,8,2014,0,25,5398,5263,0,0,0
2,1.0,1670,6212,1.0,0,0,4,7,1670,0,1947,0,98125,47.7152,-122.282,1670,7272,425000,14,11,2014,0,67,4542,5602,0,0,1
2,1.0,1210,4895,1.0,0,0,3,6,710,500,1951,0,98126,47.5202,-122.373,1100,6000,285000,20,12,2014,0,63,3685,4900,0,1,1
3,1.0,990,8840,1.0,0,0,3,6,990,0,1966,0,98023,47.3074,-122.371,1120,8625,222000,30,4,2015,0,49,7850,7505,0,0,0
4,2.5,1720,9600,1.0,0,0,3,7,1120,600,1961,0,98092,47.2917,-122.188,1520,9400,200000,27,5,2014,0,53,7880,7880,0,1,0
3,2.0,1530,8749,1.0,0,0,3,7,1530,0,1995,0,98023,47.2974,-122.372,1750,8749,247500,2,10,2014,0,19,7219,6999,0,0,0
3,1.75,1100,9452,1.0,0,0,3,6,1100,0,1942,0,98146,47.4864,-122.337,1350,9452,190000,20,11,2014,0,72,8352,8102,0,0,1
4,2.5,3020,4950,1.5,0,0,4,9,2020,1000,1921,0,98112,47.6467,-122.304,2300,5450,975000,15,12,2014,0,93,1930,3150,0,1,1
4,3.0,3180,4649,2.0,0,0,4,9,2070,1110,1925,0,98105,47.6583,-122.273,2720,5980,1130000,23,12,2014,0,89,1469,3260,0,1,1
4,1.75,1830,12540,1.0,0,0,4,8,1130,700,1958,0,98003,47.3348,-122.324,2020,12540,283200,4,5,2015,0,57,10710,10520,0,1,0
3,2.5,2540,8073,1.0,0,0,4,8,1880,660,1937,0,98177,47.7176,-122.36,2110,7702,650000,14,7,2014,0,77,5533,5592,0,1,1
3,2.0,1770,6610,1.0,0,0,4,7,960,810,1954,0,98133,47.7703,-122.343,2010,4361,449500,13,5,2014,0,60,4840,2351,0,1,1
3,1.75,1470,6682,1.0,0,0,3,7,1470,0,1987,0,98034,47.7315,-122.226,1790,7379,400000,22,10,2014,0,27,5212,5589,0,0,0
1,1.0,570,4080,1.0,0,0,3,5,570,0,1942,0,98146,47.5098,-122.334,890,5100,89950,19,2,2015,0,73,3510,4210,0,0,1
3,1.0,960,8291,1.0,0,0,3,6,960,0,1950,0,98146,47.5006,-122.334,1110,8231,158800,24,11,2014,0,64,7331,7121,0,0,1
4,3.0,2940,7108,2.0,0,1,3,9,2220,720,2011,0,98136,47.5437,-122.395,2240,7950,870000,17,9,2014,0,3,4168,5710,0,1,1
3,1.75,2450,8603,1.0,0,0,5,8,1340,1110,1940,0,98199,47.6536,-122.414,2280,5779,850000,31,7,2014,0,74,6153,3499,0,1,1
4,2.5,3310,5101,2.0,0,0,3,9,3310,0,2005,0,98052,47.6649,-122.08,3010,5176,775000,23,9,2014,0,9,1791,2166,0,0,0
3,2.5,1670,4308,2.0,0,0,3,8,1670,0,2001,0,98027,47.5307,-122.047,1670,2897,483500,1,8,2014,0,13,2638,1227,0,0,0
3,1.5,1240,5000,1.0,0,2,3,7,1240,0,1964,0,98106,47.5659,-122.36,1050,5000,336000,7,4,2015,0,51,3760,3950,0,0,1
2,1.0,670,6000,1.0,0,0,5,6,670,0,1949,0,98118,47.561,-122.275,1240,5040,415000,17,4,2015,0,66,5330,3800,0,0,1
3,1.5,1320,4400,1.0,0,0,3,6,1320,0,1909,0,98112,47.6231,-122.292,1350,4400,350000,11,8,2014,0,105,3080,3050,0,0,1
4,5.25,6110,10369,2.0,0,0,3,11,6110,0,2005,0,98059,47.5285,-122.135,4190,10762,1320000,17,11,2014,0,9,4259,6572,0,0,0
3,1.75,2440,5800,1.0,0,3,4,8,1320,1120,1945,0,98199,47.6474,-122.412,2530,5800,765000,6,8,2014,0,69,3360,3270,0,1,1
4,2.5,2900,6736,2.0,0,0,3,8,2900,0,2013,0,98059,47.4954,-122.152,2900,6736,527000,20,10,2014,0,1,3836,3836,0,0,0
4,2.75,2310,5000,1.5,0,0,5,8,1480,830,1908,0,98118,47.5502,-122.268,1100,5000,524000,18,7,2014,0,106,2690,3900,0,1,1
2,1.0,1110,5413,1.0,0,0,3,6,890,220,1937,0,98115,47.6925,-122.32,1300,5413,448000,15,7,2014,0,77,4303,4113,0,1,1
3,1.0,930,9900,1.5,0,0,4,5,930,0,1910,0,98032,47.3745,-122.231,930,7200,176500,16,1,2015,0,105,8970,6270,0,0,0
4,2.25,2420,11120,1.0,0,2,4,8,1620,800,1952,0,98146,47.4954,-122.366,2210,8497,750000,16,4,2015,0,63,8700,6287,0,1,1
4,2.25,2870,6000,1.0,0,0,5,8,1730,1140,1951,0,98112,47.6362,-122.282,2370,5500,1270000,2,12,2014,0,63,3130,3130,0,1,1
3,1.0,1480,6750,1.0,0,0,3,7,1480,0,1958,0,98146,47.505,-122.366,1480,7594,250000,26,2,2015,0,57,5270,6114,0,0,1
3,2.75,1960,6390,1.5,0,2,5,8,1960,0,1900,0,98122,47.6032,-122.285,2440,5870,759000,28,10,2014,0,114,4430,3430,0,0,1
3,2.0,1470,4640,1.5,0,0,4,7,1470,0,1926,0,98199,47.6398,-122.393,1700,5000,640000,11,12,2014,0,88,3170,3300,0,0,1
3,3.25,2460,4182,2.0,0,0,5,8,2100,360,1910,0,98115,47.6782,-122.311,2370,4284,990000,27,4,2015,0,105,1722,1914,0,1,1
4,1.75,1960,7945,1.0,0,0,4,7,980,980,1946,0,98125,47.7326,-122.291,1290,7945,395000,8,10,2014,0,68,5985,6655,0,1,1
2,1.5,1160,1103,2.0,0,0,3,7,890,270,2006,0,98133,47.7677,-122.315,1160,1086,275000,21,4,2015,0,9,-57,-74,0,1,1
3,2.5,1910,4755,2.0,0,0,3,8,1910,0,1997,0,98059,47.4956,-122.162,2460,6099,390000,5,2,2015,0,18,2845,3639,0,0,0
5,2.75,2720,4680,1.5,0,0,4,8,1710,1010,1913,0,98107,47.6612,-122.363,1670,4800,752500,24,3,2015,0,102,1960,3130,0,1,1
2,1.0,1020,5000,1.5,0,0,4,6,1020,0,1906,0,98107,47.6725,-122.396,1490,5000,450000,27,2,2015,0,109,3980,3510,0,0,1
2,1.0,900,5100,1.0,0,0,4,7,900,0,1909,0,98117,47.6804,-122.378,1400,5100,473000,17,6,2014,0,105,4200,3700,0,0,1
3,1.75,1120,10450,1.0,0,0,3,7,1120,0,1973,0,98045,47.4418,-121.772,1250,10414,178500,23,3,2015,0,42,9330,9164,0,0,0
3,1.5,1410,8415,1.0,0,0,4,7,780,630,1982,0,98023,47.2914,-122.368,1440,7361,215000,27,3,2015,0,33,7005,5921,0,1,0
4,1.75,1920,4862,1.0,0,0,5,7,1060,860,1919,0,98116,47.5747,-122.384,1840,4862,589000,12,8,2014,0,95,2942,3022,0,1,1
4,1.75,1370,9993,1.0,0,0,3,6,1370,0,1918,0,98028,47.7572,-122.228,1650,11592,325000,17,4,2015,0,97,8623,9942,0,0,0
3,2.5,1590,1937,2.5,0,0,3,8,1590,0,2004,0,98116,47.5903,-122.388,1620,2022,580000,20,8,2014,0,10,347,402,0,0,1
4,1.75,1850,7500,1.0,0,0,3,7,1850,0,1954,0,98198,47.4217,-122.333,1460,7500,181100,16,7,2014,0,60,5650,6040,0,0,1
3,2.0,1430,4200,1.0,0,0,4,7,830,600,1908,0,98199,47.6462,-122.384,1540,5000,345000,24,2,2015,0,107,2770,3460,0,1,1
3,1.75,1940,8729,1.0,0,0,3,8,1460,480,1960,0,98125,47.7027,-122.282,2250,9165,781000,30,3,2015,0,55,6789,6915,0,1,1
4,1.0,1270,3630,1.5,0,0,3,7,1270,0,1903,0,98122,47.6135,-122.307,1420,4848,402500,23,10,2014,0,111,2360,3428,0,0,1
3,1.5,1380,7200,1.0,0,0,3,7,1080,300,1948,0,98106,47.5292,-122.348,1220,7200,426000,20,4,2015,0,67,5820,5980,0,1,1
3,2.5,1720,4515,2.0,0,0,3,7,1720,0,2005,0,98065,47.5426,-121.879,2220,4618,389000,5,9,2014,0,9,2795,2398,0,0,0
4,3.25,3660,5800,2.5,0,0,3,10,3360,300,1909,1995,98112,47.6283,-122.312,3240,5800,1510000,21,5,2014,86,105,2140,2560,1,1,1
3,2.25,1870,3230,2.0,0,0,3,7,1870,0,1997,0,98056,47.4915,-122.167,1620,3363,288400,21,5,2014,0,17,1360,1743,0,0,0
4,2.0,2230,4635,1.5,0,0,5,7,1510,720,1908,0,98103,47.682,-122.349,1520,4635,700000,19,2,2015,0,107,2405,3115,0,1,1
4,3.0,2020,6000,1.0,0,0,3,8,1220,800,1968,2015,98199,47.6563,-122.401,1400,6000,830000,31,3,2015,47,47,3980,4600,1,1,1
2,1.0,1450,6380,1.0,0,0,3,7,1450,0,1967,0,98115,47.6924,-122.321,1240,6380,350500,9,10,2014,0,47,4930,5140,0,0,1
3,1.75,1630,9000,1.0,0,0,4,7,1630,0,1956,0,98166,47.4521,-122.36,1600,11120,431000,3,5,2015,0,59,7370,9520,0,0,1
3,2.5,1840,8250,1.0,0,1,3,8,1340,500,1958,0,98177,47.7767,-122.378,1970,7920,485000,31,10,2014,0,56,6410,5950,0,1,1
3,1.5,1620,7500,1.0,0,2,4,8,1620,0,1949,0,98117,47.7014,-122.381,2440,7800,780000,10,10,2014,0,65,5880,5360,0,0,1
2,1.5,1840,9000,1.0,0,2,3,8,1340,500,1957,0,98136,47.5281,-122.388,1880,7560,720000,1,8,2014,0,57,7160,5680,0,1,1
4,1.0,2080,5500,1.0,0,0,3,7,1040,1040,1941,0,98117,47.6838,-122.386,1280,4000,480000,20,6,2014,0,73,3420,2720,0,1,1
4,2.25,2550,10000,1.0,0,0,4,7,1560,990,1979,0,98028,47.77,-122.259,2440,10000,452250,16,9,2014,0,35,7450,7560,0,1,0
3,2.5,2550,8170,2.0,0,0,3,8,2550,0,1985,0,98023,47.311,-122.345,1840,8823,316000,6,4,2015,0,30,5620,6983,0,0,0
2,1.0,1160,17635,1.0,1,4,3,6,1160,0,1945,0,98178,47.5117,-122.248,1510,13122,700000,10,10,2014,0,69,16475,11612,0,0,1
4,2.0,1760,5500,1.0,0,1,3,7,780,980,1925,2004,98118,47.5183,-122.265,1510,5500,285000,29,7,2014,79,89,3740,3990,1,1,1
3,1.75,1720,4050,1.0,0,0,5,7,860,860,1906,0,98115,47.6782,-122.314,1720,4410,575000,18,9,2014,0,108,2330,2690,0,1,1
3,2.25,2300,12430,1.0,0,2,4,8,1580,720,1960,0,98166,47.435,-122.347,2500,12430,590000,22,7,2014,0,54,10130,9930,0,1,1
4,2.25,1750,10270,1.5,0,0,4,8,1750,0,1968,0,98155,47.7612,-122.31,1750,10127,364000,22,9,2014,0,46,8520,8377,0,0,1
3,2.5,1890,10190,2.0,0,0,3,8,1890,0,1986,0,98074,47.6478,-122.061,2080,9794,490000,17,12,2014,0,28,8300,7714,0,0,0
3,2.5,2160,4297,2.0,0,0,3,9,2160,0,1999,0,98029,47.5476,-122.012,2160,3968,520000,28,10,2014,0,15,2137,1808,0,0,0
3,1.0,1380,6591,1.0,0,0,4,7,1380,0,1947,0,98133,47.7164,-122.351,1610,6594,389000,8,10,2014,0,67,5211,4984,0,0,1
2,1.0,1180,6000,1.0,0,0,3,7,1180,0,1910,0,98119,47.6531,-122.373,1600,6000,450000,18,11,2014,0,104,4820,4400,0,0,1
3,2.5,2550,4240,2.0,0,0,3,7,2550,0,2006,0,98031,47.3986,-122.169,2550,4240,325000,5,12,2014,0,8,1690,1690,0,0,0
2,1.0,1070,5000,1.0,0,0,3,7,1070,0,1924,0,98103,47.6631,-122.337,1400,4000,660000,13,3,2015,0,91,3930,2600,0,0,1
3,2.25,2870,8170,2.0,0,0,3,10,2250,620,1995,0,98136,47.5363,-122.385,1310,8170,850000,20,6,2014,0,19,5300,6860,0,1,1
3,2.5,1940,9874,2.0,0,0,3,7,1940,0,1990,0,98042,47.3794,-122.113,1860,8875,285000,6,8,2014,0,24,7934,7015,0,0,0
2,1.0,870,3121,1.0,0,0,4,7,870,0,1923,0,98107,47.6659,-122.369,1570,1777,395000,11,12,2014,0,91,2251,207,0,0,1
3,2.0,1550,2401,2.0,0,0,3,7,1550,0,1996,0,98103,47.6545,-122.348,1550,3446,440000,17,7,2014,0,18,851,1896,0,0,1
3,1.75,1400,5648,1.5,0,0,5,6,1400,0,1917,0,98056,47.5133,-122.196,2320,9420,249000,13,3,2015,0,98,4248,7100,0,0,0
3,1.75,1210,4400,1.5,0,0,4,8,1210,0,1930,0,98105,47.6621,-122.288,2020,3750,635000,27,2,2015,0,85,3190,1730,0,0,1
3,3.25,3020,6073,2.0,0,0,4,9,3020,0,1954,0,98112,47.6332,-122.29,3020,7700,1400000,30,1,2015,0,61,3053,4680,0,0,1
2,1.0,950,8100,1.0,0,0,3,6,950,0,1955,0,98166,47.4572,-122.351,1620,7630,200000,4,3,2015,0,60,7150,6010,0,0,1
4,2.75,3370,8103,1.0,0,3,3,9,1970,1400,1970,2014,98136,47.5232,-122.383,2120,6360,1140000,6,5,2014,44,44,4733,4240,1,1,1
4,1.0,1460,4600,1.0,0,2,3,6,780,680,1946,0,98126,47.566,-122.38,1560,4600,445000,17,11,2014,0,68,3140,3040,0,1,1
3,1.5,1740,4200,1.5,0,0,4,7,1640,100,1920,0,98117,47.6782,-122.361,1660,3750,555000,7,7,2014,0,94,2460,2090,0,1,1
4,2.0,1720,6413,1.0,0,0,4,7,860,860,1950,0,98116,47.5734,-122.395,1280,6413,537000,24,9,2014,0,64,4693,5133,0,1,1
3,1.75,1480,7500,1.0,0,0,4,7,1480,0,1968,0,98055,47.4629,-122.187,1480,7500,315000,27,1,2015,0,47,6020,6020,0,0,0
5,2.5,3320,7266,2.0,0,0,3,9,3320,0,2000,0,98075,47.5862,-122.054,3060,10269,805000,29,1,2015,0,15,3946,7209,0,0,0
4,2.5,3490,9030,1.5,0,0,4,8,3490,0,1969,0,98023,47.3198,-122.386,2540,8400,414000,26,8,2014,0,45,5540,5860,0,0,0
2,1.5,1160,1648,2.0,0,0,3,7,1160,0,2002,0,98144,47.5916,-122.293,1458,2351,375000,15,8,2014,0,12,488,893,0,0,1
4,1.75,3010,12523,1.0,0,0,3,8,1780,1230,1952,0,98125,47.707,-122.316,2040,7560,401000,4,3,2015,0,63,9513,5520,0,1,1
3,1.0,1030,4583,1.0,0,0,3,7,1030,0,1967,0,98198,47.4231,-122.329,1730,8023,210000,28,1,2015,0,48,3553,6293,0,0,1
2,1.0,980,5110,1.0,0,0,4,7,780,200,1939,0,98115,47.7002,-122.314,1430,5110,365000,22,7,2014,0,75,4130,3680,0,1,1
5,1.5,1990,18200,1.0,0,0,3,7,1990,0,1960,0,98178,47.4938,-122.262,1860,8658,178000,24,2,2015,0,55,16210,6798,0,0,1
2,1.0,1790,4000,1.0,0,0,4,7,1040,750,1923,0,98112,47.6405,-122.301,1310,4000,710000,20,5,2014,0,91,2210,2690,0,1,1
2,1.0,810,7980,1.0,0,0,1,6,810,0,1928,0,98146,47.489,-122.337,1440,7980,255000,9,5,2014,0,86,7170,6540,0,0,1
4,1.5,1360,6110,1.0,0,0,3,7,1010,350,1955,0,98116,47.5755,-122.396,1520,6110,442000,4,8,2014,0,59,4750,4590,0,1,1
4,2.5,2120,3220,2.0,0,0,3,9,2120,0,2005,0,98052,47.6662,-122.083,2120,3547,637250,21,11,2014,0,9,1100,1427,0,0,0
3,1.75,1240,7200,1.0,0,0,5,7,1240,0,1942,0,98136,47.5142,-122.389,1640,7200,427500,30,3,2015,0,73,5960,5560,0,0,1
3,1.75,1660,5750,1.0,0,0,4,7,1080,580,1909,0,98116,47.5843,-122.385,2060,5560,680000,19,3,2015,0,106,4090,3500,0,1,1
2,2.0,1170,8251,1.0,0,0,3,7,1170,0,1941,0,98115,47.6873,-122.291,1360,6798,393820,28,8,2014,0,73,7081,5438,0,0,1
4,2.75,2470,7200,1.0,0,0,5,7,1350,1120,1940,0,98108,47.5631,-122.317,1500,6000,525000,20,8,2014,0,74,4730,4500,0,1,1
2,1.75,1310,3816,1.0,0,0,2,7,1110,200,1929,0,98117,47.679,-122.368,1510,3816,505000,15,1,2015,0,86,2506,2306,0,1,1
3,2.0,1670,11337,1.0,0,1,4,7,1670,0,1959,0,98033,47.6602,-122.188,2210,11337,555565,11,11,2014,0,55,9667,9127,0,0,0
3,1.75,1660,10819,1.0,0,0,4,7,1240,420,1942,0,98177,47.7045,-122.379,3110,11853,650000,29,10,2014,0,72,9159,8743,0,1,1
5,3.25,3500,7254,2.0,0,0,3,8,2760,740,2005,0,98065,47.5444,-121.881,2820,6317,632500,17,9,2014,0,9,3754,3497,0,1,0
3,2.5,1440,3800,2.0,0,0,3,7,1440,0,2005,0,98038,47.3606,-122.039,1890,3819,269000,24,7,2014,0,9,2360,1929,0,0,0
4,2.75,2360,7716,1.0,0,0,3,7,1390,970,1978,0,98034,47.7301,-122.223,2160,8794,405000,25,11,2014,0,36,5356,6634,0,1,0
3,3.5,3460,15745,2.0,0,0,3,10,3460,0,1986,0,98077,47.7262,-122.06,3350,14825,845000,24,7,2014,0,28,12285,11475,0,0,0
3,1.0,1750,8820,1.0,0,0,4,7,1750,0,1961,0,98032,47.3608,-122.29,1400,9600,234000,25,7,2014,0,53,7070,8200,0,0,0
4,1.75,1470,4236,1.5,0,0,4,7,1470,0,1946,0,98107,47.6692,-122.399,1480,5400,638000,22,4,2015,0,69,2766,3920,0,0,1
3,1.75,1710,10950,1.0,0,0,3,7,1060,650,1967,0,98045,47.4678,-121.745,1180,10950,290000,4,8,2014,0,47,9240,9770,0,1,0
1,0.75,520,12981,1.0,0,0,5,3,520,0,1920,0,98022,47.2082,-121.995,1340,12233,262000,25,2,2015,0,95,12461,10893,0,0,0
4,2.5,2350,5835,2.0,0,0,3,8,2350,0,2003,0,98042,47.3494,-122.153,3010,5772,270000,18,2,2015,0,12,3485,2762,0,0,0
4,2.25,2380,4876,2.0,0,0,4,9,2240,140,1948,0,98117,47.6822,-122.4,1780,4559,875000,18,11,2014,0,66,2496,2779,0,1,1
3,2.25,1920,7840,2.0,0,0,4,8,1920,0,1982,0,98032,47.3631,-122.276,2170,7210,299000,17,7,2014,0,32,5920,5040,0,0,0
3,1.0,1580,6000,1.0,0,0,5,7,1580,0,1947,0,98027,47.5286,-122.032,1580,6000,551000,3,3,2015,0,68,4420,4420,0,0,0
3,2.5,2660,13367,2.0,0,2,3,10,2660,0,1992,0,98004,47.6501,-122.217,2660,13367,1900000,4,6,2014,0,22,10707,10707,0,0,0
2,1.75,1700,5000,1.0,0,0,3,6,850,850,1915,0,98117,47.6787,-122.363,1690,5000,511718,27,10,2014,0,99,3300,3310,0,1,1
4,2.25,2680,4673,2.0,0,0,3,7,2680,0,1999,0,98011,47.7539,-122.219,2460,4645,475000,16,12,2014,0,15,1993,2185,0,0,0
4,2.75,2720,4000,1.5,0,2,5,8,1840,880,1928,0,98117,47.6797,-122.359,1600,4000,1060000,15,4,2015,0,87,1280,2400,0,1,1
6,2.5,3596,13700,1.0,0,0,5,8,1798,1798,1964,0,98166,47.4388,-122.339,1894,10500,580000,17,3,2015,0,51,10104,8606,0,1,1
2,2.25,1240,1172,2.0,0,0,3,8,1000,240,2008,0,98144,47.5877,-122.316,1260,1111,374950,20,10,2014,0,6,-68,-149,0,1,1
5,4.0,4660,9900,2.0,0,2,4,9,2600,2060,1979,0,98056,47.5135,-122.2,3380,9900,739000,16,12,2014,0,35,5240,6520,0,1,0
4,1.75,1710,7200,1.0,0,0,5,7,910,800,1975,0,98031,47.3967,-122.174,1730,7200,271000,17,12,2014,0,39,5490,5470,0,1,0
2,1.0,930,7550,1.0,0,0,3,6,930,0,1986,0,98168,47.4866,-122.303,1370,10176,230000,13,6,2014,0,28,6620,8806,0,0,1
3,2.25,1430,9150,1.0,0,0,3,7,1070,360,1984,0,98023,47.3239,-122.35,1430,6364,210000,27,4,2015,0,31,7720,4934,0,1,0
3,2.75,1650,5700,2.0,0,0,4,7,1650,0,1988,0,98166,47.4563,-122.348,1320,7620,350000,24,2,2015,0,27,4050,6300,0,0,1
3,2.25,1560,12000,1.0,0,0,4,7,1110,450,1968,0,98034,47.7256,-122.166,2190,4612,491500,6,5,2015,0,47,10440,2422,0,1,0
3,2.5,1870,9825,1.0,0,0,4,7,1250,620,1994,0,98045,47.4639,-121.744,1380,11475,325000,9,9,2014,0,20,7955,10095,0,1,0
3,2.0,1320,7625,1.0,0,0,3,7,1320,0,1987,0,98038,47.3635,-122.045,1420,7500,190000,6,10,2014,0,27,6305,6080,0,0,0
4,2.0,1400,4690,1.5,0,0,4,7,1400,0,1945,0,98117,47.6826,-122.378,1400,4690,658600,4,5,2015,0,70,3290,3290,0,0,1
3,1.5,1940,8951,1.0,0,0,3,7,1300,640,1958,0,98168,47.473,-122.328,2000,8319,299950,27,3,2015,0,57,7011,6319,0,1,1
5,2.0,2000,3000,1.5,0,0,3,6,1200,800,1931,0,98122,47.6028,-122.298,1330,4000,464000,30,3,2015,0,84,1000,2670,0,1,1
3,1.0,1640,18144,1.5,0,0,3,6,1640,0,1942,0,98168,47.5027,-122.33,1500,9065,308000,25,6,2014,0,72,16504,7565,0,0,1
3,1.0,1020,7650,1.0,0,0,3,6,1020,0,1919,0,98033,47.6795,-122.202,1870,5500,625000,29,1,2015,0,96,6630,3630,0,0,0
3,1.75,1630,9450,1.0,0,0,4,7,1080,550,1977,0,98032,47.3729,-122.295,1280,9100,240000,5,2,2015,0,38,7820,7820,0,1,0
5,4.5,2120,8944,2.0,1,4,5,8,2120,0,1939,1963,98006,47.5488,-122.197,2870,8944,1000000,20,10,2014,24,75,6824,6074,1,0,0
1,1.0,790,2400,1.0,0,0,3,7,790,0,1918,0,98122,47.6178,-122.299,1580,2566,439000,25,9,2014,0,96,1610,986,0,0,1
4,1.75,2020,6200,1.0,0,0,4,6,1010,1010,1948,0,98133,47.7013,-122.35,1440,4158,575000,11,5,2015,0,67,4180,2718,0,1,1
3,1.75,1530,7238,1.0,0,0,3,7,1530,0,1959,0,98155,47.7629,-122.315,1580,7238,418000,21,10,2014,0,55,5708,5658,0,0,1
4,3.75,3250,10949,2.0,0,0,4,9,2940,310,1930,1989,98004,47.639,-122.219,2340,15234,1210000,28,4,2015,59,85,7699,12894,1,1,0
4,3.75,2930,3200,1.5,0,0,5,9,2130,800,1925,0,98119,47.643,-122.359,1900,4320,1100000,3,6,2014,0,89,270,2420,0,1,1
3,3.75,3150,8550,2.0,0,0,3,10,3150,0,2007,0,98112,47.6387,-122.284,2510,8550,1900000,15,4,2015,0,8,5400,6040,0,0,1
2,1.0,1040,7372,1.0,0,0,5,7,840,200,1939,0,98126,47.5285,-122.378,1930,5150,380000,11,3,2015,0,76,6332,3220,0,1,1
3,1.0,880,5375,1.0,0,0,4,5,880,0,1924,0,98055,47.4858,-122.202,980,4838,256000,23,7,2014,0,90,4495,3858,0,0,0
3,1.0,1400,7066,1.0,0,0,3,8,1400,0,1957,0,98125,47.7127,-122.325,1400,7320,349950,15,5,2014,0,57,5666,5920,0,0,1
4,2.5,2600,7200,2.0,0,0,3,7,2600,0,1962,2002,98115,47.6944,-122.274,1790,6175,691500,1,7,2014,40,52,4600,4385,1,0,1
3,1.75,1590,2500,1.5,0,0,4,7,1190,400,1908,0,98105,47.6668,-122.299,1420,3800,556000,31,10,2014,0,106,910,2380,0,1,1
3,2.25,1610,7084,1.0,0,0,4,8,1280,330,1968,0,98023,47.3146,-122.384,2170,8505,218000,20,11,2014,0,46,5474,6335,0,1,0
4,2.0,1390,4500,1.5,0,0,5,7,1390,0,1908,0,98108,47.5552,-122.311,1900,5460,425000,5,12,2014,0,106,3110,3560,0,0,1
4,1.75,2360,11300,1.0,0,0,4,9,2360,0,1974,0,98006,47.5728,-122.163,2290,11951,732000,7,10,2014,0,40,8940,9661,0,0,0
3,1.0,1440,10330,1.0,0,0,4,7,1440,0,1952,0,98004,47.6245,-122.193,2080,10327,805500,27,1,2015,0,63,8890,8247,0,0,0
3,1.75,1400,5750,1.0,0,2,3,6,1100,300,1915,0,98126,47.5659,-122.38,1500,5175,507250,4,2,2015,0,100,4350,3675,0,1,1
4,1.75,2010,12044,1.0,0,0,3,9,2010,0,1982,0,98074,47.6446,-122.068,2200,11144,627800,17,3,2015,0,33,10034,8944,0,0,0
2,2.25,2550,6000,2.0,0,0,5,7,1860,690,1902,0,98115,47.6739,-122.323,2010,4000,660000,24,6,2014,0,112,3450,1990,0,1,1
2,2.5,1240,3649,2.0,0,0,3,7,1240,0,1986,0,98003,47.3241,-122.322,1400,3721,153503,9,10,2014,0,28,2409,2321,0,0,0
3,2.25,2090,9163,1.0,0,0,3,7,1460,630,1975,0,98034,47.7334,-122.167,1960,7713,456500,20,1,2015,0,40,7073,5753,0,1,0
5,2.5,2770,8100,2.0,0,0,3,9,2770,0,2002,0,98004,47.6341,-122.208,2070,8100,1310000,1,8,2014,0,12,5330,6030,0,0,0
3,2.5,3560,11448,2.0,0,0,3,11,3560,0,1997,0,98052,47.7126,-122.104,3290,11506,843500,7,12,2014,0,17,7888,8216,0,0,0
3,1.0,1240,4080,1.0,0,0,3,7,1240,0,1925,0,98103,47.667,-122.333,2060,4080,625000,18,8,2014,0,89,2840,2020,0,0,1
2,1.75,1640,4080,1.0,0,0,3,7,840,800,1921,0,98105,47.6645,-122.326,1980,4080,527000,11,6,2014,0,93,2440,2100,0,1,1
5,3.75,3940,13738,1.5,0,3,4,9,3940,0,1951,0,98004,47.6203,-122.212,2370,13320,1970000,26,2,2015,0,64,9798,10950,0,0,0
4,3.0,2550,5300,2.0,0,0,3,8,1720,830,1908,2013,98117,47.6786,-122.367,1590,4505,855000,25,2,2015,105,107,2750,2915,1,1,1
1,1.0,580,7200,1.0,0,0,3,6,580,0,2000,0,98126,47.5249,-122.373,1360,7560,315000,15,10,2014,0,14,6620,6200,0,0,1
3,1.75,1330,16000,1.0,0,0,3,7,1330,0,1978,0,98001,47.28,-122.257,1330,14374,180000,24,9,2014,0,36,14670,13044,0,0,0
2,1.0,930,5000,1.0,0,3,3,7,930,0,1926,2013,98136,47.5333,-122.388,1760,5228,700000,13,3,2015,87,89,4070,3468,1,0,1
3,1.0,1060,8625,2.0,0,0,4,7,1060,0,1962,1997,98033,47.6615,-122.179,2010,8901,476500,11,8,2014,35,52,7565,6891,1,0,0
3,1.5,1180,9048,1.0,0,0,3,7,1180,0,1960,0,98148,47.4327,-122.328,1460,8942,193000,3,6,2014,0,54,7868,7482,0,0,1
4,2.5,1850,6663,2.0,0,0,3,7,1850,0,1990,0,98030,47.3618,-122.195,1850,6417,295000,19,8,2014,0,24,4813,4567,0,0,0
2,1.0,820,4880,1.0,0,0,4,6,820,0,1925,0,98136,47.5483,-122.394,1320,4880,363000,31,7,2014,0,89,4060,3560,0,0,1
3,2.0,1850,8250,1.0,0,0,4,7,1150,700,1952,0,98002,47.3066,-122.209,1580,7153,257200,14,5,2014,0,62,6400,5573,0,1,0
3,2.0,2240,11250,1.0,0,0,3,8,2240,0,1968,0,98008,47.6371,-122.119,2200,12500,555000,29,9,2014,0,46,9010,10300,0,0,0
3,2.25,1860,15559,2.0,0,0,4,7,1860,0,1963,0,98022,47.1559,-121.646,1110,11586,380000,24,6,2014,0,51,13699,10476,0,0,0
4,2.75,2390,7330,2.0,0,0,3,7,2390,0,1989,0,98023,47.3061,-122.359,1980,6735,282000,25,7,2014,0,25,4940,4755,0,0,0
4,2.5,2040,6034,2.0,0,0,3,7,2040,0,1990,0,98115,47.6952,-122.323,1380,5986,545000,6,6,2014,0,24,3994,4606,0,0,1
3,1.5,1900,5000,1.5,0,0,3,7,1640,260,1926,0,98115,47.6779,-122.294,2090,5000,550000,6,6,2014,0,88,3100,2910,0,1,1
3,1.5,1900,5000,1.5,0,0,3,7,1640,260,1926,0,98115,47.6779,-122.294,2090,5000,921500,13,3,2015,0,89,3100,2910,0,1,1
3,1.5,2200,2880,2.0,0,0,5,7,1440,760,1904,0,98112,47.6308,-122.312,2440,4640,885000,12,5,2015,0,111,680,2200,0,1,1
4,2.25,2280,6660,1.5,0,2,3,8,1960,320,1940,1984,98119,47.6503,-122.368,1720,5336,820000,29,5,2014,44,74,4380,3616,1,1,1
3,1.0,1090,7315,1.0,0,0,5,6,1090,0,1981,0,98056,47.494,-122.165,1090,5800,289000,13,5,2014,0,33,6225,4710,0,0,0
1,1.0,670,5750,1.0,0,0,3,7,670,0,1942,2011,98116,47.5624,-122.394,1170,5750,334000,13,2,2015,69,73,5080,4580,1,0,1
3,1.0,1050,5233,1.0,0,0,5,5,1050,0,1906,0,98010,47.3106,-121.999,970,7500,206000,28,10,2014,0,108,4183,6530,0,0,0
3,2.25,2090,10733,1.0,0,0,3,7,1440,650,1958,0,98115,47.6971,-122.281,1740,8100,491950,30,6,2014,0,56,8643,6360,0,1,1
3,2.5,2030,7770,2.0,0,0,3,8,2030,0,2003,0,98024,47.5253,-121.93,1360,10782,430000,13,11,2014,0,11,5740,9422,0,0,0
3,2.0,1250,7995,1.0,0,0,4,7,1250,0,1980,0,98042,47.3684,-122.092,1540,7650,208000,18,7,2014,0,34,6745,6110,0,0,0
4,2.25,2600,6390,1.0,0,0,3,8,1390,1210,1978,0,98023,47.3174,-122.366,2110,6700,245000,8,7,2014,0,36,3790,4590,0,1,0
2,1.0,640,2500,1.0,0,0,4,6,640,0,1918,0,98117,47.6776,-122.361,1460,4200,426000,18,3,2015,0,97,1860,2740,0,0,1
3,2.5,2120,3742,2.0,0,0,3,7,2120,0,2006,0,98059,47.4787,-122.129,2250,4696,400000,1,8,2014,0,8,1622,2446,0,0,0
3,1.0,1330,5100,1.0,0,0,3,7,900,430,1942,0,98115,47.6837,-122.291,1500,5100,553000,14,4,2015,0,73,3770,3600,0,1,1
2,1.0,750,4680,1.0,0,0,3,5,750,0,1948,0,98117,47.6919,-122.371,1450,4400,296000,31,3,2015,0,67,3930,2950,0,0,1
4,2.5,1890,6156,1.0,0,0,3,7,980,910,1980,0,98106,47.551,-122.356,1590,6954,325000,6,5,2014,0,34,4266,5364,0,1,1
2,1.0,820,6366,1.0,0,0,5,6,820,0,1952,0,98133,47.7512,-122.34,1580,10169,294000,21,7,2014,0,62,5546,8589,0,0,1
3,1.75,1880,8424,1.0,0,0,4,7,1380,500,1977,0,98059,47.5116,-122.161,1970,8523,410000,19,3,2015,0,38,6544,6553,0,1,0
3,2.25,1850,4050,2.0,0,0,4,7,1850,0,1985,0,98029,47.5669,-122.017,1650,4468,445000,20,11,2014,0,29,2200,2818,0,0,0
4,2.5,2310,5362,2.0,0,4,4,8,2010,300,1928,0,98122,47.6044,-122.284,2530,5960,921000,25,3,2015,0,87,3052,3430,0,1,1
2,1.0,800,8550,1.0,0,0,3,7,800,0,1947,0,98198,47.4075,-122.294,1490,8550,95000,12,12,2014,0,67,7750,7060,0,0,1
4,1.75,1580,6396,1.0,0,0,4,6,790,790,1945,0,98126,47.5378,-122.369,1180,6396,359000,25,9,2014,0,69,4816,5216,0,1,1
4,1.75,2350,6200,1.5,0,0,4,7,1410,940,1946,0,98116,47.559,-122.397,1800,6150,555000,2,12,2014,0,68,3850,4350,0,1,1
5,3.0,3670,10583,1.0,0,0,5,8,2060,1610,1952,0,98155,47.7589,-122.277,2720,13865,569000,10,6,2014,0,62,6913,11145,0,1,1
4,2.0,1780,7350,1.0,0,0,5,7,900,880,1974,0,98058,47.4562,-122.158,1480,7350,318500,16,7,2014,0,40,5570,5870,0,1,0
2,1.5,1295,1093,2.0,0,0,3,9,1105,190,2007,0,98112,47.6192,-122.299,1295,1413,487028,11,6,2014,0,7,-202,118,0,1,1
3,1.0,1350,7560,1.0,0,0,4,7,950,400,1959,0,98032,47.3784,-122.303,1470,7560,240000,15,10,2014,0,55,6210,6090,0,1,0
3,2.25,1440,9806,1.0,0,0,3,7,1440,0,1965,0,98030,47.3857,-122.212,1590,9782,253000,2,2,2015,0,50,8366,8192,0,0,0
2,1.75,2510,19141,2.0,0,0,3,9,2510,0,1977,0,98092,47.3103,-122.199,2400,13030,368500,10,10,2014,0,37,16631,10630,0,0,0
2,1.0,910,4000,1.0,0,0,3,7,910,0,1918,0,98136,47.5427,-122.388,1060,1346,400000,27,4,2015,0,97,3090,286,0,0,1
3,2.0,1570,4625,1.5,0,0,5,8,1570,0,1927,0,98117,47.68,-122.399,1760,4625,835000,16,9,2014,0,87,3055,2865,0,0,1
3,2.5,2450,7062,2.0,0,0,3,8,2450,0,1993,0,98023,47.3061,-122.36,1960,7200,299000,1,12,2014,0,21,4612,5240,0,0,0
6,2.25,4910,6600,2.5,0,0,5,10,3580,1330,1910,0,98102,47.6458,-122.32,3280,5500,1680000,7,11,2014,0,104,1690,2220,0,1,1
3,2.0,1570,5706,1.0,0,0,3,7,1570,0,1998,0,98092,47.3156,-122.188,1570,5706,265000,14,5,2014,0,16,4136,4136,0,0,0
4,2.5,2680,7513,2.0,0,0,3,8,2680,0,1998,0,98059,47.4956,-122.161,2640,7243,437500,11,11,2014,0,16,4833,4603,0,0,0
3,1.75,2090,4725,2.0,0,0,3,7,1610,480,1947,2013,98199,47.657,-122.394,1280,4725,865000,4,6,2014,66,67,2635,3445,1,1,1
3,2.0,2150,7200,1.0,0,0,3,8,2150,0,1988,0,98029,47.5709,-122.018,2510,7222,626000,11,3,2015,0,27,5050,4712,0,0,0
2,2.0,1140,1118,2.0,0,0,3,7,1040,100,2009,0,98144,47.596,-122.311,1140,1118,247300,28,10,2014,0,5,-22,-22,0,1,1
3,1.0,1790,6000,1.5,0,0,2,8,1790,0,1937,0,98108,47.5448,-122.32,1060,4000,425000,1,10,2014,0,77,4210,2940,0,0,1
5,3.5,3100,10200,1.0,0,4,3,9,1660,1440,1970,0,98008,47.6134,-122.112,2700,10455,905000,25,6,2014,0,44,7100,7755,0,1,0
3,2.5,2220,2550,3.0,0,2,3,10,2220,0,1990,0,98117,47.6963,-122.393,2200,5610,641250,27,8,2014,0,24,330,3410,0,0,1
4,2.5,2370,9679,2.0,0,0,3,8,2370,0,1984,0,98027,47.5631,-122.085,2290,7944,675000,31,3,2015,0,31,7309,5654,0,0,0
4,1.0,1790,8400,1.0,0,0,4,7,1260,530,1954,0,98133,47.7627,-122.353,1470,8400,401500,7,9,2014,0,60,6610,6930,0,1,1
3,2.5,1610,3755,2.0,0,0,3,7,1610,0,1987,0,98052,47.6825,-122.097,1300,3823,395000,23,9,2014,0,27,2145,2523,0,0,0
5,2.75,2830,18050,1.0,0,0,5,7,1630,1200,1958,0,98040,47.5773,-122.226,2370,14250,1100000,6,3,2015,0,57,15220,11880,0,1,0
3,1.0,1010,5490,1.0,0,0,3,6,1010,0,1954,0,98168,47.4762,-122.293,1740,10658,145000,29,5,2014,0,60,4480,8918,0,0,1
3,1.0,1560,3825,1.5,0,0,3,8,1390,170,1930,0,98117,47.6803,-122.387,1700,5100,900000,16,4,2015,0,85,2265,3400,0,1,1
3,1.5,1330,8636,1.0,0,0,4,7,1330,0,1968,0,98034,47.7289,-122.203,1370,7475,374500,12,1,2015,0,47,7306,6105,0,0,0
4,2.25,2330,10451,2.0,0,0,4,8,2330,0,1965,0,98005,47.6044,-122.168,1880,8400,850000,18,11,2014,0,49,8121,6520,0,0,0
3,1.0,960,5750,1.0,0,0,3,7,960,0,1951,0,98116,47.5689,-122.393,1520,5750,490000,25,4,2015,0,64,4790,4230,0,0,1
3,2.5,1710,6773,2.0,0,0,3,8,1710,0,1993,0,98003,47.2635,-122.312,2220,7551,304000,27,4,2015,0,22,5063,5331,0,0,0
4,2.25,2230,7200,1.0,0,0,4,7,1300,930,1963,0,98133,47.7648,-122.33,2010,7752,400000,3,7,2014,0,51,4970,5742,0,1,1
3,2.0,1700,10000,2.0,0,0,3,8,1700,0,1992,0,98011,47.7661,-122.205,1460,9621,454000,14,11,2014,0,22,8300,8161,0,0,0
2,2.0,1040,4750,1.0,0,0,2,6,850,190,1950,0,98118,47.5293,-122.272,1350,5000,160000,24,12,2014,0,64,3710,3650,0,1,1
3,1.75,1070,8030,1.0,0,0,3,7,1070,0,1966,2014,98052,47.67,-122.155,1540,7875,542000,8,7,2014,48,48,6960,6335,1,0,0
4,2.5,2750,8471,2.0,0,0,3,7,2750,0,2003,0,98038,47.3671,-122.029,2610,7482,418000,16,3,2015,0,12,5721,4872,0,0,0
4,1.5,1920,6000,2.0,0,1,3,7,1920,0,1951,0,98198,47.4029,-122.321,1920,6000,406000,26,3,2015,0,64,4080,4080,0,0,1
3,2.25,1770,10000,1.0,0,0,3,7,1340,430,1978,0,98198,47.3814,-122.322,1270,5055,242500,23,9,2014,0,36,8230,3785,0,1,1
4,2.5,2460,5440,2.0,0,0,3,9,2460,0,2003,0,98058,47.448,-122.121,2460,5124,425000,7,4,2015,0,12,2980,2664,0,0,0
4,2.0,1550,4815,1.5,0,0,3,7,1550,0,1909,0,98103,47.667,-122.336,1680,4013,613000,15,5,2014,0,105,3265,2333,0,0,1
3,2.0,1460,11481,1.0,0,0,2,7,1170,290,1995,0,98045,47.4493,-121.777,1540,9680,189000,30,12,2014,0,19,10021,8140,0,1,0
4,2.25,2440,9450,1.5,0,0,3,7,2440,0,1947,2014,98125,47.7061,-122.307,1720,7503,700000,30,10,2014,67,67,7010,5783,1,0,1
3,1.0,1640,6516,1.5,0,0,4,7,1440,200,1935,0,98103,47.6693,-122.339,1770,4000,750000,2,9,2014,0,79,4876,2230,0,1,1
2,1.0,1290,4650,1.0,0,0,4,7,1290,0,1906,0,98115,47.6877,-122.325,1640,3900,494000,7,7,2014,0,108,3360,2260,0,0,1
4,3.0,3150,7778,2.0,0,0,3,9,3150,0,2000,0,98075,47.5972,-122.018,2970,6500,700000,9,6,2014,0,14,4628,3530,0,0,0
2,2.5,2305,5580,1.0,0,0,3,8,2305,0,2007,0,98077,47.7203,-122.024,1440,5748,705000,3,4,2015,0,8,3275,4308,0,0,0
3,1.75,2060,12558,1.0,0,0,4,7,1350,710,1984,0,98052,47.6659,-122.144,1850,8722,625000,22,5,2014,0,30,10498,6872,0,1,0
2,1.0,900,7500,1.0,0,0,3,5,900,0,1940,0,98198,47.4177,-122.319,1350,7500,144975,12,3,2015,0,75,6600,6150,0,0,1
4,4.5,3890,5906,2.0,0,3,3,11,3060,830,2004,0,98029,47.5426,-121.995,4170,6052,970000,28,7,2014,0,10,2016,1882,0,1,0
3,1.75,1910,12596,1.0,0,0,3,7,1340,570,1977,0,98072,47.7399,-122.099,1550,13310,415000,6,6,2014,0,37,10686,11760,0,1,0
4,3.0,2340,7048,1.0,0,0,4,8,1340,1000,1979,0,98034,47.7306,-122.227,1440,8088,485000,5,5,2014,0,35,4708,6648,0,1,0
3,3.0,2900,11769,2.0,0,0,3,10,2900,0,1997,0,98052,47.6993,-122.118,2900,9611,799950,7,11,2014,0,17,8869,6711,0,0,0
1,1.0,630,1362,1.0,0,0,3,7,630,0,1943,0,98109,47.6342,-122.342,1090,1376,430000,19,12,2014,0,71,732,286,0,0,1
5,4.75,5410,13431,2.0,0,0,4,10,5050,360,1941,0,98112,47.6306,-122.288,3750,11596,2540000,24,11,2014,0,73,8021,7846,0,1,1
3,1.5,1700,8050,1.0,0,0,3,7,1130,570,1950,0,98004,47.6304,-122.218,2920,12239,950000,5,5,2015,0,65,6350,9319,0,1,0
2,1.0,1430,8157,1.5,0,0,3,7,1150,280,1944,0,98177,47.7256,-122.361,1820,8157,350000,6,8,2014,0,70,6727,6337,0,1,1
4,2.75,2850,7510,2.0,0,0,3,8,2850,0,2008,0,98125,47.7097,-122.305,1510,8833,637000,3,11,2014,0,6,4660,7323,0,0,1
2,2.0,1760,7200,1.0,0,0,5,7,880,880,1946,0,98118,47.5658,-122.276,1760,7200,579000,5,12,2014,0,68,5440,5440,0,1,1
2,1.0,860,6000,1.0,0,0,3,6,860,0,1945,0,98022,47.2109,-121.985,1300,6000,122000,27,1,2015,0,70,5140,4700,0,0,0
2,1.0,880,3000,1.0,0,0,5,7,880,0,1927,0,98103,47.6868,-122.349,1300,3000,405000,8,8,2014,0,87,2120,1700,0,0,1
2,2.5,1360,1349,2.0,0,0,3,8,1050,310,1997,0,98112,47.6254,-122.292,1430,4400,553650,8,5,2014,0,17,-11,2970,0,1,1
2,2.5,1770,1853,3.0,0,0,3,8,1770,0,2007,0,98126,47.5472,-122.371,1770,1924,369900,3,2,2015,0,8,83,154,0,0,1
2,1.0,1180,9350,1.0,0,0,3,6,1180,0,1918,0,98178,47.4889,-122.259,1780,9306,160000,27,5,2014,0,96,8170,7526,0,0,1
3,1.0,1300,8266,1.0,0,0,4,7,1300,0,1953,0,98004,47.6337,-122.199,1300,8707,650000,28,8,2014,0,61,6966,7407,0,0,0
2,1.0,1000,16524,1.0,0,0,3,5,1000,0,1913,0,98001,47.2841,-122.255,1350,10208,115000,5,12,2014,0,101,15524,8858,0,0,0
3,2.5,1890,3880,1.5,0,0,4,8,1460,430,1915,0,98107,47.6642,-122.362,1010,3880,726000,27,1,2015,0,100,1990,2870,0,1,1
3,1.75,1810,5733,1.0,0,0,4,7,1010,800,1926,0,98116,47.5709,-122.388,1260,4680,515000,19,11,2014,0,88,3923,3420,0,1,1
4,2.5,2730,10753,2.0,0,0,3,9,2730,0,1991,0,98006,47.5414,-122.133,3090,10740,756000,26,8,2014,0,23,8023,7650,0,0,0
4,3.75,3070,5850,2.0,0,0,5,9,2400,670,1927,0,98112,47.633,-122.283,2940,5573,1570000,27,5,2014,0,87,2780,2633,0,1,1
4,2.25,2080,12007,1.0,0,0,4,8,1220,860,1979,0,98074,47.6259,-122.051,2110,12459,442000,21,5,2014,0,35,9927,10349,0,1,0
4,2.0,1620,7992,2.0,0,0,4,7,1620,0,1975,0,98031,47.395,-122.176,1710,7500,260000,2,7,2014,0,39,6372,5790,0,0,0
2,1.75,1150,2723,1.0,0,0,4,7,770,380,1923,0,98102,47.6357,-122.322,1440,4000,390000,10,9,2014,0,91,1573,2560,0,1,1
2,1.0,1250,3825,1.0,0,0,3,7,850,400,1929,0,98117,47.6805,-122.38,1370,4998,459500,1,7,2014,0,85,2575,3628,0,1,1
3,1.5,1430,8000,1.0,0,0,5,7,1430,0,1948,0,98155,47.772,-122.322,1410,9820,330000,30,9,2014,0,66,6570,8410,0,0,1
2,1.0,790,7128,1.0,0,0,3,6,790,0,1944,0,98168,47.4873,-122.324,1110,7150,189000,3,11,2014,0,70,6338,6040,0,0,1
3,1.0,1200,9322,1.5,0,0,4,7,1200,0,1954,0,98030,47.3749,-122.225,1540,9677,280000,11,12,2014,0,60,8122,8137,0,0,0
2,1.75,2110,9519,1.0,0,0,2,7,2110,0,1948,0,98155,47.7504,-122.306,1480,9519,400000,5,5,2014,0,66,7409,8039,0,0,1
4,2.0,3160,11193,1.0,0,0,5,6,2410,750,1942,0,98056,47.4937,-122.184,1020,5940,368000,25,3,2015,0,73,8033,4920,0,1,0
4,1.75,2700,7875,1.5,0,0,4,8,2700,0,1968,0,98058,47.454,-122.144,2220,7875,390000,9,6,2014,0,46,5175,5655,0,0,0
2,1.0,820,7475,1.0,0,0,3,6,820,0,1945,0,98133,47.7321,-122.341,1030,5720,245000,30,9,2014,0,69,6655,4690,0,0,1
4,2.5,1800,8432,1.0,0,0,4,7,1200,600,1960,0,98133,47.7463,-122.336,1780,8432,375000,6,8,2014,0,54,6632,6652,0,1,1
5,1.5,1750,12491,1.0,0,0,3,6,1390,360,1961,0,98033,47.6995,-122.174,1560,12473,465000,30,1,2015,0,54,10741,10913,0,1,0
3,1.0,1130,7800,1.0,0,0,3,7,1130,0,1952,0,98118,47.5239,-122.288,1170,7800,250000,5,3,2015,0,63,6670,6630,0,0,1
3,1.0,1500,9416,1.0,0,0,4,8,1500,0,1952,0,98133,47.7135,-122.332,1440,7200,475500,3,10,2014,0,62,7916,5760,0,0,1
2,1.75,1600,5795,1.5,0,0,3,8,1600,0,1940,0,98105,47.6709,-122.276,2310,6301,672324,4,8,2014,0,74,4195,3991,0,0,1
3,2.0,1200,5029,1.0,0,0,3,6,880,320,1937,0,98115,47.6936,-122.294,1510,5854,420000,23,6,2014,0,77,3829,4344,0,1,1
3,2.0,1690,5100,1.5,0,0,5,7,1690,0,1907,0,98117,47.6801,-122.38,1690,5100,515000,29,12,2014,0,107,3410,3410,0,0,1
4,2.5,2270,7665,2.0,0,0,3,9,2270,0,1986,0,98052,47.6612,-122.148,2450,8706,732350,5,11,2014,0,28,5395,6256,0,0,0
4,2.5,1910,5000,2.0,0,0,3,7,1910,0,2005,0,98038,47.3608,-122.036,2020,5000,297500,5,6,2014,0,9,3090,2980,0,0,0
3,1.5,1640,2720,1.5,0,0,3,8,1640,0,1929,0,98115,47.6869,-122.317,1490,4375,475000,8,10,2014,0,85,1080,2885,0,0,1
4,2.5,2120,6497,2.0,0,0,3,7,2120,0,2003,0,98019,47.7241,-121.957,2230,6300,414000,5,5,2015,0,12,4377,4070,0,0,0
3,1.5,1400,8840,1.0,0,0,4,6,1400,0,1952,0,98125,47.7273,-122.309,1260,8840,357250,26,6,2014,0,62,7440,7580,0,0,1
2,1.0,760,6000,1.0,0,0,4,6,760,0,1950,0,98133,47.7168,-122.34,950,6000,289950,30,10,2014,0,64,5240,5050,0,0,1
3,1.0,1070,3713,1.0,0,0,4,6,1070,0,1917,0,98118,47.5683,-122.285,1290,3960,550000,5,5,2015,0,98,2643,2670,0,0,1
3,1.75,1460,9998,1.0,0,0,3,7,960,500,1958,0,98028,47.7434,-122.242,1460,9998,446000,23,4,2015,0,57,8538,8538,0,1,0
3,2.25,1650,4859,2.0,0,0,3,7,1650,0,1988,0,98011,47.7729,-122.172,1890,5018,370000,21,8,2014,0,26,3209,3128,0,0,0
3,2.0,1260,4125,1.0,0,0,3,6,1260,0,1998,0,98188,47.4401,-122.279,1300,9091,216000,17,10,2014,0,16,2865,7791,0,0,1
2,1.5,1140,2500,1.0,0,1,3,7,630,510,1988,0,98106,47.5707,-122.359,1500,5000,355000,17,2,2015,0,27,1360,3500,0,1,1
4,2.5,2550,7312,2.0,0,0,3,9,2550,0,1988,0,98008,47.6441,-122.113,2330,7480,699000,11,9,2014,0,26,4762,5150,0,0,0
3,2.5,1553,1991,3.0,0,0,3,8,1553,0,2014,0,98133,47.7049,-122.34,1509,2431,412000,2,9,2014,0,0,438,922,0,0,1
2,1.0,1140,7200,1.0,0,0,3,6,1140,0,1923,1951,98065,47.5265,-121.823,1110,7200,276000,5,2,2015,28,92,6060,6090,1,0,0
2,1.0,790,6426,1.0,0,0,3,6,790,0,1944,0,98178,47.4933,-122.245,1380,6946,100000,4,9,2014,0,70,5636,5566,0,0,1
4,1.75,2130,5080,1.5,0,0,3,8,2130,0,1914,1993,98119,47.6427,-122.363,1900,5080,955500,1,7,2014,79,100,2950,3180,1,0,1
4,3.5,4000,15253,2.0,0,0,3,9,4000,0,2007,0,98065,47.5433,-121.887,3550,8747,762000,25,6,2014,0,7,11253,5197,0,0,0
4,2.0,1520,7983,1.0,0,0,5,7,1520,0,1967,0,98034,47.7357,-122.193,1520,7783,425000,6,5,2014,0,47,6463,6263,0,0,0
2,1.0,1657,5031,2.0,0,0,3,7,1657,0,1910,0,98116,47.5699,-122.389,2050,6201,546000,4,11,2014,0,104,3374,4151,0,0,1
3,1.75,1680,8460,1.0,0,0,3,7,1180,500,1976,0,98133,47.7554,-122.353,1890,9529,419600,20,4,2015,0,39,6780,7639,0,1,1
4,2.25,2270,5102,1.0,0,0,5,8,1340,930,1954,0,98199,47.6528,-122.408,1800,5102,735000,23,6,2014,0,60,2832,3302,0,1,1
2,2.5,2470,609,3.0,0,0,3,11,1910,560,2011,0,98112,47.6182,-122.312,2440,1229,1230000,22,4,2015,0,4,-1861,-1211,0,1,1
2,2.0,1240,2500,2.0,0,0,3,7,1240,0,1985,0,98117,47.6793,-122.395,1660,5000,445000,7,7,2014,0,29,1260,3340,0,0,1
4,2.75,2520,12500,2.0,0,0,3,8,1720,800,1979,0,98074,47.6225,-122.064,2520,13000,508500,8,12,2014,0,35,9980,10480,0,1,0
5,1.0,1340,11198,1.5,0,0,3,8,1340,0,1934,0,98155,47.736,-122.295,1390,8020,345950,10,12,2014,0,80,9858,6630,0,0,1
3,1.0,1640,9750,1.0,0,0,3,7,1640,0,1968,0,98042,47.3256,-122.141,1200,9750,207500,13,1,2015,0,47,8110,8550,0,0,0
4,2.5,3000,10920,1.0,0,0,4,8,1550,1450,1969,0,98040,47.5347,-122.227,2380,10920,1080000,4,12,2014,0,45,7920,8540,0,1,0
3,1.0,1210,3720,2.0,0,0,4,8,1210,0,1930,0,98112,47.6317,-122.301,1560,6000,640000,10,11,2014,0,84,2510,4440,0,0,1
3,1.0,1810,13068,1.0,0,0,4,7,1360,450,1941,0,98070,47.4482,-122.462,1400,13068,329500,23,3,2015,0,74,11258,11668,0,1,0
4,2.75,2200,9676,1.0,0,0,3,8,1500,700,1979,0,98028,47.7713,-122.259,2120,9585,460000,21,10,2014,0,35,7476,7465,0,1,0
5,3.0,2350,6480,2.0,0,3,4,7,1650,700,1924,1962,98118,47.558,-122.266,1840,7200,805000,20,11,2014,38,90,4130,5360,1,1,1
3,1.5,1090,10454,1.0,0,0,3,6,1090,0,1963,0,98042,47.3425,-122.082,1230,12196,200000,18,12,2014,0,51,9364,10966,0,0,0
2,1.0,1520,3360,1.0,0,0,4,7,830,690,1927,0,98117,47.6815,-122.382,1470,3774,535000,15,12,2014,0,87,1840,2304,0,1,1
3,2.25,1620,7150,1.0,0,2,4,7,1280,340,1950,0,98178,47.5048,-122.241,1620,6930,330000,28,10,2014,0,64,5530,5310,0,1,1
3,2.0,1510,3750,1.5,0,0,4,7,1510,0,1928,0,98116,47.5737,-122.383,1500,5000,479200,30,7,2014,0,86,2240,3500,0,0,1
5,2.5,3001,5710,2.0,0,0,3,8,3001,0,2006,0,98042,47.3727,-122.177,2340,5980,373000,13,5,2014,0,8,2709,3640,0,0,0
4,1.5,2020,6000,1.0,0,0,4,7,1010,1010,1953,0,98178,47.5019,-122.235,1710,6000,355000,19,3,2015,0,62,3980,4290,0,1,1
3,2.0,1380,4500,1.0,0,0,3,7,1380,0,2008,0,98038,47.3661,-122.021,1620,4000,275000,2,6,2014,0,6,3120,2380,0,0,0
3,1.5,1520,4288,1.0,0,0,3,7,1020,500,1949,0,98136,47.5284,-122.387,1660,4288,380000,20,6,2014,0,65,2768,2628,0,1,1
2,1.75,1090,4590,1.0,0,0,4,7,790,300,1915,0,98105,47.6677,-122.324,1390,4080,417000,9,2,2015,0,100,3500,2690,0,1,1
3,2.25,2520,12000,1.0,0,0,3,10,2520,0,1978,0,98074,47.6381,-122.062,2510,12000,598500,26,9,2014,0,36,9480,9490,0,0,0
3,2.0,1760,5000,1.0,0,0,5,7,960,800,1920,0,98199,47.6408,-122.403,1380,5000,629000,2,6,2014,0,94,3240,3620,0,1,1
2,1.0,930,6600,1.0,0,0,3,6,930,0,1957,0,98168,47.4868,-122.33,1250,6600,226950,9,10,2014,0,57,5670,5350,0,0,1
4,2.5,2600,11542,1.5,0,0,4,9,2200,400,1939,0,98177,47.7076,-122.377,2840,10960,1230000,31,12,2014,0,75,8942,8120,0,1,1
3,2.25,2180,11100,1.0,0,0,5,8,1700,480,1979,0,98056,47.5162,-122.176,2350,11397,415000,3,2,2015,0,36,8920,9047,0,1,0
3,2.5,1910,3075,2.0,0,0,3,8,1910,0,2001,0,98029,47.5491,-122.005,1940,3485,595000,22,4,2015,0,14,1165,1545,0,0,0
3,1.75,1100,5525,1.0,0,0,5,6,1100,0,1968,0,98042,47.3625,-122.084,1050,5200,209950,28,10,2014,0,46,4425,4150,0,0,0
2,1.0,700,3180,1.0,0,0,3,6,480,220,1951,0,98178,47.4976,-122.262,1760,6360,119900,21,10,2014,0,63,2480,4600,0,1,1
3,1.0,1080,10200,1.0,0,0,4,7,1080,0,1962,0,98023,47.3215,-122.351,1230,10400,207000,26,8,2014,0,52,9120,9170,0,0,0
3,1.5,1460,8710,1.0,0,0,3,7,1460,0,1955,0,98166,47.4561,-122.357,1400,8645,324950,24,6,2014,0,59,7250,7245,0,0,1
1,1.0,1050,7583,1.0,0,0,4,6,1050,0,1947,0,98133,47.7294,-122.341,1420,7560,210000,22,12,2014,0,67,6533,6140,0,0,1
4,1.0,1400,6739,1.0,0,0,3,7,1000,400,1954,0,98108,47.5402,-122.298,1500,6380,325088,4,12,2014,0,60,5339,4880,0,1,1
2,1.0,1220,2500,1.0,0,0,3,6,770,450,1910,0,98126,47.5727,-122.372,1540,3000,255000,12,5,2014,0,104,1280,1460,0,1,1
4,3.0,2820,2850,1.5,0,0,5,7,1860,960,1928,0,98117,47.6813,-122.367,1570,4500,697000,7,11,2014,0,86,30,2930,0,1,1
2,1.0,840,5000,1.0,0,0,4,7,840,0,1908,0,98117,47.6803,-122.371,1240,5000,457500,4,11,2014,0,106,4160,3760,0,0,1
3,2.0,1610,5100,1.5,0,0,5,8,1610,0,1940,0,98115,47.6825,-122.307,1740,5100,690000,19,5,2014,0,74,3490,3360,0,0,1
4,3.25,1860,4356,2.0,0,0,3,9,1860,0,1917,2005,98103,47.6785,-122.351,1860,4356,967000,11,3,2015,88,98,2496,2496,1,0,1
4,2.75,2450,14803,2.0,0,0,4,9,2450,0,1988,0,98059,47.5261,-122.162,2330,14803,619420,21,5,2014,0,26,12353,12473,0,0,0
2,1.0,850,3276,1.0,0,0,3,6,850,0,1910,0,98103,47.6742,-122.35,1460,4100,389000,13,10,2014,0,104,2426,2640,0,0,1
3,1.0,1800,7200,1.0,0,0,3,7,1020,780,1964,0,98118,47.5616,-122.275,1740,5475,500000,10,12,2014,0,50,5400,3735,0,1,1
4,1.75,1230,7890,1.0,0,1,4,7,1090,140,1950,0,98004,47.5808,-122.189,2380,13176,569000,26,9,2014,0,64,6660,10796,0,1,0
4,2.25,2060,8540,1.0,0,0,4,7,1540,520,1967,0,98034,47.734,-122.19,1560,7700,425000,28,7,2014,0,47,6480,6140,0,1,0
4,2.25,2750,6180,1.0,0,0,4,8,1500,1250,1948,0,98118,47.5691,-122.284,1740,6180,635000,21,5,2014,0,66,3430,4440,0,1,1
2,1.0,1120,9912,1.0,0,0,4,6,1120,0,1980,0,98070,47.3735,-122.43,1540,9750,256500,19,5,2014,0,34,8792,8210,0,0,0
4,2.5,3010,11393,2.0,0,0,3,8,3010,0,2005,0,98028,47.7389,-122.221,2810,11282,695000,23,1,2015,0,10,8383,8472,0,0,0
4,1.5,1580,5000,1.5,0,0,3,7,1390,190,1945,0,98107,47.6735,-122.393,1580,5000,535000,30,7,2014,0,69,3420,3420,0,1,1
4,2.5,2630,5379,2.0,0,0,3,8,2630,0,2004,0,98059,47.4977,-122.163,2630,5379,454200,10,4,2015,0,11,2749,2749,0,0,0
2,1.0,790,5800,1.0,0,0,3,6,790,0,1943,0,98117,47.6973,-122.36,1460,5800,418500,23,1,2015,0,72,5010,4340,0,0,1
3,1.75,2130,5489,1.0,0,0,3,8,1370,760,1999,0,98070,47.4489,-122.456,1750,7200,338500,19,10,2014,0,15,3359,5450,0,1,0
4,3.75,4520,9240,1.5,0,2,3,10,3270,1250,1992,0,98040,47.5897,-122.229,3380,9240,1250000,22,7,2014,0,22,4720,5860,0,1,0
3,2.5,1600,9830,2.0,0,0,4,8,1600,0,1993,0,98001,47.339,-122.266,1890,8910,299950,11,7,2014,0,21,8230,7020,0,0,0
4,1.75,1950,12500,1.0,0,0,3,7,1330,620,1963,0,98168,47.4999,-122.327,1760,11520,325000,31,7,2014,0,51,10550,9760,0,1,1
4,3.0,2010,8171,2.0,0,0,3,8,2010,0,1973,0,98011,47.7688,-122.218,2090,8203,434000,26,8,2014,0,41,6161,6113,0,0,0
4,1.75,2550,8976,1.0,0,0,5,7,1300,1250,1978,0,98058,47.4286,-122.179,2220,9477,328950,1,7,2014,0,36,6426,7257,0,1,0
5,3.75,5340,10655,2.5,0,3,4,10,3740,1600,1912,0,98144,47.5795,-122.285,3910,9418,2100000,19,5,2014,0,102,5315,5508,0,1,1
3,2.25,2170,5001,2.0,0,0,3,8,2170,0,2014,0,98103,47.6937,-122.338,1700,6991,802000,16,9,2014,0,0,2831,5291,0,0,1
3,1.0,1550,6840,1.5,0,0,3,7,1550,0,1918,0,98103,47.6572,-122.335,2370,4560,525000,24,10,2014,0,96,5290,2190,0,0,1
6,3.0,2790,4550,2.5,0,0,4,8,2790,0,1907,0,98119,47.627,-122.361,2590,4550,700000,2,2,2015,0,108,1760,1960,0,0,1
2,1.5,1190,1236,3.0,0,0,3,7,1190,0,2005,0,98133,47.7274,-122.357,1390,1756,277500,18,2,2015,0,10,46,366,0,0,1
3,1.0,1510,4350,1.5,0,0,5,6,1510,0,1913,0,98022,47.2052,-121.987,1210,5500,195000,19,9,2014,0,101,2840,4290,0,0,0
3,2.0,1200,6074,1.0,0,0,3,7,1200,0,1968,0,98002,47.325,-122.205,1430,6338,222000,21,8,2014,0,46,4874,4908,0,0,0
5,3.0,2830,8854,1.0,0,0,4,8,1500,1330,1979,0,98040,47.5743,-122.209,2260,8604,865000,16,4,2015,0,36,6024,6344,0,1,0
4,2.0,1650,6000,1.0,0,0,5,7,1000,650,1959,0,98144,47.5834,-122.307,1540,6000,445000,9,5,2014,0,55,4350,4460,0,1,1
4,1.5,1710,4600,1.5,0,0,3,7,1710,0,1924,0,98115,47.6847,-122.318,1740,4455,495800,9,12,2014,0,90,2890,2715,0,0,1
3,1.0,1740,4400,1.5,0,0,3,7,1740,0,1924,0,98122,47.6059,-122.3,1720,4400,548500,3,4,2015,0,91,2660,2680,0,0,1
3,1.75,1840,10723,1.0,0,0,4,7,1220,620,1974,0,98058,47.429,-122.154,1590,9820,310000,7,5,2014,0,40,8883,8230,0,1,0
3,1.5,1820,8585,1.0,0,0,4,7,1820,0,1962,0,98055,47.4479,-122.213,1740,10088,205000,11,7,2014,0,52,6765,8348,0,0,0
5,3.75,3860,6901,2.0,0,0,3,7,3860,0,2003,0,98038,47.3694,-122.032,3000,8584,470000,10,9,2014,0,11,3041,5584,0,0,0
2,2.0,1030,2271,3.0,0,0,3,7,1030,0,1999,0,98125,47.7263,-122.314,1439,1387,310000,1,5,2015,0,16,1241,-52,0,0,1
4,1.0,1410,7693,1.5,0,0,4,7,1410,0,1953,0,98133,47.7604,-122.331,1330,8395,355000,25,3,2015,0,62,6283,7065,0,0,1
5,2.5,2140,15950,1.0,0,2,4,8,1370,770,1968,0,98166,47.4797,-122.358,2600,14273,621500,27,1,2015,0,47,13810,11673,0,1,1
6,1.5,1930,8400,1.0,0,0,3,7,1030,900,1971,0,98146,47.4869,-122.34,1780,9520,175000,10,6,2014,0,43,6470,7740,0,1,1
6,1.5,1930,8400,1.0,0,0,3,7,1030,900,1971,0,98146,47.4869,-122.34,1780,9520,326000,7,1,2015,0,44,6470,7740,0,1,1
4,3.5,1930,5400,1.5,0,2,3,7,1930,0,1920,0,98116,47.5679,-122.409,1500,3340,690000,12,9,2014,0,94,3470,1840,0,0,1
4,2.5,2210,7214,2.0,0,0,3,8,2210,0,2003,0,98003,47.3554,-122.298,2270,7246,335000,19,8,2014,0,11,5004,4976,0,0,0
4,1.0,1360,11175,1.0,0,0,3,7,1360,0,1961,0,98188,47.4551,-122.272,1340,9702,197000,24,2,2015,0,54,9815,8362,0,0,1
3,1.75,1830,7969,1.0,0,0,3,7,930,900,1950,2008,98055,47.4667,-122.214,1790,7425,312500,3,7,2014,58,64,6139,5635,1,1,0
3,2.25,2120,6710,1.0,0,0,5,7,1420,700,1959,0,98155,47.7461,-122.324,1880,6960,436000,29,10,2014,0,55,4590,5080,0,1,1
4,2.5,2700,4590,2.0,0,0,3,8,2700,0,2002,0,98103,47.6734,-122.329,2080,3570,1020000,1,10,2014,0,12,1890,1490,0,0,1
4,2.25,2770,13129,2.0,0,0,4,8,2770,0,1979,0,98074,47.6268,-122.05,2400,13129,652427,5,1,2015,0,36,10359,10729,0,0,0
4,2.5,2570,6466,2.0,0,0,3,9,2570,0,1999,0,98092,47.3324,-122.17,2520,6667,355000,6,11,2014,0,15,3896,4147,0,0,0
2,1.0,880,12000,1.0,0,0,3,7,880,0,1939,0,98133,47.7436,-122.356,1960,9395,334550,29,7,2014,0,75,11120,7435,0,0,1
3,2.25,1820,9670,2.0,0,0,3,8,1820,0,1984,0,98052,47.6382,-122.11,2160,11424,557500,8,7,2014,0,30,7850,9264,0,0,0
4,2.25,1660,7184,1.0,0,0,3,7,1110,550,1963,0,98188,47.4678,-122.294,1640,7200,277500,3,11,2014,0,51,5524,5560,0,1,1
4,3.0,2200,10800,1.0,0,0,3,6,2200,0,1960,0,98058,47.4476,-122.169,1430,10800,300000,7,7,2014,0,54,8600,9370,0,0,0
4,1.0,1640,3844,1.5,0,0,4,7,1460,180,1928,0,98133,47.7017,-122.354,1230,3844,325000,25,2,2015,0,87,2204,2614,0,1,1
4,2.0,1650,3504,1.0,0,0,3,7,760,890,1951,2013,98144,47.5803,-122.294,1480,3504,402500,19,3,2015,62,64,1854,2024,1,1,1
3,1.75,1420,5170,1.0,0,0,4,7,1420,0,1963,0,98007,47.6151,-122.145,2250,7700,461000,20,8,2014,0,51,3750,5450,0,0,0
3,1.0,1270,3840,1.5,0,0,3,7,1270,0,1926,0,98103,47.6896,-122.357,1270,4175,540000,27,3,2015,0,89,2570,2905,0,0,1
3,1.0,1070,4000,1.0,0,0,4,7,1070,0,1971,0,98108,47.5529,-122.305,1090,4000,385000,16,3,2015,0,44,2930,2910,0,0,1
2,1.0,1060,3040,1.0,0,0,3,7,860,200,1924,0,98103,47.6725,-122.329,1470,3814,480000,8,7,2014,0,90,1980,2344,0,1,1
3,2.25,2190,7149,1.0,0,1,4,8,1240,950,1963,0,98056,47.5243,-122.204,3500,7149,539950,9,6,2014,0,51,4959,3649,0,1,0
3,2.5,1300,877,2.0,0,0,3,7,1060,240,2008,0,98199,47.6591,-122.392,1320,1414,417000,20,8,2014,0,6,-423,94,0,1,1
3,1.5,1330,12500,1.0,0,0,3,7,1330,0,1966,0,98027,47.5263,-122.051,2310,12500,405000,17,2,2015,0,49,11170,10190,0,0,0
3,2.25,1940,9100,1.0,0,0,4,8,1630,310,1966,0,98023,47.3133,-122.364,2080,9100,299000,23,7,2014,0,48,7160,7020,0,1,0
3,1.0,1290,5500,1.0,0,0,3,7,980,310,1951,0,98136,47.5266,-122.392,1680,5000,372220,14,5,2014,0,63,4210,3320,0,1,1
2,1.75,1560,1750,1.0,0,0,4,6,780,780,1904,0,98109,47.6347,-122.355,1850,3600,494400,22,5,2014,0,110,190,1750,0,1,1
3,1.75,2630,6500,1.0,0,0,3,7,1330,1300,1958,0,98055,47.4878,-122.221,2520,6500,280000,24,9,2014,0,56,3870,3980,0,1,0
3,2.5,2100,6021,2.0,0,0,3,7,2100,0,1992,0,98023,47.2917,-122.375,2091,7547,277950,21,11,2014,0,22,3921,5456,0,0,0
2,2.0,1300,3608,1.0,0,0,3,7,1300,0,2004,0,98198,47.3623,-122.309,1510,3608,230000,26,1,2015,0,11,2308,2098,0,0,1
4,2.5,2520,7731,2.0,0,0,3,9,2520,0,1994,0,98155,47.7709,-122.297,2000,7704,525000,2,10,2014,0,20,5211,5704,0,0,1
3,1.0,1150,6000,1.5,0,0,3,7,1150,0,1927,0,98045,47.4963,-121.787,1210,7700,307000,1,7,2014,0,87,4850,6490,0,0,0
4,2.0,2030,9600,1.5,0,0,3,6,1430,600,1947,0,98188,47.4459,-122.272,1820,14600,253779,18,6,2014,0,67,7570,12780,0,1,1
3,1.5,1880,7400,1.0,0,0,3,8,1480,400,1968,0,98155,47.7743,-122.27,1820,8660,405000,17,6,2014,0,46,5520,6840,0,1,1
2,1.0,2320,11250,2.0,0,0,4,6,2320,0,1942,0,98146,47.504,-122.362,1620,11250,360000,12,3,2015,0,73,8930,9630,0,0,1
2,1.0,1050,7500,1.5,0,3,4,6,1050,0,1910,0,98116,47.5577,-122.399,2540,13680,521000,11,5,2015,0,105,6450,11140,0,0,1
4,2.5,3030,13068,2.0,0,0,3,9,3030,0,1978,0,98005,47.6313,-122.172,2940,11999,680000,26,9,2014,0,36,10038,9059,0,0,0
3,1.5,1090,9600,1.0,0,0,4,7,1090,0,1968,0,98042,47.3639,-122.109,1240,9620,200000,23,6,2014,0,46,8510,8380,0,0,0
3,2.25,2220,4060,1.0,0,0,3,7,1330,890,1993,0,98118,47.5188,-122.265,1930,5625,330000,8,7,2014,0,21,1840,3695,0,1,1
3,2.25,1430,5999,2.0,0,0,3,7,1430,0,1987,0,98023,47.3116,-122.358,1600,5999,221000,12,8,2014,0,27,4569,4399,0,0,0
4,4.5,3780,6000,2.0,0,4,4,11,2770,1010,1910,1977,98116,47.5922,-122.388,2660,6000,1600000,4,2,2015,67,105,2220,3340,1,1,1
2,1.0,1560,4920,1.0,0,0,4,6,780,780,1947,0,98125,47.7248,-122.325,1760,7510,310000,23,7,2014,0,67,3360,5750,0,1,1
4,2.25,2220,4200,1.5,0,0,5,8,1310,910,1932,0,98199,47.6418,-122.394,2020,4940,862000,9,4,2015,0,83,1980,2920,0,1,1
3,1.5,1140,8340,1.0,0,0,3,7,1140,0,1960,0,98168,47.4773,-122.28,1140,8340,200000,19,6,2014,0,54,7200,7200,0,0,1
4,2.5,2540,11100,1.0,0,0,5,7,2540,0,1957,0,98008,47.6317,-122.124,1560,11100,630000,30,9,2014,0,57,8560,9540,0,0,0
3,2.25,1440,6232,2.0,0,0,3,7,1440,0,1985,0,98029,47.5658,-122.018,1740,5999,432250,20,3,2015,0,30,4792,4259,0,0,0
3,2.25,1570,9500,1.0,0,0,4,7,1070,500,1977,0,98033,47.6843,-122.185,2250,9583,478000,23,1,2015,0,38,7930,7333,0,1,0
4,2.25,1860,9576,1.0,0,0,3,7,1400,460,1962,0,98032,47.3612,-122.284,1860,9576,249000,23,7,2014,0,52,7716,7716,0,1,0
5,3.0,2440,4750,1.0,0,0,3,9,1450,990,2006,0,98108,47.5485,-122.302,1420,5940,495000,5,6,2014,0,8,2310,4520,0,1,1
4,2.5,2100,8800,1.0,0,2,4,7,1240,860,1960,0,98008,47.6146,-122.114,2000,8800,630000,13,11,2014,0,54,6700,6800,0,1,0
3,2.5,2440,18674,2.0,0,0,4,8,2440,0,1994,0,98042,47.3672,-122.126,2530,10603,350000,19,9,2014,0,20,16234,8073,0,0,0
5,1.5,1930,7480,2.0,0,0,3,7,1930,0,1966,0,98058,47.4503,-122.157,1480,7705,270000,2,12,2014,0,48,5550,6225,0,0,0
4,2.0,1830,9610,1.0,0,0,3,7,1830,0,1963,0,98033,47.695,-122.176,1970,10754,488250,7,10,2014,0,51,7780,8784,0,0,0
4,3.5,1850,6519,2.0,0,0,3,7,1130,720,1986,0,98023,47.3087,-122.354,1280,6664,248000,16,5,2014,0,28,4669,5384,0,1,0
4,3.5,3210,5000,3.0,0,0,3,9,3210,0,2014,0,98136,47.5203,-122.393,1360,5000,889000,14,8,2014,0,0,1790,3640,0,0,1
1,1.0,1090,5250,1.0,0,0,3,6,980,110,1927,0,98117,47.6999,-122.391,2160,5250,375000,27,8,2014,0,87,4160,3090,0,1,1
3,1.5,1870,3300,2.0,0,2,3,7,1870,0,1906,0,98102,47.6221,-122.325,1820,2460,933000,26,11,2014,0,108,1430,640,0,0,1
3,2.25,1920,8412,1.0,0,2,3,8,1460,460,1977,0,98006,47.5578,-122.132,2490,8700,625000,2,1,2015,0,38,6492,6210,0,1,0
2,1.0,700,4350,1.0,0,0,3,6,700,0,1943,0,98116,47.5577,-122.391,1620,5100,328000,28,7,2014,0,71,3650,3480,0,0,1
4,2.25,3380,9900,1.0,0,2,4,8,1690,1690,1969,0,98166,47.4438,-122.34,2390,9900,470000,18,7,2014,0,45,6520,7510,0,1,1
5,2.5,2430,6168,2.0,0,0,3,8,2430,0,2007,0,98056,47.5237,-122.199,2150,8400,502500,13,2,2015,0,8,3738,6250,0,0,0
2,1.0,900,7500,1.0,0,0,4,6,900,0,1961,0,98014,47.6481,-121.916,1190,10000,252500,7,8,2014,0,53,6600,8810,0,0,0
3,2.5,2060,8893,2.0,0,0,3,8,2060,0,1987,0,98006,47.5615,-122.165,2650,8500,610000,21,8,2014,0,27,6833,5850,0,0,0
4,2.0,2180,10447,1.0,0,0,4,8,1280,900,1969,0,98155,47.7675,-122.279,2190,10987,419000,25,7,2014,0,45,8267,8797,0,1,1
4,2.25,2140,9377,2.0,0,0,4,8,2140,0,1986,0,98092,47.2649,-122.218,2030,7846,322500,17,7,2014,0,28,7237,5816,0,0,0
6,1.0,1730,2760,1.5,0,0,3,7,1250,480,1918,0,98109,47.6342,-122.353,1630,3200,563000,6,1,2015,0,97,1030,1570,0,1,1
4,2.5,3140,12591,2.0,0,0,3,9,3140,0,1993,0,98042,47.3826,-122.146,2650,11720,464000,24,3,2015,0,22,9451,9070,0,0,0
4,4.25,3010,4887,2.0,0,3,4,10,1940,1070,1951,1996,98115,47.6933,-122.272,2540,9375,870000,17,6,2014,45,63,1877,6835,1,1,1
2,1.5,800,1196,2.0,0,0,3,8,800,0,2003,0,98103,47.6972,-122.341,1020,1087,280000,3,2,2015,0,12,396,67,0,0,1
3,2.5,3300,11570,2.0,0,0,3,9,3300,0,1994,0,98006,47.5599,-122.121,3280,11446,850000,12,9,2014,0,20,8270,8166,0,0,0
2,1.0,1530,4370,1.0,0,0,3,7,1130,400,1946,0,98115,47.6888,-122.308,1580,4275,458950,22,10,2014,0,68,2840,2695,0,1,1
2,1.0,760,5280,1.0,0,0,3,6,760,0,1946,0,98168,47.483,-122.33,1710,6594,122000,22,4,2015,0,69,4520,4884,0,0,1
5,3.0,2450,4591,2.0,0,0,3,7,2450,0,1994,0,98117,47.6828,-122.388,1060,5500,525000,13,5,2014,0,20,2141,4440,0,0,1
2,1.0,840,7425,1.0,0,0,4,6,840,0,1952,0,98166,47.4749,-122.339,1300,11674,218450,18,7,2014,0,62,6585,10374,0,0,1
3,1.5,1380,4290,1.0,0,0,3,7,1080,300,1955,0,98107,47.674,-122.379,1510,3900,525000,5,9,2014,0,59,2910,2390,0,1,1
3,1.5,1380,4290,1.0,0,0,3,7,1080,300,1955,0,98107,47.674,-122.379,1510,3900,650000,22,12,2014,0,59,2910,2390,0,1,1
2,1.0,1260,5000,1.0,0,0,3,7,1040,220,1951,0,98117,47.6782,-122.397,1510,5000,436500,29,5,2014,0,63,3740,3490,0,1,1
3,1.75,1440,7112,1.0,0,0,3,7,1180,260,1979,0,98034,47.7304,-122.227,1570,9152,410000,7,8,2014,0,35,5672,7582,0,1,0
4,1.75,1540,8311,1.0,0,0,4,7,1540,0,1950,0,98125,47.7046,-122.293,1890,7996,512500,11,9,2014,0,64,6771,6106,0,0,1
4,1.0,1060,7200,1.0,0,1,3,6,880,180,1925,0,98118,47.5591,-122.268,1910,7200,510000,18,8,2014,0,89,6140,5290,0,1,1
4,1.75,1900,10297,1.0,0,0,4,8,1900,0,1966,0,98005,47.5944,-122.155,2220,9612,566000,18,9,2014,0,48,8397,7392,0,0,0
3,1.0,1050,5500,1.0,0,0,3,6,930,120,1920,0,98126,47.5402,-122.38,1410,5834,435000,7,8,2014,0,94,4450,4424,0,1,1
5,2.75,3000,9473,1.0,0,0,3,8,1500,1500,1966,0,98052,47.6567,-122.13,2050,8820,550000,7,10,2014,0,48,6473,6770,0,1,0
3,2.0,1200,10212,1.5,0,0,5,6,1200,0,1949,0,98022,47.206,-121.998,1280,10212,251000,26,2,2015,0,66,9012,8932,0,0,0
3,1.5,1840,10125,1.0,0,0,4,8,1220,620,1959,0,98040,47.5607,-122.217,2320,10160,830000,11,12,2014,0,55,8285,7840,0,1,0
4,2.5,2790,7673,2.0,0,0,3,9,2790,0,1989,0,98052,47.6692,-122.136,2740,7837,803000,14,4,2015,0,26,4883,5097,0,0,0
3,1.0,970,9360,1.0,0,0,4,5,970,0,1942,0,98002,47.2808,-122.225,1050,11348,206000,7,4,2015,0,73,8390,10298,0,0,0
4,1.0,1070,7467,1.5,0,0,3,7,1070,0,1944,0,98178,47.4942,-122.235,1160,7467,200000,30,7,2014,0,70,6397,6307,0,0,1
2,1.0,900,5160,1.0,0,0,3,6,900,0,1952,0,98106,47.525,-122.356,900,5160,219000,6,5,2014,0,62,4260,4260,0,0,1
4,4.0,2680,6000,1.0,0,0,3,7,1380,1300,1962,2014,98199,47.6557,-122.388,1930,6000,777000,5,9,2014,52,52,3320,4070,1,1,1
3,1.5,1660,8797,1.0,0,0,4,7,1660,0,1956,0,98004,47.5892,-122.202,2350,10053,712500,3,6,2014,0,58,7137,7703,0,0,0
4,1.5,1770,6014,1.5,0,0,4,7,1240,530,1946,0,98116,47.5773,-122.393,1740,6014,600000,14,7,2014,0,68,4244,4274,0,1,1
3,2.0,1230,6802,1.5,0,0,3,7,1230,0,1940,0,98105,47.6712,-122.279,1850,6398,554663,30,3,2015,0,75,5572,4548,0,0,1
3,1.0,1740,10875,1.0,0,0,4,7,1020,720,1962,0,98188,47.4682,-122.283,1470,8532,267000,3,7,2014,0,52,9135,7062,0,1,1
3,2.0,1710,8910,1.0,0,0,5,7,1710,0,1953,0,98133,47.7719,-122.338,1430,8493,390000,24,9,2014,0,61,7200,7063,0,0,1
6,2.0,2020,7071,1.0,0,0,3,7,1010,1010,1979,0,98108,47.5329,-122.294,2020,5000,335000,1,4,2015,0,36,5051,2980,0,1,1
4,2.5,2410,9886,1.0,0,0,5,8,1990,420,1975,0,98040,47.5351,-122.223,2530,10658,938000,23,4,2015,0,40,7476,8128,0,1,0
4,2.75,2310,14745,1.0,0,0,3,7,1410,900,1993,0,98198,47.377,-122.31,2060,9678,370000,7,4,2015,0,22,12435,7618,0,1,1
5,2.5,2400,4548,2.0,0,0,3,7,2400,0,2003,0,98042,47.371,-122.127,2200,4465,335000,2,4,2015,0,12,2148,2265,0,0,0
5,2.0,3160,3990,1.5,0,0,3,7,1870,1290,1923,0,98103,47.654,-122.337,1780,4240,695000,21,4,2015,0,92,830,2460,0,1,1
3,1.0,1560,14333,1.0,0,0,4,7,1560,0,1953,0,98166,47.432,-122.348,1640,14333,387500,6,6,2014,0,61,12773,12693,0,0,1
3,2.5,1770,6187,2.0,0,0,3,7,1770,0,1992,0,98031,47.4034,-122.189,1650,7200,245000,18,3,2015,0,23,4417,5550,0,0,0
3,2.0,1600,13200,1.0,0,0,3,7,1600,0,1990,0,98045,47.4656,-121.756,1360,11520,308550,29,7,2014,0,24,11600,10160,0,0,0
3,1.75,1330,13102,1.0,0,0,3,7,1330,0,1968,0,98003,47.3172,-122.322,1270,11475,225000,24,6,2014,0,46,11772,10205,0,0,0
3,1.0,1020,10200,1.0,0,0,4,7,1020,0,1954,0,98133,47.7503,-122.348,1170,8188,335000,6,5,2015,0,61,9180,7018,0,0,1
3,2.5,2490,4904,2.0,0,0,3,9,2490,0,2003,0,98029,47.5451,-122.014,2370,4050,634000,21,8,2014,0,11,2414,1680,0,0,0
5,2.0,1700,7314,1.0,0,0,3,7,1000,700,1956,0,98108,47.549,-122.305,2000,7176,337500,14,5,2014,0,58,5614,5176,0,1,1
1,1.0,850,6567,1.0,0,0,4,6,850,0,1940,0,98010,47.327,-122.039,2160,9794,440000,4,9,2014,0,74,5717,7634,0,0,0
3,1.75,1250,13775,1.0,0,2,3,7,1250,0,1990,0,98045,47.4981,-121.772,1260,13707,350000,17,7,2014,0,24,12525,12447,0,0,0
2,1.0,610,4560,1.0,0,0,3,5,610,0,1918,0,98136,47.5498,-122.383,930,1392,400000,14,1,2015,0,97,3950,462,0,0,1
3,1.0,950,10080,1.0,0,0,4,7,950,0,1954,0,98006,47.572,-122.139,1060,10000,435000,6,4,2015,0,61,9130,8940,0,0,0
4,2.5,3860,5130,2.0,0,0,3,8,2930,930,2004,0,98065,47.5387,-121.879,3130,6163,681000,29,9,2014,0,10,1270,3033,0,1,0
3,3.5,1360,1275,2.0,0,0,3,8,1240,120,2007,0,98144,47.5904,-122.315,1360,1275,397000,29,6,2014,0,7,-85,-85,0,1,1
3,2.25,1680,9090,1.0,0,0,4,7,1130,550,1959,0,98008,47.6068,-122.13,1960,9090,480000,7,7,2014,0,55,7410,7130,0,1,0
3,2.5,1520,7200,2.0,0,0,4,7,1520,0,1985,0,98030,47.3679,-122.182,1780,7210,158000,9,9,2014,0,29,5680,5430,0,0,0
5,2.75,3890,9130,2.0,0,0,3,9,3890,0,2004,0,98065,47.5407,-121.86,3450,8361,772500,2,9,2014,0,10,5240,4911,0,0,0
5,1.5,2940,13425,1.0,0,0,3,8,1470,1470,1955,0,98155,47.7632,-122.29,1580,8200,464500,17,2,2015,0,60,10485,6620,0,1,1
3,1.75,1350,8737,1.0,0,0,3,7,1350,0,1966,0,98188,47.4378,-122.279,1600,8928,281000,24,4,2015,0,49,7387,7328,0,0,1
3,2.25,2280,5750,1.0,0,1,4,7,1150,1130,1985,0,98116,47.5641,-122.393,1500,5060,475000,17,6,2014,0,29,3470,3560,0,1,1
2,2.0,1070,4500,1.0,0,0,4,6,910,160,1932,0,98055,47.4896,-122.204,1280,4500,245000,17,10,2014,0,82,3430,3220,0,1,0
5,2.25,2540,3750,1.5,0,0,4,7,1510,1030,1925,0,98115,47.6729,-122.299,1780,3750,660000,29,7,2014,0,89,1210,1970,0,1,1
4,2.25,2270,8480,1.0,0,0,5,8,1310,960,1973,0,98006,47.5448,-122.174,1910,9050,527500,4,12,2014,0,41,6210,7140,0,1,0
3,1.75,1890,5000,1.0,0,0,3,7,1890,0,2003,0,98092,47.3357,-122.175,2960,5421,275000,6,5,2015,0,12,3110,2461,0,0,0
4,2.0,1990,4740,1.0,0,0,3,7,1080,910,1926,0,98122,47.6112,-122.303,1560,2370,430000,10,2,2015,0,89,2750,810,0,1,1
3,1.0,1220,6000,1.0,0,0,4,7,1220,0,1968,0,98002,47.3245,-122.209,1420,6000,213500,25,8,2014,0,46,4780,4580,0,0,0
3,3.0,2640,5978,2.0,0,0,3,9,2640,0,2012,0,98045,47.4759,-121.735,2680,6060,535000,12,9,2014,0,2,3338,3380,0,0,0
3,1.75,1480,9603,1.0,0,0,3,7,1480,0,1952,0,98004,47.5915,-122.202,2660,10766,641000,13,2,2015,0,63,8123,8106,0,0,0
3,2.0,2320,9420,1.0,0,0,5,7,2320,0,1952,0,98056,47.5133,-122.196,2030,9420,436300,28,10,2014,0,62,7100,7390,0,0,0
4,1.75,2410,6000,1.5,0,0,3,8,2410,0,1911,0,98109,47.6369,-122.355,1280,4000,1440000,14,10,2014,0,103,3590,2720,0,0,1
4,2.75,2090,13500,1.0,0,0,4,8,2090,0,1949,0,98040,47.573,-122.225,2130,13500,830000,27,3,2015,0,66,11410,11370,0,0,0
3,1.0,920,3532,1.0,0,0,3,6,920,0,1910,0,98118,47.5539,-122.268,1250,4000,380000,22,7,2014,0,104,2612,2750,0,0,1
3,0.75,850,8573,1.0,0,0,3,6,600,250,1945,0,98146,47.503,-122.356,850,8382,132500,20,2,2015,0,70,7723,7532,0,1,1
3,1.0,1130,9907,1.0,0,0,3,7,1130,0,1954,0,98188,47.4362,-122.286,1320,9907,179950,1,12,2014,0,60,8777,8587,0,0,1
3,1.0,1260,7265,1.0,0,0,4,7,1260,0,1954,0,98002,47.2979,-122.224,940,7200,188200,20,4,2015,0,61,6005,6260,0,0,0
4,2.0,2090,10800,1.0,0,0,4,7,2090,0,1951,0,98040,47.5759,-122.223,2090,10800,659000,2,7,2014,0,63,8710,8710,0,0,0
3,2.0,2020,7260,1.5,0,0,3,7,1180,840,1926,0,98108,47.5496,-122.311,1400,5950,317000,22,10,2014,0,88,5240,4550,0,1,1
3,2.25,1970,4564,1.0,0,0,3,8,1470,500,1959,0,98199,47.6703,-122.41,1980,5000,625000,24,11,2014,0,55,2594,3020,0,1,1
3,1.75,1820,9545,1.0,0,0,3,7,1230,590,1976,0,98155,47.7772,-122.296,1790,9530,350000,13,6,2014,0,38,7725,7740,0,1,1
3,1.5,1840,5000,1.5,0,0,5,7,1340,500,1915,0,98107,47.6652,-122.362,1840,5000,750000,25,6,2014,0,99,3160,3160,0,1,1
4,1.75,2100,10358,1.0,0,0,5,8,1280,820,1959,0,98133,47.7478,-122.338,2080,9000,457000,27,8,2014,0,55,8258,6920,0,1,1
4,2.0,1770,5000,2.0,0,0,4,7,1770,0,1906,0,98107,47.6748,-122.386,1550,5000,632500,4,3,2015,0,109,3230,3450,0,0,1
3,2.0,1110,7231,1.0,0,0,4,7,1110,0,1991,0,98031,47.4036,-122.191,1550,7245,223000,2,7,2014,0,23,6121,5695,0,0,0
4,2.75,2090,8400,1.0,0,0,4,8,1240,850,1976,0,98052,47.6872,-122.123,2340,9000,610000,2,9,2014,0,38,6310,6660,0,1,0
4,1.75,2080,8215,2.0,0,0,4,7,2080,0,1948,0,98155,47.737,-122.305,1550,8215,385000,24,10,2014,0,66,6135,6665,0,0,1
3,3.25,1400,1343,2.0,0,0,3,7,1160,240,2005,0,98118,47.5483,-122.277,1400,1326,367500,24,3,2015,0,10,-57,-74,0,1,1
3,1.0,1060,8040,1.0,0,0,4,6,1060,0,1949,0,98125,47.7121,-122.287,1300,7620,385100,4,8,2014,0,65,6980,6320,0,0,1
2,1.0,720,5913,1.0,0,0,3,6,720,0,1920,0,98118,47.5447,-122.27,1560,6600,230000,29,12,2014,0,94,5193,5040,0,0,1
3,2.75,1100,750,2.0,0,0,3,7,780,320,2008,0,98106,47.5601,-122.363,1170,4800,286000,23,6,2014,0,6,-350,3630,0,1,1
3,1.0,1010,9576,1.0,0,0,4,7,1010,0,1967,0,98001,47.2956,-122.272,1540,9576,201700,26,3,2015,0,48,8566,8036,0,0,0
4,1.75,2420,7672,1.0,0,0,3,8,1480,940,1979,0,98027,47.5637,-122.085,2370,7699,525000,19,5,2014,0,35,5252,5329,0,1,0
3,1.5,1200,7236,1.0,0,0,3,7,1200,0,1975,0,98011,47.739,-122.194,1680,7800,361000,2,2,2015,0,40,6036,6120,0,0,0
3,1.5,1950,1963,3.0,0,0,3,8,1950,0,2002,0,98117,47.6904,-122.397,1590,2028,530000,23,9,2014,0,12,13,438,0,0,1
3,2.25,1870,7403,1.0,0,0,3,7,1870,0,1950,0,98125,47.7171,-122.32,1630,7440,455000,8,10,2014,0,64,5533,5810,0,0,1
4,2.25,1310,8400,1.0,0,0,4,7,1310,0,1966,0,98034,47.7317,-122.181,1600,8400,421000,20,11,2014,0,48,7090,6800,0,0,0
4,2.0,1520,6200,1.5,0,0,3,7,1520,0,1945,0,98115,47.678,-122.269,1910,6200,640000,2,5,2014,0,69,4680,4290,0,0,1
3,1.0,1270,12733,1.0,0,0,3,7,1270,0,1955,0,98188,47.445,-122.276,1660,11536,240000,31,3,2015,0,60,11463,9876,0,0,1
2,1.0,840,7414,1.0,0,0,4,6,840,0,1928,0,98033,47.6771,-122.172,1740,9784,360000,24,10,2014,0,86,6574,8044,0,0,0
4,3.0,3010,6139,2.0,0,4,5,8,2560,450,1950,1972,98115,47.6799,-122.268,2100,6798,1240000,15,4,2015,22,65,3129,4698,1,1,1
3,1.0,1050,6874,1.0,0,0,3,6,1050,0,1954,0,98133,47.762,-122.355,1500,8954,250000,6,5,2014,0,60,5824,7454,0,0,1
7,4.75,5370,10800,1.5,0,0,3,8,5370,0,1967,0,98040,47.538,-122.223,2310,10910,884900,15,1,2015,0,48,5430,8600,0,0,0
3,1.75,1710,7320,1.0,0,0,3,7,1710,0,1948,0,98155,47.7512,-122.281,2260,8839,463000,2,5,2014,0,66,5610,6579,0,0,1
3,2.5,1640,1269,3.0,0,0,3,8,1640,0,2009,0,98112,47.6197,-122.3,1590,1231,579000,23,6,2014,0,5,-371,-359,0,0,1
6,3.75,4000,6015,2.0,0,2,3,10,3080,920,2004,0,98058,47.453,-122.118,3180,5700,570000,9,7,2014,0,10,2015,2520,0,1,0
5,4.5,4140,7924,2.0,0,0,3,10,4140,0,2005,0,98074,47.6102,-121.993,3960,8410,1060000,31,3,2015,0,10,3784,4450,0,0,0
2,1.75,1320,2609,1.0,0,0,4,7,920,400,1938,0,98117,47.6878,-122.366,1200,4220,422000,9,12,2014,0,76,1289,3020,0,1,1
4,3.5,3080,4945,2.0,0,0,3,9,2010,1070,2014,0,98126,47.5662,-122.379,1220,4945,866500,9,2,2015,0,1,1865,3725,0,1,1
3,2.5,2500,10359,2.0,0,0,3,10,2500,0,1986,0,98074,47.6286,-122.051,2580,10142,705000,13,4,2015,0,29,7859,7562,0,0,0
4,2.5,2520,9684,2.0,0,0,3,8,2520,0,1994,0,98045,47.4848,-121.801,2090,10133,470000,29,10,2014,0,20,7164,8043,0,0,0
3,1.25,2350,6200,1.0,0,0,4,7,1320,1030,1966,0,98007,47.5979,-122.135,2140,9543,360000,18,12,2014,0,48,3850,7403,0,1,0
4,2.5,2570,13450,1.0,0,4,3,8,1510,1060,1948,0,98155,47.7429,-122.285,3470,12615,795000,29,4,2015,0,67,10880,9145,0,1,1
4,2.5,3100,7807,2.0,0,0,3,9,3100,0,2003,0,98034,47.7151,-122.227,3100,7807,800000,30,3,2015,0,12,4707,4707,0,0,0
4,3.5,4730,13586,1.5,0,0,5,10,4270,460,1935,0,98112,47.6319,-122.288,3710,8828,2450000,29,5,2014,0,79,8856,5118,0,1,1
3,1.75,1030,4800,1.0,0,0,3,6,930,100,1927,0,98126,47.566,-122.373,1540,4800,277284,8,4,2015,0,88,3770,3260,0,1,1
2,1.0,1020,4002,1.0,0,0,5,7,1020,0,1953,0,98116,47.5828,-122.395,1780,5000,460000,13,4,2015,0,62,2982,3220,0,0,1
3,2.5,2080,3729,2.0,0,0,3,9,2080,0,1996,0,98033,47.6731,-122.199,2080,4000,898888,4,5,2015,0,19,1649,1920,0,0,0
2,2.0,1360,3300,2.0,0,0,3,6,1360,0,2004,0,98038,47.3489,-122.022,1310,3300,222000,28,8,2014,0,10,1940,1990,0,0,0
3,1.75,1490,9493,1.0,0,0,4,8,1490,0,1976,0,98058,47.4514,-122.134,2440,9600,312500,21,1,2015,0,39,8003,7160,0,0,0
4,2.5,2530,6500,1.5,0,0,3,8,1720,810,1975,0,98115,47.6737,-122.284,2150,5280,650000,14,7,2014,0,39,3970,3130,0,1,1
6,2.25,3140,10250,1.0,0,0,4,8,1570,1570,1959,0,98005,47.6116,-122.169,2320,10250,740000,26,8,2014,0,55,7110,7930,0,1,0
4,2.5,1770,13168,2.0,0,0,3,7,1770,0,1990,0,98019,47.7306,-121.966,2050,14859,455000,8,5,2015,0,25,11398,12809,0,0,0
5,4.0,4430,9000,2.0,0,0,3,10,4430,0,2013,0,98004,47.6168,-122.216,2470,9490,2450000,13,5,2014,0,1,4570,7020,0,0,0
3,3.25,1490,902,3.0,0,0,3,8,1220,270,2001,0,98102,47.6357,-122.324,1550,1092,500000,3,12,2014,0,13,-588,-458,0,1,1
3,2.5,1710,1296,3.0,0,0,3,8,1510,200,2004,0,98103,47.6963,-122.342,1610,1282,416000,12,9,2014,0,10,-414,-328,0,1,1
2,1.0,1140,5400,1.0,0,0,5,7,1140,0,1908,0,98112,47.6205,-122.294,1520,4800,549000,5,5,2014,0,106,4260,3280,0,0,1
5,2.0,3930,10150,1.5,0,0,4,8,3070,860,1968,0,98008,47.6317,-122.114,2200,8190,589000,25,8,2014,0,46,6220,5990,0,1,0
3,2.5,2260,5500,1.5,0,0,3,7,1280,980,1910,0,98117,47.681,-122.388,1790,5355,405000,16,12,2014,0,104,3240,3565,0,1,1
3,2.5,2260,5500,1.5,0,0,3,7,1280,980,1910,0,98117,47.681,-122.388,1790,5355,625000,8,4,2015,0,105,3240,3565,0,1,1
3,1.0,1130,7014,1.0,0,0,3,7,1130,0,1954,0,98168,47.4743,-122.274,1440,9350,205000,13,11,2014,0,60,5884,7910,0,0,1
3,3.75,1950,8625,1.0,0,0,3,8,1360,590,1959,0,98178,47.505,-122.258,1950,6670,345100,23,6,2014,0,55,6675,4720,0,1,1
3,1.0,960,7500,1.0,0,0,3,6,960,0,1953,0,98178,47.4966,-122.255,1250,6000,200000,20,10,2014,0,61,6540,4750,0,0,1
5,3.0,2140,5937,1.0,0,0,3,7,1280,860,1978,0,98118,47.5459,-122.27,1820,6710,367777,9,12,2014,0,36,3797,4890,0,1,1
3,2.75,2520,5401,1.0,0,0,4,7,1360,1160,1946,0,98119,47.6452,-122.373,1800,5036,750000,7,5,2014,0,68,2881,3236,0,1,1
5,2.25,3550,7992,2.0,0,0,3,8,3550,0,1968,0,98034,47.7285,-122.179,2110,7992,575000,5,11,2014,0,46,4442,5882,0,0,0
2,1.0,740,5000,1.0,0,0,4,6,740,0,1926,0,98118,47.5298,-122.273,1170,4968,255000,18,12,2014,0,88,4260,3798,0,0,1
4,3.75,3300,4545,1.5,0,4,3,10,2600,700,1926,1999,98105,47.6561,-122.274,3300,5000,1740000,20,5,2014,73,88,1245,1700,1,1,1
3,2.25,1640,5880,1.0,0,0,3,7,1240,400,1977,0,98106,47.5323,-122.351,1200,4760,415000,13,5,2015,0,38,4240,3560,0,1,1
3,2.5,2780,8225,2.0,0,1,3,9,2780,0,1990,0,98198,47.3509,-122.323,720,9736,449900,7,5,2015,0,25,5445,9016,0,0,1
4,2.5,3540,9349,2.0,0,0,3,10,3540,0,2003,0,98052,47.7046,-122.107,3280,7546,899000,10,4,2015,0,12,5809,4266,0,0,0
3,2.5,1440,7320,1.0,0,0,5,7,1440,0,1954,0,98125,47.7179,-122.316,1160,6941,430000,14,7,2014,0,60,5880,5781,0,0,1
6,2.5,3180,9375,1.0,0,0,4,8,1590,1590,1967,0,98006,47.5707,-122.129,2670,9625,680000,29,12,2014,0,47,6195,6955,0,1,0
5,4.0,3310,8400,2.0,0,0,3,10,3310,0,2000,0,98033,47.6914,-122.214,3430,8400,1650000,5,3,2015,0,15,5090,4970,0,0,0
3,2.0,2390,8025,2.0,0,0,5,7,2390,0,1921,0,98105,47.6707,-122.288,1920,5350,810000,18,11,2014,0,93,5635,3430,0,0,1
3,1.75,1630,15600,1.0,0,0,3,7,1630,0,1958,0,98033,47.68,-122.165,1830,10850,522000,25,7,2014,0,56,13970,9020,0,0,0
5,2.75,3490,8230,2.0,0,0,3,10,3490,0,2005,0,98075,47.5825,-121.97,3480,7331,759000,3,2,2015,0,10,4740,3851,0,0,0
4,2.75,2500,5257,2.0,0,0,3,8,2500,0,1966,0,98118,47.5293,-122.287,1660,5970,411000,19,5,2014,0,48,2757,4310,0,0,1
4,2.5,2080,9846,1.0,0,0,3,7,1240,840,1984,0,98001,47.3338,-122.268,1890,7977,286950,6,3,2015,0,31,7766,6087,0,1,0
3,1.5,1290,1286,3.0,0,0,3,7,1290,0,2000,0,98103,47.6617,-122.349,1720,1286,440000,10,6,2014,0,14,-4,-434,0,0,1
3,1.0,1700,8645,1.0,0,0,3,6,1700,0,1955,0,98146,47.4899,-122.337,1500,7980,149000,23,5,2014,0,59,6945,6480,0,0,1
3,1.0,1700,8645,1.0,0,0,3,6,1700,0,1955,0,98146,47.4899,-122.337,1500,7980,284700,12,11,2014,0,59,6945,6480,0,0,1
3,2.5,2540,11562,1.0,0,1,3,8,1290,1250,1964,0,98028,47.7614,-122.229,2230,10310,374950,9,9,2014,0,50,9022,8080,0,1,0
3,1.5,1180,8545,1.0,0,0,3,8,1180,0,1952,0,98004,47.624,-122.2,1660,9000,816000,16,9,2014,0,62,7365,7340,0,0,0
4,1.75,1520,15398,1.0,0,0,4,7,1370,150,1960,0,98027,47.5265,-122.05,1840,12500,533250,21,11,2014,0,54,13878,10660,0,1,0
3,2.75,2390,9313,1.0,0,0,5,8,1390,1000,1942,0,98133,47.7209,-122.331,2390,12712,689800,3,6,2014,0,72,6923,10322,0,1,1
4,2.75,2740,6200,1.5,0,3,4,8,1820,920,1947,0,98125,47.7084,-122.277,2430,6000,775000,13,8,2014,0,67,3460,3570,0,1,1
3,2.5,2190,8528,1.0,0,0,3,8,1760,430,1991,0,98033,47.6943,-122.209,2060,9811,702000,6,5,2015,0,24,6338,7751,0,1,0
3,1.0,1350,8700,1.5,0,0,3,6,1350,0,1942,0,98188,47.4497,-122.289,1300,8700,160000,8,7,2014,0,72,7350,7400,0,0,1
3,1.0,1350,8700,1.5,0,0,3,6,1350,0,1942,0,98188,47.4497,-122.289,1300,8700,255500,9,3,2015,0,73,7350,7400,0,0,1
2,1.0,790,7450,1.0,0,0,4,6,790,0,1944,0,98058,47.4743,-122.17,800,7450,169500,31,7,2014,0,70,6660,6650,0,0,0
4,2.25,2130,9000,2.0,0,0,4,8,2130,0,1965,0,98006,47.5716,-122.159,2110,10431,586000,15,9,2014,0,49,6870,8321,0,0,0
3,2.0,3200,18184,1.0,0,0,5,8,2000,1200,1977,0,98005,47.6034,-122.172,1670,7416,851500,8,12,2014,0,37,14984,5746,0,1,0
2,1.5,1159,4800,1.0,0,0,3,7,1159,0,1948,0,98199,47.6592,-122.399,1640,4800,582500,14,5,2014,0,66,3641,3160,0,0,1
3,1.0,1000,9295,1.0,0,0,3,7,1000,0,1955,0,98146,47.484,-122.346,1320,13500,225000,28,1,2015,0,60,8295,12180,0,0,1
3,3.25,2260,3727,2.0,0,0,3,8,1880,380,2003,0,98119,47.6422,-122.361,1600,4800,795000,31,12,2014,0,11,1467,3200,0,1,1
4,2.25,2270,9600,1.0,0,0,3,7,1290,980,1976,0,98023,47.3261,-122.355,1930,15000,304999,18,8,2014,0,38,7330,13070,0,1,0
1,0.75,760,5746,1.0,0,0,4,5,760,0,1915,0,98002,47.3046,-122.215,970,6696,95000,5,5,2015,0,100,4986,5726,0,0,0
4,1.75,1420,5382,1.0,0,0,5,5,1040,380,1942,0,98056,47.4946,-122.187,1150,5382,240000,16,10,2014,0,72,3962,4232,0,1,0
4,2.5,2500,8680,1.0,0,0,4,7,1250,1250,1958,0,98004,47.6073,-122.192,2140,8680,772000,13,8,2014,0,56,6180,6540,0,1,0
2,1.5,1450,6258,1.0,0,0,4,8,1450,0,1983,0,98198,47.3785,-122.322,1460,5375,245000,13,11,2014,0,31,4808,3915,0,0,1
5,3.0,2500,5750,1.0,0,0,3,8,1430,1070,1999,0,98126,47.551,-122.369,1980,7130,430000,5,12,2014,0,15,3250,5150,0,1,1
3,1.5,2210,6300,1.5,0,0,5,8,2210,0,1916,0,98144,47.5892,-122.29,2700,6300,799000,11,6,2014,0,98,4090,3600,0,0,1
5,2.75,3020,9187,2.0,0,0,3,9,3020,0,2007,0,98033,47.6806,-122.167,2250,9675,880000,17,4,2015,0,8,6167,7425,0,0,0
4,2.5,3290,7538,2.0,0,0,3,9,3290,0,2004,0,98075,47.598,-121.972,3450,7538,750000,8,12,2014,0,10,4248,4088,0,0,0
4,4.0,5780,7173,2.0,0,0,3,11,4130,1650,2008,0,98112,47.6374,-122.288,3930,7994,2890000,19,12,2014,0,6,1393,4064,0,1,1
3,2.5,1820,4910,2.0,0,0,3,8,1820,0,1993,0,98029,47.5703,-121.996,2090,6668,532000,4,6,2014,0,21,3090,4578,0,0,0
4,2.75,2500,10330,1.0,0,0,4,8,1380,1120,1978,0,98155,47.7743,-122.286,2270,10430,525000,5,8,2014,0,36,7830,8160,0,1,1
2,1.0,1210,9375,1.0,0,1,4,7,1210,0,1952,0,98198,47.3865,-122.322,1680,8400,239000,17,11,2014,0,62,8165,6720,0,0,1
2,1.5,1090,4000,1.0,0,0,3,8,970,120,1951,0,98116,47.5798,-122.393,1700,4000,460000,16,6,2014,0,63,2910,2300,0,1,1
4,2.25,1330,8400,1.5,0,0,3,8,1330,0,1962,0,98005,47.6078,-122.169,2270,10146,540000,5,6,2014,0,52,7070,7876,0,0,0
2,1.0,890,4590,1.0,0,0,3,7,890,0,1923,0,98117,47.6901,-122.362,1310,4590,475000,6,6,2014,0,91,3700,3280,0,0,1
3,1.75,1360,4998,1.0,0,0,3,8,1360,0,1968,2014,98108,47.547,-122.302,1350,4998,445000,21,4,2015,46,47,3638,3648,1,0,1
5,3.75,4220,9240,2.0,0,2,5,11,3420,800,1991,0,98040,47.5895,-122.229,3380,9240,1580000,5,9,2014,0,23,5020,5860,0,1,0
4,2.5,3780,6800,2.0,0,0,3,8,3780,0,2004,0,98038,47.3526,-122.012,3640,7326,549950,9,4,2015,0,11,3020,3686,0,0,0
4,2.0,2610,14321,1.5,0,0,4,6,1690,920,1940,0,98188,47.4672,-122.296,1630,8599,294950,17,10,2014,0,74,11711,6969,0,1,1
3,2.5,1980,2975,3.0,0,2,3,8,1980,0,1993,0,98109,47.6294,-122.344,1980,3144,736000,21,10,2014,0,21,995,1164,0,0,1
3,1.75,1290,8688,1.0,0,0,4,7,1290,0,1980,0,98042,47.3655,-122.08,1750,9090,214946,30,4,2015,0,35,7398,7340,0,0,0
5,3.25,3620,5500,2.0,0,2,3,9,3620,0,2003,0,98029,47.5442,-121.996,3260,5500,856000,30,10,2014,0,11,1880,2240,0,0,0
2,2.5,2680,7392,1.0,0,0,3,9,2680,0,2004,0,98053,47.717,-122.026,2315,7045,775000,4,5,2014,0,10,4712,4730,0,0,0
3,1.75,1200,8631,1.0,0,0,3,7,1200,0,1959,0,98198,47.3864,-122.308,1564,8115,205000,3,2,2015,0,56,7431,6551,0,0,1
2,2.75,1992,10946,1.5,1,4,5,6,1288,704,1903,0,98070,47.3551,-122.475,1110,8328,429592,1,10,2014,0,111,8954,7218,0,1,0
4,1.75,1640,13566,1.0,0,0,4,7,1120,520,1977,0,98072,47.7423,-122.099,1470,13530,414250,6,2,2015,0,38,11926,12060,0,1,0
4,2.75,1920,4400,1.0,0,0,4,6,960,960,1906,0,98106,47.5532,-122.365,1040,4400,399950,2,2,2015,0,109,2480,3360,0,1,1
3,2.25,1840,7326,1.0,0,0,5,7,1370,470,1979,0,98031,47.3958,-122.168,2050,7475,319990,14,10,2014,0,35,5486,5425,0,1,0
3,1.5,1310,9471,1.0,0,0,4,8,1310,0,1970,0,98052,47.6644,-122.148,2100,9449,524000,9,1,2015,0,45,8161,7349,0,0,0
2,1.0,1050,6317,1.5,0,0,4,7,1050,0,1913,0,98019,47.7364,-121.981,1600,9616,349950,8,1,2015,0,102,5267,8016,0,0,0
4,2.5,2570,4480,1.5,0,0,4,8,1580,990,1927,0,98105,47.6701,-122.291,2070,4480,889000,31,10,2014,0,87,1910,2410,0,1,1
3,1.0,930,5160,1.5,0,0,5,6,930,0,1919,0,98106,47.5256,-122.357,1060,5160,300000,7,7,2014,0,95,4230,4100,0,0,1
1,1.0,730,3000,1.0,0,0,3,7,730,0,1911,0,98107,47.6741,-122.396,1520,5000,395000,2,6,2014,0,103,2270,3480,0,0,1
2,2.5,1270,1242,3.0,0,0,3,7,1270,0,2008,0,98117,47.701,-122.362,1280,1199,348000,3,2,2015,0,7,-28,-81,0,0,1
2,1.0,1150,6000,1.0,0,1,4,7,710,440,1921,0,98033,47.6841,-122.213,2450,7200,830000,26,2,2015,0,94,4850,4750,0,1,0
2,1.0,820,10450,1.0,0,0,4,7,820,0,1965,0,98055,47.4261,-122.199,1240,11200,173000,12,6,2014,0,49,9630,9960,0,0,0
3,2.0,2220,5000,1.0,0,0,4,7,1110,1110,1966,0,98116,47.5807,-122.394,1450,5000,576750,13,2,2015,0,49,2780,3550,0,1,1
5,3.25,2500,7620,1.0,0,3,3,7,1250,1250,1962,0,98106,47.5298,-122.344,2020,7620,495000,4,5,2015,0,53,5120,5600,0,1,1
3,3.5,1540,1427,2.0,0,0,3,7,1360,180,2007,0,98109,47.542,-122.322,1220,4000,216650,15,10,2014,0,7,-113,2780,0,1,1
4,2.75,2750,15450,1.0,0,0,3,8,1800,950,1978,0,98155,47.7749,-122.283,2750,10620,615000,13,4,2015,0,37,12700,7870,0,1,1
4,2.5,3130,12463,1.0,0,0,4,8,1620,1510,1978,0,98006,47.569,-122.127,2740,11779,675000,24,10,2014,0,36,9333,9039,0,1,0
3,2.0,1430,9250,1.0,0,0,4,8,990,440,1983,0,98052,47.6952,-122.096,1830,8003,510000,1,4,2015,0,32,7820,6173,0,1,0
4,2.5,3010,5701,2.0,0,0,3,8,3010,0,2003,0,98042,47.3492,-122.152,3010,5772,359950,1,8,2014,0,11,2691,2762,0,0,0
3,1.5,1530,7500,1.5,0,0,3,7,1530,0,1986,0,98038,47.3639,-122.055,2080,11250,265000,3,10,2014,0,28,5970,9170,0,0,0
3,1.0,1240,4842,1.0,0,0,4,6,1240,0,1916,0,98118,47.5166,-122.269,1540,5110,210000,21,5,2014,0,98,3602,3570,0,0,1
4,2.25,2820,5000,1.5,0,2,4,9,1800,1020,1926,0,98122,47.6097,-122.287,2880,6000,1080000,13,4,2015,0,89,2180,3120,0,1,1
3,2.5,3560,8297,1.0,0,2,4,8,1650,1910,1948,0,98199,47.6473,-122.407,2760,8297,756000,11,2,2015,0,67,4737,5537,0,1,1
3,2.25,1630,9145,1.0,0,0,3,7,1630,0,1960,0,98146,47.5,-122.347,1630,9206,203000,24,7,2014,0,54,7515,7576,0,0,1
3,3.25,2200,7440,2.0,0,0,4,7,1710,490,1947,0,98118,47.5409,-122.268,1260,6765,525000,23,3,2015,0,68,5240,5505,0,1,1
3,1.75,1620,7500,1.0,0,0,3,7,1220,400,1981,0,98059,47.4815,-122.162,1470,7938,347500,9,3,2015,0,34,5880,6468,0,1,0
3,1.75,1480,2185,2.5,0,0,3,9,1480,0,2005,0,98034,47.6945,-122.17,1480,2441,620000,5,5,2014,0,9,705,961,0,0,0
4,2.5,2250,10696,2.0,0,0,3,8,2250,0,1996,0,98006,47.5715,-122.128,2340,13286,645000,22,4,2015,0,19,8446,10946,0,0,0
4,3.0,3540,11098,2.0,0,0,3,10,3000,540,1940,0,98112,47.634,-122.288,3430,8214,2200000,3,12,2014,0,74,7558,4784,0,1,1
3,2.0,1400,6380,1.0,0,0,4,7,700,700,1924,0,98125,47.7015,-122.316,1690,5800,432000,1,5,2015,0,91,4980,4110,0,1,1
3,1.5,2390,4452,2.0,0,1,3,9,1790,600,1929,0,98126,47.5826,-122.378,2610,5000,790000,22,12,2014,0,85,2062,2390,0,1,1
4,1.75,2400,10050,1.0,0,0,5,8,2400,0,1957,0,98008,47.6339,-122.124,1680,10050,635000,13,1,2015,0,58,7650,8370,0,0,0
3,1.5,2050,6384,1.0,0,0,3,7,1350,700,1958,0,98126,47.5325,-122.378,1590,7214,442000,19,8,2014,0,56,4334,5624,0,1,1
4,3.0,2640,5267,2.0,0,0,3,7,2640,0,2001,0,98065,47.5298,-121.88,2640,5670,490000,22,4,2015,0,14,2627,3030,0,0,0
5,1.75,2320,7700,1.0,0,0,5,7,1290,1030,1962,0,98001,47.3426,-122.285,1740,7210,250000,25,9,2014,0,52,5380,5470,0,1,0
4,2.5,2440,3600,2.5,0,0,4,8,2440,0,1902,0,98119,47.6298,-122.362,2440,5440,1330000,19,6,2014,0,112,1160,3000,0,0,1
3,1.0,1260,7500,1.0,0,0,3,6,1260,0,1954,0,98198,47.4191,-122.33,1260,7500,120000,27,10,2014,0,60,6240,6240,0,0,1
4,2.5,1930,8458,2.0,0,0,3,7,1930,0,1993,0,98038,47.3645,-122.039,1670,9485,325000,23,9,2014,0,21,6528,7815,0,0,0
4,1.75,1200,7680,1.0,0,0,3,7,1200,0,1968,0,98092,47.3138,-122.192,1490,7800,210000,12,6,2014,0,46,6480,6310,0,0,0
1,1.0,970,7639,1.0,0,0,4,5,570,400,1920,0,98166,47.4655,-122.346,1360,7380,215000,4,5,2015,0,95,6669,6020,0,1,1
3,1.75,1810,10800,1.0,0,0,5,8,1210,600,1968,0,98056,47.5236,-122.184,1800,10800,387000,29,10,2014,0,46,8990,9000,0,1,0
3,1.0,1380,7015,1.5,0,0,4,7,1380,0,1925,0,98117,47.6987,-122.36,1160,6700,408000,18,9,2014,0,89,5635,5540,0,0,1
3,1.0,1470,6500,1.0,0,0,4,7,1470,0,1953,0,98166,47.473,-122.362,1470,9300,410000,10,7,2014,0,61,5030,7830,0,0,1
3,1.0,1010,7920,1.0,0,0,3,6,1010,0,1925,0,98126,47.5249,-122.37,1520,7560,216000,16,12,2014,0,89,6910,6040,0,0,1
3,1.0,1010,7920,1.0,0,0,3,6,1010,0,1925,0,98126,47.5249,-122.37,1520,7560,390000,30,3,2015,0,90,6910,6040,0,0,1
3,1.5,1340,11744,1.0,0,0,2,7,1340,0,1950,0,98146,47.4947,-122.36,2020,13673,357000,11,12,2014,0,64,10404,11653,0,0,1
3,1.0,970,7275,1.0,0,0,4,7,970,0,1970,0,98031,47.4006,-122.188,1750,7200,215000,19,5,2014,0,44,6305,5450,0,0,0
3,1.0,1122,6554,1.5,0,0,3,5,1122,0,1900,0,98118,47.5135,-122.257,1610,5650,265000,13,2,2015,0,115,5432,4040,0,0,1
3,2.75,1670,1350,3.0,0,0,3,9,1350,320,2014,0,98116,47.5763,-122.408,1520,4800,589950,9,12,2014,0,0,-320,3280,0,1,1
3,1.75,2840,16851,1.0,0,3,3,8,1600,1240,1950,0,98155,47.7458,-122.287,2650,11063,440000,6,2,2015,0,65,14011,8413,0,1,1
2,1.0,770,8600,1.0,0,0,4,4,770,0,1914,0,98027,47.5325,-122.031,1420,6960,248000,29,4,2015,0,101,7830,5540,0,0,0
4,2.5,3052,12145,2.0,0,0,3,8,3052,0,2004,0,98003,47.2598,-122.304,2767,8604,425000,19,1,2015,0,11,9093,5837,0,0,0
3,2.5,2620,14248,2.0,0,0,4,8,1830,790,1977,0,98004,47.6281,-122.194,2620,12343,680000,12,9,2014,0,37,11628,9723,0,1,0
5,2.25,3120,10400,2.0,0,0,3,8,3120,0,1980,0,98023,47.3097,-122.34,2160,8267,341500,18,2,2015,0,35,7280,6107,0,0,0
2,1.0,1100,3975,1.0,0,0,3,7,900,200,1950,0,98105,47.6701,-122.286,1110,4280,395000,8,5,2015,0,65,2875,3170,0,1,1
5,2.75,2510,9180,1.0,0,1,4,8,1600,910,1975,0,98052,47.6389,-122.098,2650,9780,695500,8,7,2014,0,39,6670,7130,0,1,0
3,1.75,1680,8629,1.0,0,0,3,8,1200,480,1977,0,98198,47.3662,-122.319,1990,8400,308000,2,10,2014,0,37,6949,6410,0,1,1
2,1.0,1040,6900,1.0,0,0,4,7,1040,0,1915,0,98136,47.5411,-122.391,1620,6280,418000,21,4,2015,0,100,5860,4660,0,0,1
5,1.5,1750,9780,1.5,0,0,4,7,1750,0,1961,0,98028,47.7755,-122.235,1750,10295,385000,7,10,2014,0,53,8030,8545,0,0,0
3,2.5,1639,2710,2.0,0,0,3,8,1479,160,2003,0,98144,47.5924,-122.294,1580,1733,450000,21,8,2014,0,11,1071,153,0,1,1
4,2.25,2100,9984,1.0,0,0,4,7,1290,810,1973,0,98028,47.7365,-122.242,1930,10511,418800,25,6,2014,0,41,7884,8581,0,1,0
2,1.0,880,1753,2.0,0,0,4,7,880,0,1945,0,98199,47.6475,-122.397,1010,1748,330000,8,10,2014,0,69,873,738,0,0,1
3,1.75,1940,8376,1.0,0,0,4,8,1290,650,1963,0,98006,47.5586,-122.173,2400,8674,550000,16,4,2015,0,52,6436,6274,0,1,0
4,2.5,2490,11650,1.0,0,0,3,7,1390,1100,1990,0,98148,47.4416,-122.332,2010,10495,270000,30,10,2014,0,24,9160,8485,0,1,1
3,2.25,2060,7080,2.0,0,0,3,9,1800,260,1940,0,98199,47.6455,-122.409,3070,7500,978500,29,4,2015,0,75,5020,4430,0,1,1
4,2.5,2720,10455,2.0,0,2,3,10,2500,220,1981,0,98006,47.5564,-122.158,3240,12348,975000,30,9,2014,0,33,7735,9108,0,1,0
3,2.25,2180,6850,1.0,0,0,3,7,1750,430,1973,0,98034,47.7246,-122.217,1740,7016,455000,25,7,2014,0,41,4670,5276,0,1,0
2,1.0,840,9000,1.0,0,0,5,6,840,0,1951,0,98168,47.5033,-122.329,1350,10400,220000,6,4,2015,0,64,8160,9050,0,0,1
3,2.0,2370,12196,2.0,0,0,4,7,2370,0,1970,0,98033,47.6734,-122.176,1380,12196,490000,13,8,2014,0,44,9826,10816,0,0,0
4,2.25,2270,9100,2.0,0,0,3,7,2270,0,1978,0,98034,47.7242,-122.17,1710,7910,420000,21,4,2015,0,37,6830,6200,0,0,0
4,2.5,2720,7043,2.0,0,0,3,9,2720,0,2003,0,98092,47.3315,-122.169,2640,6958,408500,8,12,2014,0,11,4323,4318,0,0,0
3,1.5,1140,4800,1.5,0,0,3,7,1140,0,1915,0,98109,47.6368,-122.354,1260,4800,716000,27,3,2015,0,100,3660,3540,0,0,1
4,2.5,2460,5000,2.0,0,0,5,8,1620,840,1938,0,98112,47.6282,-122.293,2320,5000,965000,2,6,2014,0,76,2540,2680,0,1,1
3,1.5,1240,9196,1.0,0,0,3,8,1240,0,1968,0,98072,47.7562,-122.094,1690,10800,357823,13,1,2015,0,47,7956,9110,0,0,0
3,2.25,1670,9500,1.0,0,0,3,7,1170,500,1977,0,98125,47.7253,-122.309,1470,9500,425000,5,8,2014,0,37,7830,8030,0,1,1
4,1.75,2220,6731,1.0,0,0,4,7,1110,1110,1953,0,98116,47.5691,-122.391,1600,6350,711777,16,4,2015,0,62,4511,4750,0,1,1
3,1.0,980,9903,1.0,0,0,4,7,980,0,1966,0,98028,47.7746,-122.239,1830,9903,335000,1,12,2014,0,48,8923,8073,0,0,0
4,1.5,1890,6938,1.5,0,0,3,8,1890,0,1919,0,98116,47.5896,-122.389,1700,6250,825000,16,6,2014,0,95,5048,4550,0,0,1
2,1.0,1100,6000,1.5,0,0,4,6,1100,0,1900,0,98108,47.5275,-122.323,1280,6000,210000,1,5,2015,0,115,4900,4720,0,0,1
4,2.75,4250,10925,2.0,0,0,3,10,4250,0,2003,0,98059,47.5297,-122.14,4650,11544,1210000,4,4,2015,0,12,6675,6894,0,0,0
2,2.0,1370,4866,1.0,0,0,3,8,1370,0,2005,0,98053,47.704,-122.012,1365,4784,431500,1,8,2014,0,9,3496,3419,0,0,0
3,1.5,1480,13457,1.0,0,0,3,7,1480,0,1959,0,98007,47.5914,-122.136,2100,10517,475000,3,9,2014,0,55,11977,8417,0,0,0
4,3.75,3770,4000,2.5,0,0,5,9,2890,880,1916,0,98122,47.6157,-122.287,2800,5000,1500000,26,11,2014,0,98,230,2200,0,1,1
3,2.5,1530,2978,1.0,0,0,3,7,1210,320,1997,0,98117,47.6796,-122.39,1640,5100,635000,16,7,2014,0,17,1448,3460,0,1,1
3,2.75,4120,16365,1.0,0,2,3,12,4120,0,1999,0,98059,47.5265,-122.148,4020,14110,1300000,7,4,2015,0,16,12245,10090,0,0,0
3,2.25,1590,7267,1.0,0,0,4,7,1100,490,1976,0,98133,47.7457,-122.332,2060,8336,405000,1,8,2014,0,38,5677,6276,0,1,1
3,1.0,1520,8600,1.0,0,0,3,6,1040,480,1951,0,98168,47.5134,-122.335,1320,8600,210000,21,7,2014,0,63,7080,7280,0,1,1
4,2.5,2350,4675,2.0,0,0,3,9,2150,200,1923,0,98112,47.6344,-122.305,2240,3848,880000,4,5,2015,0,92,2325,1608,0,1,1
4,2.0,1370,8837,1.5,0,0,3,7,1370,0,1955,0,98188,47.4386,-122.285,1360,9000,239000,24,10,2014,0,59,7467,7640,0,0,1
3,2.5,1540,6100,1.0,0,0,3,6,770,770,1944,2014,98126,47.5696,-122.378,1710,5950,515000,14,7,2014,70,70,4560,4240,1,1,1
4,2.25,1500,5393,2.0,0,0,3,7,1500,0,1999,0,98001,47.3378,-122.262,1500,5952,215000,22,7,2014,0,15,3893,4452,0,0,0
6,2.0,1750,17685,1.0,0,0,4,5,1750,0,1943,0,98056,47.5096,-122.178,1750,9209,315000,9,4,2015,0,72,15935,7459,0,0,0
3,1.5,1800,8303,1.0,0,0,3,7,1200,600,1957,0,98133,47.7693,-122.357,1800,8171,442500,30,7,2014,0,57,6503,6371,0,1,1
2,1.0,830,6030,1.0,0,0,4,6,830,0,1925,0,98103,47.6994,-122.347,1280,6030,425000,17,12,2014,0,89,5200,4750,0,0,1
3,1.75,1540,9450,1.0,0,0,4,6,1040,500,1919,0,98103,47.6985,-122.348,1200,5400,433500,4,9,2014,0,95,7910,4200,0,1,1
3,2.25,1610,8296,2.0,0,0,3,8,1610,0,1978,0,98115,47.7,-122.297,1610,8288,450000,4,8,2014,0,36,6686,6678,0,0,1
3,2.25,1990,10260,2.0,0,0,4,8,1990,0,1987,0,98052,47.6801,-122.115,1990,10260,675000,20,5,2014,0,27,8270,8270,0,0,0
3,2.5,2070,4132,2.0,0,0,3,8,2070,0,1999,0,98074,47.6036,-122.015,1530,5606,535000,24,6,2014,0,15,2062,4076,0,0,0
3,1.75,1760,12874,1.0,0,0,4,7,1230,530,1967,0,98005,47.5906,-122.167,1950,10240,577000,13,6,2014,0,47,11114,8290,0,1,0
3,1.75,1740,8528,1.0,0,0,4,7,1290,450,1939,0,98125,47.7097,-122.303,1610,8528,480000,17,12,2014,0,75,6788,6918,0,1,1
3,1.5,1950,4473,1.0,0,0,4,6,1530,420,1914,0,98034,47.7094,-122.228,2670,14256,400000,12,1,2015,0,101,2523,11586,0,1,0
3,1.0,1280,8184,1.5,0,0,4,6,1280,0,1947,0,98155,47.7467,-122.319,1120,8184,304000,13,6,2014,0,67,6904,7064,0,0,1
3,1.75,1460,7203,1.0,0,0,3,7,1460,0,1990,0,98056,47.5049,-122.189,1570,7203,355000,25,3,2015,0,25,5743,5633,0,0,0
4,1.75,2410,8447,2.0,0,3,4,8,2060,350,1936,1980,98074,47.6499,-122.088,2520,14789,550000,14,8,2014,44,78,6037,12269,1,1,0
4,1.75,2410,8447,2.0,0,3,4,8,2060,350,1936,1980,98074,47.6499,-122.088,2520,14789,550000,16,10,2014,44,78,6037,12269,1,1,0
3,1.75,1400,7300,2.0,0,0,3,6,1400,0,1948,0,98178,47.4999,-122.268,1440,10825,210000,21,8,2014,0,66,5900,9385,0,0,1
3,2.5,2100,7587,2.0,0,0,3,9,2100,0,1990,0,98023,47.3072,-122.391,2330,8119,317000,26,2,2015,0,25,5487,5789,0,0,0
3,1.0,1000,9150,1.0,0,0,3,7,1000,0,1969,0,98059,47.4829,-122.124,1490,10647,265000,16,6,2014,0,45,8150,9157,0,0,0
4,3.5,3150,6175,2.0,0,0,3,9,3150,0,2001,0,98075,47.5966,-122.017,3150,6986,700000,2,9,2014,0,13,3025,3836,0,0,0
5,3.5,4180,17841,2.0,0,2,3,10,3160,1020,1990,0,98075,47.5618,-122.037,3260,12608,1020000,8,9,2014,0,24,13661,9348,0,1,0
2,1.5,1660,4000,1.0,0,0,3,7,1000,660,1950,0,98115,47.6832,-122.304,1570,5500,410000,24,9,2014,0,64,2340,3930,0,1,1
4,3.0,2160,4400,1.0,0,0,5,7,1320,840,1921,0,98122,47.6163,-122.293,1430,4400,665000,5,9,2014,0,93,2240,2970,0,1,1
4,2.5,2420,7744,2.0,0,0,3,9,2420,0,1994,0,98056,47.534,-122.18,2820,11129,600000,14,4,2015,0,21,5324,8309,0,0,0
4,1.75,1920,3844,1.0,0,0,3,7,1170,750,1967,0,98133,47.7041,-122.353,1480,3844,502000,4,5,2015,0,48,1924,2364,0,1,1
4,2.5,2310,8030,2.0,0,0,3,7,2310,0,1978,0,98019,47.7433,-121.982,1780,8041,364950,4,6,2014,0,36,5720,6261,0,0,0
3,2.25,2330,4000,1.5,0,2,5,7,1520,810,1927,0,98115,47.6732,-122.29,1870,4000,680000,29,5,2014,0,87,1670,2130,0,1,1
5,2.5,2340,13713,1.0,0,0,2,8,1670,670,1967,0,98003,47.3307,-122.324,2080,11000,235500,8,7,2014,0,47,11373,8920,0,1,0
4,2.5,2590,5756,2.0,0,0,3,8,2590,0,2001,0,98065,47.5356,-121.875,2620,6109,576000,21,7,2014,0,13,3166,3489,0,0,0
2,3.0,1410,1240,2.0,0,0,3,8,1140,270,2006,0,98136,47.5221,-122.39,1410,1273,405000,5,5,2014,0,8,-170,-137,0,1,1
3,2.75,2850,8039,1.0,0,0,4,8,1540,1310,1989,0,98031,47.4141,-122.204,2240,7727,335000,16,7,2014,0,25,5189,5487,0,1,0
2,1.0,730,6728,1.0,0,0,3,6,730,0,1953,0,98148,47.4275,-122.324,1170,7034,122000,20,4,2015,0,62,5998,5864,0,0,1
3,1.75,1470,6250,1.0,0,3,4,7,1070,400,1939,0,98155,47.7394,-122.288,2630,7050,432000,6,6,2014,0,75,4780,4420,0,1,1
4,2.25,2330,11400,1.0,0,0,4,8,2330,0,1974,0,98058,47.4495,-122.148,2640,10200,375000,27,8,2014,0,40,9070,7560,0,0,0
4,2.25,2460,11250,1.0,0,0,4,8,2460,0,1959,0,98002,47.3182,-122.212,1630,10216,276000,25,6,2014,0,55,8790,8586,0,0,0
2,1.0,990,8140,1.0,0,0,1,6,990,0,1910,0,98116,47.5828,-122.382,2150,5000,210000,11,5,2015,0,105,7150,2850,0,0,1
3,2.5,1450,4106,2.0,0,0,3,7,1450,0,2011,0,98038,47.3655,-122.019,2000,4000,279000,21,11,2014,0,3,2656,2000,0,0,0
3,1.75,1340,3900,2.0,0,0,5,7,1340,0,1900,0,98107,47.6711,-122.379,1470,1611,635000,23,2,2015,0,115,2560,141,0,0,1
3,2.5,2730,7372,2.0,0,0,3,9,2730,0,1998,0,98023,47.2831,-122.346,2710,8343,350000,20,2,2015,0,17,4642,5633,0,0,0
3,1.0,1140,7560,1.0,0,0,4,6,1140,0,1958,0,98058,47.4624,-122.185,1300,7560,218000,24,9,2014,0,56,6420,6260,0,0,0
4,1.5,1950,6300,1.5,0,1,3,7,1650,300,1944,0,98115,47.6819,-122.271,1760,6300,750000,24,3,2015,0,71,4350,4540,0,1,1
5,2.75,3390,5211,2.0,0,0,3,9,3390,0,2004,0,98075,47.5977,-121.981,3210,5211,735000,27,5,2014,0,10,1821,2001,0,0,0
1,1.0,720,6000,1.0,0,0,3,6,720,0,1940,0,98108,47.5266,-122.316,1040,6000,155000,2,6,2014,0,74,5280,4960,0,0,1
3,1.0,940,10368,1.0,0,0,3,7,940,0,1965,0,98052,47.6608,-122.133,2090,9620,354000,11,6,2014,0,49,9428,7530,0,0,0
3,1.75,1770,10513,1.0,0,0,4,7,1400,370,1982,0,98028,47.7726,-122.266,2070,9968,415000,7,5,2015,0,33,8743,7898,0,1,0
1,1.0,590,833,1.0,0,0,4,7,590,0,1926,0,98122,47.6082,-122.299,780,1617,202000,1,7,2014,0,88,243,837,0,0,1
3,2.5,1980,1873,2.0,0,0,3,7,1470,510,1996,0,98107,47.6659,-122.369,1500,1873,580000,6,5,2015,0,19,-107,373,0,1,1
4,3.25,3070,10375,2.0,0,0,3,10,2180,890,1962,2005,98004,47.5862,-122.198,2500,11194,1500000,22,10,2014,43,52,7305,8694,1,1,0
4,2.5,3500,7519,2.0,0,0,3,9,3500,0,2004,0,98053,47.6799,-122.024,3920,7982,790000,8,10,2014,0,10,4019,4062,0,0,0
3,2.5,2100,5112,2.0,0,0,3,8,2100,0,1999,0,98065,47.5338,-121.867,2100,4370,499900,5,3,2015,0,16,3012,2270,0,0,0
4,2.5,2810,10613,2.0,0,0,3,9,2810,0,1989,0,98006,47.5424,-122.141,2800,9933,810000,22,6,2014,0,25,7803,7133,0,0,0
4,1.5,2290,8773,1.0,0,0,4,7,1330,960,1947,0,98133,47.7173,-122.33,1740,7058,425000,20,2,2015,0,68,6483,5318,0,1,1
3,1.75,1350,7588,1.0,0,0,3,7,1350,0,1993,0,98010,47.3123,-122.023,1470,7341,241250,26,12,2014,0,21,6238,5871,0,0,0
4,1.75,2530,5000,1.5,0,2,5,8,2070,460,1917,0,98103,47.6624,-122.348,1950,3600,720000,27,8,2014,0,97,2470,1650,0,1,1
3,1.0,1280,10500,1.5,0,0,4,5,1280,0,1941,0,98024,47.566,-121.894,1410,10500,291000,15,7,2014,0,73,9220,9090,0,0,0
2,1.75,1000,3554,1.0,0,0,4,8,1000,0,1975,0,98198,47.3811,-122.32,1150,4000,210000,26,7,2014,0,39,2554,2850,0,0,1
3,3.25,3870,11000,2.0,0,2,3,9,2970,900,1991,0,98106,47.5545,-122.354,2970,11000,645000,27,4,2015,0,24,7130,8030,0,1,1
5,2.0,3370,5000,1.5,0,0,4,7,2140,1230,1907,0,98109,47.6373,-122.35,1920,3200,762000,19,5,2014,0,107,1630,1280,0,1,1
4,1.75,2290,7765,1.0,0,0,3,6,2290,0,1936,1953,98146,47.4997,-122.353,1240,8215,247500,24,7,2014,17,78,5475,6975,1,0,1
3,2.25,1670,7150,2.0,0,0,4,7,1670,0,1990,0,98042,47.3603,-122.088,1570,7040,282500,23,7,2014,0,24,5480,5470,0,0,0
3,1.75,1770,8235,1.0,0,0,3,7,1030,740,1960,0,98148,47.4323,-122.328,1560,8918,295000,16,6,2014,0,54,6465,7358,0,1,1
2,1.0,820,5100,1.0,0,0,4,6,820,0,1954,0,98056,47.5175,-122.205,2270,5100,235000,26,8,2014,0,60,4280,2830,0,0,0
3,1.75,1900,6334,1.0,0,2,3,8,1450,450,1948,0,98105,47.6675,-122.276,1530,6334,770000,1,10,2014,0,66,4434,4804,0,1,1
2,2.0,1870,4950,1.0,0,0,3,8,1870,0,2006,0,98053,47.7195,-122.022,1670,4800,559950,8,5,2014,0,8,3080,3130,0,0,0
4,2.0,1840,5419,1.0,0,0,4,7,920,920,1942,0,98199,47.6483,-122.404,1800,5419,639000,10,7,2014,0,72,3579,3619,0,1,1
3,1.0,1590,8470,1.0,0,0,4,7,1140,450,1967,0,98058,47.4473,-122.159,1570,9375,314950,28,4,2015,0,48,6880,7805,0,1,0
3,1.0,1640,6180,1.0,0,0,4,7,1640,0,1946,0,98118,47.5682,-122.284,1540,6180,525000,24,3,2015,0,69,4540,4640,0,0,1
3,1.75,2160,6272,1.0,0,0,4,8,1390,770,1960,0,98115,47.6777,-122.306,1290,5376,820000,2,6,2014,0,54,4112,4086,0,1,1
3,3.0,2490,3600,2.0,0,3,4,8,1790,700,1911,0,98119,47.6313,-122.369,2490,3600,1390000,11,9,2014,0,103,1110,1110,0,1,1
3,2.0,1290,5700,1.0,0,0,5,7,1290,0,1950,0,98116,47.5713,-122.397,1160,5700,521450,17,10,2014,0,64,4410,4540,0,0,1
3,2.0,2140,7200,1.0,0,0,4,8,1480,660,1966,0,98056,47.5084,-122.185,2070,7220,346150,19,6,2014,0,48,5060,5150,0,1,0
2,1.0,980,3800,1.0,0,0,3,7,980,0,1926,0,98103,47.6903,-122.34,1520,5010,390000,22,4,2015,0,89,2820,3490,0,0,1
5,2.25,2450,9432,2.0,0,0,3,8,2450,0,1973,0,98058,47.4519,-122.13,2310,9100,359950,24,9,2014,0,41,6982,6790,0,0,0
3,2.0,1360,5120,1.5,0,0,4,6,910,450,1924,0,98116,47.5587,-122.393,1440,5120,430000,3,6,2014,0,90,3760,3680,0,1,1
4,3.5,4610,11676,2.0,0,0,3,10,4610,0,2000,0,98075,47.6011,-121.983,3900,11164,960000,24,4,2015,0,15,7066,7264,0,0,0
3,2.5,2860,5805,2.0,0,0,3,9,2860,0,1999,0,98005,47.6218,-122.16,2360,5832,1010000,8,1,2015,0,16,2945,3472,0,0,0
3,2.0,1810,11456,1.0,0,0,3,7,1810,0,1970,0,98045,47.4648,-121.756,1360,12931,290000,20,1,2015,0,45,9646,11571,0,0,0
4,2.0,2240,10296,1.0,0,0,5,8,2240,0,1948,0,98004,47.6177,-122.217,2500,10918,1350000,17,3,2015,0,67,8056,8418,0,0,0
2,1.0,1450,4500,1.5,0,0,4,7,1450,0,1921,0,98107,47.6739,-122.396,1470,5000,526000,7,10,2014,0,93,3050,3530,0,0,1
3,3.5,1450,1091,2.0,0,0,3,8,1200,250,2007,0,98119,47.6475,-122.359,1490,3017,550000,18,4,2015,0,8,-359,1527,0,1,1
3,1.5,1820,8750,1.0,0,0,4,7,1200,620,1958,0,98198,47.4213,-122.322,1500,8000,276000,23,12,2014,0,56,6930,6500,0,1,1
5,3.25,5620,12672,2.0,0,0,4,11,4140,1480,1916,0,98144,47.5786,-122.287,4470,8050,2500000,29,12,2014,0,98,7052,3580,0,1,1
3,1.75,2080,6554,1.0,0,0,3,7,1040,1040,1950,0,98118,47.5135,-122.257,1230,5650,325000,22,1,2015,0,65,4474,4420,0,1,1
3,2.5,1780,1754,3.0,0,0,3,8,1780,0,2007,0,98126,47.548,-122.373,1780,1607,365000,26,9,2014,0,7,-26,-173,0,0,1
8,6.0,4340,9415,2.0,0,0,3,8,4340,0,1967,0,98004,47.6316,-122.202,2050,9100,2150000,7,10,2014,0,47,5075,7050,0,0,0
4,3.25,2860,3680,2.0,0,0,3,9,1980,880,1925,1993,98115,47.6752,-122.3,2010,3680,825050,5,3,2015,68,90,820,1670,1,1,1
3,1.5,2540,9520,1.0,0,0,3,8,1500,1040,1959,0,98115,47.6834,-122.306,1870,6800,690000,21,7,2014,0,55,6980,4930,0,1,1
4,1.0,1140,6250,1.5,0,0,3,6,1140,0,1958,0,98126,47.5433,-122.375,1140,1370,390000,15,4,2015,0,57,5110,230,0,0,1
3,2.0,1320,1297,3.0,0,0,3,7,1320,0,1995,0,98117,47.6959,-122.376,1380,1503,385000,4,3,2015,0,20,-23,123,0,0,1
3,2.5,2040,7503,2.0,0,0,3,8,2040,0,1987,0,98029,47.5718,-122.021,2170,7503,619000,31,3,2015,0,28,5463,5333,0,0,0
3,2.0,1910,13505,1.0,0,0,3,8,1910,0,1955,0,98034,47.7114,-122.23,2010,8000,412450,27,4,2015,0,60,11595,5990,0,0,0
3,1.75,1460,2800,2.0,0,0,3,7,1460,0,1928,0,98117,47.6779,-122.371,1220,4062,580000,23,1,2015,0,87,1340,2842,0,0,1
4,1.5,1790,4080,1.5,0,0,5,7,1790,0,1928,0,98144,47.5749,-122.291,1710,4080,704300,6,4,2015,0,87,2290,2370,0,0,1
3,2.0,1390,6005,2.0,0,0,3,8,1390,0,2005,0,98022,47.2117,-121.99,1264,5550,267000,7,11,2014,0,9,4615,4286,0,0,0
4,1.75,1880,12150,1.0,0,0,3,7,1280,600,1976,0,98023,47.3272,-122.363,1980,9680,310000,13,8,2014,0,38,10270,7700,0,1,0
3,1.5,1570,10824,2.0,0,0,3,7,1570,0,1908,0,98118,47.54,-122.275,1530,8125,227064,23,1,2015,0,107,9254,6595,0,0,1
3,2.5,2690,7000,2.0,0,0,5,7,1840,850,1943,0,98115,47.6784,-122.277,1800,6435,925000,28,5,2014,0,71,4310,4635,0,1,1
3,1.75,1670,11452,1.0,0,2,3,8,1670,0,1992,0,98022,47.1913,-122.015,1820,11152,245000,8,5,2015,0,23,9782,9332,0,0,0
3,1.0,1040,7490,1.0,0,0,3,7,1040,0,1969,0,98034,47.7137,-122.213,1520,7410,339888,14,12,2014,0,45,6450,5890,0,0,0
4,2.0,1560,7500,1.0,0,0,4,7,1560,0,1968,0,98034,47.7281,-122.181,1730,7500,439000,10,7,2014,0,46,5940,5770,0,0,0
2,1.0,1470,6120,1.0,0,0,2,7,1470,0,1940,0,98115,47.6914,-122.287,1840,6120,400000,27,5,2014,0,74,4650,4280,0,0,1
3,2.25,2070,15002,1.5,0,0,3,8,2070,0,1955,2013,98155,47.7635,-122.274,2070,15002,560000,30,6,2014,58,59,12932,12932,1,0,1
2,1.0,1370,5922,1.0,0,2,3,8,1130,240,1941,0,98199,47.6473,-122.406,2460,6759,703011,1,10,2014,0,73,4552,4299,0,1,1
2,1.0,1120,4800,1.0,0,0,3,7,770,350,1926,0,98126,47.5669,-122.372,1510,4800,363000,9,12,2014,0,88,3680,3290,0,1,1
4,2.75,2640,6240,2.0,0,0,3,9,2640,0,2001,0,98075,47.5788,-122.059,2640,5898,650000,19,9,2014,0,13,3600,3258,0,0,0
3,1.0,1030,9916,1.0,0,0,4,7,1030,0,1972,0,98034,47.7218,-122.176,1470,9044,299950,6,1,2015,0,43,8886,7574,0,0,0
3,1.0,1120,6625,1.0,0,0,3,6,1120,0,1942,0,98168,47.4879,-122.332,1120,6794,228950,22,4,2015,0,73,5505,5674,0,0,1
4,1.75,1730,11700,1.0,0,0,3,7,880,850,1956,0,98008,47.6031,-122.13,1570,7820,465000,1,10,2014,0,58,9970,6250,0,1,0
3,2.5,2090,9847,2.0,0,2,3,9,2090,0,1983,0,98006,47.5651,-122.114,2860,11483,725000,13,2,2015,0,32,7757,8623,0,0,0
3,1.0,920,14400,1.0,0,0,4,7,920,0,1977,0,98001,47.2816,-122.269,1170,9600,212500,4,6,2014,0,37,13480,8430,0,0,0
3,2.5,1720,10031,2.0,0,0,3,8,1720,0,1993,0,98028,47.7688,-122.238,2280,5845,383000,23,12,2014,0,21,8311,3565,0,0,0
3,1.75,1460,4692,1.0,0,0,3,7,1460,0,1988,0,98055,47.472,-122.192,1600,4557,244000,21,4,2015,0,27,3232,2957,0,0,0
3,1.5,1540,3570,1.5,0,0,5,7,1490,50,1930,0,98105,47.6692,-122.325,1620,4080,565000,5,8,2014,0,84,2030,2460,0,1,1
8,3.0,2850,12714,1.0,0,0,3,7,2850,0,1959,0,98055,47.4859,-122.205,1480,4942,373000,19,2,2015,0,56,9864,3462,0,0,0
3,2.0,1310,9855,1.0,0,0,3,7,1310,0,1962,0,98034,47.7296,-122.241,1310,8370,300000,2,9,2014,0,52,8545,7060,0,0,0
5,2.5,2430,4781,2.0,0,0,3,9,2430,0,2001,0,98058,47.4487,-122.117,2420,4770,405000,20,5,2014,0,13,2351,2350,0,0,0
3,1.5,860,3200,1.0,0,0,3,6,860,0,1929,0,98117,47.6791,-122.362,1220,4300,445000,29,4,2015,0,86,2340,3080,0,0,1
3,3.5,2050,2020,2.0,0,0,3,8,1520,530,2006,0,98112,47.6235,-122.306,1230,3640,761000,21,2,2015,0,9,-30,2410,0,1,1
4,2.0,1650,4745,1.0,0,0,3,7,1130,520,1972,0,98034,47.7359,-122.18,1650,5184,435000,27,4,2015,0,43,3095,3534,0,1,0
3,2.25,1570,8410,1.0,0,0,3,7,1180,390,1991,0,98022,47.1942,-121.99,1540,8410,252000,22,8,2014,0,23,6840,6870,0,1,0
3,1.75,1660,10150,1.5,0,0,3,7,1660,0,1957,0,98133,47.7512,-122.342,1640,8906,350000,23,6,2014,0,57,8490,7266,0,0,1
3,1.0,1220,8119,1.0,0,0,4,7,1220,0,1955,0,98039,47.6328,-122.236,1910,8119,875000,7,11,2014,0,59,6899,6209,0,0,0
3,1.0,1220,8119,1.0,0,0,4,7,1220,0,1955,0,98039,47.6328,-122.236,1910,8119,940000,10,2,2015,0,60,6899,6209,0,0,0
3,2.0,1780,11342,1.0,0,0,3,7,1780,0,1964,0,98148,47.4617,-122.327,2140,8449,280000,19,8,2014,0,50,9562,6309,0,0,1
3,2.5,2180,4226,2.0,0,0,3,8,2180,0,2004,0,98011,47.7733,-122.226,2540,4607,450000,19,9,2014,0,10,2046,2067,0,0,0
3,1.5,1070,9331,1.0,0,0,3,6,1070,0,1956,0,98155,47.7633,-122.313,1480,8400,220000,14,8,2014,0,58,8261,6920,0,0,1
3,1.0,1060,4880,1.0,0,0,2,6,910,150,1913,0,98118,47.5545,-122.288,1200,4880,555750,16,2,2015,0,102,3820,3680,0,1,1
3,1.5,1160,8906,1.0,0,0,3,7,1160,0,1962,0,98118,47.5362,-122.29,1160,8906,262500,11,6,2014,0,52,7746,7746,0,0,1
2,1.0,910,4725,1.0,0,0,3,7,910,0,1949,0,98115,47.676,-122.281,1600,5200,515000,1,12,2014,0,65,3815,3600,0,0,1
1,1.0,790,13062,1.0,0,0,3,6,790,0,1942,0,98168,47.4919,-122.311,1240,7137,135000,4,6,2014,0,72,12272,5897,0,0,1
2,2.0,1540,7290,2.0,0,0,3,7,1540,0,1948,1983,98136,47.551,-122.395,1540,7072,462500,18,11,2014,35,66,5750,5532,1,0,1
3,1.5,1470,9570,1.0,0,0,3,7,1280,190,1941,0,98125,47.7032,-122.306,1390,9570,458000,22,4,2015,0,74,8100,8180,0,1,1
4,2.75,3160,7143,1.5,0,0,3,8,2100,1060,1933,0,98199,47.6513,-122.406,2200,6122,845000,22,10,2014,0,81,3983,3922,0,1,1
3,2.0,1340,6783,1.0,0,0,4,7,1340,0,1987,0,98030,47.3504,-122.177,1630,6458,265000,17,4,2015,0,28,5443,4828,0,0,0
9,4.5,3830,6988,2.5,0,0,3,7,2450,1380,1938,0,98103,47.6927,-122.338,1460,6291,599999,7,5,2014,0,76,3158,4831,0,1,1
3,2.5,1800,8697,2.0,0,0,3,8,1800,0,1987,0,98023,47.3115,-122.4,1770,8390,280000,2,12,2014,0,27,6897,6620,0,0,0
3,1.0,920,7276,1.0,0,0,4,6,920,0,1961,0,98002,47.285,-122.211,1120,7276,125000,14,10,2014,0,53,6356,6156,0,0,0
4,3.0,3280,4904,2.0,0,0,3,7,3280,0,2005,0,98053,47.6802,-122.033,2600,5004,634800,9,12,2014,0,9,1624,2404,0,0,0
3,2.25,1940,11612,1.0,0,0,4,8,1100,840,1981,0,98178,47.5018,-122.23,2180,8954,359950,20,6,2014,0,33,9672,6774,0,1,1
3,1.75,1590,11454,1.0,0,0,4,8,1590,0,1979,0,98056,47.5049,-122.186,1970,9960,417000,15,12,2014,0,35,9864,7990,0,0,0
2,2.0,1340,4122,1.0,0,0,3,8,1340,0,2007,0,98053,47.7182,-122.022,1350,4273,389000,22,7,2014,0,7,2782,2923,0,0,0
4,2.5,3770,10893,2.0,0,2,3,11,3770,0,1997,0,98006,47.5646,-122.129,3710,9685,1040000,15,8,2014,0,17,7123,5975,0,0,0
6,2.5,2680,11250,1.0,0,0,5,7,1340,1340,1967,0,98033,47.6553,-122.19,2200,9875,698000,29,9,2014,0,47,8570,7675,0,1,0
4,2.5,2820,10125,2.0,0,0,3,8,2820,0,2008,0,98155,47.7494,-122.304,1560,10125,685000,18,3,2015,0,7,7305,8565,0,0,1
3,1.75,1520,7137,1.0,0,0,3,5,1520,0,1932,0,98168,47.4924,-122.311,1240,8602,198500,5,11,2014,0,82,5617,7362,0,0,1
4,2.5,2560,5428,2.0,0,0,3,8,2560,0,2012,0,98042,47.3835,-122.095,2620,5428,350000,26,3,2015,0,3,2868,2808,0,0,0
3,1.5,1540,7200,1.0,0,0,3,7,1540,0,1968,0,98011,47.7357,-122.195,1560,7500,441000,29,4,2015,0,47,5660,5940,0,0,0
3,1.75,1430,11761,1.0,0,0,4,8,1430,0,1964,0,98052,47.6686,-122.157,2040,10035,462600,11,11,2014,0,50,10331,7995,0,0,0
4,2.5,2506,6232,2.0,0,0,3,7,2506,0,2006,0,98030,47.3734,-122.182,2070,8260,365070,6,3,2015,0,9,3726,6190,0,0,0
4,2.0,2250,7500,1.0,0,0,5,7,1200,1050,1956,0,98005,47.5877,-122.157,1440,7500,550000,13,5,2014,0,58,5250,6060,0,1,0
5,1.75,2740,9600,1.0,0,0,4,7,1370,1370,1945,0,98144,47.5738,-122.315,1990,4800,470000,28,4,2015,0,70,6860,2810,0,1,1
3,1.75,1540,10400,1.0,0,0,3,6,1540,0,1977,0,98024,47.5651,-121.89,1090,7500,340000,27,8,2014,0,37,8860,6410,0,0,0
4,1.75,1690,8392,1.0,0,0,3,7,1190,500,1979,0,98028,47.773,-122.256,1880,9861,405000,7,4,2015,0,36,6702,7981,0,1,0
4,2.25,1990,4600,1.5,0,2,4,8,1420,570,1932,0,98126,47.5638,-122.38,1810,5750,661000,2,6,2014,0,82,2610,3940,0,1,1
4,2.5,2410,7069,2.0,0,0,3,9,2410,0,1993,0,98034,47.7094,-122.234,2240,7184,635000,6,11,2014,0,21,4659,4944,0,0,0
2,1.0,1150,6098,1.0,0,0,3,7,950,200,1948,0,98125,47.7259,-122.328,1790,8455,282000,5,5,2015,0,67,4948,6665,0,1,1
4,1.75,1720,10137,2.0,0,0,3,7,1720,0,1956,0,98188,47.4424,-122.276,1350,10205,235000,11,2,2015,0,59,8417,8855,0,0,1
5,2.5,2020,8250,1.0,0,0,4,8,1430,590,1978,0,98058,47.4432,-122.135,1680,8959,346500,20,4,2015,0,37,6230,7279,0,1,0
5,2.25,2240,5500,1.0,0,0,3,7,1490,750,1959,0,98136,47.5305,-122.391,2010,6050,480000,10,4,2015,0,56,3260,4040,0,1,1
4,2.25,1930,6508,2.0,0,0,3,8,1930,0,1996,0,98019,47.7458,-121.977,2170,6548,360000,16,9,2014,0,18,4578,4378,0,0,0
3,2.5,1820,6785,1.0,0,0,3,7,1420,400,1994,0,98092,47.3201,-122.177,1710,6055,245000,6,11,2014,0,20,4965,4345,0,1,0
3,3.5,1560,1490,2.0,0,0,3,8,1240,320,1995,0,98102,47.6248,-122.319,1560,1662,625000,19,9,2014,0,19,-70,102,0,1,1
5,3.0,2170,2440,1.5,0,0,4,8,1450,720,1911,0,98115,47.6724,-122.317,2070,4000,750500,29,5,2014,0,103,270,1930,0,1,1
3,1.75,1600,9579,1.0,0,0,3,8,1180,420,1977,0,98072,47.7662,-122.159,1750,9829,525000,18,4,2015,0,38,7979,8079,0,1,0
3,1.5,1240,7735,1.0,0,0,4,7,1240,0,1957,0,98008,47.601,-122.122,1260,7500,523000,13,5,2014,0,57,6495,6240,0,0,0
3,1.75,1090,4500,1.5,0,0,5,8,1090,0,1929,0,98118,47.5157,-122.256,1640,5225,292000,4,3,2015,0,86,3410,3585,0,0,1
4,2.5,2740,9599,1.0,0,2,3,8,1820,920,1961,0,98177,47.7728,-122.385,2660,8280,625000,21,1,2015,0,54,6859,5620,0,1,1
3,2.5,3110,11727,2.0,0,2,3,9,3110,0,2002,0,98065,47.5445,-121.871,4240,13353,700000,16,1,2015,0,13,8617,9113,0,0,0
3,2.5,1610,1320,2.0,0,0,3,7,1280,330,2007,0,98144,47.6,-122.298,1480,1602,399950,12,3,2015,0,8,-290,122,0,1,1
4,3.5,1880,1341,3.0,0,0,3,8,1650,230,2007,0,98122,47.6053,-122.306,1740,1883,545000,25,2,2015,0,8,-539,143,0,1,1
4,2.0,1740,6369,1.0,0,0,5,6,870,870,1954,0,98133,47.7461,-122.332,1560,7200,339999,7,8,2014,0,60,4629,5640,0,1,1
4,2.25,3270,6000,2.0,0,0,5,8,2180,1090,1909,0,98122,47.6101,-122.286,2880,6000,1210000,1,12,2014,0,105,2730,3120,0,1,1
3,2.5,1990,5149,2.0,0,0,3,8,1990,0,2003,0,98075,47.5895,-122.019,2280,4506,545000,13,11,2014,0,11,3159,2226,0,0,0
4,1.75,1960,8400,1.0,0,0,4,8,1960,0,1967,0,98023,47.3111,-122.379,2080,8400,260000,9,3,2015,0,48,6440,6320,0,0,0
3,1.75,1680,3420,1.0,0,0,3,7,960,720,1992,0,98115,47.6854,-122.291,1680,4080,526000,23,5,2014,0,22,1740,2400,0,1,1
4,3.0,2910,8540,2.0,0,0,3,9,2910,0,2003,0,98059,47.5223,-122.156,3040,6091,701000,12,11,2014,0,11,5630,3051,0,0,0
3,2.25,1500,7482,1.0,0,0,4,7,1210,290,1968,0,98055,47.4619,-122.187,1480,7308,290000,3,10,2014,0,46,5982,5828,0,1,0
1,1.0,580,1799,1.0,0,0,3,7,580,0,1908,2005,98117,47.6829,-122.375,1260,4000,330600,4,10,2014,97,106,1219,2740,1,0,1
3,1.75,2540,8280,1.0,0,0,3,7,1270,1270,1949,0,98177,47.7219,-122.358,1950,8280,550500,27,4,2015,0,66,5740,6330,0,1,1
2,1.0,950,6426,1.0,0,0,3,7,950,0,1949,0,98126,47.5653,-122.37,1360,2550,430000,13,3,2015,0,66,5476,1190,0,0,1
2,1.0,810,4560,1.0,0,0,3,7,810,0,1928,0,98126,47.5425,-122.376,1490,4560,260600,4,8,2014,0,86,3750,3070,0,0,1
5,3.0,4080,7500,2.0,0,2,4,8,2720,1360,1961,0,98103,47.6722,-122.349,2000,4545,825000,18,12,2014,0,53,3420,2545,0,1,1
4,2.0,1820,8400,1.0,0,0,5,7,1300,520,1956,0,98155,47.7615,-122.329,1700,9450,378950,23,10,2014,0,58,6580,7750,0,1,1
4,2.5,2650,9065,2.0,0,0,3,7,2650,0,2000,0,98019,47.7258,-121.959,2590,13218,435000,16,1,2015,0,15,6415,10628,0,0,0
3,2.25,1670,1396,2.0,0,0,3,9,1250,420,2015,0,98115,47.6814,-122.288,1610,5191,631000,22,4,2015,0,0,-274,3581,0,1,1
3,2.5,2480,8342,2.0,0,0,3,8,2480,0,1986,0,98058,47.4381,-122.134,2300,8303,415000,18,5,2014,0,28,5862,6003,0,0,0
3,1.75,1240,7560,1.0,0,0,3,8,1070,170,1967,0,98003,47.333,-122.3,1650,7560,222000,21,10,2014,0,47,6320,5910,0,1,0
3,2.0,1390,8250,1.0,0,0,3,7,1390,0,1987,0,98042,47.3707,-122.094,1390,7875,245000,20,8,2014,0,27,6860,6485,0,0,0
3,2.5,2880,10126,2.0,0,0,4,10,2880,0,1985,0,98074,47.6319,-122.037,2960,10514,720000,25,3,2015,0,30,7246,7554,0,0,0
3,1.0,1060,9954,1.0,0,0,4,7,1060,0,1960,0,98032,47.3801,-122.289,1620,8760,215000,23,12,2014,0,54,8894,7140,0,0,0
2,1.0,1070,2754,1.0,0,0,3,7,830,240,1924,0,98103,47.6755,-122.331,1760,4080,579100,30,10,2014,0,90,1684,2320,0,1,1
4,1.75,1640,9299,1.5,0,0,4,7,870,770,1943,0,98056,47.5334,-122.168,2460,14326,522500,28,7,2014,0,71,7659,11866,0,1,0
3,2.0,1510,3000,1.0,0,0,4,7,910,600,1972,0,98115,47.6804,-122.319,1620,4000,489000,19,9,2014,0,42,1490,2380,0,1,1
3,1.0,1230,2353,1.5,0,0,4,6,1230,0,1925,0,98106,47.5177,-122.354,1280,1572,240000,6,5,2015,0,90,1123,292,0,0,1
3,2.0,1510,3657,1.0,0,0,3,8,1510,0,2007,0,98053,47.7225,-122.029,1510,3657,420250,21,4,2015,0,8,2147,2147,0,0,0
4,2.0,2260,6000,1.0,0,0,3,8,1430,830,1958,0,98115,47.6876,-122.298,2030,5874,628000,13,5,2014,0,56,3740,3844,0,1,1
4,2.5,1920,7277,2.0,0,0,4,8,1920,0,1990,0,98031,47.4058,-122.192,2300,7645,320000,6,5,2015,0,25,5357,5345,0,0,0
2,1.0,1200,8063,1.0,0,0,4,6,1200,0,1958,0,98198,47.4204,-122.324,1200,7500,232000,5,5,2014,0,56,6863,6300,0,0,1
4,2.25,2020,5600,1.0,0,2,4,8,1210,810,1961,0,98115,47.6821,-122.267,2660,6050,810000,14,11,2014,0,53,3580,3390,0,1,1
4,1.5,2010,7561,1.5,0,0,4,7,1890,120,1921,0,98002,47.311,-122.227,1420,6564,245000,11,12,2014,0,93,5551,5144,0,1,0
3,2.25,1930,8192,1.0,0,0,3,7,1470,460,1984,0,98003,47.2624,-122.299,1510,8192,273000,7,5,2015,0,31,6262,6682,0,1,0
5,1.0,1950,6250,1.5,0,0,4,7,1450,500,1917,0,98136,47.5511,-122.386,1950,6250,438000,21,4,2015,0,98,4300,4300,0,1,1
3,1.0,1250,4800,1.0,0,0,4,7,1250,0,1951,0,98126,47.5517,-122.381,1404,4800,340000,16,5,2014,0,63,3550,3396,0,0,1
2,2.5,1380,951,3.0,0,0,3,9,1380,0,2006,0,98103,47.6654,-122.355,1430,3400,552000,9,6,2014,0,8,-429,1970,0,0,1
3,1.75,2050,4080,2.0,0,0,3,8,2050,0,1991,0,98105,47.6698,-122.325,1890,4080,790000,25,11,2014,0,23,2030,2190,0,0,1
3,1.0,1310,15022,1.0,0,0,3,7,1310,0,1934,1984,98168,47.5008,-122.332,1530,13154,235000,2,3,2015,50,81,13712,11624,1,0,1
2,1.0,1010,3600,1.0,0,0,3,7,1010,0,1913,0,98107,47.6641,-122.357,1540,3600,775000,10,10,2014,0,101,2590,2060,0,0,1
3,2.75,1850,9600,1.5,0,0,5,7,1850,0,1965,0,98034,47.7259,-122.226,1250,10500,489200,14,5,2014,0,49,7750,9250,0,0,0
3,2.25,1750,8900,2.0,0,0,4,8,1750,0,1977,0,98058,47.4451,-122.136,1680,7910,341000,29,7,2014,0,37,7150,6230,0,0,0
4,2.5,2154,6050,2.0,0,0,3,8,2154,0,2012,0,98030,47.3513,-122.174,2305,5769,335000,1,10,2014,0,2,3896,3464,0,0,0
3,1.75,1230,1441,2.0,0,0,3,8,1010,220,2004,0,98116,47.5626,-122.382,1170,1942,393500,21,1,2015,0,11,211,772,0,1,1
3,2.0,1960,8846,1.0,0,3,4,6,980,980,1940,0,98178,47.5101,-122.246,2190,6363,360000,18,9,2014,0,74,6886,4173,0,1,1
4,1.0,1070,5750,1.0,0,0,3,6,870,200,1923,0,98126,47.564,-122.379,1270,5750,400800,4,3,2015,0,92,4680,4480,0,1,1
3,1.0,1450,5378,1.0,0,0,3,7,1190,260,1939,0,98199,47.6436,-122.405,1810,5559,585000,3,11,2014,0,75,3928,3749,0,1,1
4,2.75,3680,5000,2.0,0,3,3,9,2480,1200,1936,0,98105,47.6599,-122.269,3200,5000,1600000,1,10,2014,0,78,1320,1800,0,1,1
3,1.0,1220,13000,1.0,0,0,4,7,1220,0,1955,0,98133,47.7608,-122.353,1510,12600,300000,15,5,2014,0,59,11780,11090,0,0,1
4,2.75,2950,4560,2.0,0,0,5,7,1810,1140,1912,0,98103,47.6525,-122.333,2000,4560,1050000,14,11,2014,0,102,1610,2560,0,1,1
3,1.5,1340,1110,2.0,0,0,3,7,1040,300,1999,0,98117,47.698,-122.366,1220,1110,360000,22,9,2014,0,15,-230,-110,0,1,1
4,2.25,2870,5453,2.0,0,1,4,8,2220,650,1926,0,98146,47.5129,-122.388,1660,4800,665900,20,6,2014,0,88,2583,3140,0,1,1
4,1.0,2590,18224,1.5,0,0,4,7,2000,590,1911,0,98118,47.5318,-122.286,1800,7080,470000,22,8,2014,0,103,15634,5280,0,1,1
4,1.75,2090,8164,1.0,0,0,4,8,1070,1020,1963,0,98052,47.6715,-122.155,1310,7975,581000,13,5,2014,0,51,6074,6665,0,1,0
6,3.5,3000,8401,1.0,0,0,3,8,1500,1500,1979,0,98125,47.7226,-122.299,1400,8403,527000,7,7,2014,0,35,5401,7003,0,1,1
4,1.75,1730,7245,1.0,0,0,4,7,880,850,1955,0,98007,47.5995,-122.144,1550,7245,423000,6,5,2015,0,60,5515,5695,0,1,0
4,3.5,2850,4416,1.5,0,0,3,7,2040,810,1926,0,98103,47.6835,-122.342,1860,4416,875000,27,9,2014,0,88,1566,2556,0,1,1
3,1.0,1020,6903,1.0,0,0,3,7,1020,0,1951,0,98116,47.571,-122.392,1440,6678,410000,29,7,2014,0,63,5883,5238,0,0,1
3,2.5,2200,6005,2.0,0,0,3,9,2200,0,1997,0,98072,47.7408,-122.169,2320,6098,606000,16,3,2015,0,18,3805,3778,0,0,0
3,2.5,2990,6771,1.0,0,0,3,7,1550,1440,2003,0,98106,47.5237,-122.353,1800,6771,373000,9,11,2014,0,11,3781,4971,0,1,1
5,2.0,2450,9488,1.0,0,0,4,7,1240,1210,1900,1955,98133,47.7056,-122.34,1310,5693,550000,29,5,2014,55,114,7038,4383,1,1,1
3,2.5,1900,7604,2.0,0,0,3,8,1900,0,1990,0,98033,47.7002,-122.188,1980,9583,512500,21,5,2014,0,24,5704,7603,0,0,0
4,2.5,2640,7388,2.0,0,0,3,7,2640,0,2003,0,98038,47.3505,-122.027,2640,6383,360000,28,4,2015,0,12,4748,3743,0,0,0
3,2.0,1340,1480,3.0,0,0,3,8,1340,0,1997,0,98117,47.6904,-122.393,1340,1321,369000,26,9,2014,0,17,140,-19,0,0,1
4,2.5,3220,5262,2.0,0,0,3,9,3220,0,2003,0,98033,47.6878,-122.162,3220,4921,825000,30,12,2014,0,11,2042,1701,0,0,0
3,2.0,930,11475,1.0,0,0,3,7,930,0,1978,0,98045,47.4644,-121.745,1280,11250,255000,1,12,2014,0,36,10545,9970,0,0,0
4,2.5,3240,10800,1.0,0,0,3,10,2260,980,1946,0,98105,47.6709,-122.262,3490,10800,1290000,28,5,2014,0,68,7560,7310,0,1,1
5,2.5,2630,8470,1.5,0,0,4,8,2630,0,1968,0,98002,47.2863,-122.196,1780,8575,270000,8,8,2014,0,46,5840,6795,0,0,0
3,2.5,1730,4924,2.0,0,0,3,8,1730,0,1996,0,98029,47.5672,-122.005,1610,4313,480680,24,9,2014,0,18,3194,2703,0,0,0
4,1.75,2120,7725,1.0,0,0,3,8,1220,900,1965,0,98007,47.6003,-122.144,2160,7725,525000,3,3,2015,0,50,5605,5565,0,1,0
3,1.0,880,9238,1.5,0,0,5,6,880,0,1946,0,98155,47.7494,-122.319,1170,9238,291500,23,6,2014,0,68,8358,8068,0,0,1
4,2.0,1800,13551,1.0,0,0,4,7,1800,0,1974,0,98059,47.4721,-122.128,1730,13551,305000,30,12,2014,0,40,11751,11821,0,0,0
3,1.75,1600,7500,1.0,0,0,3,7,1600,0,1998,0,98002,47.2831,-122.199,1620,7461,285000,7,5,2015,0,17,5900,5841,0,0,0
5,1.75,3290,8000,1.0,0,0,3,7,1790,1500,1968,0,98030,47.3733,-122.214,2380,7000,329500,8,1,2015,0,47,4710,4620,0,1,0
4,2.25,2890,18226,3.0,1,4,3,10,2890,0,1984,0,98056,47.5169,-122.209,2870,11151,1570000,8,7,2014,0,30,15336,8281,0,0,0
3,2.5,1730,7202,1.0,0,0,3,7,1330,400,1991,0,98198,47.4099,-122.329,2100,8125,379260,11,8,2014,0,23,5472,6025,0,1,1
3,2.5,1590,3411,2.0,0,0,3,7,1590,0,2000,0,98065,47.5303,-121.878,1590,3411,356000,9,7,2014,0,14,1821,1821,0,0,0
4,1.75,1710,8947,1.0,0,0,4,7,1710,0,1956,0,98007,47.5947,-122.135,1360,10133,571900,1,12,2014,0,58,7237,8773,0,0,0
3,1.75,1995,18360,2.0,0,0,3,7,1995,0,1957,0,98198,47.4129,-122.322,1980,13640,271500,21,8,2014,0,57,16365,11660,0,0,1
3,1.75,1300,10030,1.0,0,0,4,7,1300,0,1967,0,98034,47.7359,-122.192,1520,7713,390000,16,3,2015,0,48,8730,6193,0,0,0
2,2.5,1360,2070,2.0,0,0,3,8,1360,0,1999,0,98102,47.6423,-122.329,1920,2092,755000,5,1,2015,0,16,710,172,0,0,1
2,2.5,1590,1485,2.0,0,0,3,8,1300,290,1994,0,98199,47.6375,-122.387,1880,3675,509500,18,11,2014,0,20,-105,1795,0,1,1
2,1.0,1200,6278,1.0,0,0,3,7,1080,120,1942,0,98103,47.7001,-122.351,1200,6211,486700,25,3,2015,0,73,5078,5011,0,1,1
2,1.0,1170,3000,1.5,0,0,3,7,1170,0,1910,0,98103,47.6697,-122.338,1530,4000,527500,28,7,2014,0,104,1830,2470,0,0,1
5,2.5,2010,3600,1.5,0,0,3,6,1510,500,1912,0,98119,47.6522,-122.366,1780,3600,475000,15,8,2014,0,102,1590,1820,0,1,1
3,2.75,1880,1793,2.0,0,0,3,7,1810,70,2001,0,98108,47.5405,-122.293,1800,2537,268000,27,8,2014,0,13,-87,737,0,1,1
4,2.5,2270,13449,1.0,0,0,4,9,1310,960,1975,0,98040,47.5416,-122.232,2810,13475,780000,22,7,2014,0,39,11179,10665,0,1,0
9,3.0,3680,4400,2.0,0,0,3,7,2830,850,1908,0,98102,47.6374,-122.324,1960,2450,700000,6,1,2015,0,107,720,490,0,1,1
3,2.0,1880,3000,1.0,0,0,4,8,1040,840,1931,0,98109,47.6418,-122.351,1790,3000,710000,2,9,2014,0,83,1120,1210,0,1,1
3,1.0,1050,5664,1.0,0,0,4,7,910,140,1947,0,98115,47.6897,-122.285,1500,5664,445000,12,6,2014,0,67,4614,4164,0,1,1
3,3.25,1689,1388,3.0,0,0,3,8,1689,0,2008,0,98125,47.7174,-122.317,1459,1384,384400,18,6,2014,0,6,-301,-75,0,0,1
6,3.0,2860,17853,1.0,0,0,3,8,1430,1430,1962,2015,98006,47.546,-122.175,1920,13452,815000,27,3,2015,53,53,14993,11532,1,1,0
4,2.5,2710,4069,3.0,0,0,4,10,2710,0,1990,0,98122,47.604,-122.288,1810,3586,865000,29,10,2014,0,24,1359,1776,0,0,1
3,2.0,1770,7200,1.0,0,0,4,7,1770,0,1967,0,98033,47.6642,-122.173,2250,11250,514000,28,8,2014,0,47,5430,9000,0,0,0
4,2.75,2820,13193,1.0,0,0,3,8,1860,960,1965,0,98006,47.5579,-122.174,2580,13193,615000,20,5,2014,0,49,10373,10613,0,1,0
4,2.5,3110,6930,2.0,0,0,3,9,3110,0,2004,0,98052,47.7011,-122.112,3090,7000,755000,13,10,2014,0,10,3820,3910,0,0,0
4,1.0,1480,8321,1.0,0,0,3,7,1080,400,1953,0,98155,47.7629,-122.318,1580,8502,425000,27,4,2015,0,62,6841,6922,0,1,1
2,1.0,940,9839,1.0,0,0,3,6,940,0,1910,0,98136,47.5379,-122.386,1330,8740,375000,18,6,2014,0,104,8899,7410,0,0,1
4,2.5,2680,4548,2.0,0,0,3,8,2680,0,2009,0,98052,47.7073,-122.114,2750,4548,750000,24,4,2015,0,6,1868,1798,0,0,0
4,2.75,3190,5408,2.0,0,0,3,9,3190,0,2005,0,98075,47.5903,-121.988,3160,5773,722000,26,9,2014,0,9,2218,2613,0,0,0
3,2.5,1920,4480,2.0,0,1,3,9,1920,0,1949,1997,98119,47.6472,-122.373,1790,4500,1010000,31,3,2015,48,66,2560,2710,1,0,1
3,2.5,2610,7510,2.0,0,0,3,9,2610,0,1996,0,98052,47.6648,-122.137,2610,8458,725000,25,6,2014,0,18,4900,5848,0,0,0
3,2.0,1450,8771,2.0,0,0,4,7,1450,0,1991,0,98022,47.1947,-121.989,1450,8653,271900,15,1,2015,0,24,7321,7203,0,0,0
6,4.5,3902,3880,3.0,0,4,4,9,2782,1120,1977,0,98116,47.5837,-122.399,1100,3870,1300000,5,6,2014,0,37,-22,2770,0,1,1
4,2.5,2460,7800,1.0,0,0,3,8,1500,960,1977,0,98023,47.3081,-122.384,2210,7800,261500,22,12,2014,0,37,5340,5590,0,1,0
3,2.5,2170,5000,2.0,0,0,3,9,2170,0,2003,0,98029,47.5458,-121.996,2170,5000,619500,16,5,2014,0,11,2830,2830,0,0,0
5,2.25,1970,15247,1.0,0,0,3,7,1450,520,1986,0,98024,47.5669,-121.905,1300,10800,435000,10,6,2014,0,28,13277,9500,0,1,0
3,1.0,1000,5454,1.0,0,0,3,7,1000,0,1954,0,98133,47.7339,-122.337,1320,5250,210000,3,10,2014,0,60,4454,3930,0,0,1
3,2.0,1580,4010,1.0,0,0,4,7,790,790,1909,0,98117,47.6769,-122.371,1350,5350,489950,26,11,2014,0,105,2430,4000,0,1,1
4,1.5,2130,8800,1.0,0,0,3,7,1100,1030,1962,0,98032,47.383,-122.288,1480,8120,260000,8,5,2014,0,52,6670,6640,0,1,0
4,1.0,1370,8499,1.0,0,0,3,7,1370,0,1949,0,98155,47.736,-122.301,1370,8187,300000,28,6,2014,0,65,7129,6817,0,0,1
4,2.0,2150,14161,1.0,0,2,3,8,1330,820,1966,0,98003,47.3376,-122.323,2310,14034,530000,22,4,2015,0,49,12011,11724,0,1,0
3,1.0,1370,4000,2.0,0,0,4,8,1370,0,1918,0,98105,47.6711,-122.324,1370,4000,593500,5,1,2015,0,97,2630,2630,0,0,1
3,1.75,1690,8901,1.0,0,0,3,7,1690,0,1986,0,98030,47.3546,-122.176,1690,7532,199500,24,2,2015,0,29,7211,5842,0,0,0
5,1.0,1690,3240,1.5,0,0,3,7,1690,0,1914,0,98115,47.6746,-122.325,1230,4500,544500,2,9,2014,0,100,1550,3270,0,0,1
3,1.0,1430,13370,1.0,0,0,3,7,1430,0,1962,0,98034,47.7317,-122.241,1670,10075,394900,18,2,2015,0,53,11940,8405,0,0,0
4,3.75,1980,4095,2.0,0,0,3,9,1980,0,2009,0,98103,47.6901,-122.356,1480,3840,912000,31,7,2014,0,5,2115,2360,0,0,1
3,2.5,1490,8102,2.0,0,0,4,7,1490,0,1990,0,98042,47.3712,-122.092,1640,7943,260000,10,7,2014,0,24,6612,6303,0,0,0
5,3.0,3620,12778,1.0,0,2,5,8,1900,1720,1964,0,98006,47.5512,-122.191,2930,10669,858000,19,2,2015,0,51,9158,7739,0,1,0
4,1.75,1490,8544,1.0,0,0,4,7,1490,0,1970,0,98031,47.3894,-122.166,1180,8372,242150,13,5,2015,0,45,7054,7192,0,0,0
3,1.75,1230,7200,1.0,0,0,3,7,1230,0,1986,0,98023,47.2881,-122.363,1540,7210,220000,30,10,2014,0,28,5970,5670,0,0,0
3,2.0,1900,7980,1.0,0,0,4,7,1340,560,1977,0,98023,47.305,-122.373,1690,7840,235000,30,4,2015,0,38,6080,6150,0,1,0
3,1.75,1530,10300,1.0,0,0,4,7,1530,0,1978,0,98133,47.7767,-122.356,1940,9883,370000,21,10,2014,0,36,8770,7943,0,0,1
5,1.5,2240,6337,1.0,0,0,3,8,1280,960,1956,0,98125,47.7046,-122.316,1870,6380,534950,11,7,2014,0,58,4097,4510,0,1,1
4,2.5,3470,14271,2.0,0,0,3,9,3470,0,2005,0,98065,47.5423,-121.877,3450,9380,730000,15,3,2015,0,10,10801,5930,0,0,0
3,1.0,1100,5734,1.0,0,0,4,7,1100,0,1955,0,98030,47.3632,-122.174,1770,6050,178000,1,8,2014,0,59,4634,4280,0,0,0
3,1.0,1610,7140,1.0,0,0,3,7,1080,530,1976,0,98031,47.3943,-122.189,1800,7600,215000,9,2,2015,0,39,5530,5800,0,1,0
3,2.75,1910,15508,1.0,0,0,3,8,1210,700,1984,0,98023,47.3128,-122.345,2450,7989,300000,12,3,2015,0,31,13598,5539,0,1,0
3,2.0,1510,7066,1.0,0,2,3,7,1230,280,1973,0,98125,47.7053,-122.303,1950,8089,430000,15,5,2014,0,41,5556,6139,0,1,1
3,1.5,1280,4366,2.0,0,0,4,6,1280,0,1985,0,98002,47.335,-122.215,1280,4366,183000,31,7,2014,0,29,3086,3086,0,0,0
3,2.5,1910,1501,2.5,0,0,3,8,1530,380,2007,0,98199,47.6441,-122.385,1760,1750,585000,12,6,2014,0,7,-409,-10,0,1,1
3,1.0,1170,3330,2.0,0,0,4,6,1170,0,1969,0,98092,47.3155,-122.182,1090,3330,192950,16,7,2014,0,45,2160,2240,0,0,0
2,1.0,1550,7713,1.0,0,0,3,7,1550,0,1930,1979,98117,47.7005,-122.358,1340,6350,599000,26,9,2014,49,84,6163,5010,1,0,1
3,1.0,1060,7920,1.0,0,0,4,7,1060,0,1968,0,98106,47.5649,-122.358,1060,7457,326500,8,7,2014,0,46,6860,6397,0,0,1
2,1.0,1040,5765,1.0,0,0,3,7,1040,0,1944,0,98133,47.7024,-122.346,1040,3844,358803,18,7,2014,0,70,4725,2804,0,0,1
3,2.5,1550,12920,2.0,0,0,5,7,1550,0,1999,0,98033,47.6973,-122.194,2610,10800,537000,28,5,2014,0,15,11370,8190,0,0,0
2,1.0,920,5889,1.0,0,0,4,6,920,0,1950,0,98002,47.3012,-122.218,1210,6180,156000,29,1,2015,0,65,4969,4970,0,0,0
3,1.0,1250,8276,1.5,0,0,5,6,1250,0,1939,0,98022,47.2092,-121.997,1250,8792,219000,25,3,2015,0,76,7026,7542,0,0,0
3,1.5,2540,2700,2.0,0,0,4,8,1630,910,1922,0,98119,47.637,-122.361,2520,5400,1190000,1,5,2015,0,93,160,2880,0,1,1
5,1.75,2190,16788,1.0,0,2,3,8,1380,810,1978,0,98030,47.3764,-122.176,1920,8366,248000,27,4,2015,0,37,14598,6446,0,1,0
3,1.75,1830,10954,1.0,0,0,3,7,1830,0,1963,0,98155,47.7554,-122.306,1850,8624,346950,28,7,2014,0,51,9124,6774,0,0,1
3,1.0,1850,5775,2.0,0,0,3,6,1740,110,1928,0,98108,47.5446,-122.296,1520,3578,330000,17,9,2014,0,86,3925,2058,0,1,1
3,1.0,1410,8250,1.0,0,0,3,7,1410,0,1954,0,98177,47.7621,-122.36,1580,8250,325000,31,7,2014,0,60,6840,6670,0,0,1
3,1.75,1460,7884,1.0,0,0,3,8,1460,0,1975,0,98058,47.4457,-122.128,2050,7210,315000,27,10,2014,0,39,6424,5160,0,0,0
3,2.5,1500,1375,2.0,0,0,3,9,1200,300,2014,0,98119,47.6451,-122.375,1680,1627,649950,23,6,2014,0,0,-125,-53,0,1,1
3,1.0,1130,7200,1.5,0,0,4,6,1130,0,1942,0,98133,47.7298,-122.355,1350,1358,316000,25,8,2014,0,72,6070,8,0,0,1
2,2.5,1620,3196,2.0,0,0,3,8,1620,0,2008,0,98065,47.5167,-121.878,1750,2828,386000,17,6,2014,0,6,1576,1078,0,0,0
2,1.75,2330,7280,1.0,0,0,3,7,1450,880,1982,0,98188,47.4282,-122.28,1830,12178,535000,8,4,2015,0,33,4950,10348,0,1,1
3,3.0,1520,1800,3.0,0,0,3,7,1520,0,2003,0,98115,47.6822,-122.326,1520,1500,600000,25,3,2015,0,12,280,-20,0,0,1
4,2.5,2840,8746,2.0,0,0,3,8,2840,0,2001,0,98022,47.19,-122.013,2630,9900,339000,18,11,2014,0,13,5906,7270,0,0,0
3,2.0,1520,7456,1.0,0,0,3,7,1520,0,1949,0,98166,47.4745,-122.343,1740,8464,167000,26,9,2014,0,65,5936,6724,0,0,1
3,1.0,1740,4800,1.0,0,0,3,8,1740,0,1952,0,98118,47.5596,-122.27,1600,4800,430000,15,12,2014,0,62,3060,3200,0,0,1
4,4.0,4000,9309,2.0,0,0,3,9,4000,0,2007,0,98065,47.5421,-121.888,3920,8048,688000,21,8,2014,0,7,5309,4128,0,0,0
3,2.25,2780,6000,1.0,0,3,4,9,1670,1110,1948,0,98199,47.6442,-122.406,2780,6000,834500,8,9,2014,0,66,3220,3220,0,1,1
4,4.25,3500,8750,1.0,0,4,5,9,2140,1360,1951,0,98177,47.7222,-122.367,3110,8750,1080000,28,6,2014,0,63,5250,5640,0,1,1
3,1.0,1290,4000,1.5,0,0,3,7,1290,0,1926,0,98118,47.5462,-122.277,1160,5040,402500,10,4,2015,0,89,2710,3880,0,0,1
3,2.5,2390,6435,1.0,0,0,3,8,1600,790,1978,0,98034,47.726,-122.194,2020,7300,432500,16,12,2014,0,36,4045,5280,0,1,0
5,1.75,2460,14100,1.0,0,0,3,7,1380,1080,1972,0,98028,47.7452,-122.224,2028,11078,485000,14,8,2014,0,42,11640,9050,0,1,0
4,2.25,2200,8292,2.0,0,0,3,7,2200,0,1990,0,98155,47.7456,-122.315,1090,8290,410000,21,10,2014,0,24,6092,7200,0,0,1
3,2.5,1870,7344,1.0,0,0,3,8,1470,400,1980,0,98034,47.7265,-122.206,1930,7344,455000,15,5,2014,0,34,5474,5414,0,1,0
4,2.5,2060,8968,1.0,0,0,4,7,1190,870,1975,0,98155,47.7686,-122.317,1350,8972,459500,29,12,2014,0,39,6908,7622,0,1,1
4,1.75,1610,11305,1.0,0,0,3,7,1610,0,1968,0,98034,47.727,-122.176,1870,11850,371000,12,12,2014,0,46,9695,9980,0,0,0
3,2.25,2120,3400,2.0,0,0,3,7,2120,0,2002,0,98092,47.3364,-122.17,2420,3400,289500,20,2,2015,0,13,1280,980,0,0,0
3,3.5,1450,1263,2.0,0,0,3,8,1160,290,2007,0,98199,47.6508,-122.383,1390,1282,395000,21,10,2014,0,7,-187,-108,0,1,1
2,1.0,1980,5000,1.0,0,0,4,7,1090,890,1923,0,98144,47.586,-122.295,1720,5000,496752,14,6,2014,0,91,3020,3280,0,1,1
2,1.0,860,6800,1.0,0,0,3,6,860,0,1943,0,98133,47.7274,-122.337,1220,6800,227000,1,10,2014,0,71,5940,5580,0,0,1
3,1.75,1460,9261,1.0,0,0,3,7,1460,0,1985,0,98056,47.5155,-122.189,1550,8800,330000,4,8,2014,0,29,7801,7250,0,0,0
5,2.0,2590,8610,1.0,0,0,4,7,1340,1250,1958,0,98008,47.6112,-122.126,1750,8610,480000,23,1,2015,0,57,6020,6860,0,1,0
4,1.5,1780,3120,1.5,0,3,3,8,1780,0,1926,0,98118,47.5589,-122.264,1710,3600,705000,7,4,2015,0,89,1340,1890,0,0,1
4,2.5,2920,4000,1.5,0,0,5,8,1910,1010,1909,0,98105,47.6578,-122.28,2470,4000,1400000,2,5,2014,0,105,1080,1530,0,1,1
4,3.25,2820,6611,1.0,0,0,3,7,1410,1410,1958,0,98155,47.7473,-122.285,2320,6611,485000,12,12,2014,0,56,3791,4291,0,1,1
3,2.25,1550,1919,3.0,0,0,3,8,1550,0,2003,0,98107,47.6729,-122.379,1550,2918,622000,9,3,2015,0,12,369,1368,0,0,1
3,1.75,1960,6380,1.0,0,0,4,7,980,980,1939,0,98115,47.6975,-122.316,1480,6380,561500,27,6,2014,0,75,4420,4900,0,1,1
3,1.0,970,9600,1.0,0,0,3,7,970,0,1972,0,98045,47.4451,-121.768,1110,9600,242000,16,9,2014,0,42,8630,8490,0,0,0
3,1.5,1360,10726,1.0,0,0,4,7,1360,0,1966,0,98059,47.4948,-122.134,1650,10726,348500,24,6,2014,0,48,9366,9076,0,0,0
3,1.5,1360,10726,1.0,0,0,4,7,1360,0,1966,0,98059,47.4948,-122.134,1650,10726,370000,26,3,2015,0,49,9366,9076,0,0,0
6,3.75,3810,6663,2.0,0,0,4,8,3810,0,1977,0,98103,47.6938,-122.34,1610,4561,752000,14,4,2015,0,38,2853,2951,0,0,1
3,1.75,1340,8250,1.0,0,0,3,7,1100,240,1985,0,98042,47.3668,-122.09,1540,7860,230000,31,10,2014,0,29,6910,6320,0,1,0
3,2.25,1990,4977,3.0,0,0,3,9,1990,0,2012,0,98118,47.5404,-122.268,1280,5000,715000,18,3,2015,0,3,2987,3720,0,0,1
3,1.75,1120,10187,1.0,0,0,3,7,1120,0,1968,0,98198,47.3694,-122.311,1900,8736,240415,17,4,2015,0,47,9067,6836,0,0,1
4,1.75,2060,4080,1.5,0,0,3,7,1460,600,1922,1996,98105,47.6698,-122.325,1620,4080,562000,25,11,2014,74,92,2020,2460,1,1,1
3,1.5,1170,4080,1.0,0,0,5,6,1170,0,1917,0,98126,47.5338,-122.381,920,4242,360000,5,8,2014,0,97,2910,3322,0,0,1
3,2.5,1610,1246,2.0,0,1,3,9,1080,530,2014,0,98119,47.6423,-122.375,1610,1249,659950,29,10,2014,0,0,-364,-361,0,1,1
3,2.0,1890,1599,2.0,0,0,3,9,1430,460,2012,0,98136,47.5438,-122.385,1780,1562,458500,23,6,2014,0,2,-291,-218,0,1,1
2,2.0,1070,649,2.0,0,0,3,9,720,350,2008,0,98106,47.5213,-122.357,1070,928,259950,5,3,2015,0,7,-421,-142,0,1,1
3,1.75,1680,6108,1.0,0,0,3,8,1680,0,1989,0,98055,47.4501,-122.208,2220,5664,366000,18,9,2014,0,25,4428,3444,0,0,0
4,2.75,2890,7821,2.0,0,0,3,9,2890,0,2014,0,98006,47.554,-122.189,2890,10108,978000,28,4,2015,0,1,4931,7218,0,0,0
2,1.0,1360,6120,1.0,0,0,3,7,1060,300,1947,0,98115,47.6841,-122.291,1800,5100,525000,21,4,2015,0,68,4760,3300,0,1,1
3,1.5,1660,4800,2.0,0,0,3,8,1660,0,1907,0,98119,47.6352,-122.358,1690,4000,926300,22,5,2014,0,107,3140,2310,0,0,1
2,1.0,1620,6120,1.0,0,0,3,7,1620,0,1951,0,98115,47.6731,-122.326,1650,4590,750000,23,4,2015,0,64,4500,2940,0,0,1
2,1.0,960,6263,1.0,0,1,4,6,960,0,1942,0,98033,47.6646,-122.202,1460,6054,660000,4,12,2014,0,72,5303,4594,0,0,0
4,1.75,1000,7200,1.5,0,0,4,6,1000,0,1947,0,98155,47.742,-122.324,1280,7200,305000,13,8,2014,0,67,6200,5920,0,0,1
2,2.5,2395,6143,1.0,0,0,3,8,2395,0,2003,0,98053,47.7114,-122.029,2170,6162,800000,26,4,2015,0,12,3748,3992,0,0,0
4,1.75,3050,9440,1.0,0,0,3,8,1800,1250,1966,0,98034,47.7228,-122.183,2020,8660,600000,27,4,2015,0,49,6390,6640,0,1,0
4,3.25,2960,4296,2.0,0,0,3,9,2190,770,2007,0,98119,47.6526,-122.372,2150,6000,1140000,10,3,2015,0,8,1336,3850,0,1,1
3,2.25,1250,1017,3.0,0,0,3,8,1250,0,2008,0,98133,47.7099,-122.333,1250,1017,318000,10,10,2014,0,6,-233,-233,0,0,1
4,2.0,1940,5000,1.0,0,0,4,7,980,960,1910,0,98107,47.6719,-122.369,1940,5000,639000,6,10,2014,0,104,3060,3060,0,1,1
3,2.5,1750,3900,2.0,0,0,3,8,1750,0,1977,0,98052,47.6638,-122.129,1750,5700,453000,16,3,2015,0,38,2150,3950,0,0,0
4,1.75,2150,9148,1.0,0,0,4,7,2150,0,1955,0,98004,47.5828,-122.197,2370,9148,800000,17,11,2014,0,59,6998,6778,0,0,0
2,1.75,1500,6800,1.0,0,0,4,7,910,590,1942,0,98117,47.7004,-122.371,1450,6800,437000,4,6,2014,0,72,5300,5350,0,1,1
4,2.5,3000,8645,2.0,0,0,3,8,3000,0,1985,0,98034,47.7315,-122.224,1930,8866,490000,26,9,2014,0,29,5645,6936,0,0,0
4,1.75,1520,7700,1.0,0,0,4,7,1520,0,1967,0,98034,47.7356,-122.191,1520,7500,499950,10,7,2014,0,47,6180,5980,0,0,0
3,1.5,1190,10116,1.0,0,0,3,7,1190,0,1968,0,98042,47.385,-122.085,1190,9905,160134,26,12,2014,0,46,8926,8715,0,0,0
3,1.0,990,8255,1.0,0,0,3,7,990,0,1953,0,98148,47.425,-122.331,1180,9750,191000,15,12,2014,0,61,7265,8570,0,0,1
3,1.0,1250,7280,1.0,0,0,3,7,1250,0,1965,0,98001,47.3414,-122.286,1450,7350,221000,15,1,2015,0,50,6030,5900,0,0,0
4,2.0,2080,6360,1.0,0,0,3,7,1330,750,1960,0,98118,47.5392,-122.278,2080,6741,352800,28,10,2014,0,54,4280,4661,0,1,1
3,2.5,1640,10424,2.0,0,0,3,7,1640,0,1988,0,98019,47.7345,-121.977,1560,10101,350000,11,5,2015,0,27,8784,8541,0,0,0
4,1.5,1550,3000,1.5,0,0,3,7,1350,200,1918,0,98105,47.6604,-122.324,1710,5535,458000,17,6,2014,0,96,1450,3825,0,1,1
3,3.0,3250,5093,2.0,0,3,3,10,3250,0,2004,0,98146,47.5123,-122.39,2820,7752,1050000,7,4,2015,0,11,1843,4932,0,0,1
3,1.75,1260,11775,1.0,0,0,5,6,1260,0,1942,0,98108,47.5501,-122.296,1270,5480,353000,24,7,2014,0,72,10515,4210,0,0,1
3,3.5,2840,4468,3.0,0,0,3,10,2840,0,2006,0,98052,47.7069,-122.117,3040,5400,717550,1,8,2014,0,8,1628,2360,0,0,0
3,2.25,1960,6500,2.0,0,0,4,8,1960,0,1977,0,98052,47.6642,-122.129,1860,6160,450000,7,8,2014,0,37,4540,4300,0,0,0
3,1.0,760,3090,1.0,0,0,2,5,760,0,1903,0,98118,47.5513,-122.275,1020,5356,167500,24,9,2014,0,111,2330,4336,0,0,1
4,2.25,2240,9684,2.0,0,0,4,9,2240,0,1970,0,98040,47.5489,-122.225,2440,9618,939000,21,4,2015,0,45,7444,7178,0,0,0
3,1.75,1820,15570,1.0,0,2,3,8,1820,0,1948,0,98146,47.5068,-122.386,2490,9480,700000,29,4,2015,0,67,13750,6990,0,0,1
3,1.0,1160,4360,1.0,0,0,4,8,1160,0,1929,0,98105,47.6718,-122.291,1810,4360,501000,29,8,2014,0,85,3200,2550,0,0,1
3,2.25,1640,8625,1.0,0,0,3,8,1320,320,1987,0,98052,47.6772,-122.153,1770,9476,580000,4,2,2015,0,28,6985,7706,0,1,0
4,2.5,2800,4687,2.0,0,0,3,9,2800,0,2005,0,98038,47.3594,-122.04,2750,4750,399000,24,11,2014,0,9,1887,2000,0,0,0
3,1.75,1780,5000,1.5,0,0,3,6,1080,700,1957,0,98146,47.5105,-122.36,1500,5000,240000,15,4,2015,0,58,3220,3500,0,1,1
4,2.0,1480,3132,1.0,0,0,5,6,740,740,1910,0,98108,47.55,-122.312,1480,6420,335000,28,5,2014,0,104,1652,4940,0,1,1
3,3.0,2010,2554,2.0,0,0,3,7,1860,150,2001,0,98118,47.5525,-122.269,1370,5100,475000,17,3,2015,0,14,544,3730,0,1,1
3,2.0,2880,5100,1.5,0,0,4,7,2080,800,1926,0,98117,47.6805,-122.385,1820,5100,660000,26,8,2014,0,88,2220,3280,0,1,1
3,1.0,940,1948,1.0,0,0,5,6,940,0,1900,0,98107,47.6733,-122.383,1700,5000,551000,24,7,2014,0,114,1008,3300,0,0,1
4,1.75,1620,10530,1.0,0,0,3,7,1620,0,1968,0,98030,47.3808,-122.211,1890,9975,249950,20,3,2015,0,47,8910,8085,0,0,0
3,1.75,1530,6743,1.0,0,0,3,7,1410,120,1955,0,98116,47.5745,-122.396,2040,6000,575000,3,7,2014,0,59,5213,3960,0,1,1
4,2.75,3460,11350,1.0,0,4,4,9,1780,1680,1974,0,98006,47.568,-122.153,3200,13874,1090000,18,7,2014,0,40,7890,10674,0,1,0
4,2.5,2890,7306,2.0,0,0,3,7,2890,0,2006,0,98065,47.5447,-121.883,2850,6687,515000,18,11,2014,0,8,4416,3837,0,0,0
3,1.5,1980,11214,1.0,0,0,3,7,1980,0,1959,0,98168,47.4696,-122.298,1510,9072,235000,10,12,2014,0,55,9234,7562,0,0,1
3,1.0,1980,3243,1.5,0,0,3,8,1980,0,1912,0,98102,47.6429,-122.327,1380,1249,796000,15,9,2014,0,102,1263,-131,0,0,1
2,1.5,1450,2550,1.0,0,0,3,7,820,630,1984,0,98103,47.6911,-122.348,1450,5100,450000,23,4,2015,0,31,1100,3650,0,1,1
4,3.0,4280,18834,1.0,0,4,5,11,2180,2100,1971,0,98116,47.5811,-122.4,2490,8858,2050000,6,11,2014,0,43,14554,6368,0,1,1
4,2.5,1810,6509,2.0,0,0,3,7,1810,0,1994,0,98042,47.3531,-122.143,1760,7417,270000,8,5,2014,0,20,4699,5657,0,0,0
3,1.0,1610,4108,1.5,0,0,5,7,1610,0,1928,0,98126,47.5704,-122.376,1680,4467,565000,9,3,2015,0,87,2498,2787,0,0,1
1,2.5,1820,3008,2.0,0,0,3,7,1090,730,1910,2004,98103,47.6529,-122.339,1860,3420,680000,4,8,2014,94,104,1188,1560,1,1,1
4,2.25,3740,18000,1.0,0,0,4,9,1870,1870,1951,0,98177,47.7027,-122.378,2610,10902,1150000,15,9,2014,0,63,14260,8292,0,1,1
4,3.25,3526,15958,2.0,0,0,3,10,3526,0,1997,0,98075,47.567,-122.033,3639,15090,911000,4,5,2015,0,18,12432,11451,0,0,0
2,1.0,1070,6625,1.0,0,0,3,7,830,240,1950,0,98116,47.5736,-122.393,1310,6625,425000,12,11,2014,0,64,5555,5315,0,1,1
2,1.0,1270,6000,1.0,0,0,3,7,1270,0,1939,0,98199,47.6482,-122.393,1770,6000,425000,5,3,2015,0,76,4730,4230,0,0,1
4,1.5,1970,14490,1.5,0,0,4,7,1970,0,1963,0,98059,47.4612,-122.069,1880,14880,374950,14,8,2014,0,51,12520,13000,0,0,0
3,2.25,1640,7630,1.0,0,0,4,8,1180,460,1968,0,98032,47.3739,-122.29,1930,7630,247000,3,12,2014,0,46,5990,5700,0,1,0
3,1.0,1600,7161,1.0,0,0,3,8,1600,0,1953,0,98118,47.5507,-122.261,1760,8280,475000,12,12,2014,0,61,5561,6520,0,0,1
3,2.5,3020,5868,2.0,0,0,3,7,3020,0,2003,0,98092,47.3361,-122.175,2710,5470,275000,1,8,2014,0,11,2848,2760,0,0,0
3,2.5,2700,9994,1.0,0,3,4,7,1350,1350,1959,0,98198,47.397,-122.321,2470,10664,402000,6,6,2014,0,55,7294,8194,0,1,1
3,3.0,3700,16857,1.0,0,0,3,10,2170,1530,2000,0,98117,47.6956,-122.392,2320,12000,1100000,14,8,2014,0,14,13157,9680,0,1,1
4,1.75,2190,9225,1.0,0,0,4,7,1250,940,1959,0,98028,47.7396,-122.256,2190,9225,375000,30,7,2014,0,55,7035,7035,0,1,0
5,2.75,2840,12253,1.0,0,0,3,7,1420,1420,1960,0,98028,47.7618,-122.253,2210,11620,396000,11,9,2014,0,54,9413,9410,0,1,0
4,2.75,2610,9077,1.0,0,0,4,8,1310,1300,1987,0,98058,47.4612,-122.147,1900,10500,320000,16,7,2014,0,27,6467,8600,0,1,0
3,2.5,2630,5827,2.0,0,0,3,8,2630,0,2001,0,98053,47.688,-122.038,2330,4715,610000,9,7,2014,0,13,3197,2385,0,0,0
3,1.5,1090,7698,1.0,0,0,5,7,1090,0,1966,0,98058,47.4553,-122.174,1540,7624,249950,17,11,2014,0,48,6608,6084,0,0,0
2,2.0,1670,7772,1.0,0,0,4,6,860,810,1919,0,98126,47.5461,-122.377,1300,7770,448000,26,3,2015,0,96,6102,6470,0,1,1
3,1.0,1300,3600,2.0,0,0,3,7,1300,0,1900,0,98119,47.6345,-122.366,2510,4800,819000,28,4,2015,0,115,2300,2290,0,0,1
4,2.5,1700,6031,2.0,0,0,3,8,1700,0,1994,0,98030,47.3582,-122.191,1930,6035,225000,1,12,2014,0,20,4331,4105,0,0,0
4,2.5,2770,6000,2.0,0,0,3,8,2400,370,1993,0,98136,47.5536,-122.383,2120,6000,685000,14,4,2015,0,22,3230,3880,0,1,1
3,3.25,3240,8338,2.0,0,0,3,9,3240,0,2001,0,98074,47.6321,-122.064,3420,8405,812000,20,6,2014,0,13,5098,4985,0,0,0
2,2.5,2300,6400,1.0,0,0,3,8,2300,0,2007,0,98053,47.7196,-122.02,2300,6400,705000,2,12,2014,0,7,4100,4100,0,0,0
4,3.0,2483,6870,2.0,0,0,3,8,2483,0,2005,0,98030,47.3627,-122.199,1943,6434,360000,29,4,2015,0,10,4387,4491,0,0,0
1,1.5,760,779,3.0,0,0,3,8,760,0,2006,0,98107,47.6715,-122.382,1290,1189,344000,12,1,2015,0,9,19,-101,0,0,1
4,1.5,2040,6900,2.0,0,0,3,9,2040,0,1903,0,98112,47.6188,-122.285,3150,8220,825000,22,10,2014,0,111,4860,5070,0,0,1
3,1.0,1200,6120,1.0,0,0,4,7,950,250,1945,0,98115,47.6929,-122.287,1550,6120,476500,27,4,2015,0,70,4920,4570,0,1,1
2,1.0,960,5096,1.0,0,0,5,7,960,0,1949,0,98126,47.5314,-122.378,1760,4488,379500,24,11,2014,0,65,4136,2728,0,0,1
3,3.25,2260,7701,2.0,0,0,3,8,1760,500,2000,0,98146,47.5053,-122.377,1880,7529,477590,31,7,2014,0,14,5441,5649,0,1,1
3,1.0,1910,8190,1.0,0,0,4,7,1010,900,1946,0,98117,47.697,-122.365,1600,5042,490000,20,5,2014,0,68,6280,3442,0,1,1
3,1.5,1500,5000,1.5,0,0,4,7,1140,360,1927,0,98117,47.679,-122.373,1500,5000,470000,28,6,2014,0,87,3500,3500,0,1,1
3,2.25,1360,1236,2.0,0,0,3,8,1140,220,2006,0,98112,47.6198,-122.299,1620,1231,500000,24,7,2014,0,8,-124,-389,0,1,1
3,1.0,1320,7341,1.0,0,0,3,7,1320,0,1982,0,98155,47.7367,-122.295,1160,7573,370000,30,6,2014,0,32,6021,6413,0,0,1
2,1.5,1940,4400,1.0,0,0,3,7,970,970,1923,0,98112,47.6371,-122.279,1480,3080,790000,11,3,2015,0,92,2460,1600,0,1,1
4,2.75,3040,2800,2.0,0,0,3,9,2100,940,1906,2014,98102,47.6245,-122.327,1260,2178,840000,28,5,2014,108,108,-240,918,1,1,1
3,2.25,2210,11585,1.0,0,0,4,7,1510,700,1958,0,98155,47.7574,-122.279,1870,14092,507000,28,8,2014,0,56,9375,12222,0,1,1
3,1.75,1540,6273,1.0,0,0,4,6,770,770,1951,0,98118,47.5305,-122.277,1140,5512,263500,22,11,2014,0,63,4733,4372,0,1,1
3,2.5,1320,1683,2.0,0,0,3,8,1270,50,2004,0,98106,47.5357,-122.365,1320,2206,369000,12,7,2014,0,10,363,886,0,1,1
3,2.5,3040,5326,2.0,0,0,3,9,3040,0,2008,0,98055,47.4472,-122.207,3040,5442,500000,14,8,2014,0,6,2286,2402,0,0,0
2,1.0,910,4301,1.0,0,0,4,7,910,0,1923,0,98117,47.6814,-122.399,1810,4301,570000,6,4,2015,0,92,3391,2491,0,0,1
4,3.0,2040,7145,1.0,0,0,3,8,1490,550,1994,0,98092,47.3275,-122.171,1940,7145,284000,6,3,2015,0,21,5105,5205,0,1,0
2,1.0,980,4108,1.0,0,0,3,7,980,0,1947,0,98117,47.687,-122.381,1500,4046,415000,10,11,2014,0,67,3128,2546,0,0,1
3,1.0,980,3090,1.5,0,0,3,6,980,0,1903,0,98118,47.5525,-122.277,980,3090,197500,15,5,2014,0,111,2110,2110,0,0,1
4,3.75,4420,9492,2.0,0,1,3,9,3420,1000,1962,2005,98125,47.7211,-122.283,2880,9900,925000,27,10,2014,43,52,5072,7020,1,1,1
3,2.0,1570,6300,1.0,0,0,3,7,820,750,1953,2005,98118,47.5565,-122.275,1510,4281,468000,12,11,2014,52,61,4730,2771,1,1,1
3,1.0,1600,5001,1.5,0,0,5,6,1080,520,1930,0,98125,47.7232,-122.289,1340,5001,355000,15,7,2014,0,84,3401,3661,0,1,1
4,1.75,1830,6000,1.0,0,0,4,7,930,900,1939,0,98199,47.6536,-122.41,1540,6000,639000,12,8,2014,0,75,4170,4460,0,1,1
3,2.5,2820,14250,2.0,0,0,3,11,2820,0,1991,0,98074,47.6396,-122.054,2820,12600,720000,12,4,2015,0,24,11430,9780,0,0,0
3,1.75,1800,6000,1.0,0,0,5,6,900,900,1950,0,98155,47.7505,-122.317,1060,6628,381000,12,6,2014,0,64,4200,5568,0,1,1
3,3.0,2980,3730,2.0,0,0,3,9,2980,0,2005,0,98029,47.5533,-121.995,2710,3640,670000,11,11,2014,0,9,750,930,0,0,0
3,1.0,1690,6658,1.0,0,0,3,7,1690,0,1942,1982,98133,47.7099,-122.35,1080,5925,400000,28,10,2014,40,72,4968,4845,1,0,1
3,1.0,1250,9427,1.0,0,0,3,6,1250,0,1931,0,98034,47.7254,-122.175,1590,8250,294000,2,4,2015,0,84,8177,6660,0,0,0
3,1.75,1500,10230,1.0,0,0,2,7,1500,0,1968,0,98058,47.4349,-122.168,1770,8374,315001,10,3,2015,0,47,8730,6604,0,0,0
3,2.0,1630,10723,1.0,0,0,5,7,1630,0,1959,0,98059,47.4898,-122.133,1450,10723,360000,31,7,2014,0,55,9093,9273,0,0,0
3,2.0,1410,2700,2.0,0,0,4,7,1410,0,1902,0,98122,47.6029,-122.302,1750,4000,520000,5,8,2014,0,112,1290,2250,0,0,1
3,1.0,1140,4560,1.0,0,0,4,6,770,370,1944,0,98117,47.6889,-122.362,1340,3980,474000,10,10,2014,0,70,3420,2640,0,1,1
4,2.5,3280,5876,2.0,0,0,3,7,3280,0,2004,0,98053,47.6802,-122.034,2600,5000,702000,13,3,2015,0,11,2596,2400,0,0,0
4,2.5,2020,7277,2.0,0,0,3,8,2020,0,1993,0,98055,47.4318,-122.19,2820,7284,308000,5,3,2015,0,22,5257,4464,0,0,0
5,4.0,4580,4443,3.0,1,4,3,10,4580,0,2004,0,98075,47.5682,-122.059,2710,4443,2000000,24,5,2014,0,10,-137,1733,0,0,0
3,2.5,2270,7917,2.0,0,0,3,8,2270,0,1986,0,98092,47.2643,-122.22,2160,7917,340000,25,7,2014,0,28,5647,5757,0,0,0
2,1.75,1310,10200,1.0,0,0,4,6,1310,0,1947,0,98065,47.5231,-121.82,1500,7200,306500,1,4,2015,0,68,8890,5700,0,0,0
3,2.0,1420,3600,1.5,0,0,4,7,1420,0,1904,0,98119,47.6367,-122.364,1250,3600,716000,26,1,2015,0,111,2180,2350,0,0,1
5,3.0,4180,8561,2.0,0,0,3,7,4180,0,2003,0,98053,47.6833,-122.04,3425,6591,673200,29,8,2014,0,11,4381,3166,0,0,0
4,2.25,1950,6000,1.0,0,0,3,7,1350,600,1961,0,98115,47.6909,-122.301,1980,6000,564500,23,3,2015,0,54,4050,4020,0,1,1
4,1.75,1790,11801,1.0,0,0,4,8,1790,0,1974,0,98056,47.5172,-122.17,2000,12988,393000,6,2,2015,0,41,10011,10988,0,0,0
5,1.75,1400,5071,1.0,0,0,3,5,1400,0,1916,0,98014,47.6499,-121.908,1200,7500,425000,12,3,2015,0,99,3671,6300,0,0,0
4,2.5,3120,7448,2.0,0,0,3,9,3120,0,1998,0,98042,47.3645,-122.126,2980,8102,444900,18,3,2015,0,17,4328,5122,0,0,0
3,3.25,1370,1194,3.0,0,0,3,8,1370,0,2004,0,98107,47.6718,-122.388,1800,2678,469000,18,8,2014,0,10,-176,878,0,0,1
3,1.75,1520,7875,1.0,0,0,5,8,1520,0,1969,0,98006,47.5569,-122.176,2150,9428,525000,26,9,2014,0,45,6355,7278,0,0,0
3,2.5,2410,17424,1.0,0,0,3,7,1630,780,1978,0,98030,47.3741,-122.218,1530,11761,330000,4,4,2015,0,37,15014,10231,0,1,0
4,1.0,1260,4080,1.0,0,0,4,7,1260,0,1911,0,98105,47.6644,-122.324,1340,4080,618000,2,10,2014,0,103,2820,2740,0,0,1
4,2.5,2830,7350,1.0,0,0,3,8,1690,1140,1982,0,98023,47.3088,-122.341,2350,7768,295500,17,11,2014,0,32,4520,5418,0,1,0
2,1.0,1020,9200,1.0,0,0,3,7,1020,0,1978,0,98045,47.4461,-121.769,1520,9600,303000,4,5,2015,0,37,8180,8080,0,0,0
4,2.5,2200,8065,2.0,0,0,3,7,2200,0,1998,0,98031,47.4042,-122.213,2641,8535,300000,8,7,2014,0,16,5865,5894,0,0,0
3,1.5,1420,7520,1.0,0,0,4,7,1420,0,1956,0,98007,47.601,-122.134,2000,7520,413107,15,10,2014,0,58,6100,5520,0,0,0
3,1.0,1350,3090,1.5,0,0,5,6,1350,0,1914,0,98103,47.682,-122.348,1350,3090,400000,20,8,2014,0,100,1740,1740,0,0,1
3,1.0,1290,6859,1.0,0,0,4,7,1290,0,1941,0,98136,47.5317,-122.387,1560,6369,535000,8,4,2015,0,74,5569,4809,0,0,1
4,2.0,1680,2600,1.0,0,0,5,7,840,840,1915,0,98107,47.6648,-122.363,1680,3340,555000,19,9,2014,0,99,920,1660,0,1,1
3,2.5,2280,6386,2.0,0,0,3,8,2280,0,2008,0,98042,47.3861,-122.096,2550,4835,312000,19,11,2014,0,6,4106,2285,0,0,0
3,2.25,1840,3500,1.5,0,0,5,8,1540,300,1910,0,98122,47.6063,-122.292,1800,3300,785200,3,6,2014,0,104,1660,1500,0,1,1
4,2.0,2040,11850,1.0,0,2,3,7,1020,1020,1959,0,98033,47.6891,-122.208,2040,8504,749000,16,10,2014,0,55,9810,6464,0,1,0
3,1.5,1490,10367,1.0,0,0,3,7,1010,480,1957,0,98146,47.4973,-122.347,1000,8254,285000,5,4,2015,0,58,8877,7254,0,1,1
4,2.5,2440,5088,2.0,0,0,3,7,2440,0,2007,0,98065,47.5406,-121.889,2440,5762,425000,10,9,2014,0,7,2648,3322,0,0,0
3,2.0,1930,15540,1.0,0,0,3,8,1260,670,1958,0,98155,47.7675,-122.307,1900,12123,360000,17,7,2014,0,56,13610,10223,0,1,1
3,1.0,1200,6615,1.0,0,0,4,7,1200,0,1954,0,98106,47.5168,-122.351,1230,6615,260000,5,5,2015,0,61,5415,5385,0,0,1
3,2.0,1550,8509,1.0,0,0,3,7,1150,400,1959,0,98106,47.5299,-122.344,1840,7620,369000,30,5,2014,0,55,6959,5780,0,1,1
4,2.5,2180,11132,1.0,0,0,4,8,1620,560,1978,0,98023,47.3187,-122.367,1950,13801,275000,15,8,2014,0,36,8952,11851,0,1,0
3,2.25,1430,1448,3.0,0,0,3,8,1430,0,2005,0,98103,47.6916,-122.341,1430,1383,407000,3,9,2014,0,9,18,-47,0,0,1
2,1.75,1230,5418,1.0,0,0,3,8,990,240,1949,0,98117,47.6839,-122.376,1330,5074,575000,12,4,2015,0,66,4188,3744,0,1,1
3,1.5,1670,3852,2.0,0,3,4,8,1670,0,1928,0,98119,47.6411,-122.371,2320,4572,1240000,27,4,2015,0,87,2182,2252,0,0,1
2,2.5,2720,4913,1.0,0,1,4,8,1700,1020,1936,0,98199,47.6384,-122.404,2520,5303,875000,8,1,2015,0,79,2193,2783,0,1,1
4,1.5,2220,6811,1.0,0,0,4,7,1270,950,1961,0,98056,47.5059,-122.193,1800,7350,320000,12,7,2014,0,53,4591,5550,0,1,0
3,1.5,1520,9041,1.0,0,0,4,7,1520,0,1954,0,98004,47.6158,-122.213,3260,10020,810000,3,7,2014,0,60,7521,6760,0,0,0
3,1.75,1590,7620,1.0,0,0,4,7,1090,500,1984,0,98038,47.3655,-122.048,1590,7620,274000,14,4,2015,0,31,6030,6030,0,1,0
4,1.75,1480,9523,1.0,0,0,3,7,1120,360,1959,0,98030,47.3732,-122.217,1590,8300,239900,19,12,2014,0,55,8043,6710,0,1,0
4,1.5,1860,7808,1.0,0,0,3,7,1080,780,1953,0,98125,47.7314,-122.3,1530,7884,450000,14,12,2014,0,61,5948,6354,0,1,1
3,1.0,1360,5967,1.0,0,0,3,6,1360,0,1954,0,98178,47.4973,-122.256,1360,6052,265000,15,4,2015,0,61,4607,4692,0,0,1
4,3.0,2360,6250,1.0,0,2,3,7,1460,900,1960,0,98118,47.512,-122.249,2500,6250,418000,16,6,2014,0,54,3890,3750,0,1,1
3,2.0,2360,5737,2.0,0,0,3,8,2360,0,2003,0,98028,47.7633,-122.262,1600,9163,390000,13,8,2014,0,11,3377,7563,0,0,0
3,2.0,1860,7500,1.0,0,0,3,7,930,930,1909,1950,98106,47.5662,-122.364,1000,5000,430000,22,4,2015,41,106,5640,4000,1,1,1
3,2.25,2630,9705,2.5,0,2,4,8,2630,0,1987,0,98052,47.6485,-122.121,2640,14284,1440000,23,4,2015,0,28,7075,11644,0,0,0
4,2.25,2330,7220,2.0,0,1,3,8,1600,730,1988,0,98177,47.7764,-122.386,2220,9100,650000,1,4,2015,0,27,4890,6880,0,1,1
2,1.0,720,18000,1.0,0,0,3,6,720,0,1950,0,98178,47.5054,-122.261,1250,7925,195000,9,5,2014,0,64,17280,6675,0,0,1
3,1.75,1640,4590,1.5,0,0,5,7,1640,0,1951,0,98115,47.6846,-122.294,1760,5100,700000,19,2,2015,0,64,2950,3340,0,0,1
2,1.0,1030,8576,1.5,0,0,5,6,1030,0,1952,0,98155,47.7352,-122.295,1310,8504,315000,7,10,2014,0,62,7546,7194,0,0,1
3,1.0,1790,5250,1.0,0,0,3,7,1400,390,1943,0,98105,47.6627,-122.276,1790,5250,603000,8,10,2014,0,71,3460,3460,0,1,1
2,1.0,840,3400,1.0,0,2,4,7,840,0,1924,0,98119,47.6403,-122.372,2000,4000,530000,29,6,2014,0,90,2560,2000,0,0,1
3,1.75,1300,8480,1.0,0,0,3,7,1300,0,1969,0,98052,47.6991,-122.13,1740,7280,397500,9,9,2014,0,45,7180,5540,0,0,0
3,1.0,1240,5250,1.5,0,0,4,6,1240,0,1904,0,98055,47.4917,-122.206,1240,5250,221000,25,3,2015,0,111,4010,4010,0,0,0
4,2.25,2170,8050,1.0,0,0,3,7,1220,950,1976,0,98072,47.7354,-122.174,1820,7700,466000,2,12,2014,0,38,5880,5880,0,1,0
3,1.0,1330,5412,2.0,0,0,5,7,1330,0,1905,0,98022,47.2053,-121.993,1710,10825,197500,19,6,2014,0,109,4082,9115,0,0,0
3,3.0,1390,1080,2.0,0,0,3,7,1140,250,2006,0,98118,47.5325,-122.282,1450,1461,280000,7,5,2015,0,9,-310,11,0,1,1
2,1.5,1240,3873,1.0,0,0,4,6,860,380,1909,0,98116,47.5752,-122.388,1240,4336,412000,3,10,2014,0,105,2633,3096,0,1,1
2,1.0,880,6731,1.0,0,0,4,7,880,0,1950,0,98116,47.5694,-122.395,1240,6731,454000,18,8,2014,0,64,5851,5491,0,0,1
5,1.5,2520,5753,1.5,0,0,4,7,1510,1010,1928,0,98022,47.2058,-121.997,1620,6875,250000,9,6,2014,0,86,3233,5255,0,1,0
5,1.75,2020,7902,1.0,0,0,3,7,1220,800,1962,0,98168,47.51,-122.327,2220,8819,245000,13,5,2014,0,52,5882,6599,0,1,1
3,1.75,2060,7251,1.0,0,0,3,7,1350,710,1987,0,98030,47.3569,-122.175,1520,7582,290000,7,10,2014,0,27,5191,6062,0,1,0
2,1.0,930,7742,1.0,0,0,3,6,930,0,1933,0,98168,47.507,-122.302,2240,8723,160000,5,2,2015,0,82,6812,6483,0,0,1
2,1.5,2700,7225,1.5,0,4,3,8,1660,1040,1910,2008,98116,47.5892,-122.383,2970,5150,1260000,30,3,2015,98,105,4525,2180,1,1,1
2,1.0,1060,6050,1.0,0,0,3,7,940,120,1939,0,98125,47.7028,-122.321,1540,5279,325000,27,3,2015,0,76,4990,3739,0,1,1
2,1.0,670,6750,1.0,0,0,4,5,670,0,1947,0,98188,47.4521,-122.283,1700,11520,185000,8,1,2015,0,68,6080,9820,0,0,1
3,2.0,1750,4990,1.0,0,0,3,7,950,800,1916,0,98107,47.6667,-122.361,1700,5000,477000,25,9,2014,0,98,3240,3300,0,1,1
2,1.0,930,7623,1.0,0,0,2,6,930,0,1942,0,98166,47.467,-122.349,1300,7641,100000,30,6,2014,0,72,6693,6341,0,0,1
4,2.5,2420,11481,1.0,0,0,3,8,1370,1050,1985,0,98003,47.341,-122.318,2290,8985,345000,4,5,2015,0,30,9061,6695,0,1,0
3,1.0,1150,7156,1.0,0,0,4,6,1150,0,1953,0,98168,47.4864,-122.317,1210,7156,203000,20,6,2014,0,61,6006,5946,0,0,1
4,2.5,2480,5000,2.0,0,0,3,7,2480,0,2004,0,98053,47.6811,-122.035,2410,5000,599000,28,10,2014,0,10,2520,2590,0,0,0
4,1.0,1310,6000,1.5,0,0,3,7,1310,0,1940,0,98144,47.5822,-122.295,1630,6000,370000,20,7,2014,0,74,4690,4370,0,0,1
3,1.0,1240,8000,1.0,0,0,4,6,1040,200,1954,0,98198,47.4204,-122.316,1240,8000,140000,27,2,2015,0,61,6760,6760,0,1,1
3,1.0,1150,5100,2.0,0,0,3,8,1150,0,1911,2005,98136,47.5349,-122.384,1440,5100,500000,23,6,2014,94,103,3950,3660,1,0,1
3,1.75,1460,4000,1.0,0,2,4,7,730,730,1929,0,98144,47.5768,-122.307,1360,4000,527200,3,2,2015,0,86,2540,2640,0,1,1
5,2.75,3060,7015,1.0,0,0,5,8,1600,1460,1979,0,98146,47.5052,-122.372,2190,7600,549900,10,5,2014,0,35,3955,5410,0,1,1
4,2.5,3520,8095,2.0,0,0,3,9,3520,0,2006,0,98052,47.7065,-122.109,2460,4676,760000,2,5,2015,0,9,4575,2216,0,0,0
2,1.0,960,4400,1.0,0,0,4,7,960,0,1951,0,98118,47.5269,-122.264,1520,5000,319000,28,7,2014,0,63,3440,3480,0,0,1
3,2.5,2430,15264,2.0,0,0,3,8,2430,0,1997,0,98030,47.3805,-122.208,2260,10416,362300,23,6,2014,0,17,12834,8156,0,0,0
3,2.5,1930,4505,1.0,0,3,4,7,1440,490,1973,0,98198,47.3459,-122.326,1550,4505,421000,27,4,2015,0,42,2575,2955,0,1,1
3,1.0,1090,4000,1.5,0,0,4,7,1090,0,1945,0,98117,47.6846,-122.386,1520,4000,690000,4,3,2015,0,70,2910,2480,0,0,1
4,1.75,1650,6900,1.0,0,0,3,7,910,740,1978,1993,98002,47.2802,-122.211,1540,7645,238000,8,12,2014,15,36,5250,6105,1,1,0
6,4.0,5310,12741,2.0,0,2,3,10,3600,1710,1967,0,98040,47.5696,-122.213,4190,12632,1050000,23,4,2015,0,48,7431,8442,0,1,0
3,2.5,1690,4476,2.0,0,0,3,7,1690,0,2008,0,98042,47.3663,-122.114,2250,4488,302500,8,4,2015,0,7,2786,2238,0,0,0
4,1.75,1400,7920,1.0,0,0,3,7,1400,0,1963,0,98058,47.4658,-122.184,1910,7700,259950,11,3,2015,0,52,6520,5790,0,0,0
3,2.5,1360,3718,2.0,0,0,3,7,1360,0,1987,0,98052,47.6827,-122.097,1090,3718,369950,25,9,2014,0,27,2358,2628,0,0,0
3,2.5,1850,6676,2.0,0,0,3,7,1850,0,1986,0,98023,47.3103,-122.36,1700,6663,268000,8,10,2014,0,28,4826,4963,0,0,0
5,2.5,2860,4000,2.0,0,0,4,8,2160,700,1910,0,98102,47.6225,-122.318,1340,1224,1200000,23,9,2014,0,104,1140,-116,0,1,1
3,1.0,1120,10176,1.0,0,0,3,6,920,200,1905,0,98118,47.5235,-122.277,1350,7500,345000,16,7,2014,0,109,9056,6150,0,1,1
3,2.5,1920,7200,2.0,0,2,3,10,1780,140,1997,0,98116,47.5709,-122.408,2080,5000,900000,8,4,2015,0,18,5280,2920,0,1,1
3,2.5,3230,5000,2.0,0,2,5,8,2430,800,1945,0,98117,47.7011,-122.389,1820,5000,850000,3,7,2014,0,69,1770,3180,0,1,1
3,1.75,1260,6500,1.0,0,0,4,7,1260,0,1966,0,98008,47.6224,-122.116,1500,7700,390000,6,5,2014,0,48,5240,6200,0,0,0
3,1.75,1540,6909,1.0,0,0,4,7,920,620,1955,0,98155,47.7451,-122.313,1130,6908,345000,10,6,2014,0,59,5369,5778,0,1,1
3,2.5,1700,3150,2.0,0,0,3,8,1700,0,2005,0,98029,47.5505,-121.998,1700,3600,534500,16,6,2014,0,9,1450,1900,0,0,0
6,5.25,3600,3960,2.0,0,0,3,7,2400,1200,1971,0,98126,47.5656,-122.372,1450,4600,643500,18,11,2014,0,43,360,3150,0,1,1
3,2.75,3150,5520,1.5,0,0,4,8,2130,1020,1925,0,98112,47.6345,-122.302,3160,6200,1210000,2,4,2015,0,90,2370,3040,0,1,1
2,1.75,1280,4000,1.0,0,0,4,7,730,550,1929,0,98116,47.5798,-122.383,2250,5382,495000,15,1,2015,0,86,2720,3132,0,1,1
2,1.0,980,4120,1.0,0,0,3,7,830,150,1950,2014,98115,47.6815,-122.291,1760,4120,535000,30,7,2014,64,64,3140,2360,1,1,1
4,2.5,2190,6578,2.0,0,0,3,7,2190,0,2004,0,98065,47.5305,-121.847,2190,5416,435000,29,10,2014,0,10,4388,3226,0,0,0
4,2.0,2470,1831,2.0,0,0,3,7,1970,500,2009,0,98166,47.4645,-122.337,1310,7500,305000,13,11,2014,0,5,-639,6190,0,1,1
4,2.5,2590,7910,2.0,0,0,3,9,2590,0,2001,0,98115,47.6978,-122.284,1700,7488,799000,19,6,2014,0,13,5320,5788,0,0,1
4,2.5,2580,15031,2.0,0,0,3,9,2580,0,1999,0,98052,47.6895,-122.094,3030,10361,700000,13,11,2014,0,15,12451,7331,0,0,0
3,2.25,1270,1213,2.0,0,0,3,8,1040,230,2005,0,98107,47.6736,-122.375,1410,1265,467000,20,5,2014,0,9,-57,-145,0,1,1
3,1.0,1250,7560,1.0,0,0,3,6,1250,0,1959,0,98058,47.4493,-122.173,1270,7615,263000,7,4,2015,0,56,6310,6345,0,0,0
4,2.5,4660,7157,2.0,0,0,3,9,3020,1640,2003,0,98059,47.5352,-122.156,3300,7047,760000,20,8,2014,0,11,2497,3747,0,1,0
4,2.5,2019,4435,2.0,0,3,3,8,2019,0,2008,0,98022,47.1958,-121.974,1950,4800,293000,7,2,2015,0,7,2416,2850,0,0,0
3,2.0,1490,7929,1.0,0,0,3,7,1490,0,1989,0,98002,47.2875,-122.218,1650,7929,245000,21,8,2014,0,25,6439,6279,0,0,0
3,1.0,1030,15264,1.0,0,0,4,7,1030,0,1962,0,98056,47.5016,-122.168,1430,14840,240000,23,4,2015,0,53,14234,13410,0,0,0
4,2.75,2560,7961,1.0,0,2,4,8,1450,1110,1975,0,98033,47.6499,-122.199,2500,9009,880000,17,11,2014,0,39,5401,6509,0,1,0
3,2.0,1460,6377,1.0,0,0,3,7,1460,0,1995,0,98038,47.3679,-122.02,1600,6250,285000,25,6,2014,0,19,4917,4650,0,0,0
2,1.0,770,6017,1.0,0,0,3,7,770,0,1950,0,98125,47.7223,-122.321,1670,7500,407500,16,4,2015,0,65,5247,5830,0,0,1
4,2.5,1960,3543,2.0,0,0,3,7,1960,0,2004,0,98056,47.4849,-122.184,2420,3646,325000,12,8,2014,0,10,1583,1226,0,0,0
3,1.75,1900,10454,1.0,0,0,3,7,1390,510,1978,0,98155,47.7748,-122.291,2000,12000,405000,17,10,2014,0,36,8554,10000,0,1,1
3,2.5,1970,4120,1.5,0,0,3,6,1230,740,1927,0,98106,47.5328,-122.346,1470,4080,291700,7,4,2015,0,88,2150,2610,0,1,1
3,2.5,2490,18525,2.0,0,3,3,8,2490,0,1995,0,98022,47.2119,-122.001,1850,9516,370000,16,10,2014,0,19,16035,7666,0,0,0
3,1.5,1430,8960,1.0,0,0,4,6,1430,0,1953,0,98166,47.4759,-122.349,1560,10125,270000,28,5,2014,0,61,7530,8565,0,0,1
4,2.5,2680,7200,1.0,0,0,3,8,1380,1300,1952,2013,98033,47.6835,-122.187,1950,8520,800000,27,5,2014,61,62,4520,6570,1,1,0
3,1.75,1610,3210,1.0,0,0,5,7,910,700,1928,0,98103,47.6656,-122.335,1420,3210,626500,23,9,2014,0,86,1600,1790,0,1,1
4,3.5,4300,8406,2.0,0,1,3,11,3580,720,1987,0,98040,47.5396,-122.214,2770,10006,1130000,21,10,2014,0,27,4106,7236,0,1,0
4,2.5,3200,7545,2.0,0,0,3,7,3200,0,2003,0,98038,47.3666,-122.03,2840,7137,399950,22,8,2014,0,11,4345,4297,0,0,0
3,1.75,2140,15030,1.0,0,0,4,7,1570,570,1958,0,98166,47.4181,-122.338,2170,15030,419000,24,7,2014,0,56,12890,12860,0,1,1
4,3.5,3410,10769,2.0,0,0,3,10,3410,0,2008,0,98004,47.6081,-122.198,2650,10058,1410000,19,5,2014,0,6,7359,7408,0,0,0
4,2.75,2090,8064,2.0,0,0,5,7,2090,0,1967,0,98033,47.6829,-122.195,1460,8400,710000,31,7,2014,0,47,5974,6940,0,0,0
3,1.0,1410,4840,1.0,0,2,4,6,1230,180,1942,0,98033,47.6646,-122.204,1410,5400,650000,30,3,2015,0,73,3430,3990,0,1,0
3,1.0,1400,6879,1.0,0,0,3,7,1400,0,1951,0,98155,47.7508,-122.286,1950,7400,403000,18,3,2015,0,64,5479,5450,0,0,1
3,3.25,3620,4000,2.0,0,0,3,10,2730,890,2005,0,98199,47.6393,-122.403,1910,5000,1020000,3,7,2014,0,9,380,3090,0,1,1
4,2.5,2260,13600,1.0,0,0,4,8,1770,490,1974,0,98040,47.5436,-122.233,2630,13995,865000,22,9,2014,0,40,11340,11365,0,1,0
4,1.0,2150,3588,2.0,0,3,4,8,1850,300,1926,0,98126,47.5767,-122.378,1950,3588,810000,16,10,2014,0,88,1438,1638,0,1,1
3,2.5,1256,1154,3.0,0,0,3,7,1256,0,2005,0,98125,47.7146,-122.311,1309,1232,316750,15,7,2014,0,9,-102,-77,0,0,1
6,2.75,2850,15240,1.0,0,0,3,7,1850,1000,1962,0,98106,47.5288,-122.345,2090,7620,360000,4,2,2015,0,53,12390,5530,0,1,1
2,1.0,700,5100,1.0,0,0,4,5,700,0,1953,0,98056,47.4957,-122.168,970,5811,208000,16,4,2015,0,62,4400,4841,0,0,0
4,1.75,1400,11934,1.0,0,0,3,7,1050,350,1961,0,98028,47.7346,-122.244,2080,10400,295000,27,2,2015,0,54,10534,8320,0,1,0
4,1.75,3130,18253,2.0,0,0,3,7,3130,0,1978,0,98133,47.7402,-122.348,1850,12220,652500,6,5,2015,0,37,15123,10370,0,0,1
4,3.0,2170,5764,2.0,0,0,3,8,2170,0,1992,0,98029,47.5673,-121.999,2010,5681,560000,25,7,2014,0,22,3594,3671,0,0,0
3,1.0,1020,8400,1.0,0,0,4,7,1020,0,1957,0,98056,47.4905,-122.18,1690,8030,280000,4,5,2015,0,58,7380,6340,0,0,0
3,2.5,1760,8584,1.5,0,0,5,7,1760,0,1937,0,98148,47.4612,-122.325,2160,8584,289950,30,6,2014,0,77,6824,6424,0,0,1
2,1.75,1710,8645,1.0,0,0,4,7,1510,200,1923,0,98115,47.7005,-122.313,1280,5366,475000,16,7,2014,0,91,6935,4086,0,1,1
1,1.0,500,7440,1.0,0,0,1,5,500,0,1928,0,98106,47.5252,-122.362,1350,7440,125000,2,10,2014,0,86,6940,6090,0,0,1
4,1.5,1370,9750,1.0,0,0,3,7,1070,300,1953,0,98168,47.4718,-122.323,1540,9789,296000,20,8,2014,0,61,8380,8249,0,1,1
3,2.25,1650,6250,1.5,0,0,3,7,1650,0,1910,0,98116,47.5639,-122.4,2060,6250,390000,23,2,2015,0,105,4600,4190,0,0,1
3,1.0,1180,3750,1.0,0,0,3,6,1030,150,1940,0,98116,47.5726,-122.382,1280,3750,425000,19,11,2014,0,74,2570,2470,0,1,1
6,3.0,3110,5000,1.5,0,0,5,7,1810,1300,1921,0,98103,47.6631,-122.348,1600,4000,725000,26,6,2014,0,93,1890,2400,0,1,1
3,2.25,2080,12134,1.0,0,0,4,8,1530,550,1973,0,98052,47.6315,-122.102,2320,12400,605000,2,7,2014,0,41,10054,10080,0,1,0
3,1.0,1600,1950,2.0,0,0,2,7,1600,0,1906,0,98122,47.6028,-122.312,1310,1138,302000,5,11,2014,0,108,350,-172,0,0,1
3,2.25,2380,6000,2.0,0,0,5,9,1650,730,1931,0,98199,47.6472,-122.393,2000,6000,886000,18,3,2015,0,84,3620,4000,0,1,1
4,1.75,1630,6120,1.0,0,0,5,7,980,650,1918,0,98115,47.6821,-122.31,1630,4080,540000,14,8,2014,0,96,4490,2450,0,1,1
4,2.25,1910,8400,2.0,0,0,3,7,1910,0,1975,0,98072,47.7352,-122.175,1910,8400,435000,14,4,2015,0,40,6490,6490,0,0,0
4,3.25,3140,10752,2.0,0,0,3,7,2300,840,1992,0,98146,47.5022,-122.363,1300,9920,409000,10,10,2014,0,22,7612,8620,0,1,1
3,1.0,1250,7280,1.0,0,0,3,7,1250,0,1975,0,98052,47.6986,-122.129,1690,7280,405000,6,1,2015,0,40,6030,5590,0,0,0
3,2.5,1990,3984,2.0,0,0,3,8,1990,0,2004,0,98075,47.5914,-122.017,2320,3984,560200,11,6,2014,0,10,1994,1664,0,0,0
4,1.75,2110,7208,1.0,0,0,3,8,1170,940,1975,0,98058,47.4464,-122.129,1820,7208,324000,23,6,2014,0,39,5098,5388,0,1,0
4,2.5,2490,8290,2.0,0,0,3,9,2490,0,1999,0,98092,47.3305,-122.171,2690,7008,390000,19,5,2014,0,15,5800,4318,0,0,0
2,1.0,800,5000,1.0,0,0,3,6,800,0,1938,0,98055,47.4914,-122.204,1220,5000,414000,7,4,2015,0,77,4200,3780,0,0,0
3,2.5,2360,4670,2.0,0,0,3,7,2360,0,1998,0,98065,47.537,-121.871,2420,5620,441500,3,9,2014,0,16,2310,3200,0,0,0
3,2.5,1770,5146,2.0,0,0,3,7,1770,0,1992,0,98106,47.5263,-122.356,1230,5160,375000,9,3,2015,0,23,3376,3930,0,0,1
4,2.5,2710,5500,2.0,0,0,3,9,2710,0,1999,0,98074,47.6027,-122.023,2710,6242,668500,2,6,2014,0,15,2790,3532,0,0,0
5,1.5,1940,10202,1.5,0,0,4,7,1940,0,1940,0,98125,47.7213,-122.31,1900,8000,540000,7,10,2014,0,74,8262,6100,0,0,1
4,3.25,3440,4920,2.0,0,4,3,10,2520,920,2014,0,98116,47.5727,-122.409,2350,5166,1350000,25,3,2015,0,1,1480,2816,0,1,1
4,2.75,2410,9549,1.0,0,0,4,7,1780,630,1956,0,98033,47.6503,-122.197,2090,9549,758000,7,5,2014,0,58,7139,7459,0,1,0
4,2.25,2290,10687,2.0,0,0,3,9,2290,0,1978,0,98004,47.5878,-122.202,2290,10300,949880,27,5,2014,0,36,8397,8010,0,0,0
3,1.0,1030,4089,1.5,0,0,3,7,1030,0,1927,0,98116,47.574,-122.385,1440,4917,570000,7,5,2015,0,88,3059,3477,0,0,1
3,1.5,1490,4400,1.5,0,0,4,7,1490,0,1906,0,98122,47.6113,-122.292,1560,4400,670000,26,6,2014,0,108,2910,2840,0,0,1
4,1.75,2370,8400,1.0,0,0,5,9,1270,1100,1949,0,98105,47.6716,-122.264,2370,8400,1130000,6,4,2015,0,66,6030,6030,0,1,1
4,2.0,1930,3976,1.5,0,0,4,8,1930,0,1914,0,98122,47.6117,-122.297,1470,4080,650000,22,10,2014,0,100,2046,2610,0,0,1
2,1.75,1600,4000,1.0,0,0,5,7,850,750,1918,0,98112,47.6408,-122.3,1860,4000,690000,16,6,2014,0,96,2400,2140,0,1,1
2,1.0,770,4000,1.0,0,0,5,5,770,0,1924,0,98117,47.6959,-122.364,1420,5040,413500,19,5,2014,0,90,3230,3620,0,0,1
3,2.5,2300,9752,2.0,0,2,3,8,2300,0,1968,2003,98075,47.5825,-122.076,2640,10764,765000,14,4,2015,35,47,7452,8124,1,0,0
4,2.75,3400,7081,2.0,0,0,3,9,3400,0,2001,0,98006,47.5661,-122.123,3060,7081,828200,10,12,2014,0,13,3681,4021,0,0,0
2,1.0,900,4397,1.0,0,0,3,6,900,0,1918,0,98055,47.4851,-122.205,1430,4500,205000,26,7,2014,0,96,3497,3070,0,0,0
3,2.5,1450,5175,1.0,0,0,3,8,1030,420,1995,0,98133,47.7082,-122.338,1740,9250,465000,2,12,2014,0,19,3725,7510,0,1,1
4,2.5,2240,5402,2.0,0,0,3,8,2240,0,2005,0,98133,47.772,-122.35,2240,7560,556000,11,3,2015,0,10,3162,5320,0,0,1
4,2.5,1780,4169,2.0,0,0,3,8,1780,0,1994,0,98029,47.5695,-122.006,1830,4164,540000,8,6,2014,0,20,2389,2334,0,0,0
4,2.5,2320,4254,2.0,0,0,3,8,2320,0,2004,0,98059,47.48,-122.137,2330,4602,423000,29,7,2014,0,10,1934,2272,0,0,0
3,1.75,1590,14766,1.0,0,0,3,8,1590,0,1963,0,98007,47.5902,-122.147,2040,10190,375000,10,4,2015,0,52,13176,8150,0,0,0
3,1.0,990,12696,1.5,0,0,3,7,990,0,1936,0,98168,47.4776,-122.279,1260,8937,173250,9,12,2014,0,78,11706,7677,0,0,1
3,1.5,2605,12030,1.0,0,0,3,8,1355,1250,2003,0,98019,47.7725,-121.899,1590,15242,599900,5,2,2015,0,12,9425,13652,0,1,0
5,2.75,2870,4461,1.0,0,0,3,7,1650,1220,1976,0,98107,47.675,-122.39,1890,4196,646000,18,6,2014,0,38,1591,2306,0,1,1
5,4.75,5180,17811,2.0,0,2,3,11,4070,1110,2001,0,98065,47.5405,-121.868,3960,15103,1080000,5,6,2014,0,13,12631,11143,0,1,0
4,2.0,2180,3870,1.0,0,0,3,7,1020,1160,1900,0,98122,47.6089,-122.303,1520,2580,558000,10,6,2014,0,114,1690,1060,0,1,1
2,1.0,850,5225,1.0,0,0,3,7,850,0,1949,0,98126,47.5311,-122.38,1230,5225,354000,10,11,2014,0,65,4375,3995,0,0,1
4,4.0,4050,9517,2.0,0,0,3,11,3360,690,1990,0,98040,47.5769,-122.215,3330,9436,1200000,8,1,2015,0,25,5467,6106,0,1,0
4,2.0,2250,4200,1.5,0,0,3,7,1650,600,1909,0,98122,47.6136,-122.297,1200,3360,670000,31,3,2015,0,106,1950,2160,0,1,1
6,4.25,3100,9378,3.0,0,2,3,11,3100,0,1978,0,98112,47.6381,-122.314,3270,6334,1130000,6,10,2014,0,36,6278,3064,0,0,1
2,1.0,1747,12250,2.5,0,0,4,6,1747,0,1948,0,98001,47.3282,-122.285,1620,10300,267500,7,8,2014,0,66,10503,8680,0,0,0
4,2.5,2410,4708,2.0,0,0,3,8,2410,0,2002,0,98092,47.3229,-122.182,2517,5290,299800,25,2,2015,0,13,2298,2773,0,0,0
4,1.75,2070,9120,1.0,0,0,4,7,1250,820,1958,0,98008,47.6045,-122.123,1650,8400,430000,14,4,2015,0,57,7050,6750,0,1,0
5,1.0,1860,3040,1.5,0,0,3,7,1530,330,1921,0,98103,47.6559,-122.339,1910,3600,775000,13,3,2015,0,94,1180,1690,0,1,1
3,1.0,950,5214,1.0,0,0,3,7,830,120,1944,0,98126,47.5362,-122.379,1490,7636,333000,22,1,2015,0,71,4264,6146,0,1,1
3,2.0,1060,11765,1.0,0,0,4,6,1060,0,1951,0,98125,47.7333,-122.302,1500,9151,336000,7,4,2015,0,64,10705,7651,0,0,1
2,1.0,880,1712,2.0,0,0,4,7,880,0,1945,0,98199,47.6475,-122.397,1360,1748,323000,9,1,2015,0,70,832,388,0,0,1
2,2.25,1550,2079,2.0,0,0,3,8,1550,0,2008,0,98106,47.54,-122.368,1420,1977,328000,5,12,2014,0,6,529,557,0,0,1
3,1.0,1590,4600,1.5,0,0,4,7,1290,300,1926,0,98117,47.6807,-122.399,1770,4350,572500,10,12,2014,0,88,3010,2580,0,1,1
3,1.75,1650,5100,1.0,0,0,5,7,1040,610,1908,0,98115,47.6873,-122.321,1540,5100,600000,22,5,2014,0,106,3450,3560,0,1,1
4,3.0,2430,7242,2.0,0,0,3,8,2430,0,2003,0,98038,47.3533,-122.015,2430,7242,412000,20,4,2015,0,12,4812,4812,0,0,0
3,2.5,1810,7200,1.0,0,0,5,7,1310,500,1960,0,98033,47.6885,-122.211,2050,7200,827500,3,12,2014,0,54,5390,5150,0,1,0
3,2.5,1280,5040,2.0,0,0,4,7,1280,0,1985,0,98118,47.5611,-122.276,1500,5040,415000,13,11,2014,0,29,3760,3540,0,0,1
7,2.75,3410,4056,1.5,0,0,4,8,2130,1280,1906,0,98102,47.6454,-122.316,2510,4056,750000,12,11,2014,0,108,646,1546,0,1,1
3,2.75,2220,4000,2.0,0,0,3,8,1700,520,1914,2000,98122,47.617,-122.291,1800,4000,800000,10,7,2014,86,100,1780,2200,1,1,1
3,1.0,1060,6000,1.0,0,0,3,8,1060,0,1954,0,98118,47.5427,-122.275,1240,7874,420000,17,3,2015,0,61,4940,6634,0,0,1
3,1.5,1120,8250,1.0,0,0,4,7,1120,0,1957,0,98056,47.4905,-122.179,1320,8400,266000,15,10,2014,0,57,7130,7080,0,0,0
4,2.5,2680,10590,2.0,0,0,3,8,2680,0,2004,0,98019,47.7377,-121.97,2330,5566,499000,21,10,2014,0,10,7910,3236,0,0,0
4,1.5,1770,5750,2.0,0,0,3,7,1770,0,1947,0,98116,47.5621,-122.394,970,5750,440000,26,6,2014,0,67,3980,4780,0,0,1
2,1.75,1260,5300,1.0,0,0,4,7,840,420,1951,0,98103,47.6809,-122.348,1280,3000,630000,30,3,2015,0,64,4040,1720,0,1,1
3,1.75,1430,6818,1.0,0,0,5,7,1430,0,1972,0,98034,47.7271,-122.196,1480,7210,424000,4,8,2014,0,42,5388,5730,0,0,0
4,3.5,3270,15704,2.0,0,0,3,9,2110,1160,1990,0,98074,47.6256,-122.042,3020,8582,650000,19,8,2014,0,24,12434,5562,0,1,0
4,1.75,1720,10018,1.0,0,0,5,7,1720,0,1960,0,98042,47.3614,-122.119,1220,10018,248500,7,5,2014,0,54,8298,8798,0,0,0
3,1.75,1270,12420,1.0,0,0,4,7,1270,0,1962,0,98056,47.5387,-122.179,1560,9910,379600,21,4,2015,0,53,11150,8350,0,0,0
4,2.5,3260,10032,1.0,0,0,3,8,1960,1300,1978,0,98125,47.7203,-122.323,1802,7249,538000,21,7,2014,0,36,6772,5447,0,1,1
4,2.5,2050,6360,2.0,0,0,3,8,2050,0,1988,0,98029,47.5641,-122.011,2070,7541,530000,16,6,2014,0,26,4310,5471,0,0,0
4,2.25,2050,9720,2.0,0,0,3,8,2050,0,1967,0,98008,47.5911,-122.119,2310,9680,545000,20,1,2015,0,48,7670,7370,0,0,0
2,1.0,840,3522,1.0,0,0,3,6,840,0,1947,0,98199,47.6575,-122.395,1390,4800,405100,14,5,2014,0,67,2682,3410,0,0,1
3,1.75,1300,8800,1.0,0,0,4,8,1300,0,1963,0,98008,47.6199,-122.116,1350,8800,502000,9,6,2014,0,51,7500,7450,0,0,0
3,2.25,1260,3000,2.0,0,0,3,7,1260,0,2003,0,98029,47.5454,-121.997,1630,3042,425000,3,11,2014,0,11,1740,1412,0,0,0
3,2.25,1650,2958,2.0,0,0,3,7,1650,0,1985,0,98031,47.3916,-122.167,1510,3788,233500,23,6,2014,0,29,1308,2278,0,0,0
3,2.5,1710,10341,2.0,0,2,3,7,1710,0,1986,0,98030,47.3494,-122.171,1830,9358,287000,23,3,2015,0,29,8631,7528,0,0,0
3,1.0,1180,8775,1.0,0,0,3,7,1180,0,1966,0,98002,47.2848,-122.223,1300,8100,190000,13,2,2015,0,49,7595,6800,0,0,0
2,1.0,950,3090,1.0,0,0,4,6,950,0,1909,0,98118,47.551,-122.276,1230,4120,330000,1,12,2014,0,105,2140,2890,0,0,1
5,3.5,3620,7821,2.0,0,2,3,10,2790,830,1958,2010,98040,47.5738,-122.215,2690,9757,1490000,11,9,2014,52,56,4201,7067,1,1,0
3,2.25,2140,10256,2.0,0,0,3,8,2140,0,1987,0,98038,47.3751,-122.044,2040,11717,393000,9,9,2014,0,27,8116,9677,0,0,0
4,2.75,1920,4627,1.0,0,0,3,8,1010,910,1998,0,98178,47.5003,-122.23,1910,7210,353000,24,9,2014,0,16,2707,5300,0,1,1
2,1.0,750,6720,1.0,0,0,3,6,750,0,1916,0,98108,47.552,-122.31,920,6720,260000,20,10,2014,0,98,5970,5800,0,0,1
3,2.5,2060,2551,2.0,0,0,3,8,1900,160,2001,0,98005,47.5881,-122.165,2060,2936,680000,15,12,2014,0,13,491,876,0,1,0
3,2.25,2380,11200,1.0,0,0,4,8,2380,0,1963,0,98004,47.5873,-122.193,2010,11200,921000,15,7,2014,0,51,8820,9190,0,0,0
2,1.0,750,6380,1.0,0,0,3,7,750,0,1949,0,98125,47.7033,-122.308,1690,6495,319000,18,12,2014,0,65,5630,4805,0,0,1
3,1.0,1160,10881,1.0,0,0,2,7,920,240,1983,0,98074,47.6339,-122.033,1280,10843,280000,22,4,2015,0,32,9721,9563,0,1,0
3,1.0,1050,6300,1.0,0,0,3,6,1050,0,1942,0,98146,47.5128,-122.374,740,6300,220000,11,6,2014,0,72,5250,5560,0,0,1
3,1.5,1740,5200,1.0,0,0,4,7,1060,680,1977,0,98042,47.3657,-122.094,1540,5200,219000,21,1,2015,0,38,3460,3660,0,1,0
4,2.75,2050,7171,1.0,0,0,3,8,1540,510,1988,0,98074,47.6194,-122.042,1960,7110,528000,8,8,2014,0,26,5121,5150,0,1,0
3,1.75,1980,8100,1.0,0,0,4,7,1310,670,1949,0,98133,47.7353,-122.331,1450,8212,405000,27,5,2014,0,65,6120,6762,0,1,1
3,2.5,1690,1618,2.0,0,0,3,8,1150,540,2014,0,98029,47.5518,-121.998,1690,1618,372977,14,5,2014,0,0,-72,-72,0,1,0
4,3.25,2320,5900,1.5,0,2,4,9,2320,0,1910,0,98144,47.597,-122.292,2320,6240,934550,7,5,2015,0,105,3580,3920,0,0,1
3,1.5,2480,9900,2.0,0,3,3,10,2130,350,1940,0,98177,47.7018,-122.381,2860,9288,1470000,6,2,2015,0,75,7420,6428,0,1,1
4,2.25,2290,5350,2.0,0,0,4,9,2120,170,1958,0,98199,47.6428,-122.411,2910,5350,975000,3,6,2014,0,56,3060,2440,0,1,1
5,2.5,3180,13806,2.0,0,0,4,10,3180,0,1990,0,98033,47.652,-122.182,3180,13798,800866,5,5,2014,0,24,10626,10618,0,0,0
7,3.5,3470,16264,2.0,0,0,4,9,3470,0,1980,0,98007,47.6203,-122.149,3040,13500,950000,13,4,2015,0,35,12794,10460,0,0,0
4,3.0,1540,4140,1.5,0,0,5,7,1540,0,1902,0,98107,47.6728,-122.396,1460,5000,624000,4,9,2014,0,112,2600,3540,0,0,1
5,2.25,2800,8442,2.0,1,4,3,9,2800,0,1963,2001,98075,47.5784,-122.076,3220,9156,1850000,14,8,2014,38,51,5642,5936,1,0,0
3,1.0,1050,9876,1.0,0,0,3,7,1050,0,1953,0,98028,47.7635,-122.262,1760,9403,310000,14,5,2014,0,61,8826,7643,0,0,0
3,1.75,1480,6800,1.0,0,0,4,7,1480,0,1968,0,98055,47.4633,-122.188,1500,7900,315000,4,12,2014,0,46,5320,6400,0,0,0
3,2.0,1010,5973,1.0,0,0,5,6,1010,0,1942,0,98033,47.6652,-122.202,1920,6015,675000,20,8,2014,0,72,4963,4095,0,0,0
3,1.75,1660,8208,1.0,0,0,4,8,1660,0,1965,0,98005,47.5919,-122.154,2210,11000,490000,13,11,2014,0,49,6548,8790,0,0,0
5,2.25,2760,6350,1.0,0,0,3,7,1380,1380,1958,0,98126,47.5561,-122.379,2060,6342,600000,11,2,2015,0,57,3590,4282,0,1,1
4,1.75,2220,6500,2.0,0,3,4,8,2220,0,1964,0,98166,47.4519,-122.375,2430,11600,480000,9,6,2014,0,50,4280,9170,0,0,1
3,1.0,1270,7500,1.0,0,0,3,6,1270,0,1954,0,98198,47.4214,-122.316,1250,8000,196900,13,2,2015,0,61,6230,6750,0,0,1
3,2.0,1330,8748,1.0,0,0,3,7,1330,0,1986,0,98003,47.2619,-122.298,1510,8584,205500,27,2,2015,0,29,7418,7074,0,0,0
2,1.75,1210,1040,2.0,0,0,3,8,1210,0,2014,0,98029,47.5519,-121.999,1210,1090,357186,16,6,2014,0,0,-170,-120,0,0,0
4,2.5,2120,6754,2.0,0,0,3,7,2120,0,1998,0,98030,47.3629,-122.184,2120,6937,275000,28,1,2015,0,17,4634,4817,0,0,0
3,1.75,2090,12026,1.0,0,0,4,7,2090,0,1948,0,98002,47.3095,-122.217,1700,9496,248500,6,9,2014,0,66,9936,7796,0,0,0
3,2.5,2680,7836,2.0,0,0,3,8,2680,0,1990,2009,98092,47.3203,-122.185,2340,8040,350000,2,6,2014,19,24,5156,5700,1,0,0
3,2.75,1950,12240,1.0,0,0,3,7,1250,700,1956,0,98028,47.7401,-122.258,1880,12000,390000,15,7,2014,0,58,10290,10120,0,1,0
5,2.25,3740,14913,1.5,0,0,4,9,3740,0,1979,0,98074,47.6234,-122.059,2180,7600,660000,13,4,2015,0,36,11173,5420,0,0,0
3,1.75,1140,8263,1.0,0,0,5,7,1140,0,1950,0,98155,47.7407,-122.327,1140,6770,310000,17,11,2014,0,64,7123,5630,0,0,1
3,2.5,2480,5137,2.0,0,0,3,9,2480,0,2000,0,98052,47.684,-122.164,2480,6023,717000,12,6,2014,0,14,2657,3543,0,0,0
5,2.5,2580,11250,1.0,0,0,3,7,1410,1170,1964,0,98198,47.397,-122.313,2240,11780,260000,30,12,2014,0,50,8670,9540,0,1,1
3,2.0,2290,5001,1.0,0,0,4,7,1490,800,1960,0,98103,47.6909,-122.339,1230,5001,745000,30,4,2015,0,55,2711,3771,0,1,1
4,2.5,2320,12042,1.0,0,0,4,7,1320,1000,1975,0,98072,47.763,-122.16,2160,7054,470000,18,2,2015,0,40,9722,4894,0,1,0
3,2.5,2530,8820,2.0,0,0,3,8,2530,0,1997,0,98031,47.42,-122.205,2340,9472,429000,5,5,2015,0,18,6290,7132,0,0,0
4,2.0,1400,7140,1.0,0,0,3,7,1400,0,1969,0,98155,47.7719,-122.309,1610,10500,220000,8,4,2015,0,46,5740,8890,0,0,1
3,3.0,2060,1850,2.0,0,0,3,8,1400,660,2007,0,98119,47.6543,-122.373,1910,2951,497000,3,9,2014,0,7,-210,1041,0,1,1
3,1.0,1640,4000,1.5,0,0,5,7,1640,0,1909,0,98103,47.6563,-122.351,2140,4000,716100,14,7,2014,0,105,2360,1860,0,0,1
3,1.0,1320,8500,1.0,0,0,4,7,1320,0,1954,0,98039,47.6187,-122.226,2790,10800,937500,24,3,2015,0,61,7180,8010,0,0,0
4,2.0,1760,4500,1.5,0,0,5,7,1760,0,1906,0,98103,47.6711,-122.331,1740,4220,720000,27,10,2014,0,108,2740,2480,0,0,1
3,3.25,2130,2306,2.0,0,1,5,7,1420,710,1924,0,98136,47.5424,-122.391,1560,4500,616000,27,4,2015,0,91,176,2940,0,1,1
3,2.0,1390,7120,1.0,0,0,3,7,1390,0,1988,0,98030,47.3786,-122.179,1530,7688,259000,14,4,2015,0,27,5730,6158,0,0,0
3,1.75,1400,3825,1.5,0,0,4,6,1100,300,1904,0,98117,47.6793,-122.393,1720,5100,538000,14,5,2014,0,110,2425,3380,0,1,1
3,2.75,3230,9576,1.5,0,0,4,8,3230,0,1966,0,98034,47.7307,-122.183,2820,9576,605000,7,5,2015,0,49,6346,6756,0,0,0
3,1.0,1110,7603,1.0,0,0,3,7,1110,0,1967,0,98034,47.7262,-122.224,1260,8094,369950,3,11,2014,0,47,6493,6834,0,0,0
3,2.5,1670,4220,2.0,0,0,3,7,1670,0,2002,0,98038,47.3834,-122.028,1670,4238,310000,14,4,2015,0,13,2550,2568,0,0,0
3,1.0,1540,9450,1.0,0,0,4,7,1540,0,1960,0,98198,47.3612,-122.315,1210,9450,227500,28,4,2015,0,55,7910,8240,0,0,1
4,2.25,2090,7400,1.0,0,0,3,9,1670,420,1973,0,98023,47.3178,-122.38,2260,8000,274000,21,11,2014,0,41,5310,5740,0,1,0
3,2.0,1410,8088,1.0,0,0,3,7,1410,0,1987,0,98034,47.7303,-122.227,1770,7401,410000,20,11,2014,0,27,6678,5631,0,0,0
4,2.25,1910,5120,1.0,0,0,3,8,1300,610,1954,0,98199,47.6534,-122.409,1810,5153,650000,11,9,2014,0,60,3210,3343,0,1,1
3,2.0,1678,13862,1.0,0,0,3,7,1678,0,1994,0,98030,47.3744,-122.19,1550,11753,353000,5,5,2015,0,21,12184,10203,0,0,0
3,1.0,960,12745,1.0,0,0,4,6,960,0,1977,0,98038,47.3617,-122.03,1160,10488,224975,4,3,2015,0,38,11785,9328,0,0,0
2,1.75,2080,13054,1.0,0,1,3,7,2080,0,1951,0,98155,47.7435,-122.292,2440,13054,600000,12,5,2015,0,64,10974,10614,0,0,1
3,2.25,1790,7700,1.0,0,0,4,7,1340,450,1976,0,98034,47.7205,-122.168,1610,7350,437500,18,2,2015,0,39,5910,5740,0,1,0
3,2.5,2540,6093,2.0,0,0,3,9,2540,0,1999,0,98034,47.7042,-122.236,2540,5924,567000,21,5,2014,0,15,3553,3384,0,0,0
5,1.5,1790,11656,2.0,0,0,3,7,1790,0,1963,0,98198,47.3961,-122.308,2040,9790,225000,6,5,2015,0,52,9866,7750,0,0,1
2,1.0,940,9330,1.0,0,0,3,6,940,0,1941,0,98118,47.5445,-122.273,1900,6145,255000,6,9,2014,0,73,8390,4245,0,0,1
5,3.75,6810,7500,2.5,0,0,3,13,6110,700,1922,0,98102,47.6285,-122.322,2660,7500,2480000,4,3,2015,0,93,690,4840,0,1,1
2,1.0,900,4600,1.0,0,0,3,6,900,0,1951,0,98117,47.6918,-122.361,1060,4600,370000,13,6,2014,0,63,3700,3540,0,0,1
4,1.75,1900,8800,1.0,0,0,3,8,1140,760,1975,0,98033,47.6579,-122.197,2280,8800,675000,21,4,2015,0,40,6900,6520,0,1,0
3,1.0,1440,4268,1.0,0,0,3,7,1040,400,1953,0,98108,47.5468,-122.293,1370,4268,285000,4,9,2014,0,61,2828,2898,0,1,1
4,2.5,2240,7245,1.0,0,0,4,7,1140,1100,1972,0,98034,47.7161,-122.17,1740,7350,475000,2,12,2014,0,42,5005,5610,0,1,0
4,2.5,3320,5034,2.0,0,0,4,7,3320,0,2006,0,98042,47.4011,-122.164,2580,4950,410000,8,5,2015,0,9,1714,2370,0,0,0
4,2.25,1950,5950,1.0,0,0,3,8,1330,620,1947,0,98109,47.639,-122.347,2600,5593,895000,2,7,2014,0,67,4000,2993,0,1,1
3,1.5,1240,7733,1.0,0,0,3,6,790,450,1941,0,98125,47.714,-122.283,1130,7733,375000,22,8,2014,0,73,6493,6603,0,1,1
4,2.5,1830,4694,2.0,0,0,3,7,1830,0,2003,0,98038,47.3573,-122.016,1830,5175,349000,27,4,2015,0,12,2864,3345,0,0,0
3,1.75,1740,4400,1.5,0,0,3,8,1740,0,1903,0,98122,47.6115,-122.292,1740,4400,650500,6,4,2015,0,112,2660,2660,0,0,1
3,1.75,1410,15120,1.0,0,0,4,7,1410,0,1950,0,98004,47.5974,-122.195,1880,15120,760000,28,4,2015,0,65,13710,13240,0,0,0
4,2.75,2050,3960,1.0,0,0,4,7,1180,870,1986,0,98116,47.5808,-122.394,1440,5040,480000,20,5,2014,0,28,1910,3600,0,1,1
4,2.75,3220,16145,2.0,0,0,3,10,3220,0,1993,0,98075,47.5786,-121.995,3200,12921,689000,26,9,2014,0,21,12925,9721,0,0,0
3,1.75,1960,5000,1.0,0,0,5,6,980,980,1911,0,98108,47.5576,-122.317,1790,5000,415000,13,5,2014,0,103,3040,3210,0,1,1
3,1.75,1070,6110,1.0,0,0,4,7,1070,0,1968,0,98002,47.3249,-122.207,1350,6148,195000,27,4,2015,0,47,5040,4798,0,0,0
5,2.5,2820,9956,1.0,0,0,4,7,1410,1410,1967,0,98168,47.4715,-122.33,2700,9956,318000,31,7,2014,0,47,7136,7256,0,1,1
2,1.0,800,3090,1.0,0,0,4,6,800,0,1925,0,98118,47.5518,-122.277,1400,3090,339950,30,10,2014,0,89,2290,1690,0,0,1
3,1.0,1260,7897,1.0,0,0,3,7,1260,0,1979,0,98022,47.1946,-122.003,1560,8285,215000,24,11,2014,0,35,6637,6725,0,0,0
3,2.5,2420,7423,2.0,0,0,3,8,2420,0,1990,0,98092,47.3199,-122.186,2260,7629,339900,18,8,2014,0,24,5003,5369,0,0,0
1,1.5,810,3211,2.0,0,0,4,7,810,0,1982,0,98033,47.6939,-122.184,1320,3298,285000,19,5,2014,0,32,2401,1978,0,0,0
3,1.0,1600,5000,1.5,0,0,3,7,1110,490,1947,0,98107,47.655,-122.358,1380,5000,550000,16,7,2014,0,67,3400,3620,0,1,1
4,1.0,1350,9000,1.5,0,0,4,7,1350,0,1964,0,98103,47.6953,-122.332,1940,8000,430000,25,7,2014,0,50,7650,6060,0,0,1
3,1.0,970,7790,1.0,0,0,3,6,970,0,1967,0,98003,47.3165,-122.325,1150,8160,219000,2,12,2014,0,47,6820,7010,0,0,0
2,1.5,1780,4750,1.0,0,0,4,7,1080,700,1947,0,98117,47.6859,-122.395,1690,5962,555000,15,8,2014,0,67,2970,4272,0,1,1
3,2.0,1350,7686,1.0,0,0,3,7,1350,0,1989,0,98038,47.3609,-122.053,1470,7686,233000,21,7,2014,0,25,6336,6216,0,0,0
5,2.25,2550,9200,1.0,0,0,4,8,1580,970,1975,0,98166,47.4673,-122.363,2090,9200,454000,22,4,2015,0,40,6650,7110,0,1,1
4,2.5,1700,4418,2.0,0,0,3,8,1700,0,1931,2000,98112,47.6434,-122.3,2090,4174,950000,31,3,2015,69,84,2718,2084,1,0,1
3,2.5,2430,7857,2.0,0,0,5,8,1730,700,1980,0,98055,47.4546,-122.211,2160,8740,359000,15,9,2014,0,34,5427,6580,0,1,0
5,2.0,2740,8230,1.5,0,0,3,7,2210,530,1962,0,98155,47.7352,-122.297,2130,8232,407500,3,9,2014,0,52,5490,6102,0,1,1
3,1.5,1560,7300,1.0,0,0,4,7,1040,520,1964,0,98001,47.3427,-122.281,1460,7910,224000,28,5,2014,0,50,5740,6450,0,1,0
2,1.0,1040,4590,1.0,0,0,3,7,1040,0,1954,0,98146,47.5078,-122.337,1040,6120,210000,18,7,2014,0,60,3550,5080,0,0,1
4,1.75,1820,9824,1.0,0,0,5,7,1820,0,1968,0,98042,47.3833,-122.093,1410,11013,261000,23,1,2015,0,47,8004,9603,0,0,0
3,3.0,1833,1706,3.0,0,0,3,9,1833,0,1998,0,98115,47.6827,-122.325,1466,1455,719000,6,8,2014,0,16,-127,-11,0,0,1
3,2.5,2160,3738,2.0,0,0,3,8,2160,0,1994,0,98126,47.5661,-122.375,1500,4000,440000,3,2,2015,0,21,1578,2500,0,0,1
3,2.75,2100,10362,2.0,0,0,3,9,1510,590,1998,0,98045,47.4347,-121.417,2240,11842,525000,21,5,2014,0,16,8262,9602,0,1,0
3,1.5,1370,9720,2.0,0,0,3,7,1370,0,1968,0,98034,47.7302,-122.197,1510,8775,375000,21,7,2014,0,46,8350,7265,0,0,0
2,2.5,1414,1960,2.0,0,0,3,8,1414,0,1986,0,98006,47.5423,-122.189,1414,2511,428000,31,3,2015,0,29,546,1097,0,0,0
5,3.25,4115,7910,2.0,0,0,3,9,4115,0,2014,0,98053,47.6847,-122.016,3950,6765,988830,18,11,2014,0,0,3795,2815,0,0,0
3,1.75,1550,6225,1.0,0,0,4,7,1550,0,1949,0,98002,47.3098,-122.218,1760,9496,199950,4,10,2014,0,65,4675,7736,0,0,0
4,2.25,2100,3671,1.5,0,0,3,8,1750,350,1929,0,98112,47.6359,-122.3,1800,4560,840000,28,10,2014,0,85,1571,2760,0,1,1
3,1.75,1160,7006,1.0,0,0,4,7,1160,0,1992,0,98022,47.1937,-121.98,1670,7750,285000,8,9,2014,0,22,5846,6080,0,0,0
5,2.5,3597,4972,2.0,0,0,3,7,3597,0,2006,0,98001,47.3002,-122.282,3193,6000,330000,15,9,2014,0,8,1375,2807,0,0,0
3,1.5,1230,10125,1.0,0,0,3,7,1230,0,1960,0,98198,47.397,-122.299,1970,10125,147500,2,1,2015,0,55,8895,8155,0,0,1
4,2.5,2190,7125,2.0,0,0,5,8,2190,0,1978,0,98032,47.3709,-122.285,2190,8075,320000,7,11,2014,0,36,4935,5885,0,0,0
3,1.75,1040,9000,1.0,0,0,4,7,1040,0,1967,0,98027,47.5253,-122.043,1750,10878,382500,1,7,2014,0,47,7960,9128,0,0,0
5,4.0,4690,8208,2.0,0,0,3,9,3040,1650,1926,0,98112,47.6321,-122.304,3300,8001,2050000,24,3,2015,0,89,3518,4701,0,1,1
4,2.25,2270,10000,1.0,0,0,5,8,1720,550,1974,0,98006,47.5599,-122.142,2270,10148,596000,14,8,2014,0,40,7730,7878,0,1,0
4,2.25,1950,7280,2.0,0,0,4,8,1950,0,1979,0,98023,47.2957,-122.37,1910,7280,220000,11,11,2014,0,35,5330,5370,0,0,0
3,2.5,1880,6818,2.0,0,0,3,8,1880,0,1993,0,98031,47.4206,-122.183,1970,7000,325000,25,9,2014,0,21,4938,5030,0,0,0
4,2.5,2850,5664,2.0,0,0,3,9,2850,0,2001,0,98075,47.5835,-121.996,2850,5475,679950,26,3,2015,0,14,2814,2625,0,0,0
2,1.0,1160,6911,1.0,0,0,3,7,1160,0,1947,0,98125,47.7149,-122.318,1120,6948,175000,18,2,2015,0,68,5751,5828,0,0,1
3,1.75,1370,10050,1.0,0,1,4,7,1370,0,1966,0,98023,47.3338,-122.341,1720,10050,268000,1,12,2014,0,48,8680,8330,0,0,0
4,2.0,1540,7575,1.0,0,0,4,7,1040,500,1978,0,98032,47.3664,-122.279,1720,7575,215000,21,7,2014,0,36,6035,5855,0,1,0
4,2.25,2130,7172,2.0,0,0,4,8,2130,0,1964,0,98008,47.6271,-122.112,1910,7653,593450,22,4,2015,0,51,5042,5743,0,0,0
2,1.75,1350,4614,1.0,0,0,3,8,1350,0,2008,0,98053,47.7091,-122.015,1680,4775,498800,9,7,2014,0,6,3264,3095,0,0,0
5,3.25,2450,6534,2.0,0,0,3,8,1770,680,1951,2014,98115,47.688,-122.281,1620,6534,849000,8,12,2014,63,63,4084,4914,1,1,1
4,2.5,1940,4875,2.0,0,0,4,9,1940,0,1925,0,98112,47.6427,-122.304,1790,4875,1150000,29,12,2014,0,89,2935,3085,0,0,1
5,2.5,2890,5110,2.0,0,2,3,9,2890,0,2003,0,98029,47.5453,-121.995,3010,5110,825000,15,7,2014,0,11,2220,2100,0,0,0
3,1.75,1680,9769,1.0,0,0,3,8,1340,340,1989,0,98058,47.4631,-122.126,1730,9686,265000,24,2,2015,0,26,8089,7956,0,1,0
4,2.25,1960,10400,1.0,0,0,4,8,1220,740,1985,0,98023,47.3199,-122.392,1650,8660,285000,23,12,2014,0,29,8440,7010,0,1,0
3,1.75,1590,7931,1.0,0,0,3,7,1190,400,1979,0,98038,47.3628,-122.05,1680,7931,240000,31,12,2014,0,35,6341,6251,0,1,0
4,1.0,1390,17739,1.0,0,0,3,7,1390,0,1958,0,98003,47.3457,-122.302,1230,7840,261000,21,7,2014,0,56,16349,6610,0,0,0
4,1.75,2440,7350,1.0,0,0,3,8,1610,830,1978,0,98032,47.3743,-122.285,2180,7680,330000,27,6,2014,0,36,4910,5500,0,1,0
4,2.0,1850,7560,1.0,0,0,4,7,1540,310,1978,0,98032,47.3666,-122.277,1620,7658,250000,2,6,2014,0,36,5710,6038,0,1,0
4,2.5,2800,9538,2.0,0,0,3,8,2800,0,1993,0,98003,47.2675,-122.307,1970,7750,350000,10,7,2014,0,21,6738,5780,0,0,0
3,2.0,1910,8050,1.0,0,0,4,7,1000,910,1980,0,98030,47.37,-122.17,1780,7344,275000,30,10,2014,0,34,6140,5564,0,1,0
4,2.25,2460,7620,1.0,0,0,3,7,1230,1230,1969,0,98106,47.5285,-122.345,2090,7620,325000,23,2,2015,0,46,5160,5530,0,1,1
1,1.0,810,5000,1.0,0,1,3,7,590,220,1936,0,98106,47.5696,-122.36,1920,5000,255000,24,4,2015,0,79,4190,3080,0,1,1
3,1.5,1900,5250,1.0,0,0,4,7,1500,400,1943,0,98117,47.6991,-122.392,1810,5250,562200,20,3,2015,0,72,3350,3440,0,1,1
3,2.5,2200,7350,1.0,0,0,5,8,1570,630,1988,0,98058,47.4395,-122.161,2350,7557,365000,4,5,2014,0,26,5150,5207,0,1,0
3,1.5,1190,11996,1.0,0,0,4,7,1190,0,1969,0,98077,47.7561,-122.071,1190,9756,332900,16,3,2015,0,46,10806,8566,0,0,0
4,2.5,2400,3986,2.0,0,0,3,8,2400,0,1999,0,98065,47.5344,-121.877,2070,3986,487275,21,4,2015,0,16,1586,1916,0,0,0
3,2.5,1670,5791,2.0,0,0,3,7,1670,0,1995,0,98055,47.4424,-122.188,1610,6034,310000,29,4,2015,0,20,4121,4424,0,0,0
2,1.0,990,4800,1.0,0,0,3,6,990,0,1908,0,98118,47.5615,-122.28,1700,5400,245000,15,1,2015,0,107,3810,3700,0,0,1
3,1.75,2920,10573,1.0,0,0,4,7,2920,0,1964,0,98055,47.4429,-122.195,1560,10572,325000,15,4,2015,0,51,7653,9012,0,0,0
3,1.75,1840,9401,1.0,0,0,3,8,1840,0,1971,0,98075,47.5847,-122.075,2850,14323,550000,12,11,2014,0,43,7561,11473,0,0,0
2,1.0,910,4500,1.5,0,0,4,7,910,0,1906,0,98118,47.5633,-122.289,1270,3500,350000,12,5,2014,0,108,3590,2230,0,0,1
3,1.5,1240,9500,1.0,0,0,4,7,1240,0,1955,0,98166,47.4756,-122.35,1845,10125,259950,12,11,2014,0,59,8260,8280,0,0,1
4,2.5,1980,7264,2.0,0,0,3,7,1980,0,1996,0,98038,47.3678,-122.019,1600,6380,240000,1,12,2014,0,18,5284,4780,0,0,0
3,1.0,1200,10080,1.0,0,0,4,7,1200,0,1969,0,98042,47.3261,-122.135,1230,9800,186000,11,2,2015,0,46,8880,8570,0,0,0
3,1.5,1280,15028,1.0,0,0,3,7,1280,0,1982,0,98074,47.6304,-122.035,1470,13698,395000,4,2,2015,0,33,13748,12228,0,0,0
4,2.5,3150,5757,2.0,0,0,3,9,3150,0,2004,0,98058,47.4568,-122.117,3100,5757,475000,15,9,2014,0,10,2607,2657,0,0,0
5,3.5,3500,10794,2.0,0,0,3,10,3500,0,1996,0,98075,47.5887,-121.974,3110,10837,815000,4,8,2014,0,18,7294,7727,0,0,0
3,1.5,1680,13751,1.0,0,0,4,7,1680,0,1951,0,98040,47.5716,-122.227,1760,13500,572000,2,9,2014,0,63,12071,11740,0,0,0
3,2.5,1360,3188,2.0,0,0,3,7,1360,0,1986,0,98052,47.6831,-122.096,1090,3188,419500,17,10,2014,0,28,1828,2098,0,0,0
3,2.25,2110,7350,1.0,0,0,3,8,1530,580,1980,0,98023,47.3088,-122.341,2640,7777,298700,3,9,2014,0,34,5240,5137,0,1,0
3,1.5,1900,9994,1.0,0,0,3,7,1120,780,1960,0,98168,47.4729,-122.301,1900,9994,278000,22,4,2015,0,55,8094,8094,0,1,1
4,2.0,2380,4500,1.5,0,0,3,6,1470,910,1926,2014,98118,47.5652,-122.281,1300,4500,455000,30,12,2014,88,88,2120,3200,1,1,1
5,3.5,4050,13495,1.0,0,2,4,9,2230,1820,1988,0,98166,47.4384,-122.352,3210,13495,925000,19,8,2014,0,26,9445,10285,0,1,1
2,1.5,1120,1201,3.0,0,0,3,8,1120,0,1999,0,98103,47.6524,-122.353,1370,1298,465000,15,4,2015,0,16,81,-72,0,0,1
4,4.0,2850,2970,2.0,0,0,3,8,2120,730,1999,0,98029,47.547,-122.01,2380,3559,620000,1,10,2014,0,15,120,1179,0,1,0
4,2.25,2360,7650,1.0,0,0,3,8,1640,720,1963,0,98155,47.75,-122.292,2320,11060,499900,22,4,2015,0,52,5290,8740,0,1,1
5,3.0,2540,11422,1.0,0,0,3,8,1270,1270,1962,2014,98006,47.5459,-122.176,2090,10741,620000,6,2,2015,52,53,8882,8651,1,1,0
3,1.75,1160,6120,1.0,0,0,3,7,1040,120,1941,0,98115,47.6926,-122.287,1530,6120,450000,8,11,2014,0,73,4960,4590,0,1,1
4,3.5,2710,2147,2.0,0,0,3,10,2220,490,2007,0,98029,47.5468,-121.994,2650,2252,690000,20,2,2015,0,8,-563,-398,0,1,0
3,2.0,1870,9527,1.0,0,0,4,7,1870,0,1951,1997,98040,47.5777,-122.224,1970,11904,832500,18,8,2014,46,63,7657,9934,1,0,0
3,1.0,1010,9678,1.0,0,0,5,7,1010,0,1955,0,98188,47.4396,-122.285,1010,9375,245000,7,11,2014,0,59,8668,8365,0,0,1
4,2.75,2420,6495,2.0,0,0,3,8,2420,0,2005,0,98038,47.3771,-122.029,2420,6200,369000,7,8,2014,0,9,4075,3780,0,0,0
4,3.25,3830,8331,2.0,0,0,3,9,3830,0,2014,0,98053,47.6906,-122.019,4080,8425,1050000,15,10,2014,0,0,4501,4345,0,0,0
3,3.0,3040,5067,3.0,0,2,3,10,3040,0,1993,0,98118,47.5409,-122.267,1820,5998,653000,17,9,2014,0,21,2027,4178,0,0,1
2,1.75,1460,10500,1.0,0,0,3,7,1460,0,1980,0,98045,47.4461,-121.768,1340,9600,220650,22,4,2015,0,35,9040,8260,0,0,0
5,3.0,1940,6355,1.0,0,0,3,8,1200,740,2007,0,98168,47.498,-122.322,1940,5033,300000,16,6,2014,0,7,4415,3093,0,1,1
4,2.5,1950,5451,2.0,0,0,3,7,1950,0,2004,0,98058,47.4341,-122.144,2240,6221,360000,24,11,2014,0,10,3501,3981,0,0,0
3,2.5,2450,5760,2.0,0,0,3,9,2450,0,2000,0,98074,47.6145,-122.026,2450,5762,672500,30,3,2015,0,15,3310,3312,0,0,0
4,1.5,1730,7020,1.5,0,0,4,5,1730,0,1953,0,98056,47.4939,-122.167,1110,7020,268000,23,4,2015,0,62,5290,5910,0,0,0
4,1.5,1690,3245,1.5,0,0,3,8,1690,0,1929,0,98126,47.5445,-122.375,1380,1590,440000,2,12,2014,0,85,1555,210,0,0,1
3,2.5,2550,7200,2.0,0,2,3,10,2550,0,1981,2013,98144,47.5996,-122.288,2030,3500,1400000,14,5,2014,32,33,4650,1470,1,0,1
4,2.5,2290,11072,2.0,0,0,3,9,2290,0,1986,0,98074,47.6283,-122.03,2340,9774,590000,18,7,2014,0,28,8782,7434,0,0,0
4,1.75,1880,7632,1.0,0,0,4,7,1180,700,1978,0,98023,47.3068,-122.372,1840,8528,266500,29,5,2014,0,36,5752,6688,0,1,0
4,2.5,2930,8679,2.0,0,0,3,8,2930,0,2014,0,98056,47.5164,-122.19,2030,7264,635000,16,12,2014,0,0,5749,5234,0,0,0
4,2.25,2440,9320,1.0,0,0,4,7,1880,560,1957,0,98007,47.5933,-122.135,1530,9335,650000,12,3,2015,0,58,6880,7805,0,1,0
4,1.75,2280,7840,1.0,0,0,3,7,1280,1000,1957,0,98055,47.4809,-122.224,2120,7260,312500,24,2,2015,0,58,5560,5140,0,1,0
3,1.0,900,6099,1.0,0,0,3,6,790,110,1944,0,98168,47.4807,-122.289,1240,6099,225000,25,9,2014,0,70,5199,4859,0,1,1
4,1.75,1980,8400,1.0,0,0,3,7,1330,650,1968,0,98052,47.6721,-122.152,1920,8400,425000,19,11,2014,0,46,6420,6480,0,1,0
5,2.25,2340,9225,2.0,0,0,3,8,2340,0,1973,0,98052,47.6369,-122.098,2140,9348,572000,16,7,2014,0,41,6885,7208,0,0,0
4,2.5,3110,5048,2.0,0,0,3,8,3110,0,2002,0,98042,47.3782,-122.125,3110,5190,386500,7,4,2015,0,13,1938,2080,0,0,0
2,1.0,980,5000,1.0,0,0,3,6,980,0,1904,0,98107,47.6744,-122.369,1270,4500,452000,21,1,2015,0,111,4020,3230,0,0,1
4,2.0,1480,6324,1.0,0,0,3,7,1480,0,1943,0,98122,47.6147,-122.302,1480,3600,278000,12,12,2014,0,71,4844,2120,0,0,1
2,1.75,2130,6574,1.0,0,0,3,8,1500,630,1946,0,98199,47.6529,-122.411,2130,6275,450000,14,4,2015,0,69,4444,4145,0,1,1
2,1.0,1270,5100,1.0,0,0,3,7,1100,170,1900,0,98115,47.6771,-122.328,1670,3900,611000,4,11,2014,0,114,3830,2230,0,1,1
2,2.5,1150,2064,2.0,0,0,3,7,1150,0,2004,0,98001,47.3516,-122.292,1880,2855,214100,5,6,2014,0,10,914,975,0,0,0
3,2.5,1840,5011,2.0,0,0,3,8,1840,0,2012,0,98038,47.3555,-122.054,2000,4793,317000,14,5,2014,0,2,3171,2793,0,0,0
4,3.5,3180,12528,2.0,0,1,4,9,2060,1120,1979,0,98177,47.7058,-122.379,2850,11410,1000000,5,3,2015,0,36,9348,8560,0,1,1
5,2.75,1510,5700,2.0,0,1,4,7,1510,0,1946,0,98105,47.6653,-122.27,2190,5700,1000000,24,4,2015,0,69,4190,3510,0,0,1
4,2.5,3070,7200,2.0,0,0,3,8,3070,0,2005,0,98059,47.4899,-122.138,2590,7200,525000,5,5,2015,0,10,4130,4610,0,0,0
3,2.25,1800,6680,2.0,0,0,3,8,1800,0,1983,0,98034,47.7293,-122.223,1630,8621,436000,1,10,2014,0,31,4880,6991,0,0,0
3,1.75,1540,9154,1.0,0,0,3,8,1540,0,1983,0,98074,47.6207,-122.042,1990,10273,450000,18,7,2014,0,31,7614,8283,0,0,0
3,1.75,2330,14892,1.0,0,0,3,8,1970,360,1980,0,98074,47.6267,-122.046,2570,14217,588500,2,5,2014,0,34,12562,11647,0,1,0
4,1.75,1400,8374,1.0,0,0,3,7,1400,0,1953,0,98166,47.4735,-122.344,1420,8360,340000,11,5,2015,0,62,6974,6940,0,0,1
3,2.5,3380,7126,2.0,0,0,3,8,3380,0,1965,2003,98008,47.6276,-122.122,1810,7308,749000,11,8,2014,38,49,3746,5498,1,0,0
3,1.5,1440,7875,1.0,0,0,4,8,1440,0,1968,0,98058,47.4561,-122.148,1800,8964,330000,11,5,2015,0,47,6435,7164,0,0,0
3,2.5,1740,1279,3.0,0,0,3,8,1740,0,2008,0,98116,47.5891,-122.387,1740,1280,568000,21,8,2014,0,6,-461,-460,0,0,1
3,1.75,1470,8925,1.0,0,0,4,7,1470,0,1957,0,98022,47.2026,-122.0,1430,9282,239000,24,9,2014,0,57,7455,7852,0,0,0
3,2.5,2810,4932,2.0,0,0,3,8,2810,0,2003,0,98011,47.7739,-122.227,2470,4919,528000,7,1,2015,0,12,2122,2449,0,0,0
4,3.0,2090,5102,1.0,0,0,3,7,1350,740,1994,0,98106,47.5427,-122.356,2090,5102,385000,30,7,2014,0,20,3012,3012,0,1,1
4,3.25,4110,14219,2.0,0,2,4,10,2570,1540,1979,0,98028,47.7382,-122.264,2760,12283,825000,2,9,2014,0,35,10109,9523,0,1,0
5,3.25,3230,5000,2.0,0,1,3,9,2350,880,2002,0,98136,47.5202,-122.393,1520,5000,815000,26,11,2014,0,12,1770,3480,0,1,1
3,1.75,2070,6000,1.0,0,3,3,8,1340,730,1955,0,98136,47.5226,-122.382,2200,6000,690000,7,10,2014,0,59,3930,3800,0,1,1
3,1.0,1660,7440,1.0,0,0,3,7,1270,390,1957,0,98106,47.5242,-122.362,1540,7440,210000,25,3,2015,0,58,5780,5900,0,1,1
4,1.0,1590,4280,1.5,0,0,3,7,1590,0,1924,0,98103,47.667,-122.335,2230,4280,599000,16,4,2015,0,91,2690,2050,0,0,1
3,1.75,1860,5584,1.0,0,0,3,8,1310,550,1951,0,98199,47.637,-122.4,1630,6022,860000,12,2,2015,0,64,3724,4392,0,1,1
3,1.0,1420,9600,1.0,0,0,4,6,1420,0,1954,0,98188,47.4232,-122.292,1400,8415,147200,12,2,2015,0,61,8180,7015,0,0,1
3,1.0,1240,5758,1.5,0,0,4,6,960,280,1910,0,98116,47.5675,-122.396,1460,5750,476900,6,5,2015,0,105,4518,4290,0,1,1
4,2.5,2640,11816,2.0,0,0,3,8,2640,0,1999,0,98019,47.733,-121.968,2400,11816,570000,6,5,2015,0,16,9176,9416,0,0,0
3,1.0,1440,3060,1.5,0,0,4,7,1440,0,1910,0,98115,47.6769,-122.307,1440,3570,567500,16,10,2014,0,104,1620,2130,0,0,1
3,1.5,1820,12686,1.0,0,0,4,7,1820,0,1952,0,98004,47.5886,-122.195,3020,11550,875000,7,7,2014,0,62,10866,8530,0,0,0
3,2.0,2220,10275,2.0,0,0,3,9,1640,580,1980,0,98027,47.5304,-122.055,2300,9975,490000,10,6,2014,0,34,8055,7675,0,1,0
3,1.75,2430,9133,1.0,0,0,4,7,1410,1020,1978,0,98059,47.5116,-122.157,1980,9592,335000,10,6,2014,0,36,6703,7612,0,1,0
3,1.75,1670,10798,1.0,0,0,4,8,1670,0,1962,0,98006,47.549,-122.17,2290,10798,550000,15,4,2015,0,53,9128,8508,0,0,0
3,1.75,1180,10541,1.0,0,0,4,7,940,240,1981,0,98074,47.6348,-122.032,1230,10879,385000,16,5,2014,0,33,9361,9649,0,1,0
3,1.75,1620,8085,1.0,0,0,3,7,1210,410,1976,0,98011,47.7349,-122.197,1700,8085,395000,18,7,2014,0,38,6465,6385,0,1,0
2,1.0,1030,5750,1.0,0,0,5,8,1030,0,1928,0,98116,47.5861,-122.391,1570,5750,650000,11,6,2014,0,86,4720,4180,0,0,1
4,2.75,2900,5803,2.0,0,0,3,9,2900,0,2007,0,98028,47.7368,-122.232,2900,6212,637000,4,3,2015,0,8,2903,3312,0,0,0
3,2.25,3420,9900,1.0,0,0,3,9,1710,1710,1963,2004,98028,47.7412,-122.256,2290,10700,692500,14,10,2014,41,51,6480,8410,1,1,0
3,1.5,1580,10517,1.0,0,0,4,6,1580,0,1957,0,98002,47.2903,-122.214,1400,10658,233500,5,9,2014,0,57,8937,9258,0,0,0
3,2.0,1230,11413,1.0,0,0,3,7,990,240,1984,0,98074,47.6321,-122.034,1570,11517,400000,24,6,2014,0,30,10183,9947,0,1,0
5,2.5,2200,4080,1.5,0,0,5,7,1420,780,1916,0,98103,47.6872,-122.35,1300,4080,547000,20,6,2014,0,98,1880,2780,0,1,1
3,1.0,1090,6435,1.0,0,0,4,7,1090,0,1955,0,98106,47.5334,-122.365,1340,6435,365000,2,5,2014,0,59,5345,5095,0,0,1
3,1.75,1970,8000,1.0,0,0,4,8,1970,0,1968,0,98052,47.6324,-122.1,1910,8000,525000,9,10,2014,0,46,6030,6090,0,0,0
4,3.0,3220,8936,2.0,0,0,3,9,2450,770,1990,0,98031,47.4208,-122.213,2810,10500,430000,22,5,2014,0,24,5716,7690,0,1,0
3,1.0,1600,7500,1.0,0,0,3,7,1600,0,1966,0,98034,47.7198,-122.182,2050,7200,325000,15,12,2014,0,48,5900,5150,0,0,0
2,1.0,670,6300,1.0,0,0,5,6,670,0,1942,0,98126,47.5161,-122.374,760,6300,279000,10,7,2014,0,72,5630,5540,0,0,1
4,1.75,2360,4750,2.0,0,0,5,7,1660,700,1911,0,98115,47.6729,-122.293,1810,4750,805000,11,3,2015,0,104,2390,2940,0,1,1
3,3.0,2150,3962,1.5,0,0,3,7,1540,610,1949,0,98125,47.7183,-122.285,1730,4609,419950,4,2,2015,0,66,1812,2879,0,1,1
2,1.0,620,4455,1.0,0,0,3,6,620,0,1927,0,98117,47.6877,-122.395,1180,5000,425000,16,4,2015,0,88,3835,3820,0,0,1
4,1.75,1730,5922,2.0,0,0,5,7,1730,0,1949,0,98125,47.7188,-122.321,1700,6127,446000,24,7,2014,0,65,4192,4427,0,0,1
5,2.0,2500,7860,1.0,0,0,3,7,1040,1460,1963,0,98034,47.7212,-122.226,2060,9684,455000,2,3,2015,0,52,5360,7624,0,1,0
3,1.0,990,4440,1.0,0,0,3,6,990,0,1943,0,98106,47.522,-122.354,990,6771,226550,9,7,2014,0,71,3450,5781,0,0,1
3,2.0,1420,4080,1.5,0,0,5,8,1420,0,1904,0,98103,47.6801,-122.348,1220,3060,764000,30,9,2014,0,110,2660,1840,0,0,1
3,2.25,2170,15000,2.0,0,0,4,8,2170,0,1978,0,98042,47.3863,-122.158,2430,14256,439950,5,5,2015,0,37,12830,11826,0,0,0
4,2.0,1880,5100,1.0,0,0,3,8,1880,0,1952,0,98103,47.6872,-122.349,1610,4590,453000,16,12,2014,0,62,3220,2980,0,0,1
3,1.0,1300,9620,1.0,0,0,3,7,1300,0,1971,0,98003,47.282,-122.331,1420,9620,219950,6,2,2015,0,44,8320,8200,0,0,0
3,1.5,2360,6750,2.0,0,0,5,7,1930,430,1926,0,98103,47.6923,-122.332,1320,4500,702500,14,5,2014,0,88,4390,3180,0,1,1
3,1.5,1780,12231,1.0,0,0,4,8,1780,0,1956,0,98003,47.335,-122.321,2460,12663,285000,16,10,2014,0,58,10451,10203,0,0,0
2,2.25,2160,2578,3.0,0,0,3,8,2160,0,2005,0,98103,47.6607,-122.354,1800,2142,798750,13,2,2015,0,10,418,342,0,0,1
2,1.0,950,5316,1.0,0,2,3,7,950,0,1948,0,98126,47.57,-122.38,1620,6085,320000,26,6,2014,0,66,4366,4465,0,0,1
3,1.75,1680,14630,1.5,0,0,3,8,1680,0,1985,0,98027,47.5272,-122.044,1920,14630,425000,16,12,2014,0,29,12950,12710,0,0,0
4,2.5,2290,4450,2.0,0,0,3,9,2290,0,2004,0,98072,47.7385,-122.169,2570,5096,540000,16,7,2014,0,10,2160,2526,0,0,0
4,3.75,3920,4500,3.0,0,0,3,8,3920,0,2013,0,98103,47.6805,-122.346,2040,3000,1170000,25,3,2015,0,2,580,960,0,0,1
3,1.75,1500,13891,1.0,0,0,4,7,1500,0,1951,0,98005,47.5866,-122.175,2020,13891,576000,21,4,2015,0,64,12391,11871,0,0,0
3,1.75,1720,7200,1.0,0,0,3,7,1140,580,1977,0,98052,47.6977,-122.132,1700,8400,525000,17,4,2015,0,38,5480,6700,0,1,0
4,2.5,2641,8615,2.0,0,0,3,7,2641,0,1998,0,98031,47.4038,-122.213,2641,8091,324950,22,8,2014,0,16,5974,5450,0,0,0
3,2.5,2460,5400,1.0,0,0,4,8,1520,940,2001,0,98056,47.5231,-122.202,1745,5400,464000,11,8,2014,0,13,2940,3655,0,1,0
4,2.25,1995,7102,2.0,0,0,4,8,1995,0,1981,0,98023,47.2986,-122.37,1880,7950,266000,7,7,2014,0,33,5107,6070,0,0,0
3,1.75,1270,4800,1.0,0,0,3,7,1270,0,1952,2014,98126,47.5362,-122.376,1220,4800,415000,18,6,2014,62,62,3530,3580,1,0,1
4,2.75,3080,6731,2.0,0,3,3,9,3080,0,2003,0,98058,47.4522,-122.118,3080,6731,550000,19,9,2014,0,11,3651,3651,0,0,0
3,2.25,1670,7606,2.0,0,0,3,7,1670,0,1990,0,98022,47.1949,-121.982,1670,7433,235000,14,1,2015,0,25,5936,5763,0,0,0
3,2.0,1470,8089,1.0,0,0,3,7,1470,0,1987,0,98198,47.3878,-122.316,1530,7721,280000,20,6,2014,0,27,6619,6191,0,0,1
3,1.75,1730,7807,1.0,0,0,3,7,1260,470,1976,0,98034,47.7211,-122.169,1800,7650,459000,30,10,2014,0,38,6077,5850,0,1,0
3,1.0,1070,7615,1.0,0,0,4,7,1070,0,1969,0,98023,47.3189,-122.373,1240,6906,195000,14,10,2014,0,45,6545,5666,0,0,0
3,1.5,1660,8738,1.0,0,0,4,7,1080,580,1959,0,98002,47.3117,-122.208,1500,8466,235000,12,11,2014,0,55,7078,6966,0,1,0
4,2.25,2410,16650,1.0,0,0,4,8,2410,0,1965,0,98006,47.5706,-122.163,2720,11141,711800,26,11,2014,0,49,14240,8421,0,0,0
3,2.5,1040,1032,3.0,0,0,3,7,1040,0,2007,0,98107,47.6673,-122.377,1290,1275,440000,16,1,2015,0,8,-8,-15,0,0,1
2,1.0,970,3300,1.0,0,0,4,7,970,0,1916,0,98103,47.6609,-122.343,1060,3600,515000,17,2,2015,0,99,2330,2540,0,0,1
5,2.75,2910,9480,1.5,0,0,3,8,2910,0,1939,0,98105,47.6552,-122.278,2940,6600,1200000,2,5,2014,0,75,6570,3660,0,0,1
3,1.75,2340,12443,1.5,0,0,4,8,2340,0,1965,0,98006,47.5432,-122.177,1970,9600,560000,6,4,2015,0,50,10103,7630,0,0,0
3,1.75,1880,11249,1.0,0,0,3,7,1330,550,1985,0,98001,47.3295,-122.257,1870,14547,340000,20,6,2014,0,29,9369,12677,0,1,0
2,1.0,1110,3500,1.5,0,0,3,6,970,140,1912,0,98102,47.6453,-122.327,1884,1778,600000,10,11,2014,0,102,2390,-106,0,1,1
4,2.5,2790,7938,2.0,0,0,3,9,2790,0,1997,0,98074,47.6223,-122.026,2780,7779,764000,18,6,2014,0,17,5148,4999,0,0,0
4,2.0,1590,8779,1.0,0,0,3,8,1590,0,2001,0,98019,47.7408,-121.974,2090,9600,337000,29,7,2014,0,13,7189,7510,0,0,0
4,1.0,1200,7552,1.0,0,0,3,6,1060,140,1919,0,98126,47.5317,-122.37,1580,7680,249000,19,11,2014,0,95,6352,6100,0,1,1
3,2.25,1510,6000,1.0,0,0,4,7,1150,360,1993,0,98038,47.3484,-122.036,1510,6000,269950,29,1,2015,0,22,4490,4490,0,1,0
4,2.5,3070,4000,2.0,0,0,4,8,2070,1000,1940,0,98105,47.659,-122.281,2560,4000,1300000,31,3,2015,0,75,930,1440,0,1,1
4,2.25,2110,7560,2.0,0,0,4,8,2110,0,1974,0,98034,47.7331,-122.183,2110,7560,475000,11,9,2014,0,40,5450,5450,0,0,0
3,2.0,2350,8459,1.5,0,0,3,9,2350,0,1989,0,98023,47.3043,-122.349,2430,8459,339000,10,3,2015,0,26,6109,6029,0,0,0
4,3.5,3270,15160,1.0,0,2,3,8,1660,1610,1997,0,98155,47.7437,-122.287,2790,15160,600000,11,3,2015,0,18,11890,12370,0,1,1
4,1.75,2220,4760,1.0,0,0,3,7,1320,900,1918,0,98106,47.5215,-122.348,940,4760,397500,7,8,2014,0,96,2540,3820,0,1,1
3,2.0,1760,9055,2.0,0,0,4,7,1760,0,1985,0,98052,47.6534,-122.128,2010,9383,460000,7,5,2014,0,29,7295,7373,0,0,0
4,2.75,2200,5207,1.0,0,0,5,7,1120,1080,1951,0,98133,47.74,-122.343,1210,6008,370000,16,12,2014,0,63,3007,4798,0,1,1
4,1.0,1550,7296,1.5,0,0,3,6,1550,0,1957,0,98106,47.5184,-122.366,1370,7680,250000,25,3,2015,0,58,5746,6310,0,0,1
2,2.25,1040,1516,2.0,0,0,3,8,1040,0,2008,0,98122,47.6037,-122.307,1560,1920,430000,30,9,2014,0,6,476,360,0,0,1
3,1.5,2560,4000,1.5,0,0,5,8,1660,900,1927,0,98112,47.6384,-122.279,2560,4000,1090000,7,8,2014,0,87,1440,1440,0,1,1
3,1.75,1850,8160,1.0,0,0,3,8,1850,0,1952,0,98177,47.7241,-122.363,1600,8160,670000,19,4,2015,0,63,6310,6560,0,0,1
3,1.5,2090,11895,1.0,0,0,3,7,1790,300,1954,0,98118,47.5362,-122.267,2180,11072,461550,23,4,2015,0,61,9805,8892,0,1,1
3,2.5,2010,2386,2.0,0,0,3,8,1390,620,2014,0,98029,47.5525,-121.998,1690,1870,479990,5,8,2014,0,0,376,180,0,1,0
4,2.5,2518,4663,2.0,0,0,3,8,2518,0,2005,0,98075,47.5894,-122.017,2280,4525,643000,14,4,2015,0,10,2145,2245,0,0,0
3,2.75,2810,12813,2.0,0,0,3,8,2040,770,1988,0,98052,47.6796,-122.114,1890,10336,607000,30,9,2014,0,26,10003,8446,0,1,0
3,2.5,2600,10092,1.0,0,0,3,9,2600,0,1984,0,98074,47.6223,-122.032,2440,9298,625000,23,5,2014,0,30,7492,6858,0,0,0
3,2.5,2060,8778,1.0,0,0,3,8,1160,900,1953,2010,98136,47.5245,-122.384,1990,7560,731100,29,7,2014,57,61,6718,5570,1,1,1
4,2.5,2130,10375,2.0,0,0,4,8,2130,0,1986,0,98058,47.4381,-122.16,2220,8508,435000,3,11,2014,0,28,8245,6288,0,0,0
3,3.0,2290,15600,1.0,0,0,3,8,1420,870,1948,1990,98001,47.3558,-122.29,1890,14143,465000,29,10,2014,42,66,13310,12253,1,1,0
3,1.0,1230,6380,1.5,0,0,3,7,1230,0,1927,0,98115,47.6947,-122.315,1250,6380,740000,15,4,2015,0,88,5150,5130,0,0,1
3,2.0,1430,7280,1.0,0,0,3,7,990,440,1980,0,98030,47.3742,-122.18,1430,7280,250000,19,11,2014,0,34,5850,5850,0,1,0
2,2.5,2270,1763,3.0,0,0,3,7,1820,450,2009,0,98052,47.6757,-122.121,2180,1763,656000,11,3,2015,0,6,-507,-417,0,1,0
4,2.5,1910,8058,2.0,0,0,3,8,1910,0,1992,0,98031,47.3891,-122.172,1910,6500,300000,9,10,2014,0,22,6148,4590,0,0,0
4,2.5,2690,6124,2.0,0,0,3,7,2690,0,2007,0,98042,47.3343,-122.058,2300,6002,311000,7,8,2014,0,7,3434,3702,0,0,0
3,1.75,1330,7482,1.0,0,0,4,7,1330,0,1975,0,98034,47.7322,-122.207,1480,8096,360000,21,7,2014,0,39,6152,6616,0,0,0
4,2.5,3060,10043,1.0,0,0,4,8,1700,1360,1968,0,98133,47.7387,-122.337,1630,8296,475000,19,5,2014,0,46,6983,6666,0,1,1
3,3.25,1760,1778,3.0,0,0,3,8,1760,0,2008,0,98125,47.7201,-122.301,1520,1615,469950,9,8,2014,0,6,18,95,0,0,1
3,1.75,1570,8750,1.0,0,0,3,7,1570,0,1960,0,98148,47.4425,-122.333,1890,8825,240000,3,7,2014,0,54,7180,6935,0,0,1
2,1.0,960,8100,1.0,0,0,3,6,810,150,1936,0,98168,47.494,-122.304,960,12150,232000,29,9,2014,0,78,7140,11190,0,1,1
3,2.25,1960,7000,1.0,0,0,3,8,1600,360,1980,0,98058,47.4427,-122.126,1980,7140,355000,10,12,2014,0,34,5040,5160,0,1,0
4,2.0,1790,2250,1.0,0,2,4,7,840,950,1909,0,98103,47.6526,-122.345,1440,1545,475000,21,5,2014,0,105,460,105,0,1,1
3,2.5,2560,9825,2.0,0,0,4,9,2560,0,1988,0,98006,47.5497,-122.145,2710,12034,823000,24,3,2015,0,27,7265,9324,0,0,0
2,1.5,1010,3060,1.0,0,0,4,7,1010,0,1918,0,98103,47.6897,-122.354,1160,4080,395000,12,11,2014,0,96,2050,2920,0,0,1
4,3.75,2560,5250,2.0,0,0,3,7,1900,660,1963,2006,98133,47.7326,-122.342,1400,5250,499000,27,4,2015,43,52,2690,3850,1,1,1
2,1.75,1200,3136,1.0,0,0,3,7,800,400,1904,2005,98122,47.6132,-122.297,1330,3164,420000,2,4,2015,101,111,1936,1834,1,1,1
3,2.5,3910,14000,2.0,0,0,3,10,3910,0,1999,0,98008,47.6374,-122.12,2280,14000,961500,12,8,2014,0,15,10090,11720,0,0,0
4,1.75,2260,12238,1.0,0,0,3,9,2260,0,1967,0,98005,47.5976,-122.178,2430,10204,833000,31,3,2015,0,48,9978,7774,0,0,0
3,2.25,2110,11319,2.0,0,0,4,8,2110,0,1978,0,98072,47.742,-122.105,1860,11319,479000,23,6,2014,0,36,9209,9459,0,0,0
4,2.5,3340,10422,2.0,0,0,3,10,3340,0,1996,0,98033,47.6515,-122.197,1770,9490,1150000,1,7,2014,0,18,7082,7720,0,0,0
3,1.0,1400,8100,1.5,0,0,3,6,1400,0,1944,0,98125,47.7124,-122.289,1420,8100,267000,8,7,2014,0,70,6700,6680,0,0,1
3,2.5,2010,9725,2.0,0,0,4,8,2010,0,1987,0,98029,47.568,-122.018,1850,6858,490000,31,7,2014,0,27,7715,5008,0,0,0
4,2.0,2300,3400,1.5,0,0,5,8,1550,750,1915,0,98117,47.678,-122.361,1670,4200,619000,29,5,2014,0,99,1100,2530,0,1,1
3,2.0,1340,3000,2.0,0,0,5,7,1340,0,1905,0,98103,47.6857,-122.349,1120,3000,549000,25,11,2014,0,109,1660,1880,0,0,1
3,1.75,1560,7245,1.5,0,0,3,7,1560,0,1962,1985,98052,47.6868,-122.119,2220,8502,422500,23,10,2014,23,52,5685,6282,1,0,0
4,3.5,3350,9681,1.0,0,1,3,7,2140,1210,1980,0,98198,47.3978,-122.322,2580,9681,400000,1,8,2014,0,34,6331,7101,0,1,1
4,2.75,3710,7984,2.0,0,0,3,9,3710,0,1999,0,98065,47.5352,-121.868,2950,7984,692500,9,7,2014,0,15,4274,5034,0,0,0
4,2.5,2430,5499,2.0,0,0,3,8,2430,0,2002,0,98042,47.3779,-122.125,2890,5190,310000,26,6,2014,0,12,3069,2300,0,0,0
3,1.75,2430,8820,1.0,0,2,3,8,1630,800,1977,0,98178,47.4972,-122.233,2390,10050,499900,16,12,2014,0,37,6390,7660,0,1,1
3,2.25,2100,7335,2.0,0,0,3,8,2100,0,1983,0,98074,47.647,-122.061,2050,8930,492000,27,8,2014,0,31,5235,6880,0,0,0
3,2.5,1630,2640,2.0,0,0,5,8,1630,0,1919,0,98119,47.6452,-122.371,1630,3000,800000,16,7,2014,0,95,1010,1370,0,0,1
4,1.0,1640,4200,1.5,0,0,3,7,1640,0,1925,0,98103,47.6601,-122.332,1730,3990,832600,7,4,2015,0,90,2560,2260,0,0,1
4,2.75,2310,7350,1.0,0,0,3,8,1670,640,1989,0,98011,47.7505,-122.182,2600,6077,470000,18,3,2015,0,26,5040,3477,0,1,0
2,2.0,1930,4500,1.0,0,0,3,8,1930,0,2003,0,98053,47.7104,-122.031,1670,5200,542000,21,10,2014,0,11,2570,3530,0,0,0
4,2.5,2300,7500,1.0,0,3,2,7,1650,650,1959,0,98198,47.4125,-122.33,2300,7500,308130,10,10,2014,0,55,5200,5200,0,1,1
2,1.0,1050,2699,1.0,0,0,3,7,1050,0,2005,0,98029,47.5471,-121.996,1240,2671,310000,11,3,2015,0,10,1649,1431,0,0,0
2,1.0,1500,8015,1.0,0,0,3,6,1500,0,1947,0,98146,47.5027,-122.348,1130,8015,235000,22,10,2014,0,67,6515,6885,0,0,1
3,1.0,1150,7560,1.0,0,0,4,6,1150,0,1958,0,98058,47.4613,-122.184,1230,7560,215000,19,9,2014,0,56,6410,6330,0,0,0
4,1.5,1920,10403,1.0,0,0,3,7,1370,550,1959,0,98023,47.2987,-122.366,1550,9619,210000,5,6,2014,0,55,8483,8069,0,1,0
3,1.75,1720,9342,1.0,0,0,4,7,1140,580,1981,0,98092,47.3177,-122.182,1330,7540,245000,10,12,2014,0,33,7622,6210,0,1,0
4,2.5,2400,6078,2.0,0,0,3,8,2400,0,2001,0,98001,47.2606,-122.285,2406,7642,299000,3,2,2015,0,14,3678,5236,0,0,0
4,1.75,2080,7200,1.0,0,0,4,7,1050,1030,1966,0,98001,47.3385,-122.282,1500,7350,198000,3,7,2014,0,48,5120,5850,0,1,0
5,3.25,3400,7452,2.0,0,0,3,10,3400,0,1999,0,98007,47.6141,-122.136,2650,8749,950000,23,5,2014,0,15,4052,6099,0,0,0
4,1.75,2200,7600,2.0,0,0,3,8,2200,0,1978,0,98092,47.3131,-122.191,1910,7600,300000,20,2,2015,0,37,5400,5690,0,0,0
5,1.75,2140,8580,1.0,0,0,3,7,1200,940,1962,0,98033,47.6625,-122.178,1600,9206,528000,4,9,2014,0,52,6440,7606,0,1,0
5,3.25,3850,16249,2.0,0,2,3,9,3030,820,2002,0,98092,47.3324,-122.168,2640,7393,507000,18,6,2014,0,12,12399,4753,0,1,0
4,3.25,4270,6384,2.0,0,0,3,9,3060,1210,2001,0,98065,47.5362,-121.874,2850,6285,770000,19,2,2015,0,14,2114,3435,0,1,0
3,1.75,1340,7210,1.0,0,0,4,7,1340,0,1975,0,98031,47.4182,-122.167,1370,7210,255000,20,2,2015,0,40,5870,5840,0,0,0
1,1.5,1100,3451,1.5,0,0,4,8,1100,0,1978,0,98198,47.3829,-122.322,1400,4560,220000,5,5,2015,0,37,2351,3160,0,0,1
5,2.75,2870,5349,2.0,0,0,3,9,2870,0,2005,0,98059,47.5405,-122.187,2800,5000,690700,23,2,2015,0,10,2479,2200,0,0,0
2,1.0,1320,8380,1.0,0,0,3,7,1320,0,1953,0,98177,47.705,-122.367,1290,8025,447000,27,6,2014,0,61,7060,6735,0,0,1
6,2.0,2150,4505,1.0,0,0,3,7,1270,880,1952,0,98119,47.6514,-122.369,1740,4505,755000,20,5,2014,0,62,2355,2765,0,1,1
4,1.5,2470,6000,1.5,0,0,3,7,1480,990,1940,0,98199,47.6365,-122.391,2140,4000,700000,13,3,2015,0,75,3530,1860,0,1,1
4,2.75,1910,7700,1.0,0,0,4,7,1000,910,1980,0,98030,47.369,-122.17,1880,7875,250000,15,7,2014,0,34,5790,5995,0,1,0
3,2.5,2130,6969,2.0,0,0,3,7,2130,0,2003,0,98038,47.3655,-122.027,1670,9545,320000,10,5,2014,0,11,4839,7875,0,0,0
4,2.5,2240,14667,2.0,0,0,4,9,2240,0,1989,0,98059,47.5276,-122.161,2410,11243,565000,14,5,2014,0,25,12427,8833,0,0,0
5,2.75,1800,4500,2.0,0,0,4,7,1680,120,1939,0,98107,47.6648,-122.358,1730,4500,754300,24,4,2015,0,76,2700,2770,0,1,1
3,1.5,2160,9000,1.0,0,2,4,8,1400,760,1949,0,98177,47.7241,-122.369,3010,9000,650000,5,5,2014,0,65,6840,5990,0,1,1
4,2.5,3140,8455,2.0,0,0,3,8,3140,0,2003,0,98059,47.4866,-122.147,3140,7391,529888,18,2,2015,0,12,5315,4251,0,0,0
3,2.5,1920,9812,2.0,0,0,3,8,1920,0,2000,0,98028,47.7633,-122.243,1830,10534,432000,6,11,2014,0,14,7892,8704,0,0,0
3,1.0,1050,7670,1.5,0,0,5,7,1050,0,1955,0,98022,47.2046,-121.996,1220,7670,235000,18,3,2015,0,60,6620,6450,0,0,0
4,3.5,3695,6556,2.0,0,0,3,9,3695,0,2014,0,98053,47.683,-122.015,4160,6786,994900,27,1,2015,0,1,2861,2626,0,0,0
4,2.5,3910,8442,2.0,0,0,3,9,2710,1200,2000,0,98038,47.3766,-122.027,2650,7576,489000,3,4,2015,0,15,4532,4926,0,1,0
4,2.75,3010,7427,2.0,0,0,3,8,3010,0,2010,0,98052,47.7068,-122.112,3000,4929,800000,20,4,2015,0,5,4417,1929,0,0,0
4,1.5,1370,9957,1.0,0,0,3,7,900,470,1972,0,98034,47.7237,-122.181,1510,8088,370000,16,5,2014,0,42,8587,6578,0,1,0
4,2.75,2080,9600,1.0,0,0,3,8,1240,840,1979,0,98034,47.7149,-122.235,1880,9525,436000,12,12,2014,0,35,7520,7645,0,1,0
3,2.5,2250,3757,2.0,0,0,3,7,2250,0,2006,0,98059,47.4787,-122.129,2250,4556,395000,28,5,2014,0,8,1507,2306,0,0,0
5,1.75,2120,8399,1.0,0,0,4,7,1320,800,1942,0,98133,47.7621,-122.335,2120,8398,377691,23,5,2014,0,72,6279,6278,0,1,1
5,3.0,2220,5185,2.0,0,3,3,7,2220,0,2003,0,98118,47.543,-122.29,2340,6316,370000,17,4,2015,0,12,2965,3976,0,0,1
3,2.5,1440,4394,1.0,0,0,5,8,1440,0,1987,0,98029,47.5688,-122.019,1900,5893,515000,23,10,2014,0,27,2954,3993,0,0,0
3,1.0,910,7686,1.0,0,0,3,7,910,0,1969,0,98001,47.3405,-122.288,1020,7686,169000,26,9,2014,0,45,6776,6666,0,0,0
3,1.0,1270,4268,1.0,0,0,3,7,1270,0,1921,0,98117,47.6848,-122.392,1310,4080,475000,21,3,2015,0,94,2998,2770,0,0,1
3,2.5,2480,6180,2.0,0,0,3,9,2480,0,1999,0,98031,47.4044,-122.208,2870,6180,420000,25,4,2015,0,16,3700,3310,0,0,0
6,2.75,2630,9420,2.0,0,0,5,9,2510,120,1900,0,98103,47.6695,-122.337,1540,4969,1300000,1,7,2014,0,114,6790,3429,0,1,1
3,2.0,2410,13300,2.0,0,0,3,9,1840,570,1985,0,98006,47.5632,-122.148,2930,10900,822000,25,2,2015,0,30,10890,7970,0,1,0
3,2.25,1570,6810,1.0,0,0,3,8,1180,390,1988,0,98074,47.6176,-122.044,1620,6584,485000,30,3,2015,0,27,5240,4964,0,1,0
4,1.0,1900,8505,1.0,0,0,3,7,1200,700,1956,0,98055,47.4406,-122.196,1440,8505,270000,7,8,2014,0,58,6605,7065,0,1,0
6,2.5,2590,11250,1.0,0,0,4,8,1390,1200,1978,0,98055,47.4608,-122.196,2270,8360,300000,1,4,2015,0,37,8660,6090,0,1,0
4,2.5,3810,7728,2.0,0,0,3,9,3810,0,2007,0,98074,47.5925,-122.058,3290,7728,878000,16,4,2015,0,8,3918,4438,0,0,0
3,2.5,2290,4203,2.0,0,0,3,9,2290,0,2001,0,98006,47.5441,-122.172,2290,5089,590000,3,4,2015,0,14,1913,2799,0,0,0
1,2.25,1220,2100,2.0,0,2,4,8,1220,0,1946,1979,98033,47.6703,-122.204,3150,6000,611900,19,11,2014,33,68,880,2850,1,0,0
3,1.75,1100,7373,1.0,0,0,4,7,1100,0,1968,0,98092,47.3124,-122.183,1430,8415,240000,19,3,2015,0,47,6273,6985,0,0,0
4,2.5,2810,10951,2.0,0,0,3,8,2810,0,2003,0,98092,47.3249,-122.187,1680,6625,395000,17,4,2015,0,12,8141,4945,0,0,0
3,1.0,890,7110,1.0,0,0,3,6,890,0,1957,0,98178,47.4971,-122.261,1100,8375,169000,16,7,2014,0,57,6220,7275,0,0,1
3,2.0,1280,14972,1.0,0,0,3,7,1280,0,1963,0,98031,47.4129,-122.209,1800,9698,200500,24,3,2015,0,52,13692,7898,0,0,0
3,2.5,2320,7140,2.0,0,0,3,8,2320,0,1990,0,98003,47.275,-122.295,2360,7955,308000,10,4,2015,0,25,4820,5595,0,0,0
3,2.25,1720,7885,2.0,0,0,3,8,1720,0,1983,0,98023,47.3136,-122.344,2340,7885,290256,10,7,2014,0,31,6165,5545,0,0,0
3,1.75,1530,8800,1.0,0,0,4,7,1040,490,1967,0,98058,47.4483,-122.158,1530,8690,279950,27,4,2015,0,48,7270,7160,0,1,0
3,1.75,1580,7875,1.0,0,0,3,7,1580,0,1979,0,98022,47.1958,-122.003,1560,8314,195000,7,8,2014,0,35,6295,6754,0,0,0
4,3.0,2680,15438,2.0,0,2,3,8,2680,0,1902,1956,98039,47.6109,-122.226,4480,14406,1160000,6,4,2015,54,113,12758,9926,1,0,0
3,2.25,1640,3896,2.0,0,0,3,8,1640,0,1994,0,98029,47.5689,-122.006,1780,3999,478000,1,7,2014,0,20,2256,2219,0,0,0
3,2.25,2520,6690,2.0,0,2,5,8,1700,820,1944,1990,98126,47.5705,-122.381,1990,5792,835000,14,8,2014,46,70,4170,3802,1,1,1
3,2.25,1400,2421,2.0,0,0,3,9,1400,0,2005,0,98034,47.695,-122.169,1500,2743,639000,17,4,2015,0,10,1021,1243,0,0,0
4,2.75,2300,12633,2.0,0,0,3,9,2300,0,1984,0,98074,47.6218,-122.032,2240,9246,623000,13,10,2014,0,30,10333,7006,0,0,0
3,1.75,1900,7680,1.0,0,0,3,7,1260,640,1959,0,98178,47.5081,-122.266,2000,7740,220000,17,12,2014,0,55,5780,5740,0,1,1
3,2.25,2000,18099,1.0,0,0,4,8,1250,750,1978,0,98006,47.5443,-122.18,2060,12000,526000,25,3,2015,0,37,16099,9940,0,1,0
2,1.0,900,5016,1.0,0,0,3,6,900,0,1948,0,98118,47.542,-122.282,1420,5184,243500,23,1,2015,0,67,4116,3764,0,0,1
4,2.5,2980,4930,2.0,0,0,3,9,2890,90,2000,0,98006,47.5445,-122.12,2980,6099,750000,12,5,2014,0,14,1950,3119,0,1,0
4,2.0,1850,9126,1.0,0,0,5,7,1850,0,1963,0,98059,47.5009,-122.164,1730,9110,329000,18,3,2015,0,52,7276,7380,0,0,0
4,1.0,1570,4000,1.5,0,0,3,7,1570,0,1920,0,98102,47.6275,-122.321,1610,4000,525000,26,9,2014,0,94,2430,2390,0,0,1
2,1.0,670,3101,1.0,0,0,4,6,670,0,1948,0,98118,47.5546,-122.274,1660,4100,190000,17,3,2015,0,67,2431,2440,0,0,1
4,2.5,2660,10800,1.0,0,0,3,7,2660,0,1955,2014,98005,47.5894,-122.172,2640,10800,772650,26,6,2014,59,59,8140,8160,1,0,0
3,2.5,2110,4038,2.0,0,0,4,8,2110,0,1989,0,98042,47.3875,-122.153,2110,3727,355000,10,7,2014,0,25,1928,1617,0,0,0
3,2.75,1210,3600,1.5,0,2,5,7,1210,0,1910,0,98103,47.6798,-122.354,1630,3910,678500,11,3,2015,0,105,2390,2280,0,0,1
4,2.5,2670,11877,2.0,0,0,3,9,2670,0,1996,0,98074,47.6327,-122.036,2430,11333,669950,26,6,2014,0,18,9207,8903,0,0,0
3,2.25,3000,18450,1.0,0,0,3,10,3000,0,1983,0,98077,47.7274,-122.062,2980,12304,850000,11,3,2015,0,32,15450,9324,0,0,0
3,2.75,2200,3885,2.0,0,0,3,8,2200,0,2002,0,98074,47.6171,-122.028,2710,6000,572000,27,8,2014,0,12,1685,3290,0,0,0
3,1.75,1540,13002,1.0,0,0,2,8,1200,340,1984,0,98074,47.6231,-122.044,1620,10098,492450,1,8,2014,0,30,11462,8478,0,1,0
3,1.75,2080,11866,1.0,0,0,3,8,2080,0,1960,0,98005,47.5872,-122.173,2240,10696,813000,30,10,2014,0,54,9786,8456,0,0,0
3,2.0,1780,9732,1.0,0,0,3,8,1780,0,1967,0,98040,47.5796,-122.229,1900,10200,710000,28,8,2014,0,47,7952,8300,0,0,0
3,1.5,1960,2400,2.0,0,0,3,8,1330,630,1911,0,98119,47.6423,-122.37,2090,4000,792500,2,12,2014,0,103,440,1910,0,1,1
5,1.5,1690,7725,1.5,0,0,4,7,1690,0,1961,0,98032,47.3859,-122.288,1690,7739,285900,13,3,2015,0,54,6035,6049,0,0,0
3,2.0,2080,12972,1.0,0,0,4,7,1250,830,1981,0,98070,47.3733,-122.432,1530,10089,389000,11,5,2015,0,34,10892,8559,0,1,0
3,2.25,2070,2833,2.0,0,2,3,8,1490,580,1966,0,98136,47.5543,-122.398,1940,3794,675000,5,12,2014,0,48,763,1854,0,1,1
4,3.25,4020,11588,2.0,0,0,3,11,4020,0,2000,0,98059,47.5217,-122.155,3190,8066,1050000,7,5,2015,0,15,7568,4876,0,0,0
4,1.75,3620,10400,1.0,0,0,4,8,1820,1800,1965,0,98005,47.6069,-122.167,2410,10400,768500,8,1,2015,0,50,6780,7990,0,1,0
4,2.0,2330,7778,1.0,0,0,3,7,1230,1100,1961,0,98125,47.7109,-122.323,1250,8160,500000,26,12,2014,0,53,5448,6910,0,1,1
3,2.5,1460,8800,1.0,0,0,4,7,1460,0,1956,0,98040,47.5895,-122.232,2200,8800,685000,30,12,2014,0,58,7340,6600,0,0,0
4,2.75,2250,5700,1.0,0,0,3,8,1200,1050,1951,0,98109,47.6406,-122.344,1720,3850,648475,23,5,2014,0,63,3450,2130,0,1,1
6,5.0,2850,6600,2.0,0,0,3,7,2850,0,1994,0,98033,47.6813,-122.187,1870,9900,655000,22,4,2015,0,21,3750,8030,0,0,0
4,2.75,2640,4000,2.0,0,0,5,8,1730,910,1925,0,98115,47.6727,-122.297,1530,3740,895000,12,9,2014,0,89,1360,2210,0,1,1
3,1.0,1310,9554,1.0,0,0,3,7,960,350,1962,0,98001,47.2949,-122.285,1310,9845,195000,8,4,2015,0,53,8244,8535,0,1,0
4,2.5,2720,7350,2.0,0,0,3,9,2720,0,1989,0,98023,47.3028,-122.35,2570,8336,368000,8,12,2014,0,25,4630,5766,0,0,0
4,3.5,3430,13609,2.0,0,0,3,11,3430,0,2001,0,98059,47.5196,-122.151,3880,11614,997000,28,2,2015,0,14,10179,7734,0,0,0
3,2.0,1170,7258,1.0,0,0,3,7,1170,0,1984,0,98001,47.3333,-122.266,1410,7750,250000,21,5,2014,0,30,6088,6340,0,0,0
3,1.75,1390,8980,1.0,0,0,4,8,1390,0,1985,0,98022,47.2015,-122.005,1770,9085,278500,12,3,2015,0,30,7590,7315,0,0,0
4,1.5,1540,7300,2.0,0,0,3,7,1540,0,1973,0,98001,47.3317,-122.276,1580,7650,260000,28,1,2015,0,42,5760,6070,0,0,0
2,1.0,760,6141,1.0,0,0,2,6,760,0,1920,0,98118,47.5469,-122.277,900,4120,162500,1,10,2014,0,94,5381,3220,0,0,1
4,1.0,1280,8316,1.0,0,0,3,6,1280,0,1950,0,98168,47.4989,-122.302,1310,7830,239000,14,7,2014,0,64,7036,6520,0,0,1
4,2.5,2990,5122,2.0,0,0,3,8,2990,0,2004,0,98075,47.5773,-122.055,3140,7875,600000,21,11,2014,0,10,2132,4735,0,0,0
4,2.25,1770,7778,2.0,0,0,3,7,1770,0,1998,0,98031,47.4192,-122.201,1770,7591,350000,28,4,2015,0,17,6008,5821,0,0,0
5,3.75,3830,8131,2.0,0,0,3,10,3830,0,2005,0,98075,47.5837,-121.971,3570,7290,852500,15,12,2014,0,9,4301,3720,0,0,0
3,2.5,2870,5490,2.0,0,0,3,9,2870,0,2008,0,98055,47.4471,-122.207,3040,5442,485000,21,7,2014,0,6,2620,2402,0,0,0
3,1.0,1520,8320,1.0,0,0,3,6,1520,0,1953,0,98133,47.7699,-122.335,1500,8320,299000,7,10,2014,0,61,6800,6820,0,0,1
2,1.0,660,6509,1.0,0,0,4,5,660,0,1952,0,98056,47.4938,-122.171,970,5713,227450,22,4,2015,0,63,5849,4743,0,0,0
3,1.0,1800,5612,1.0,0,0,4,7,1200,600,1942,0,98126,47.525,-122.378,1450,5250,383000,23,5,2014,0,72,3812,3800,0,1,1
5,1.5,3050,2992,1.5,0,0,4,8,1920,1130,1931,0,98112,47.621,-122.302,1200,1209,760000,11,2,2015,0,84,-58,9,0,1,1
2,1.0,820,3000,1.0,0,0,4,7,820,0,1924,0,98103,47.6842,-122.348,1490,3000,532500,17,2,2015,0,91,2180,1510,0,0,1
3,2.0,1490,3072,1.0,0,0,5,7,770,720,1912,0,98144,47.5772,-122.307,1320,3072,438500,25,8,2014,0,102,1582,1752,0,1,1
3,2.5,1560,9361,1.5,0,0,4,7,1360,200,1936,0,98108,47.5591,-122.295,1670,6244,545500,18,6,2014,0,78,7801,4574,0,1,1
3,1.75,1660,9549,1.0,0,0,3,7,1660,0,1956,0,98033,47.6503,-122.198,2090,9549,675000,14,4,2015,0,59,7889,7459,0,0,0
3,1.75,1180,4080,1.0,0,0,4,6,760,420,1928,0,98117,47.6825,-122.391,1490,4080,450000,18,6,2014,0,86,2900,2590,0,1,1
3,1.0,960,10815,1.0,0,0,5,5,960,0,1900,0,98010,47.3091,-122.006,1330,10815,199999,23,12,2014,0,114,9855,9485,0,0,0
3,1.5,1630,16170,1.0,0,0,3,7,1630,0,1988,0,98034,47.7104,-122.235,1630,9931,375000,10,9,2014,0,26,14540,8301,0,0,0
3,1.5,1520,7123,1.0,0,0,4,7,1520,0,1959,0,98056,47.4991,-122.176,1450,8023,292600,8,7,2014,0,55,5603,6573,0,0,0
5,2.75,3050,8904,1.0,0,0,4,8,1650,1400,1956,0,98040,47.5709,-122.214,2920,8904,1040000,19,3,2015,0,59,5854,5984,0,1,0
3,1.0,1000,4959,1.0,0,0,3,8,1000,0,1945,0,98105,47.6629,-122.277,2240,4959,610000,10,10,2014,0,69,3959,2719,0,0,1
4,2.5,2650,9451,2.0,0,0,4,8,2650,0,1993,0,98042,47.3693,-122.129,2510,8850,397450,25,8,2014,0,21,6801,6340,0,0,0
3,2.25,1750,15528,1.0,0,0,3,8,1270,480,1963,0,98155,47.7739,-122.274,2170,12000,382000,14,4,2015,0,52,13778,9830,0,1,1
3,2.25,1770,7667,1.0,0,0,3,8,1270,500,1966,0,98177,47.7724,-122.362,2180,8103,370000,16,1,2015,0,49,5897,5923,0,1,1
3,2.25,1770,7667,1.0,0,0,3,8,1270,500,1966,0,98177,47.7724,-122.362,2180,8103,520000,28,4,2015,0,49,5897,5923,0,1,1
2,1.0,770,7906,1.0,0,0,4,6,770,0,1948,0,98155,47.766,-122.32,990,7906,260000,1,7,2014,0,66,7136,6916,0,0,1
4,2.5,3370,7200,2.0,0,0,3,8,3370,0,2014,0,98177,47.7698,-122.384,1880,7200,890000,20,11,2014,0,0,3830,5320,0,0,1
5,2.0,2130,8412,1.0,0,0,3,7,1440,690,1946,2000,98155,47.7403,-122.318,2310,7474,344000,26,8,2014,54,68,6282,5164,1,1,1
3,1.0,1050,8498,1.0,0,0,3,7,1050,0,1958,0,98031,47.4038,-122.203,1340,8498,205000,25,6,2014,0,56,7448,7158,0,0,0
5,2.5,2803,8550,1.0,0,0,3,8,2803,0,1963,2011,98003,47.3032,-122.306,1810,8550,379000,7,5,2015,48,52,5747,6740,1,0,0
3,2.0,2080,12094,2.0,0,0,4,8,2080,0,1982,0,98052,47.7035,-122.164,2230,12204,424240,22,8,2014,0,32,10014,9974,0,0,0
3,2.0,2080,12094,2.0,0,0,4,8,2080,0,1982,0,98052,47.7035,-122.164,2230,12204,589950,24,11,2014,0,32,10014,9974,0,0,0
4,1.75,2120,4650,1.0,0,1,3,7,1190,930,1951,0,98117,47.6964,-122.4,2070,6487,582000,12,5,2014,0,63,2530,4417,0,1,1
3,2.5,2550,7709,2.0,0,0,3,9,2550,0,1989,0,98023,47.3081,-122.391,2410,9250,349000,12,3,2015,0,26,5159,6840,0,0,0
3,1.0,1290,12005,1.0,0,0,4,7,1290,0,1966,0,98033,47.6835,-122.199,1930,8000,658000,8,4,2015,0,49,10715,6070,0,0,0
5,2.75,1790,5000,1.5,0,0,4,7,1060,730,1915,0,98106,47.5655,-122.363,1400,5000,294000,29,10,2014,0,99,3210,3600,0,1,1
5,3.5,2720,7598,2.0,0,0,3,8,1860,860,1993,0,98115,47.6931,-122.283,2430,7728,690000,26,6,2014,0,21,4878,5298,0,1,1
3,1.0,1040,5000,1.5,0,2,3,7,1040,0,1912,0,98107,47.6754,-122.359,1440,4400,600000,23,4,2015,0,103,3960,2960,0,0,1
3,1.0,840,5200,1.0,0,0,3,6,840,0,1969,2014,98042,47.3685,-122.077,870,5200,199990,16,1,2015,45,46,4360,4330,1,0,0
3,1.75,1650,8850,1.0,0,0,3,7,1650,0,1959,0,98188,47.4331,-122.291,1400,8800,220000,9,12,2014,0,55,7200,7400,0,0,1
4,2.25,2080,15750,1.0,0,0,3,8,1460,620,1976,0,98034,47.7225,-122.2,1960,10500,440000,26,1,2015,0,39,13670,8540,0,1,0
4,2.5,1540,1994,2.0,0,0,3,8,1540,0,2014,0,98029,47.5526,-121.999,1540,1689,439990,4,9,2014,0,0,454,149,0,0,0
4,2.5,3880,7208,2.0,0,0,3,10,3880,0,2006,0,98075,47.5841,-121.971,3280,7221,815000,11,3,2015,0,9,3328,3941,0,0,0
4,2.25,1860,3766,2.0,0,0,3,8,1860,0,1995,0,98029,47.5699,-122.006,1860,4169,535000,21,4,2015,0,20,1906,2309,0,0,0
3,1.75,1280,10016,1.0,0,0,4,7,1280,0,1975,0,98003,47.2823,-122.333,1670,9764,215000,26,11,2014,0,39,8736,8094,0,0,0
3,2.5,2200,7278,2.0,0,0,3,8,2200,0,1990,0,98058,47.4624,-122.132,2190,8580,349900,30,5,2014,0,24,5078,6390,0,0,0
3,1.0,1570,5510,1.0,0,0,4,7,1070,500,1940,0,98115,47.6942,-122.319,1770,6380,495000,18,2,2015,0,75,3940,4610,0,1,1
3,2.5,2074,4900,2.0,0,0,3,8,2074,0,1997,0,98034,47.7327,-122.233,1840,7382,515100,14,10,2014,0,17,2826,5542,0,0,0
4,2.25,2520,10370,2.0,0,0,3,9,2520,0,1980,0,98074,47.6377,-122.049,2848,12682,657500,22,1,2015,0,35,7850,9834,0,0,0
5,1.75,2190,8250,1.0,0,2,3,7,1190,1000,1963,0,98055,47.4887,-122.223,2570,8250,250000,19,1,2015,0,52,6060,5680,0,1,0
5,1.75,2190,8250,1.0,0,2,3,7,1190,1000,1963,0,98055,47.4887,-122.223,2570,8250,385000,21,4,2015,0,52,6060,5680,0,1,0
3,1.5,2320,7500,1.0,0,0,3,7,2320,0,1976,0,98019,47.7413,-121.979,1480,10000,307000,22,5,2014,0,38,5180,8520,0,0,0
3,2.5,1370,9253,1.0,0,0,3,7,1090,280,1994,0,98042,47.3717,-122.073,1470,9253,288000,13,5,2015,0,21,7883,7783,0,1,0
3,1.75,1730,7200,1.5,0,0,4,6,1730,0,1944,0,98032,47.3774,-122.236,860,7200,226450,28,10,2014,0,70,5470,6340,0,0,0
3,2.5,1640,6991,1.0,0,0,3,7,1110,530,1967,0,98125,47.7255,-122.327,1860,7342,390000,10,3,2015,0,48,5351,5482,0,1,1
3,1.0,1300,10236,1.0,0,0,4,6,1300,0,1971,0,98045,47.5028,-121.77,1380,11325,350000,30,9,2014,0,43,8936,9945,0,0,0
3,1.5,1560,7884,1.0,0,0,3,7,1060,500,1969,0,98125,47.7312,-122.298,1820,9000,368000,1,12,2014,0,45,6324,7180,0,1,1
2,1.0,1120,4284,1.0,0,0,3,6,730,390,1921,0,98105,47.6688,-122.324,2050,4160,469000,18,8,2014,0,93,3164,2110,0,1,1
5,2.5,3810,15916,1.5,0,0,5,8,3810,0,1967,0,98058,47.4521,-122.14,2470,11662,515000,13,1,2015,0,48,12106,9192,0,0,0
3,1.75,1440,8560,1.0,0,0,4,7,1440,0,1979,0,98034,47.7296,-122.232,1460,7560,410000,23,1,2015,0,36,7120,6100,0,0,0
3,1.75,1520,7700,1.0,0,0,3,7,820,700,1969,0,98034,47.7226,-122.219,1420,7674,460000,25,3,2015,0,46,6180,6254,0,1,0
4,2.5,2500,9654,1.0,0,0,3,8,1830,670,1979,0,98023,47.3137,-122.343,2500,8839,241500,19,9,2014,0,35,7154,6339,0,1,0
4,1.0,1210,6000,1.5,0,2,3,7,1210,0,1943,0,98178,47.5026,-122.234,1470,6000,279000,18,8,2014,0,71,4790,4530,0,0,1
3,1.5,1050,6615,1.0,0,0,4,6,800,250,1950,0,98199,47.6578,-122.39,1530,5250,420000,20,10,2014,0,64,5565,3720,0,1,1
3,1.0,1240,8840,1.0,0,0,3,6,1240,0,1952,0,98125,47.7277,-122.308,1250,8840,294950,14,7,2014,0,62,7600,7590,0,0,1
4,3.5,3460,3997,2.0,0,0,3,10,2560,900,2004,0,98103,47.6718,-122.329,1860,4000,1320000,12,5,2014,0,10,537,2140,0,1,1
3,1.75,1270,4800,1.0,0,0,3,7,1270,0,1953,0,98117,47.693,-122.361,1490,4800,335000,15,9,2014,0,61,3530,3310,0,0,1
4,2.25,2980,8051,1.5,0,2,4,10,2020,960,1935,0,98199,47.6426,-122.409,2760,5499,1160000,5,6,2014,0,79,5071,2739,0,1,1
2,1.0,1250,3708,1.5,0,0,3,7,1250,0,1926,0,98117,47.685,-122.363,1430,3708,520000,11,3,2015,0,89,2458,2278,0,0,1
4,1.75,1740,8800,1.0,0,0,4,8,1740,0,1965,0,98007,47.6232,-122.142,2180,8436,560000,16,9,2014,0,49,7060,6256,0,0,0
4,1.5,1730,7464,2.0,0,0,4,7,1730,0,1959,0,98032,47.3782,-122.304,1370,7860,243400,12,10,2014,0,55,5734,6490,0,0,0
3,2.0,1240,14404,1.0,0,0,3,7,1240,0,1988,0,98053,47.6614,-122.06,1350,9990,405000,29,5,2014,0,26,13164,8640,0,0,0
2,1.0,1670,14695,1.5,0,0,5,7,1670,0,1930,0,98033,47.7001,-122.2,1800,11355,495000,2,10,2014,0,84,13025,9555,0,0,0
4,2.5,2140,7095,2.0,0,0,3,8,2140,0,1992,0,98038,47.3528,-122.057,1600,7182,350000,2,4,2015,0,23,4955,5582,0,0,0
5,2.75,2530,7601,1.0,0,0,3,7,1520,1010,1992,0,98188,47.4683,-122.263,2400,7776,368500,11,12,2014,0,22,5071,5376,0,1,1
2,1.0,960,8236,1.0,0,0,2,6,960,0,1948,0,98058,47.4698,-122.166,1260,8236,99000,5,1,2015,0,67,7276,6976,0,0,0
4,3.75,4130,12320,2.0,0,0,3,11,4130,0,2001,0,98059,47.5194,-122.151,3690,11227,1070000,3,6,2014,0,13,8190,7537,0,0,0
4,1.75,1710,7724,1.0,0,0,3,8,1710,0,1983,0,98155,47.7721,-122.293,1940,7724,430000,26,8,2014,0,31,6014,5784,0,0,1
3,1.5,1490,8475,1.0,0,0,4,7,1490,0,1963,0,98052,47.6571,-122.133,1490,8540,412500,15,5,2014,0,51,6985,7050,0,0,0
3,2.5,2210,7620,2.0,0,0,3,8,2210,0,1994,0,98052,47.6938,-122.13,1920,7440,535000,23,5,2014,0,20,5410,5520,0,0,0
3,1.5,1650,8676,1.0,0,0,4,8,1130,520,1979,0,98133,47.7471,-122.352,1400,8499,390000,4,11,2014,0,35,7026,7099,0,1,1
3,1.5,1260,3135,1.0,0,0,4,7,780,480,1944,0,98107,47.6693,-122.371,1540,3025,499000,8,9,2014,0,70,1875,1485,0,1,1
3,1.0,1960,7955,1.0,0,0,4,7,1260,700,1963,0,98177,47.7641,-122.364,1850,8219,375000,30,7,2014,0,51,5995,6369,0,1,1
4,2.5,1800,7620,2.0,0,0,3,8,1800,0,1995,0,98055,47.4346,-122.201,1800,6879,349000,28,10,2014,0,19,5820,5079,0,0,0
3,2.25,1940,7482,1.0,0,0,4,7,1240,700,1964,0,98004,47.6004,-122.195,2340,9310,635000,31,10,2014,0,50,5542,6970,0,1,0
4,2.75,2820,8009,2.0,0,0,3,9,2820,0,2001,0,98075,47.6,-121.977,2820,7398,682000,15,12,2014,0,13,5189,4578,0,0,0
4,2.25,2820,16770,1.0,0,0,4,8,1920,900,1966,0,98023,47.3186,-122.364,2320,13850,321027,3,2,2015,0,49,13950,11530,0,1,0
2,1.0,720,4120,1.0,0,0,5,5,720,0,1915,0,98002,47.303,-122.217,940,6180,150000,25,11,2014,0,99,3400,5240,0,0,0
3,1.75,1640,17583,1.0,0,0,3,7,1110,530,1969,0,98034,47.726,-122.203,1420,11680,410000,13,12,2014,0,45,15943,10260,0,1,0
3,2.0,1560,4080,2.0,0,0,3,7,1560,0,1923,1982,98115,47.6892,-122.319,1900,4080,449950,23,5,2014,59,91,2520,2180,1,0,1
6,2.5,1560,7144,1.0,0,0,3,6,1060,500,1913,0,98118,47.5335,-122.272,1300,6232,194990,13,10,2014,0,101,5584,4932,0,1,1
4,1.75,1910,8775,1.0,0,0,3,7,1210,700,1956,0,98028,47.7396,-122.247,2210,8778,475000,2,1,2015,0,59,6865,6568,0,1,0
5,1.75,1570,3000,2.0,0,0,4,7,1570,0,1908,0,98105,47.6677,-122.316,1610,3000,530000,28,1,2015,0,107,1430,1390,0,0,1
4,2.5,2038,7643,2.0,0,0,3,8,2038,0,2011,0,98092,47.3296,-122.18,2634,6824,319950,22,7,2014,0,3,5605,4190,0,0,0
3,2.25,1720,9435,1.0,0,0,4,7,1220,500,1978,0,98023,47.2979,-122.377,1690,7215,210000,27,3,2015,0,37,7715,5525,0,1,0
3,2.75,1670,3330,1.5,0,0,4,7,1670,0,1925,0,98107,47.6551,-122.36,1370,5000,485000,26,12,2014,0,89,1660,3630,0,0,1
4,2.75,2830,10240,2.0,0,0,4,9,2830,0,1998,0,98075,47.5903,-121.986,3490,10240,774000,28,1,2015,0,17,7410,6750,0,0,0
4,2.0,1690,8208,1.0,0,0,4,7,1210,480,1958,0,98008,47.6052,-122.126,1620,8496,478000,15,10,2014,0,56,6518,6876,0,1,0
4,2.5,1620,5280,2.0,0,0,4,7,1620,0,1924,1971,98146,47.5132,-122.384,1590,5280,385000,23,10,2014,47,90,3660,3690,1,0,1
3,1.5,1480,7117,1.0,0,0,3,7,1170,310,1960,0,98028,47.7766,-122.248,2230,14775,285000,18,3,2015,0,55,5637,12545,0,1,0
4,2.5,2700,4004,2.0,0,0,3,9,2700,0,2004,0,98029,47.5521,-121.995,2260,4459,723000,14,5,2014,0,10,1304,2199,0,0,0
3,1.5,1780,16000,1.0,0,0,2,7,1240,540,1960,0,98198,47.419,-122.322,1860,9775,279000,12,8,2014,0,54,14220,7915,0,1,1
3,1.5,1430,7560,1.0,0,0,5,6,1430,0,1958,0,98058,47.4518,-122.179,1150,7560,195000,6,3,2015,0,57,6130,6410,0,0,0
2,1.0,2160,2192,1.0,0,0,5,8,1170,990,1925,0,98119,47.6364,-122.371,1150,2152,625000,15,10,2014,0,89,32,1002,0,1,1
3,1.75,1800,9314,2.0,0,0,3,8,1800,0,1979,0,98011,47.7762,-122.198,2100,9658,270000,28,4,2015,0,36,7514,7558,0,0,0
2,2.0,1930,5520,1.0,0,0,3,8,1930,0,2006,0,98053,47.7191,-122.022,1640,4533,559000,7,10,2014,0,8,3590,2893,0,0,0
4,2.25,1960,14834,1.0,0,0,4,8,1330,630,1976,0,98072,47.7434,-122.095,1540,15000,474000,2,2,2015,0,39,12874,13460,0,1,0
4,2.5,1920,7345,2.0,0,0,3,8,1920,0,1992,0,98038,47.3526,-122.055,1860,7364,303500,14,11,2014,0,22,5425,5504,0,0,0
3,1.75,1470,8645,1.0,0,0,3,6,1470,0,1949,0,98155,47.7524,-122.323,1470,7680,350000,26,12,2014,0,65,7175,6210,0,0,1
5,3.0,2980,10064,1.0,0,0,3,7,1680,1300,1940,0,98155,47.7372,-122.316,1590,7800,367500,6,8,2014,0,74,7084,6210,0,1,1
5,3.0,2980,10064,1.0,0,0,3,7,1680,1300,1940,0,98155,47.7372,-122.316,1590,7800,595000,25,2,2015,0,75,7084,6210,0,1,1
3,2.25,2130,8801,1.0,0,0,3,8,1370,760,1976,0,98155,47.7462,-122.29,2820,8801,482975,2,10,2014,0,38,6671,5981,0,1,1
4,2.5,2030,4499,2.0,0,0,3,8,2030,0,2003,0,98058,47.4511,-122.119,2030,4539,365500,19,11,2014,0,11,2469,2509,0,0,0
4,2.0,1790,7800,1.0,0,0,5,8,1790,0,1972,0,98008,47.6266,-122.103,2150,7838,570000,11,7,2014,0,42,6010,5688,0,0,0
3,2.5,2260,8040,2.0,0,0,3,8,2260,0,1990,0,98092,47.3203,-122.184,2390,8040,335000,2,2,2015,0,25,5780,5650,0,0,0
4,2.0,2350,4815,1.5,0,0,4,7,1450,900,1914,0,98103,47.6681,-122.338,1640,4013,767500,8,4,2015,0,101,2465,2373,0,1,1
3,2.5,1690,1613,2.0,0,0,3,8,1150,540,2014,0,98029,47.5518,-121.998,1690,1662,386591,19,5,2014,0,0,-77,-28,0,1,0
3,1.0,1320,5750,1.5,0,0,3,7,1320,0,1913,0,98108,47.5288,-122.325,1010,5700,279000,22,7,2014,0,101,4430,4690,0,0,1
4,2.5,2870,9292,2.0,0,0,3,8,2540,330,1979,0,98058,47.4522,-122.123,2590,7533,399000,27,5,2014,0,35,6422,4943,0,1,0
4,2.75,2940,4232,2.0,0,0,3,9,2940,0,2004,0,98029,47.5529,-121.99,2410,4000,710000,18,9,2014,0,10,1292,1590,0,0,0
3,1.0,1190,4120,1.0,0,0,3,6,1190,0,1929,0,98118,47.5513,-122.272,1360,4635,320000,24,2,2015,0,86,2930,3275,0,0,1
3,2.5,1800,3253,2.0,0,0,3,7,1800,0,2001,0,98108,47.5401,-122.292,1800,3081,300000,23,10,2014,0,13,1453,1281,0,0,1
3,1.75,1580,9187,1.0,0,0,3,8,1180,400,1993,0,98038,47.3538,-122.047,1620,6397,263000,10,7,2014,0,21,7607,4777,0,1,0
3,2.5,1730,4408,2.0,0,0,3,8,1730,0,1996,0,98029,47.5683,-122.005,1730,4408,445000,10,10,2014,0,18,2678,2678,0,0,0
3,2.0,1910,9001,1.0,0,0,4,7,1910,0,1957,0,98008,47.6037,-122.119,2040,8700,554000,6,4,2015,0,58,7091,6660,0,0,0
2,1.75,1000,5100,1.0,0,0,3,6,940,60,1906,0,98117,47.6787,-122.391,1900,5100,335000,24,7,2014,0,108,4100,3200,0,1,1
4,2.75,2520,6964,1.0,0,0,4,7,1260,1260,1987,0,98031,47.4038,-122.175,1930,6949,307000,29,12,2014,0,27,4444,5019,0,1,0
3,1.0,1420,8160,1.0,0,0,3,7,970,450,1947,0,98125,47.7164,-122.306,1340,8160,404000,2,3,2015,0,68,6740,6820,0,1,1
4,3.5,3080,5250,2.0,0,0,3,9,3080,0,2003,0,98075,47.5992,-121.972,2980,5509,775000,31,7,2014,0,11,2170,2529,0,0,0
3,1.0,1060,9126,1.0,0,2,5,7,1060,0,1956,0,98022,47.201,-121.999,1300,9126,220000,21,5,2014,0,58,8066,7826,0,0,0
4,2.5,2160,9750,2.0,0,0,3,8,2160,0,1983,0,98028,47.7438,-122.246,2840,10535,518000,3,9,2014,0,31,7590,7695,0,0,0
4,3.5,4060,9486,2.0,0,0,3,10,4060,0,2005,0,98033,47.6634,-122.2,2410,9486,1600000,9,12,2014,0,9,5426,7076,0,0,0
1,2.25,1940,2550,2.0,0,0,4,7,1100,840,1979,0,98133,47.7313,-122.343,1580,5100,315000,23,10,2014,0,35,610,3520,0,1,1
4,2.5,2250,11349,2.0,0,0,3,8,2250,0,1991,0,98034,47.7111,-122.239,2110,9964,572650,31,7,2014,0,23,9099,7854,0,0,0
2,1.0,1620,9205,1.0,0,0,5,6,850,770,1921,0,98034,47.7119,-122.23,2460,5469,350000,19,6,2014,0,93,7585,3009,0,1,0
2,1.0,920,5850,1.0,0,0,4,6,920,0,1900,0,98108,47.5441,-122.304,1640,5476,285000,19,9,2014,0,114,4930,3836,0,0,1
3,2.5,1370,7247,2.0,0,0,3,7,1370,0,1995,0,98032,47.3767,-122.303,1720,8085,231000,25,3,2015,0,20,5877,6365,0,0,0
3,1.0,920,5200,1.0,0,0,4,6,920,0,1969,0,98042,47.3603,-122.085,920,5200,179000,13,8,2014,0,45,4280,4280,0,0,0
3,1.5,1360,9625,1.0,0,0,3,7,1360,0,1963,0,98030,47.3799,-122.211,1890,9625,244000,30,3,2015,0,52,8265,7735,0,0,0
3,1.5,1630,11662,1.0,0,0,3,7,1630,0,1943,1963,98188,47.4455,-122.278,1700,11662,185850,6,3,2015,20,72,10032,9962,1,0,1
6,2.5,3610,12033,2.0,0,0,3,8,3210,400,1970,0,98011,47.7692,-122.219,2210,8577,610000,22,12,2014,0,44,8423,6367,0,1,0
4,2.5,3010,9155,2.0,0,0,3,9,3010,0,2005,0,98038,47.3542,-122.027,3010,5762,419000,10,10,2014,0,9,6145,2752,0,0,0
3,1.75,2320,6400,1.0,0,2,4,8,1420,900,1957,0,98199,47.6449,-122.389,2540,7680,779000,26,8,2014,0,57,4080,5140,0,1,1
5,3.0,3290,14134,1.0,0,0,3,7,1870,1420,2004,0,98052,47.6708,-122.14,1970,11470,695000,15,9,2014,0,10,10844,9500,0,1,0
3,2.5,2040,7580,2.0,0,2,3,8,2040,0,1998,0,98092,47.2618,-122.209,1960,7820,319900,20,3,2015,0,17,5540,5860,0,0,0
3,2.75,1920,7700,1.0,0,0,4,8,1320,600,1978,0,98023,47.3213,-122.378,2040,8000,329000,12,1,2015,0,37,5780,5960,0,1,0
3,2.5,2120,4512,2.0,0,0,3,8,2120,0,1988,0,98011,47.75,-122.183,2000,4553,475226,27,8,2014,0,26,2392,2553,0,0,0
3,2.5,2170,5000,2.0,0,0,3,9,2170,0,2003,0,98029,47.5453,-121.996,2170,5000,638000,25,3,2015,0,12,2830,2830,0,0,0
2,1.5,1330,15873,1.0,0,0,3,7,900,430,1984,0,98074,47.6359,-122.033,1610,12043,440000,25,3,2015,0,31,14543,10433,0,1,0
3,2.0,1580,5080,1.0,0,0,4,6,800,780,1942,0,98146,47.4963,-122.35,1580,7114,214000,9,2,2015,0,73,3500,5534,0,1,1
3,2.75,3580,14217,2.0,0,3,4,10,2210,1370,1989,0,98023,47.3244,-122.379,3990,14674,600000,29,4,2015,0,26,10637,10684,0,1,0
4,2.0,2580,4500,2.0,0,0,4,9,1850,730,1905,0,98102,47.6245,-122.316,2590,4100,935000,14,4,2015,0,110,1920,1510,0,1,1
4,1.75,1930,10210,1.5,0,2,3,8,1670,260,1941,0,98125,47.7078,-122.277,2730,6600,630000,27,10,2014,0,73,8280,3870,0,1,1
3,2.5,2120,4780,2.0,0,0,3,7,2120,0,2004,0,98053,47.681,-122.032,1690,2650,575000,30,9,2014,0,10,2660,960,0,0,0
4,1.75,1310,9690,1.0,0,0,4,7,1310,0,1967,0,98011,47.7559,-122.226,2280,9618,323000,16,7,2014,0,47,8380,7338,0,0,0
3,2.5,2670,13218,1.0,0,0,4,10,2670,0,1988,0,98042,47.3683,-122.153,1960,13130,425000,16,5,2014,0,26,10548,11170,0,0,0
4,1.5,1530,9000,1.0,0,0,4,6,1530,0,1976,0,98014,47.6492,-121.908,1520,8500,299800,21,7,2014,0,38,7470,6980,0,0,0
6,1.75,2920,5000,2.5,0,0,4,9,2780,140,1908,0,98122,47.6024,-122.295,2020,5000,823000,5,5,2014,0,106,2080,2980,0,1,1
3,1.0,1010,8108,1.0,0,0,3,7,1010,0,1955,0,98155,47.735,-122.309,1110,8108,200000,8,9,2014,0,59,7098,6998,0,0,1
4,2.5,1820,3899,2.0,0,0,3,7,1820,0,1999,0,98019,47.735,-121.985,1820,3899,359950,28,4,2015,0,16,2079,2079,0,0,0
4,2.5,2090,8325,1.0,0,0,4,7,1470,620,1983,0,98056,47.4888,-122.184,1700,8025,375000,3,2,2015,0,32,6235,6325,0,1,0
4,3.0,2250,7882,2.0,0,0,3,8,1570,680,1986,0,98198,47.3703,-122.314,1550,7508,250000,19,3,2015,0,29,5632,5958,0,1,1
3,2.25,1450,1387,3.0,0,0,3,8,1450,0,2000,0,98115,47.6765,-122.302,1450,1429,497000,23,10,2014,0,14,-63,-21,0,0,1
4,2.5,2280,8798,2.0,0,0,4,8,2280,0,1987,0,98028,47.7471,-122.247,2180,8632,520000,13,8,2014,0,27,6518,6452,0,0,0
4,3.5,2720,6781,2.0,0,0,3,8,2100,620,1999,0,98055,47.4612,-122.215,2280,5942,365000,17,7,2014,0,15,4061,3662,0,1,0
3,2.25,2250,8000,1.0,0,0,3,8,1460,790,1976,0,98034,47.7229,-122.202,1930,9000,459900,8,12,2014,0,38,5750,7070,0,1,0
3,2.0,1090,6090,1.0,0,0,3,7,940,150,1940,0,98118,47.5118,-122.259,1840,6090,158000,6,5,2015,0,75,5000,4250,0,1,1
3,2.0,1970,9600,1.0,0,0,4,7,1300,670,1967,0,98003,47.2824,-122.301,1710,7703,294700,6,6,2014,0,47,7630,5993,0,1,0
3,1.75,2330,12141,1.0,0,0,3,7,1390,940,1983,0,98072,47.7607,-122.146,1850,12141,535000,2,7,2014,0,31,9811,10291,0,1,0
4,4.5,4060,10800,2.0,0,0,3,10,4060,0,2007,0,98188,47.4241,-122.29,1830,9768,530000,24,1,2015,0,8,6740,7938,0,0,1
4,2.0,1470,7000,1.0,0,0,4,8,1470,0,1967,0,98032,47.3742,-122.289,1640,7000,215000,4,2,2015,0,48,5530,5360,0,0,0
2,1.0,1620,5400,1.0,0,0,3,6,920,700,1926,0,98125,47.7069,-122.299,1540,7245,290000,3,2,2015,0,89,3780,5705,0,1,1
5,2.75,3220,5934,2.0,0,0,3,9,3220,0,2006,0,98052,47.7076,-122.101,3100,5934,798000,11,3,2015,0,9,2714,2834,0,0,0
4,2.5,3270,9578,2.0,0,0,3,9,3270,0,1993,0,98027,47.5373,-122.051,3120,8784,785000,7,11,2014,0,21,6308,5664,0,0,0
3,1.75,2160,8565,1.0,0,0,3,8,1730,430,1971,0,98028,47.7664,-122.262,2910,9570,433000,18,3,2015,0,44,6405,6660,0,1,0
2,1.0,1150,6835,1.0,0,1,3,7,1010,140,1922,0,98118,47.5567,-122.273,1150,6561,425000,21,7,2014,0,92,5685,5411,0,1,1
4,2.5,2240,7540,1.0,0,0,3,8,1540,700,1962,0,98115,47.6965,-122.308,1960,7250,654000,24,7,2014,0,52,5300,5290,0,1,1
3,1.5,1280,5065,2.0,0,0,4,6,1280,0,1983,0,98002,47.3343,-122.217,1070,4491,215000,17,10,2014,0,31,3785,3421,0,0,0
3,1.0,840,6540,1.0,0,0,3,6,840,0,1970,2014,98042,47.3743,-122.116,1010,6600,232000,18,3,2015,44,45,5700,5590,1,0,0
3,1.75,1680,10500,1.0,0,0,4,8,1680,0,1959,0,98005,47.6098,-122.169,2250,10400,675000,7,5,2014,0,55,8820,8150,0,0,0
5,2.75,2330,8000,1.0,0,0,4,7,1550,780,1972,0,98052,47.6651,-122.144,1750,8419,665000,4,11,2014,0,42,5670,6669,0,1,0
6,3.0,2880,7560,2.0,0,0,3,7,2880,0,1980,0,98144,47.5959,-122.3,1470,1815,525000,14,8,2014,0,34,4680,345,0,0,1
3,2.75,2910,3094,2.0,0,2,5,7,2010,900,1939,0,98125,47.7071,-122.276,2400,7530,780000,4,5,2015,0,76,184,5130,0,1,1
3,1.5,1310,8100,1.0,0,0,3,7,1310,0,1965,0,98034,47.7328,-122.201,1330,8100,290000,25,8,2014,0,49,6790,6770,0,0,0
2,1.0,1790,15783,1.0,0,0,4,8,1360,430,1959,0,98117,47.691,-122.387,1790,7494,560000,25,3,2015,0,56,13993,5704,0,1,1
3,2.5,2830,6536,2.0,0,0,3,9,2830,0,1989,0,98072,47.7462,-122.172,2710,6954,605500,17,6,2014,0,25,3706,4244,0,0,0
4,2.5,3150,5979,2.0,0,0,3,9,3150,0,2005,0,98052,47.7082,-122.101,3150,6595,762500,26,8,2014,0,9,2829,3445,0,0,0
5,3.25,3930,5500,2.0,0,0,3,9,2910,1020,2014,0,98033,47.6802,-122.208,2040,5115,1740000,5,3,2015,0,1,1570,3075,0,1,0
6,2.75,2840,8346,1.0,0,0,5,8,1420,1420,1961,0,98118,47.5518,-122.266,2250,8346,665000,24,6,2014,0,53,5506,6096,0,1,1
5,1.0,2480,4400,1.5,0,0,3,7,1640,840,1919,0,98122,47.6046,-122.3,1940,4400,540000,11,3,2015,0,96,1920,2460,0,1,1
3,2.5,1930,6180,1.0,0,0,3,7,1330,600,1961,0,98155,47.7481,-122.327,1940,6180,375000,19,11,2014,0,53,4250,4240,0,1,1
3,1.0,1260,6826,1.0,0,0,3,6,720,540,1944,0,98125,47.731,-122.303,1300,6826,342000,16,5,2014,0,70,5566,5526,0,1,1
4,2.5,3160,13063,2.0,0,0,3,10,3160,0,1999,0,98075,47.5996,-122.021,3350,14213,693000,10,12,2014,0,15,9903,10863,0,0,0
4,1.75,1770,12462,1.0,0,2,4,8,1770,0,1962,0,98166,47.4355,-122.338,2310,14810,638500,20,4,2015,0,53,10692,12500,0,0,1
3,1.0,990,8062,1.0,0,0,4,7,990,0,1960,0,98198,47.4151,-122.334,1420,8790,250000,9,7,2014,0,54,7072,7370,0,0,1
3,2.5,1580,4698,2.0,0,0,3,7,1580,0,1998,0,98038,47.3539,-122.025,2070,4698,325000,1,5,2015,0,17,3118,2628,0,0,0
4,1.75,1560,4290,2.0,0,0,3,7,1560,0,1994,0,98108,47.5292,-122.323,1250,6000,270000,1,4,2015,0,21,2730,4750,0,0,1
6,2.5,2640,3680,2.0,0,0,5,8,1760,880,1922,0,98126,47.5771,-122.38,1960,3680,880000,10,7,2014,0,92,1040,1720,0,1,1
2,1.75,2120,6350,1.0,0,0,4,6,1440,680,1924,0,98103,47.6974,-122.356,1590,6350,300000,6,8,2014,0,90,4230,4760,0,1,1
2,1.0,1200,8750,1.0,0,0,3,6,1200,0,1948,0,98155,47.7548,-122.327,1100,8408,290000,15,12,2014,0,66,7550,7308,0,0,1
3,1.0,1460,5825,1.0,0,0,5,5,1260,200,1942,0,98056,47.4958,-122.191,1150,5926,259950,23,1,2015,0,73,4365,4776,0,1,0
4,3.25,4890,13402,2.0,0,0,3,13,4890,0,2004,0,98059,47.5303,-122.131,5790,13539,1780000,10,10,2014,0,10,8512,7749,0,0,0
3,1.0,1580,5250,1.0,0,0,5,7,1580,0,1954,0,98056,47.4964,-122.168,1180,5940,299950,6,11,2014,0,60,3670,4760,0,0,0
3,2.25,2060,8640,1.0,0,0,4,8,2060,0,1966,0,98033,47.6534,-122.195,2030,9000,890000,12,6,2014,0,48,6580,6970,0,0,0
3,2.5,1690,4500,1.5,0,1,4,8,1690,0,1928,0,98116,47.5841,-122.383,2140,7200,719000,8,5,2014,0,86,2810,5060,0,0,1
3,2.5,2330,3995,2.0,0,0,3,9,2330,0,2006,0,98029,47.5542,-122.001,2330,3740,660000,26,3,2015,0,9,1665,1410,0,0,0
4,1.75,1820,8118,1.0,0,0,4,7,1080,740,1980,0,98031,47.4104,-122.172,1810,8050,264000,18,6,2014,0,34,6298,6240,0,1,0
3,1.75,1890,11141,1.0,0,0,4,8,1890,0,1968,0,98006,47.5697,-122.163,2720,11144,575000,8,9,2014,0,46,9251,8424,0,0,0
4,3.5,3020,12750,2.0,0,0,3,10,3020,0,1990,0,98033,47.6524,-122.184,3120,14351,845800,21,11,2014,0,24,9730,11231,0,0,0
3,1.75,1170,8182,1.0,0,0,3,7,1170,0,1962,0,98155,47.7368,-122.298,1610,8183,352500,11,6,2014,0,52,7012,6573,0,0,1
3,1.0,1270,8400,1.0,0,0,3,7,1270,0,1955,0,98011,47.7604,-122.198,1390,8400,347000,23,6,2014,0,59,7130,7010,0,0,0
4,2.75,1950,6192,2.0,0,0,3,8,1950,0,1992,0,98029,47.5698,-121.999,2040,5441,560000,9,1,2015,0,23,4242,3401,0,0,0
4,2.0,2060,6400,1.0,0,0,3,7,1170,890,1977,0,98002,47.2924,-122.197,1890,8736,257500,20,2,2015,0,38,4340,6846,0,1,0
3,1.0,1100,4600,1.0,0,0,3,7,1100,0,1917,0,98116,47.5686,-122.385,1200,5175,450000,28,5,2014,0,97,3500,3975,0,0,1
4,1.0,1140,7208,1.0,0,0,3,7,900,240,1970,0,98072,47.742,-122.173,1300,7991,410000,13,11,2014,0,44,6068,6691,0,1,0
3,1.75,1980,13503,1.0,0,2,4,9,1320,660,1952,0,98008,47.5867,-122.111,2450,10890,810000,13,6,2014,0,62,11523,8440,0,1,0
5,3.0,2480,10090,1.0,0,0,3,7,1300,1180,2004,0,98178,47.4964,-122.263,2290,9900,372500,12,5,2014,0,10,7610,7610,0,1,1
3,1.0,1050,9083,1.0,0,0,3,7,1050,0,1951,0,98155,47.7533,-122.307,1440,9071,325000,3,12,2014,0,63,8033,7631,0,0,1
3,1.0,1260,7660,1.0,0,0,3,6,1260,0,1947,0,98133,47.7476,-122.35,1990,7861,280000,21,10,2014,0,67,6400,5871,0,0,1
4,1.0,1360,5900,1.5,0,0,4,7,1360,0,1949,0,98155,47.7512,-122.318,1050,5900,329950,27,8,2014,0,65,4540,4850,0,0,1
4,2.5,2450,12987,1.0,0,0,4,9,2030,420,1980,0,98007,47.6197,-122.15,2730,13685,836000,12,12,2014,0,34,10537,10955,0,1,0
5,2.5,2260,7040,2.0,0,0,3,8,2260,0,1999,0,98038,47.352,-122.038,2180,6910,365000,9,4,2015,0,16,4780,4730,0,0,0
2,1.0,1060,6000,1.0,0,0,4,5,1060,0,1908,0,98002,47.3066,-122.223,940,6000,111300,11,2,2015,0,107,4940,5060,0,0,0
3,1.75,1610,8613,1.0,0,0,5,7,1610,0,1962,0,98033,47.6527,-122.195,2010,8670,725000,23,6,2014,0,52,7003,6660,0,0,0
4,2.5,3350,6605,2.0,0,0,3,8,2670,680,1990,0,98011,47.7498,-122.181,2730,5962,550000,18,2,2015,0,25,3255,3232,0,1,0
2,1.0,790,7500,1.0,0,0,3,7,790,0,1951,0,98198,47.4007,-122.294,1560,7794,130000,16,4,2015,0,64,6710,6234,0,0,1
2,1.75,1660,4000,1.0,0,0,3,7,990,670,1940,0,98112,47.6394,-122.28,2070,4000,765000,26,9,2014,0,74,2340,1930,0,1,1
3,1.5,1420,7480,1.0,0,0,4,7,1420,0,1963,0,98058,47.4651,-122.184,1720,7700,255000,21,4,2015,0,52,6060,5980,0,0,0
3,1.75,1250,5546,1.0,0,0,4,7,1250,0,1987,0,98055,47.4725,-122.187,1640,4791,268000,8,9,2014,0,27,4296,3151,0,0,0
3,1.75,1700,8534,1.0,0,0,4,7,1700,0,1953,0,98004,47.6276,-122.205,2100,10443,985000,1,4,2015,0,62,6834,8343,0,0,0
4,2.5,2660,8469,2.0,0,0,3,10,2660,0,1994,0,98006,47.5529,-122.12,2920,10697,751305,18,11,2014,0,20,5809,7777,0,0,0
3,1.0,1350,7553,1.5,0,0,3,6,1350,0,1914,0,98118,47.5345,-122.274,1380,7470,280000,23,4,2015,0,101,6203,6090,0,0,1
4,2.0,1810,8750,1.0,0,0,2,7,1110,700,1967,0,98058,47.4307,-122.17,1810,8750,304000,16,6,2014,0,47,6940,6940,0,1,0
4,2.75,2210,13235,2.0,0,0,3,8,1730,480,1988,0,98003,47.3541,-122.303,1750,7542,200000,23,4,2015,0,27,11025,5792,0,1,0
3,2.25,2470,11603,2.0,0,2,3,8,1540,930,1988,0,98052,47.6569,-122.123,2850,11250,736000,24,3,2015,0,27,9133,8400,0,1,0
4,2.5,2700,6515,2.0,0,0,3,9,2700,0,1998,0,98058,47.4356,-122.11,2900,6710,426500,10,7,2014,0,16,3815,3810,0,0,0
2,1.75,1760,4400,1.0,0,0,4,7,880,880,1930,0,98103,47.65,-122.34,1330,4180,640000,20,6,2014,0,84,2640,2850,0,1,1
5,2.0,1930,6120,1.5,0,0,3,6,1930,0,1941,1969,98146,47.5073,-122.337,1130,6120,230000,21,5,2014,28,73,4190,4990,1,0,1
4,1.0,1680,5043,1.5,0,0,4,6,1680,0,1911,0,98118,47.5354,-122.273,1560,5765,366350,24,3,2015,0,104,3363,4205,0,0,1
2,1.0,1390,8336,1.0,0,0,4,6,910,480,1946,0,98166,47.4646,-122.361,1610,7847,365000,6,1,2015,0,69,6946,6237,0,1,1
4,2.25,2240,8322,2.0,0,0,3,8,2240,0,1979,0,98034,47.728,-122.206,2240,6448,482000,25,2,2015,0,36,6082,4208,0,0,0
4,1.0,1980,7991,1.5,0,0,3,7,1980,0,1962,0,98058,47.4604,-122.17,1730,7700,345000,16,5,2014,0,52,6011,5970,0,0,0
3,1.75,1830,5120,1.5,0,2,5,8,1830,0,1903,0,98122,47.6051,-122.311,2120,5120,682000,14,5,2014,0,111,3290,3000,0,0,1
3,1.75,980,6002,1.0,0,0,4,6,980,0,1942,0,98033,47.6643,-122.203,1150,6054,657500,15,8,2014,0,72,5022,4904,0,0,0
6,2.5,3550,6533,2.0,0,0,3,8,3550,0,1925,0,98144,47.5719,-122.284,3140,6234,895000,19,4,2015,0,90,2983,3094,0,0,1
3,1.5,1660,5665,1.0,0,0,5,7,920,740,1918,0,98118,47.5391,-122.274,1530,5665,425000,3,4,2015,0,97,4005,4135,0,1,1
4,2.5,2490,8750,2.0,0,0,3,8,2040,450,1976,0,98008,47.5931,-122.116,2120,10240,532500,6,8,2014,0,38,6260,8120,0,1,0
4,2.5,2329,9436,2.0,0,0,3,9,2329,0,1995,0,98011,47.7366,-122.204,2660,10252,540000,8,10,2014,0,19,7107,7592,0,0,0
3,2.25,1790,9580,2.0,0,0,3,8,1790,0,1984,0,98006,47.5541,-122.162,2060,9995,578000,11,7,2014,0,30,7790,7935,0,0,0
3,3.0,2830,6041,2.0,0,3,3,8,1840,990,1915,0,98118,47.5694,-122.283,3420,6360,1090000,9,2,2015,0,100,3211,2940,0,1,1
3,1.0,1160,9750,1.0,0,0,3,7,1160,0,1968,0,98077,47.7429,-122.072,1160,10565,322500,4,9,2014,0,46,8590,9405,0,0,0
3,1.0,1000,10560,1.0,0,0,3,7,1000,0,1955,0,98003,47.3217,-122.317,1190,9375,140000,15,1,2015,0,60,9560,8185,0,0,0
4,2.0,1870,3497,1.0,0,0,3,7,1200,670,1954,0,98106,47.5309,-122.347,1270,3497,355000,11,3,2015,0,61,1627,2227,0,1,1
4,2.25,2200,6967,2.0,0,0,3,8,2200,0,1986,0,98011,47.7355,-122.202,1970,7439,515000,18,3,2015,0,29,4767,5469,0,0,0
3,1.0,1300,7200,1.0,0,0,4,7,1300,0,1952,0,98146,47.5063,-122.369,1740,7100,309000,28,4,2015,0,63,5900,5360,0,0,1
3,1.0,1160,7875,1.0,0,0,3,7,1160,0,1953,0,98125,47.724,-122.323,1600,7875,285000,6,11,2014,0,61,6715,6275,0,0,1
3,1.75,2100,5000,1.5,0,0,3,8,2100,0,1916,0,98117,47.6776,-122.36,1830,4200,700000,10,11,2014,0,98,2900,2370,0,0,1
3,2.5,1490,8628,2.0,0,0,3,7,1490,0,1994,0,98038,47.3643,-122.041,1640,8514,289000,30,3,2015,0,21,7138,6874,0,0,0
3,1.75,1450,8378,1.0,0,0,4,8,1450,0,1978,0,98023,47.3093,-122.385,1860,8496,230000,18,8,2014,0,36,6928,6636,0,0,0
3,2.5,1930,7120,1.0,0,0,4,7,1420,510,1961,0,98133,47.7715,-122.34,1600,8352,432500,12,8,2014,0,53,5190,6752,0,1,1
3,1.75,1660,10440,1.0,0,0,3,7,1040,620,1978,0,98045,47.4448,-121.77,1240,10380,288000,31,7,2014,0,36,8780,9140,0,1,0
3,1.75,1260,12330,1.0,0,0,3,7,1260,0,1968,0,98072,47.7412,-122.095,1320,12800,354000,1,8,2014,0,46,11070,11480,0,0,0
3,1.0,1170,11000,1.0,0,0,2,6,1170,0,1980,0,98019,47.7346,-121.983,1590,10894,119500,4,6,2014,0,34,9830,9304,0,0,0
3,2.5,1420,2581,3.0,0,0,3,7,1420,0,2004,0,98133,47.7027,-122.357,1420,2509,435000,11,6,2014,0,10,1161,1089,0,0,1
4,1.75,1800,8385,1.0,0,0,5,6,900,900,1950,0,98133,47.7744,-122.338,1770,8385,377000,1,4,2015,0,65,6585,6615,0,1,1
4,2.5,2000,7376,2.0,0,0,3,8,2000,0,1990,0,98029,47.5719,-121.999,1950,5218,602000,20,3,2015,0,25,5376,3268,0,0,0
3,1.75,1660,4800,1.0,0,0,3,7,960,700,1941,1996,98116,47.5734,-122.412,1510,4800,530000,27,10,2014,55,73,3140,3290,1,1,1
4,2.0,1540,3740,1.0,0,0,4,7,770,770,1946,0,98117,47.6886,-122.375,1090,5080,525000,25,3,2015,0,69,2200,3990,0,1,1
2,1.5,1160,1086,2.0,0,0,3,7,890,270,2006,0,98155,47.768,-122.315,1160,1086,250000,10,11,2014,0,8,-74,-74,0,1,1
3,1.0,1700,6356,1.5,0,0,3,7,1700,0,1907,0,98118,47.5677,-122.281,2080,6000,681000,28,5,2014,0,107,4656,3920,0,0,1
3,2.5,2080,3920,2.0,0,0,3,8,2080,0,2010,0,98118,47.5412,-122.286,2110,3710,448500,8,5,2015,0,5,1840,1600,0,0,1
3,2.0,1030,7260,1.0,0,0,3,6,1030,0,1947,0,98146,47.5113,-122.347,1380,8100,260000,22,10,2014,0,67,6230,6720,0,0,1
3,1.75,1770,8050,1.0,0,0,4,7,1020,750,1963,0,98008,47.5862,-122.118,2000,7875,538000,30,10,2014,0,51,6280,5875,0,1,0
3,2.0,1540,7947,1.0,0,0,3,7,1120,420,1961,0,98011,47.7605,-122.217,1910,7950,385500,21,5,2014,0,53,6407,6040,0,1,0
4,2.5,2650,6000,2.0,0,0,3,9,2650,0,2000,0,98038,47.3768,-122.028,2630,6381,428400,5,9,2014,0,14,3350,3751,0,0,0
4,2.75,2690,9240,2.0,0,0,3,8,2690,0,1998,0,98022,47.1896,-122.014,2640,9240,346290,29,7,2014,0,16,6550,6600,0,0,0
4,2.75,2210,8430,2.0,0,0,3,9,2210,0,1999,0,98075,47.5994,-122.017,2460,8069,587000,3,2,2015,0,16,6220,5609,0,0,0
4,2.5,2390,6775,2.0,0,0,3,7,2390,0,2003,0,98056,47.4811,-122.182,2560,6346,355000,20,8,2014,0,11,4385,3786,0,0,0
5,2.75,2580,7865,1.0,0,0,4,8,1480,1100,1964,0,98007,47.6208,-122.139,2140,8400,650000,28,4,2015,0,51,5285,6260,0,1,0
4,2.5,2160,5455,2.0,0,0,3,7,2160,0,2003,0,98056,47.4799,-122.183,2160,5257,340000,30,7,2014,0,11,3295,3097,0,0,0
4,2.5,2230,8624,1.0,0,0,4,8,1430,800,1969,0,98052,47.6623,-122.152,1970,8402,565000,3,7,2014,0,45,6394,6432,0,1,0
4,2.0,2000,5000,1.5,0,0,5,7,2000,0,1925,0,98144,47.5787,-122.293,2200,5000,630000,19,2,2015,0,90,3000,2800,0,0,1
3,1.0,1280,7198,1.0,0,0,5,6,1280,0,1916,1983,98022,47.2094,-121.996,1260,7198,227000,7,11,2014,67,98,5918,5938,1,0,0
4,2.75,2810,17674,1.0,0,0,4,8,1640,1170,1978,0,98052,47.6745,-122.144,2400,11240,600000,29,7,2014,0,36,14864,8840,0,1,0
4,1.75,1680,6758,1.0,0,0,3,8,1680,0,1974,0,98008,47.641,-122.113,1910,7000,540400,2,2,2015,0,41,5078,5090,0,0,0
3,2.5,2150,8060,2.0,0,0,3,8,2150,0,1995,0,98033,47.6952,-122.188,2150,7172,569000,1,10,2014,0,19,5910,5022,0,0,0
3,2.5,2820,8159,2.0,0,0,3,9,2820,0,2004,0,98029,47.5527,-121.992,2910,5000,735000,10,7,2014,0,10,5339,2090,0,0,0
3,2.25,1750,9353,1.0,0,0,3,7,1210,540,1987,0,98034,47.7305,-122.225,1930,8545,434000,16,12,2014,0,27,7603,6615,0,1,0
2,2.0,1060,4000,1.0,0,0,2,7,1000,60,1914,0,98103,47.6626,-122.337,1310,4000,578888,19,3,2015,0,101,2940,2690,0,1,1
4,2.75,2660,7754,1.5,0,0,3,8,1590,1070,1986,0,98023,47.3078,-122.337,2250,7754,280500,22,4,2015,0,29,5094,5504,0,1,0
2,2.0,1670,3507,1.0,0,0,3,9,1670,0,2007,0,98029,47.5545,-122.003,2330,3889,539950,5,2,2015,0,8,1837,1559,0,0,0
3,2.5,1790,6191,2.0,0,0,3,8,1790,0,1992,0,98031,47.4102,-122.195,1790,6758,250000,11,11,2014,0,22,4401,4968,0,0,0
3,2.5,1940,8547,1.0,0,0,3,7,1460,480,1989,0,98030,47.3491,-122.177,1750,7803,266000,8,5,2014,0,25,6607,6053,0,1,0
3,2.0,1390,7200,1.0,0,0,3,7,1390,0,1996,0,98058,47.434,-122.154,1630,7340,258000,22,7,2014,0,18,5810,5710,0,0,0
3,2.25,1264,1536,2.0,0,0,3,8,1264,0,2003,0,98105,47.6694,-122.279,1264,2067,530000,6,8,2014,0,11,272,803,0,0,1
2,1.0,1095,5120,1.5,0,0,3,7,1095,0,1901,0,98122,47.6058,-122.313,1310,5120,302282,22,7,2014,0,113,4025,3810,0,0,1
2,1.0,850,6213,1.0,0,0,3,6,750,100,1916,0,98136,47.5282,-122.384,1880,5500,370000,11,3,2015,0,99,5363,3620,0,1,1
4,2.0,1760,5307,1.5,0,0,4,7,1170,590,1948,0,98105,47.6714,-122.28,1850,6600,625000,13,10,2014,0,66,3547,4750,0,1,1
1,1.0,690,6825,1.0,0,0,4,5,690,0,1917,0,98002,47.3109,-122.225,1330,5381,142500,9,4,2015,0,98,6135,4051,0,0,0
3,1.75,1400,7405,1.0,0,0,3,7,1400,0,1961,0,98133,47.7569,-122.334,1820,7440,334000,21,1,2015,0,54,6005,5620,0,0,1
5,3.0,1810,3000,2.0,0,0,3,7,1810,0,1998,0,98118,47.5622,-122.291,1670,3000,362000,8,7,2014,0,16,1190,1330,0,0,1
2,1.0,1310,4000,1.0,0,0,3,7,950,360,1942,0,98144,47.5798,-122.306,1310,4000,181000,17,4,2015,0,73,2690,2690,0,1,1
3,1.0,1400,10425,1.0,0,0,4,7,1400,0,1968,0,98003,47.2738,-122.301,1440,10425,241500,31,12,2014,0,46,9025,8985,0,0,0
3,1.75,2350,12720,1.0,0,0,4,7,1180,1170,1964,0,98030,47.3594,-122.175,1680,10400,245000,4,2,2015,0,51,10370,8720,0,1,0
3,1.0,1150,8848,1.0,0,0,3,7,1150,0,1968,0,98042,47.3626,-122.111,1220,9576,227500,6,5,2015,0,47,7698,8356,0,0,0
5,1.5,1710,8100,1.5,0,0,4,7,1710,0,1961,0,98032,47.3839,-122.288,1480,8025,158550,3,10,2014,0,53,6390,6545,0,0,0
3,2.25,1660,10247,1.0,0,0,5,7,1130,530,1968,0,98034,47.7262,-122.222,1680,7637,450000,25,9,2014,0,46,8587,5957,0,1,0
3,1.75,1950,10080,1.0,0,0,4,7,1950,0,1967,0,98034,47.7282,-122.186,2340,8800,485000,4,2,2015,0,48,8130,6460,0,0,0
4,1.75,1780,9794,1.0,0,0,3,7,1780,0,1967,0,98077,47.7419,-122.073,1160,9750,353000,6,11,2014,0,47,8014,8590,0,0,0
4,3.0,2450,4668,2.0,0,0,3,8,2450,0,2004,0,98028,47.7721,-122.235,2460,4895,500000,6,4,2015,0,11,2218,2435,0,0,0
1,2.25,2060,10600,1.5,0,0,3,7,1560,500,1927,1983,98003,47.3291,-122.304,2060,11880,360000,8,9,2014,56,87,8540,9820,1,1,0
3,1.5,1540,11858,1.0,0,0,4,7,1540,0,1966,0,98059,47.4755,-122.157,1550,11473,357500,23,2,2015,0,49,10318,9923,0,0,0
3,2.5,1650,13816,2.0,0,0,3,7,1650,0,1998,0,98014,47.6553,-121.912,1650,15144,272000,6,5,2014,0,16,12166,13494,0,0,0
3,1.0,1160,7854,1.0,0,0,3,7,1160,0,1960,0,98125,47.7304,-122.308,1300,8317,422000,28,4,2015,0,55,6694,7017,0,0,1
2,2.0,1440,15000,1.0,0,0,3,7,1440,0,1985,0,98072,47.7648,-122.159,1780,15000,365000,17,9,2014,0,29,13560,13220,0,0,0
2,1.0,1060,6504,1.0,0,0,3,6,1060,0,1950,0,98155,47.7412,-122.327,1100,7200,275053,22,9,2014,0,64,5444,6100,0,0,1
3,2.75,2620,17919,1.0,0,1,4,9,2620,0,1949,0,98039,47.6144,-122.228,3400,14400,1880000,6,11,2014,0,65,15299,11000,0,0,0
3,1.75,1630,9000,1.0,0,0,3,7,960,670,1955,0,98004,47.6023,-122.205,1880,9000,725000,11,3,2015,0,60,7370,7120,0,1,0
3,1.75,1840,9697,1.0,0,0,4,7,1500,340,1985,0,98030,47.3764,-122.179,1430,8079,235000,12,6,2014,0,29,7857,6649,0,1,0
2,1.0,820,4206,1.0,0,0,3,5,820,0,1949,0,98125,47.7076,-122.284,1810,7200,510000,11,12,2014,0,65,3386,5390,0,0,1
2,1.0,820,4206,1.0,0,0,3,5,820,0,1949,0,98125,47.7076,-122.284,1810,7200,489950,8,4,2015,0,66,3386,5390,0,0,1
3,2.5,2010,4195,2.0,0,0,3,8,2010,0,1998,0,98034,47.732,-122.197,2010,5779,463000,30,7,2014,0,16,2185,3769,0,0,0
4,2.25,1990,5948,2.0,0,0,3,8,1990,0,1991,0,98029,47.5712,-121.995,2150,6459,536000,17,6,2014,0,23,3958,4309,0,0,0
4,2.5,2990,6145,2.0,0,0,3,8,2990,0,2003,0,98003,47.2612,-122.294,2590,6512,375000,21,10,2014,0,11,3155,3922,0,0,0
4,2.5,2540,4727,2.0,0,0,3,9,2540,0,1999,0,98034,47.7034,-122.236,3640,5129,630000,8,9,2014,0,15,2187,1489,0,0,0
3,2.25,1640,14374,1.0,0,0,4,7,1140,500,1963,0,98148,47.4476,-122.332,2020,10500,362000,6,5,2014,0,51,12734,8480,0,1,1
4,2.75,2500,11659,1.0,0,2,3,9,1490,1010,1979,0,98003,47.3381,-122.332,2830,9915,350000,4,2,2015,0,36,9159,7085,0,1,0
4,3.5,4020,13515,2.0,0,0,3,11,4020,0,2001,0,98004,47.6462,-122.212,3930,13515,1690000,3,10,2014,0,13,9495,9585,0,0,0
3,2.0,1500,8775,1.0,0,0,3,6,1390,110,1943,0,98166,47.4809,-122.335,1310,8775,255000,24,2,2015,0,72,7275,7465,0,1,1
4,2.5,1594,7665,1.0,0,0,5,7,1088,506,1975,0,98002,47.3262,-122.211,1536,6000,269000,6,8,2014,0,39,6071,4464,0,1,0
4,3.0,2130,4838,1.5,0,0,4,7,2130,0,1930,0,98055,47.4871,-122.203,1070,4838,370000,25,8,2014,0,84,2708,3768,0,0,0
3,1.0,1130,7920,1.0,0,0,3,7,1130,0,1961,0,98059,47.4852,-122.125,1390,8580,270000,1,5,2015,0,54,6790,7190,0,0,0
3,2.0,1690,9516,1.0,0,0,3,7,1690,0,1997,0,98022,47.2132,-122.001,1850,9516,265000,24,2,2015,0,18,7826,7666,0,0,0
2,1.0,1440,4046,1.0,0,0,3,7,960,480,1946,0,98117,47.6901,-122.382,1400,4046,487000,29,4,2015,0,69,2606,2646,0,1,1
4,3.25,3270,6027,2.0,0,0,3,10,3270,0,2001,0,98074,47.6346,-122.063,3270,6546,835000,4,8,2014,0,13,2757,3276,0,0,0
4,2.75,1610,11201,1.0,0,0,5,7,1020,590,1982,0,98033,47.7024,-122.198,1610,9000,575000,1,12,2014,0,32,9591,7390,0,1,0
3,1.0,950,8000,1.0,0,0,3,7,950,0,1968,0,98034,47.7193,-122.184,2270,8540,335000,12,7,2014,0,46,7050,6270,0,0,0
3,1.0,1010,7200,1.0,0,0,5,6,1010,0,1948,0,98155,47.7601,-122.307,1590,7663,318000,8,8,2014,0,66,6190,6073,0,0,1
3,2.0,1420,11325,1.0,0,0,3,7,1420,0,1980,0,98027,47.5356,-122.046,2330,3474,510000,9,4,2015,0,35,9905,1144,0,0,0
3,1.5,1200,9720,1.0,0,0,4,7,1200,0,1965,0,98042,47.4225,-122.153,1380,10284,242500,2,5,2014,0,49,8520,8904,0,0,0
5,2.25,2020,8400,1.0,0,0,4,7,1010,1010,1963,0,98040,47.5763,-122.219,1890,9233,750000,4,12,2014,0,51,6380,7343,0,1,0
5,3.5,3390,7950,2.0,0,2,3,7,3390,0,2003,0,98056,47.4792,-122.181,2580,6900,439900,21,7,2014,0,11,4560,4320,0,0,0
2,1.0,1700,3040,1.5,0,0,3,8,1460,240,1914,0,98119,47.6442,-122.369,1620,3230,710000,7,4,2015,0,101,1340,1610,0,1,1
5,3.25,3410,9088,2.0,0,3,3,9,2760,650,1912,0,98119,47.6285,-122.361,3540,7100,2400000,4,6,2014,0,102,5678,3560,0,1,1
3,1.75,2030,13700,1.0,0,0,3,8,1630,400,1976,0,98011,47.7726,-122.197,2120,11200,435000,15,12,2014,0,38,11670,9080,0,1,0
4,2.75,2860,6867,1.0,0,1,5,7,1560,1300,1946,0,98115,47.6723,-122.263,2290,5350,874000,26,12,2014,0,68,4007,3060,0,1,1
4,1.75,1690,4080,1.0,0,0,4,7,870,820,1984,0,98144,47.572,-122.289,1320,4080,385000,16,6,2014,0,30,2390,2760,0,1,1
2,1.0,760,4746,1.0,0,0,3,5,760,0,1930,0,98055,47.4836,-122.214,1360,7810,110000,30,10,2014,0,84,3986,6450,0,0,0
3,1.75,1780,8085,1.0,0,0,3,7,1210,570,1976,0,98011,47.7357,-122.197,1780,8085,477000,20,6,2014,0,38,6305,6305,0,1,0
3,2.0,1550,6394,1.5,0,0,5,8,1550,0,1918,0,98126,47.5222,-122.379,1440,6387,500000,12,9,2014,0,96,4844,4947,0,0,1
4,2.5,4090,11225,2.0,0,0,3,10,4090,0,2005,0,98075,47.581,-121.971,3510,8762,885000,28,8,2014,0,9,7135,5252,0,0,0
2,1.0,880,5600,1.0,0,0,5,7,880,0,1955,0,98178,47.5071,-122.265,1240,7015,235000,27,8,2014,0,59,4720,5775,0,0,1
3,2.75,1320,15236,1.0,0,0,3,7,880,440,1995,0,98030,47.365,-122.184,1490,8351,210000,4,5,2015,0,20,13916,6861,0,1,0
2,1.0,950,4000,1.0,0,0,3,6,950,0,1910,0,98144,47.5728,-122.312,1480,4000,320000,20,4,2015,0,105,3050,2520,0,0,1
3,1.75,1390,7904,1.0,0,0,3,7,1390,0,1985,0,98056,47.4892,-122.181,1910,7904,406000,13,3,2015,0,30,6514,5994,0,0,0
3,1.75,1900,10225,1.0,0,0,4,8,1220,680,1963,0,98166,47.4781,-122.357,1850,12630,350000,28,10,2014,0,51,8325,10780,0,1,1
4,2.5,3340,8930,2.0,0,2,3,10,3340,0,1999,0,98065,47.535,-121.867,3160,7865,720000,10,7,2014,0,15,5590,4705,0,0,0
3,1.0,1400,5662,1.5,0,0,5,5,1400,0,1920,0,98027,47.5271,-122.036,1250,14375,343000,25,9,2014,0,94,4262,13125,0,0,0
3,2.25,2220,15757,1.0,0,0,3,8,1280,940,1982,0,98074,47.6212,-122.043,2020,14098,558000,9,12,2014,0,32,13537,12078,0,1,0
4,1.0,1210,7740,1.5,0,0,3,7,1210,0,1922,0,98126,47.5216,-122.374,1100,7740,364000,17,4,2015,0,93,6530,6640,0,0,1
3,1.75,2390,11242,1.0,0,0,3,7,1290,1100,1959,0,98155,47.7759,-122.272,2270,9650,420000,28,10,2014,0,55,8852,7380,0,1,1
5,2.0,1870,7344,1.5,0,0,3,7,1870,0,1960,0,98007,47.5951,-122.144,1870,7650,450000,15,5,2015,0,55,5474,5780,0,0,0
2,1.5,940,5000,1.0,0,0,4,7,810,130,1925,0,98126,47.5375,-122.374,940,5026,392000,13,8,2014,0,89,4060,4086,0,1,1
4,1.0,1120,2685,1.0,0,0,3,5,860,260,1939,0,98055,47.4904,-122.203,1120,4838,100000,10,6,2014,0,75,1565,3718,0,1,0
3,2.5,1250,1103,3.0,0,2,3,8,1250,0,2005,0,98103,47.6619,-122.352,1250,1188,480000,12,6,2014,0,9,-147,-62,0,0,1
3,1.5,1060,9225,1.0,0,0,4,7,1060,0,1955,0,98003,47.3217,-122.318,1270,9375,212000,27,8,2014,0,59,8165,8105,0,0,0
5,2.5,2410,8960,1.0,0,0,5,7,1600,810,1978,0,98011,47.7372,-122.2,2410,11514,560000,3,12,2014,0,36,6550,9104,0,1,0
5,2.75,2844,3990,2.0,0,0,3,8,2844,0,2013,0,98092,47.3259,-122.167,2273,3900,359950,28,4,2015,0,2,1146,1627,0,0,0
5,4.0,3460,5400,2.0,0,0,3,10,2830,630,2012,0,98056,47.5201,-122.204,1890,5400,980000,10,4,2015,0,3,1940,3510,0,1,0
2,1.0,1580,2199,2.0,0,2,3,8,1580,0,1921,1995,98103,47.6541,-122.329,2170,4405,720000,13,11,2014,74,93,619,2235,1,0,1
2,1.0,1520,5400,1.0,0,0,3,7,920,600,1951,0,98115,47.6796,-122.279,1600,5400,619950,29,9,2014,0,63,3880,3800,0,1,1
4,2.0,1800,2970,1.0,0,0,4,7,1000,800,1923,0,98115,47.6833,-122.312,1690,3801,415000,16,6,2014,0,91,1170,2111,0,1,1
4,2.5,2650,11108,2.0,0,0,3,10,2650,0,1987,0,98074,47.6304,-122.051,2650,11585,672500,15,4,2015,0,28,8458,8935,0,0,0
3,1.0,1000,4171,1.0,0,0,3,7,1000,0,1985,0,98052,47.6834,-122.097,1090,3479,352500,17,10,2014,0,29,3171,2389,0,0,0
4,2.0,2300,8400,1.0,0,0,4,6,1150,1150,1962,0,98003,47.3282,-122.332,1230,8400,258750,3,9,2014,0,52,6100,7170,0,1,0
3,1.0,1080,7000,1.0,0,0,4,6,1080,0,1916,0,98133,47.7637,-122.351,1410,7214,350000,23,2,2015,0,99,5920,5804,0,0,1
3,1.0,902,10464,1.0,0,0,3,7,902,0,1965,0,98198,47.363,-122.308,1510,7210,152000,29,7,2014,0,49,9562,5700,0,0,1
2,1.0,730,7528,1.0,0,0,3,7,730,0,1946,0,98115,47.6997,-122.305,1620,7528,378500,9,6,2014,0,68,6798,5908,0,0,1
3,1.5,1570,6700,1.0,0,0,4,7,1570,0,1956,0,98007,47.6022,-122.134,1570,7300,419000,2,5,2014,0,58,5130,5730,0,0,0
5,3.0,2876,13927,1.0,0,2,4,9,1970,906,1973,0,98040,47.5528,-122.229,3500,14454,895000,21,5,2014,0,41,11051,10954,0,1,0
4,2.25,2290,9546,1.0,0,0,4,8,1780,510,1976,0,98006,47.5617,-122.13,2360,8864,668500,26,9,2014,0,38,7256,6504,0,1,0
2,2.5,1470,2533,2.0,0,0,3,8,1470,0,2005,0,98033,47.6874,-122.165,1470,6511,487000,21,8,2014,0,9,1063,5041,0,0,0
3,3.5,2620,10137,2.0,0,0,3,8,1970,650,1992,0,98146,47.4979,-122.371,1960,7680,538000,2,12,2014,0,22,7517,5720,0,1,1
4,2.0,2020,7767,1.0,0,0,3,8,2020,0,1995,0,98003,47.3391,-122.309,1940,8239,315000,24,9,2014,0,19,5747,6299,0,0,0
3,2.5,2100,4440,2.0,0,4,3,7,2100,0,1945,0,98116,47.5865,-122.397,2100,6000,800000,28,4,2015,0,70,2340,3900,0,0,1
3,1.75,1510,8250,1.0,0,0,4,8,1510,0,1962,0,98008,47.6183,-122.113,1770,8250,516130,14,7,2014,0,52,6740,6480,0,0,0
4,2.5,4280,12796,2.0,0,0,3,11,3400,880,1999,0,98006,47.5588,-122.124,3520,9593,1200000,27,4,2015,0,16,8516,6073,0,1,0
4,2.5,3238,9112,1.0,0,2,4,8,1678,1560,1979,0,98198,47.4005,-122.311,3056,9668,355425,12,3,2015,0,36,5874,6612,0,1,1
3,2.5,2740,5925,2.0,0,2,3,10,2740,0,1913,1992,98112,47.6313,-122.303,2740,5948,1160000,24,6,2014,79,101,3185,3208,1,0,1
4,2.5,2020,9600,2.0,0,0,4,7,2020,0,1954,0,98136,47.5434,-122.395,2250,8550,689000,26,9,2014,0,60,7580,6300,0,0,1
3,3.25,1520,1500,3.0,0,0,3,7,1520,0,2000,0,98107,47.67,-122.389,1520,1323,500000,13,1,2015,0,15,-20,-197,0,0,1
4,2.25,1600,15312,1.0,0,0,4,7,1080,520,1979,0,98045,47.4629,-121.743,1620,12375,299500,21,11,2014,0,35,13712,10755,0,1,0
4,2.5,2090,5289,2.0,0,0,3,8,2090,0,1989,0,98058,47.4289,-122.164,2080,7109,349950,24,6,2014,0,25,3199,5029,0,0,0
5,3.25,4020,4500,2.0,0,0,3,9,3120,900,2010,0,98004,47.6349,-122.204,3550,5775,1420000,28,10,2014,0,4,480,2225,0,1,0
4,2.25,2910,10189,2.0,0,0,3,9,2910,0,1988,0,98006,47.5465,-122.155,2780,10125,998000,16,12,2014,0,26,7279,7345,0,0,0
3,1.0,900,9600,1.0,0,0,4,7,900,0,1970,0,98072,47.7423,-122.173,1220,8240,329000,5,5,2015,0,45,8700,7020,0,0,0
3,1.75,1720,5956,2.0,0,0,3,8,1720,0,1981,0,98033,47.6875,-122.202,1620,9324,575000,9,10,2014,0,33,4236,7704,0,0,0
5,2.25,3030,9430,2.0,0,0,4,8,2600,430,1961,0,98133,47.7515,-122.353,2230,8425,529900,2,10,2014,0,53,6400,6195,0,1,1
4,2.5,3030,10189,1.0,0,0,3,9,2380,650,2003,0,98004,47.6367,-122.206,1940,10189,1470000,20,11,2014,0,11,7159,8249,0,1,0
4,1.75,2190,9400,1.0,0,0,4,7,1450,740,1962,0,98033,47.6531,-122.196,1980,9000,725000,1,8,2014,0,52,7210,7020,0,1,0
3,2.5,1680,5000,2.0,0,0,3,8,1680,0,1987,0,98023,47.3196,-122.395,1720,5000,286000,23,10,2014,0,27,3320,3280,0,0,0
3,2.0,1210,9926,1.0,0,0,4,7,1210,0,1954,2015,98006,47.5731,-122.135,1690,9737,335000,5,3,2015,61,61,8716,8047,1,0,0
3,1.5,1120,7000,1.0,0,0,3,7,1120,0,1955,0,98007,47.5987,-122.146,1470,7950,395300,15,5,2014,0,59,5880,6480,0,0,0
4,2.75,3180,13348,2.0,0,0,3,8,3020,160,2004,0,98019,47.7439,-121.977,3020,10029,510000,15,7,2014,0,10,10168,7009,0,1,0
3,1.0,920,7500,1.0,0,0,4,7,920,0,1970,0,98032,47.3791,-122.289,1660,8000,203000,6,2,2015,0,45,6580,6340,0,0,0
2,1.0,700,8301,1.0,0,0,3,6,700,0,1953,0,98155,47.7712,-122.323,1250,8304,248000,4,12,2014,0,61,7601,7054,0,0,1
3,2.25,2540,7216,2.0,0,0,3,8,2540,0,1991,0,98023,47.2906,-122.349,2140,7531,265000,27,1,2015,0,24,4676,5391,0,0,0
4,1.5,2100,4560,1.5,0,0,4,8,2100,0,1912,0,98103,47.6497,-122.336,1930,4560,1000000,4,5,2015,0,103,2460,2630,0,0,1
3,2.0,1420,9828,1.0,0,0,4,7,1420,0,1990,0,98010,47.3287,-122.011,1550,7227,241400,6,4,2015,0,25,8408,5677,0,0,0
4,1.75,1450,10074,1.0,0,0,4,7,1450,0,1966,0,98058,47.4546,-122.182,1340,8023,309950,12,3,2015,0,49,8624,6683,0,0,0
3,1.75,1550,4057,1.0,0,0,3,6,830,720,1945,0,98106,47.5291,-122.351,1100,4116,294010,26,8,2014,0,69,2507,3016,0,1,1
3,2.25,1920,9672,2.0,0,0,4,8,1920,0,1984,0,98074,47.6233,-122.046,1950,10125,345000,16,12,2014,0,30,7752,8175,0,0,0
3,2.25,1920,9672,2.0,0,0,4,8,1920,0,1984,0,98074,47.6233,-122.046,1950,10125,625000,4,5,2015,0,31,7752,8175,0,0,0
4,2.5,2510,4543,2.0,0,0,3,8,2510,0,2002,0,98075,47.5962,-122.039,2550,4675,660000,9,7,2014,0,12,2033,2125,0,0,0
2,2.0,1660,4500,1.0,0,0,3,8,1660,0,2003,0,98053,47.7094,-122.031,1670,5580,559000,17,3,2015,0,12,2840,3910,0,0,0
4,3.25,3990,9786,2.0,0,0,3,9,3990,0,2004,0,98053,47.6784,-122.026,3920,8200,866000,7,7,2014,0,10,5796,4280,0,0,0
3,2.0,2350,5700,1.5,0,0,4,8,1810,540,1939,0,98112,47.639,-122.31,2170,6000,770000,5,5,2014,0,75,3350,3830,0,1,1
3,1.5,1350,7827,1.0,0,0,4,7,1350,0,1968,0,98030,47.3786,-122.219,1900,7827,259950,15,8,2014,0,46,6477,5927,0,0,0
5,2.75,2980,9838,1.0,0,0,3,7,1710,1270,1968,0,98030,47.3807,-122.222,2240,9838,352000,11,3,2015,0,47,6858,7598,0,1,0
5,4.75,6390,13180,2.0,0,0,3,10,4560,1830,1940,0,98112,47.6312,-122.291,4010,8137,2470000,24,6,2014,0,74,6790,4127,0,1,1
3,2.0,1590,10229,1.0,0,0,3,7,1590,0,1966,0,98034,47.7239,-122.227,1320,10222,395000,6,11,2014,0,48,8639,8902,0,0,0
4,1.75,1400,6650,1.5,0,0,4,6,1400,0,1942,0,98168,47.4888,-122.332,1120,8645,276500,16,3,2015,0,73,5250,7525,0,0,1
4,3.25,3500,10260,2.0,0,0,3,10,3500,0,1987,0,98008,47.5902,-122.13,3500,10658,798000,24,7,2014,0,27,6760,7158,0,0,0
2,2.0,1370,5756,1.0,0,0,3,8,1370,0,1986,0,98034,47.714,-122.205,1380,5444,380000,13,8,2014,0,28,4386,4064,0,0,0
4,2.5,2810,10433,2.0,0,0,3,8,2810,0,2001,0,98022,47.1895,-122.015,2640,9240,350000,19,8,2014,0,13,7623,6600,0,0,0
3,2.5,2220,6049,2.0,0,0,4,8,2220,0,1990,0,98031,47.3972,-122.182,1980,7226,325000,14,5,2014,0,24,3829,5246,0,0,0
3,2.5,2110,4549,2.0,0,0,4,8,2110,0,1989,0,98042,47.3885,-122.154,2110,4030,336000,2,4,2015,0,26,2439,1920,0,0,0
5,2.25,1780,7245,1.0,0,0,4,8,1330,450,1976,0,98052,47.6946,-122.12,1780,7653,472000,30,9,2014,0,38,5465,5873,0,1,0
3,1.75,1410,8100,2.0,0,0,3,7,1410,0,1985,0,98038,47.3617,-122.046,1560,8100,263000,30,6,2014,0,29,6690,6540,0,0,0
3,3.0,2110,4000,1.0,0,2,4,7,1110,1000,1965,0,98126,47.5696,-122.375,1730,4000,565000,16,7,2014,0,49,1890,2270,0,1,1
3,2.5,2700,8444,2.0,0,0,3,10,2700,0,1992,0,98006,47.5597,-122.113,2840,9165,765000,8,10,2014,0,22,5744,6325,0,0,0
3,2.25,2610,9409,1.0,1,4,4,8,2610,0,1963,0,98075,47.5789,-122.076,2970,9156,1520000,11,8,2014,0,51,6799,6186,0,0,0
3,2.0,1660,8174,1.0,0,0,3,7,830,830,1981,0,98034,47.7103,-122.199,1610,9318,405000,23,12,2014,0,33,6514,7708,0,1,0
3,2.5,1610,3516,2.0,0,0,3,8,1610,0,2006,0,98055,47.4491,-122.188,1610,3056,305000,27,4,2015,0,9,1906,1446,0,0,0
3,2.25,1740,9370,1.0,0,0,3,7,1390,350,1992,0,98198,47.391,-122.316,1740,7555,289950,1,9,2014,0,22,7630,5815,0,1,1
3,1.0,840,12091,1.0,0,0,3,6,840,0,1959,0,98023,47.3281,-122.343,840,9324,96500,29,10,2014,0,55,11251,8484,0,0,0
3,1.0,840,12091,1.0,0,0,3,6,840,0,1959,0,98023,47.3281,-122.343,840,9324,185000,25,2,2015,0,56,11251,8484,0,0,0
4,1.0,1470,6061,1.5,0,0,3,7,1470,0,1945,0,98168,47.4819,-122.289,1230,6175,150550,27,8,2014,0,69,4591,4945,0,0,1
4,2.0,2470,5080,1.5,0,0,3,6,1970,500,1948,1988,98106,47.5308,-122.348,1060,5080,339000,24,6,2014,40,66,2610,4020,1,1,1
4,1.75,2220,7230,1.0,0,1,3,8,1280,940,1950,0,98125,47.7065,-122.279,2210,7230,675000,2,2,2015,0,65,5010,5020,0,1,1
3,1.75,1720,4080,1.0,0,0,4,7,960,760,1924,0,98144,47.5747,-122.287,1660,4080,615000,24,6,2014,0,90,2360,2420,0,1,1
4,2.5,2700,9320,2.0,0,0,4,8,2700,0,1994,0,98033,47.6861,-122.198,2120,8056,837500,4,6,2014,0,20,6620,5936,0,0,0
2,1.0,950,11835,1.0,0,0,3,5,950,0,1932,0,98028,47.7494,-122.237,1690,12586,250000,19,8,2014,0,82,10885,10896,0,0,0
3,2.5,1790,8144,2.0,0,0,3,8,1790,0,1989,0,98074,47.6169,-122.045,1800,7503,583000,25,6,2014,0,25,6354,5703,0,0,0
3,2.5,1610,1728,3.0,0,0,3,8,1610,0,2000,0,98115,47.6776,-122.318,1540,3090,499000,4,9,2014,0,14,118,1550,0,0,1
3,2.5,2290,6328,2.0,0,0,3,8,2290,0,2001,0,98146,47.5103,-122.382,1600,6180,550000,16,7,2014,0,13,4038,4580,0,0,1
3,2.5,2100,4097,2.0,0,0,3,9,2100,0,2008,0,98004,47.5983,-122.2,1820,4764,990400,19,2,2015,0,7,1997,2944,0,0,0
2,1.0,1120,6236,1.0,0,0,4,6,1120,0,1954,0,98155,47.763,-122.291,1340,7784,325000,12,2,2015,0,61,5116,6444,0,0,1
3,2.5,1530,6000,2.0,0,0,4,7,1530,0,1991,0,98038,47.3487,-122.036,1360,6000,265000,10,7,2014,0,23,4470,4640,0,0,0
3,2.5,3490,9362,1.0,0,3,5,9,1770,1720,1960,0,98105,47.6605,-122.27,3640,7425,1620000,8,1,2015,0,55,5872,3785,0,1,1
3,1.5,1180,8353,1.0,0,0,3,7,1180,0,1960,0,98155,47.7652,-122.274,1710,8748,347500,9,3,2015,0,55,7173,7038,0,0,1
5,2.0,2050,3000,1.5,0,0,3,7,1470,580,1912,1984,98103,47.6864,-122.352,1560,4500,629000,9,1,2015,72,103,950,2940,1,1,1
2,2.0,2360,11340,1.5,0,0,3,9,2360,0,1997,0,98040,47.5835,-122.227,3030,11340,1090000,8,7,2014,0,17,8980,8310,0,0,0
4,2.5,2570,7859,2.0,0,0,3,8,2570,0,1992,0,98038,47.3736,-122.045,2150,7284,397500,30,6,2014,0,22,5289,5134,0,0,0
2,1.0,1270,3700,1.5,0,0,3,7,1270,0,1909,0,98144,47.5949,-122.307,1980,3200,404500,30,10,2014,0,105,2430,1220,0,0,1
3,1.5,1250,7500,1.0,0,0,3,7,1250,0,1967,0,98030,47.3719,-122.215,1260,7563,225000,13,5,2014,0,47,6250,6303,0,0,0
3,2.25,2510,9900,1.0,0,0,3,8,1610,900,1978,0,98023,47.2988,-122.374,1940,8510,267000,13,5,2015,0,37,7390,6570,0,1,0
4,3.75,2690,4000,2.0,0,3,4,9,2120,570,1909,1989,98119,47.6418,-122.372,2830,4000,800000,11,6,2014,80,105,1310,1170,1,1,1
4,2.5,2900,6918,2.0,0,0,3,8,2900,0,2001,0,98001,47.3504,-122.284,2720,10376,339000,10,2,2015,0,14,4018,7656,0,0,0
4,2.5,3830,11972,1.0,1,4,3,11,2370,1460,1981,0,98155,47.7404,-122.284,3080,12297,1850000,15,4,2015,0,34,8142,9217,0,1,1
5,1.0,1280,3876,1.5,0,0,3,7,1280,0,1923,0,98105,47.6605,-122.324,1420,3825,525000,30,9,2014,0,91,2596,2405,0,0,1
5,3.5,4350,6218,2.0,0,2,3,10,3520,830,2007,0,98027,47.5396,-121.997,3260,5989,1150000,6,10,2014,0,7,1868,2729,0,1,0
1,1.0,1370,6250,1.5,0,0,4,7,1370,0,1921,0,98136,47.5571,-122.385,1450,6250,565000,23,12,2014,0,93,4880,4800,0,0,1
2,2.25,1230,1280,2.0,0,0,3,8,960,270,2012,0,98144,47.5942,-122.298,1130,1357,387000,20,5,2014,0,2,50,227,0,1,1
4,3.5,4410,12426,2.0,0,2,3,12,3420,990,1996,0,98006,47.5518,-122.107,4090,12127,1500000,11,7,2014,0,18,8016,8037,0,1,0
2,1.0,910,7617,1.0,0,0,3,6,910,0,1936,0,98125,47.7332,-122.305,1310,6624,235000,26,8,2014,0,78,6707,5314,0,0,1
2,1.0,910,7617,1.0,0,0,3,6,910,0,1936,0,98125,47.7332,-122.305,1310,6624,365000,16,1,2015,0,79,6707,5314,0,0,1
3,2.5,2150,7484,2.0,0,0,3,8,2150,0,1988,0,98074,47.6191,-122.043,2150,6879,368250,21,5,2014,0,26,5334,4729,0,0,0
3,2.5,2150,7484,2.0,0,0,3,8,2150,0,1988,0,98074,47.6191,-122.043,2150,6879,580000,13,11,2014,0,26,5334,4729,0,0,0
4,3.25,3190,11774,2.0,1,4,3,8,2610,580,1956,1991,98178,47.5033,-122.225,2240,8725,1100000,17,7,2014,35,58,8584,6485,1,1,1
4,2.5,2130,4496,2.0,0,0,3,7,2130,0,2004,0,98001,47.3041,-122.28,3220,5400,215000,27,1,2015,0,11,2366,2180,0,0,0
4,2.5,2740,9959,2.0,0,0,3,9,2740,0,1989,0,98029,47.5672,-122.011,2630,9905,648000,9,9,2014,0,25,7219,7275,0,0,0
4,3.0,3150,9318,2.0,0,0,3,9,3150,0,2001,0,98075,47.5959,-122.018,3150,9318,705000,3,9,2014,0,13,6168,6168,0,0,0
3,2.25,1450,1540,2.0,0,0,3,8,1180,270,2005,0,98107,47.6685,-122.365,1450,1540,465000,9,1,2015,0,10,90,90,0,1,1
5,2.0,2400,3500,1.5,0,0,3,8,1900,500,1911,0,98103,47.6762,-122.356,1520,4000,650000,22,12,2014,0,103,1100,2480,0,1,1
4,2.25,2280,7500,1.0,0,0,4,7,1140,1140,1963,0,98198,47.4182,-122.332,1660,8000,335000,21,7,2014,0,51,5220,6340,0,1,1
4,2.5,2460,8029,2.0,0,0,3,9,2460,0,1989,0,98074,47.6262,-122.03,2420,7987,638250,3,3,2015,0,26,5569,5567,0,0,0
4,2.0,1620,4600,2.0,0,0,3,7,1620,0,1909,0,98108,47.5533,-122.307,1620,4500,375000,27,4,2015,0,106,2980,2880,0,0,1
4,1.75,2170,9525,1.0,0,0,3,8,2170,0,1960,0,98040,47.5685,-122.217,1910,9525,842000,16,7,2014,0,54,7355,7615,0,0,0
3,2.25,2880,7200,1.0,0,0,3,8,1710,1170,1970,0,98133,47.7707,-122.35,1880,10200,499950,8,10,2014,0,44,4320,8320,0,1,1
5,2.0,2900,11970,2.0,0,0,4,7,2900,0,1969,0,98072,47.741,-122.095,1260,12398,310000,26,2,2015,0,46,9070,11138,0,0,0
3,2.5,2160,8809,1.0,0,0,3,9,1540,620,2014,0,98103,47.6994,-122.349,930,5420,730000,31,10,2014,0,0,6649,4490,0,1,1
4,1.75,2250,4750,1.5,0,0,4,7,1420,830,1924,0,98115,47.6738,-122.292,1930,4750,637800,13,11,2014,0,90,2500,2820,0,1,1
3,1.0,1340,4800,1.5,0,0,4,5,1340,0,1903,0,98055,47.477,-122.209,1240,4800,225000,6,2,2015,0,112,3460,3560,0,0,0
4,1.0,1390,10800,1.5,0,0,4,7,1390,0,1941,0,98177,47.7248,-122.359,1390,9360,417500,10,6,2014,0,73,9410,7970,0,0,1
4,2.0,1600,10160,1.0,0,0,4,7,1600,0,1972,0,98022,47.2015,-122.003,1540,9352,265000,20,3,2015,0,43,8560,7812,0,0,0
4,2.5,2050,8683,2.0,0,0,3,8,2050,0,1987,0,98074,47.62,-122.043,2010,8744,550000,25,7,2014,0,27,6633,6734,0,0,0
3,2.5,2660,10637,2.0,0,0,3,9,2660,0,1991,0,98011,47.7383,-122.22,2590,8637,595000,1,8,2014,0,23,7977,6047,0,0,0
3,1.5,1540,13475,1.0,0,0,4,7,1540,0,1972,0,98059,47.4766,-122.153,1550,13475,270000,14,7,2014,0,42,11935,11925,0,0,0
5,3.0,2640,3200,2.0,0,0,4,7,2140,500,1906,0,98112,47.6188,-122.308,1540,2242,739375,18,7,2014,0,108,560,702,0,1,1
2,1.75,1210,1032,2.0,0,0,3,8,1210,0,2014,0,98029,47.5522,-121.999,1210,1090,357562,8,7,2014,0,0,-178,-120,0,0,0
2,1.75,1350,4286,1.0,0,0,3,8,1350,0,2004,0,98053,47.7171,-122.033,1440,4839,455000,30,9,2014,0,10,2936,3399,0,0,0
5,2.25,2600,9600,1.0,0,2,4,8,1810,790,1969,0,98023,47.3257,-122.365,2070,9660,310000,1,5,2015,0,46,7000,7590,0,1,0
2,1.0,1340,8100,1.0,0,2,3,8,1340,0,1950,0,98177,47.7212,-122.364,1680,7752,452000,19,8,2014,0,64,6760,6072,0,0,1
3,2.0,1760,16928,1.0,0,0,3,7,1760,0,1953,0,98004,47.6363,-122.202,3430,10059,810000,13,1,2015,0,62,15168,6629,0,0,0
3,2.0,1840,4750,1.0,0,0,5,7,1010,830,1951,0,98117,47.6862,-122.395,1760,5510,730001,27,5,2014,0,63,2910,3750,0,1,1
3,2.5,1730,3000,2.0,0,0,3,8,1730,0,1996,0,98103,47.6532,-122.34,1730,1774,665000,16,7,2014,0,18,1270,44,0,0,1
4,1.75,1650,7800,1.0,0,0,3,8,1650,0,1968,0,98058,47.4507,-122.139,1750,10400,327500,4,6,2014,0,46,6150,8650,0,0,0
4,2.5,2180,3375,1.5,0,0,4,7,1420,760,1926,0,98117,47.6846,-122.361,1560,3375,657000,25,6,2014,0,88,1195,1815,0,1,1
3,1.75,1490,10844,1.0,0,0,3,7,1210,280,1974,0,98008,47.6208,-122.106,2090,9944,445000,17,7,2014,0,40,9354,7854,0,1,0
3,2.5,1530,762,2.0,0,0,3,8,1050,480,2007,0,98119,47.642,-122.374,1610,1482,450000,31,7,2014,0,7,-768,-128,0,1,1
3,1.0,1180,7455,1.0,0,0,4,7,1180,0,1964,0,98034,47.7276,-122.241,1450,8154,350000,26,9,2014,0,50,6275,6704,0,0,0
4,2.5,2080,17532,2.0,0,0,3,9,2080,0,1996,0,98059,47.4835,-122.136,2550,12560,460000,12,11,2014,0,18,15452,10010,0,0,0
4,2.25,1880,6160,2.0,0,0,3,7,1880,0,1993,0,98023,47.3214,-122.347,1580,6405,272000,4,11,2014,0,21,4280,4825,0,0,0
3,2.5,2510,5544,2.0,0,0,3,7,2510,0,2001,0,98053,47.6903,-122.042,2660,5614,535000,20,1,2015,0,14,3034,2954,0,0,0
2,1.0,1060,5200,1.0,0,0,3,6,1060,0,1969,0,98042,47.3688,-122.08,910,5200,216500,30,4,2015,0,46,4140,4290,0,0,0
3,2.5,2130,12245,2.0,0,0,3,8,2130,0,1989,0,98042,47.3406,-122.057,1910,12216,325000,25,2,2015,0,26,10115,10306,0,0,0
3,1.75,1320,7280,1.0,0,0,3,7,1320,0,1968,0,98034,47.7229,-122.18,1370,7800,420200,6,4,2015,0,47,5960,6430,0,0,0
3,1.75,1040,5650,1.0,0,0,5,6,1040,0,1951,0,98178,47.5111,-122.256,1290,5650,258000,2,12,2014,0,63,4610,4360,0,0,1
3,2.0,1150,4500,1.5,0,0,3,7,1150,0,1917,1991,98103,47.6985,-122.348,1230,5400,450000,2,12,2014,74,97,3350,4170,1,0,1
4,2.25,2120,3794,2.0,0,0,4,7,1420,700,1926,0,98117,47.6893,-122.359,1420,3840,720168,8,12,2014,0,88,1674,2420,0,1,1
3,2.0,2130,5000,1.5,0,0,5,7,1330,800,1925,0,98107,47.6746,-122.362,2010,5000,652000,2,10,2014,0,89,2870,2990,0,1,1
4,2.5,2340,8248,2.0,0,0,3,8,2340,0,1989,0,98074,47.6314,-122.03,2140,9963,569500,30,7,2014,0,25,5908,7823,0,0,0
3,1.75,1890,3825,1.0,0,0,3,7,1290,600,1974,0,98117,47.6831,-122.381,1320,3825,524950,19,5,2014,0,40,1935,2505,0,1,1
2,1.0,1140,10152,1.0,0,0,3,6,760,380,1942,0,98155,47.7369,-122.321,1340,10141,153000,23,3,2015,0,73,9012,8801,0,1,1
3,2.5,2780,5467,2.0,0,2,3,9,2780,0,2000,0,98126,47.5791,-122.378,2630,5000,775000,22,10,2014,0,14,2687,2370,0,0,1
4,2.5,2390,6111,2.0,0,0,3,8,2390,0,1997,0,98030,47.3677,-122.173,2520,6500,338500,12,1,2015,0,18,3721,3980,0,0,0
3,1.75,2390,9000,1.0,0,0,3,8,1500,890,1975,0,98052,47.6809,-122.113,2040,9000,570000,1,5,2015,0,40,6610,6960,0,1,0
3,2.0,2680,8429,1.0,0,0,4,9,1880,800,1950,1991,98038,47.372,-122.036,1570,8640,653000,29,10,2014,41,64,5749,7070,1,1,0
2,2.5,1560,1222,2.0,0,0,3,8,1080,480,2008,0,98122,47.604,-122.307,1560,2081,435000,20,11,2014,0,6,-338,521,0,1,1
2,1.0,1130,8160,1.0,0,0,4,6,1130,0,1952,0,98168,47.4997,-122.317,1060,6120,207000,26,11,2014,0,62,7030,5060,0,0,1
4,2.25,2050,9583,2.0,0,2,3,8,1770,280,1965,0,98198,47.3978,-122.313,2230,9730,386000,25,6,2014,0,49,7533,7500,0,1,1
5,2.25,2600,8075,1.5,0,0,4,8,2600,0,1969,0,98092,47.2961,-122.188,2200,8800,265000,27,8,2014,0,45,5475,6600,0,0,0
3,2.25,1050,572,2.0,0,0,3,7,740,310,2006,0,98106,47.5549,-122.363,1260,1062,250000,7,1,2015,0,9,-478,-198,0,1,1
3,2.0,2600,6600,2.0,0,4,3,10,1930,670,1970,2014,98122,47.6055,-122.285,2670,6270,1700000,5,1,2015,44,45,4000,3600,1,1,1
4,2.5,2811,7251,2.0,0,0,3,9,2811,0,2009,0,98038,47.3686,-122.058,3040,7250,455000,3,12,2014,0,5,4440,4210,0,0,0
4,3.25,4060,13000,2.0,0,3,3,11,4060,0,2000,0,98040,47.581,-122.246,3220,13800,1800000,27,5,2014,0,14,8940,10580,0,0,0
3,2.0,2260,7200,1.0,0,3,3,7,1130,1130,1941,0,98144,47.5886,-122.288,2260,6000,759000,30,10,2014,0,73,4940,3740,0,1,1
3,2.25,2430,8327,1.0,0,0,4,9,1430,1000,1978,0,98006,47.5534,-122.16,2550,10427,690000,27,8,2014,0,36,5897,7877,0,1,0
2,1.0,1180,5100,1.5,0,0,3,7,1180,0,1926,0,98103,47.6947,-122.346,980,5100,447500,18,3,2015,0,89,3920,4120,0,0,1
4,2.25,2010,7575,1.0,0,0,3,7,1220,790,1974,0,98034,47.7328,-122.2,1820,7831,440000,13,6,2014,0,40,5565,6011,0,1,0
3,2.0,1230,7789,1.0,0,0,3,7,1230,0,1994,0,98042,47.3718,-122.073,1470,8670,278000,14,4,2015,0,21,6559,7200,0,0,0
5,2.5,2750,6000,1.5,0,0,3,8,1750,1000,1904,1994,98103,47.6729,-122.334,1520,4158,980000,14,7,2014,90,110,3250,2638,1,1,1
3,2.75,1300,14197,1.0,0,0,3,7,860,440,1996,0,98030,47.3652,-122.183,1550,7596,245000,30,6,2014,0,18,12897,6046,0,1,0
3,1.5,1150,11475,1.0,0,0,3,7,1150,0,1971,0,98045,47.4629,-121.744,1640,11475,287000,21,10,2014,0,43,10325,9835,0,0,0
3,2.5,2050,11690,2.0,0,0,4,9,2050,0,1989,0,98059,47.5279,-122.161,2410,10172,585000,15,7,2014,0,25,9640,7762,0,0,0
4,1.75,1700,5846,1.0,0,0,3,8,1700,0,1957,0,98199,47.6539,-122.408,1480,5177,616000,1,7,2014,0,57,4146,3697,0,0,1
3,1.75,1610,9000,1.0,0,0,4,7,1100,510,1978,0,98092,47.3187,-122.179,1610,8000,203000,15,1,2015,0,37,7390,6390,0,1,0
4,2.75,2720,3840,2.0,0,0,3,8,1790,930,1920,2009,98107,47.6624,-122.361,1360,3880,860000,6,5,2015,89,95,1120,2520,1,1,1
4,2.5,2190,12690,1.0,0,2,3,8,1170,1020,1973,0,98033,47.6627,-122.189,2630,10843,833000,30,3,2015,0,42,10500,8213,0,1,0
4,2.75,2730,6856,2.0,0,0,3,8,2730,0,2003,0,98072,47.7739,-122.164,2520,5569,565000,11,12,2014,0,11,4126,3049,0,0,0
3,2.5,2490,7589,2.0,0,0,3,9,2490,0,1991,0,98056,47.5355,-122.179,2500,10386,572500,12,2,2015,0,24,5099,7886,0,0,0
4,2.0,1510,4235,1.0,0,0,3,7,1510,0,1955,0,98108,47.546,-122.293,1510,4268,254000,16,5,2014,0,59,2725,2758,0,0,1
3,2.5,1950,3730,2.0,0,0,3,9,1950,0,1996,0,98033,47.6731,-122.199,2080,4000,899000,26,2,2015,0,19,1780,1920,0,0,0
3,2.0,1300,6000,1.0,0,0,5,7,1300,0,1943,0,98136,47.5482,-122.392,1230,6000,560000,24,4,2015,0,72,4700,4770,0,0,1
3,1.75,1610,7200,1.0,0,0,3,7,1180,430,1976,0,98007,47.5966,-122.144,1520,7973,512500,4,3,2015,0,39,5590,6453,0,1,0
4,2.5,2040,5000,1.5,0,0,5,7,1180,860,1924,0,98117,47.6786,-122.36,1540,5000,775000,23,2,2015,0,91,2960,3460,0,1,1
2,1.0,700,4700,1.0,0,0,5,5,700,0,1953,0,98056,47.4953,-122.169,960,5200,200000,11,6,2014,0,61,4000,4240,0,0,0
3,1.0,970,4700,1.0,0,0,4,6,720,250,1943,0,98106,47.5285,-122.354,1560,4600,172000,31,7,2014,0,71,3730,3040,0,1,1
3,1.0,910,6000,1.0,0,0,2,6,910,0,1956,0,98146,47.5065,-122.338,1090,6957,219900,22,5,2014,0,58,5090,5867,0,0,1
3,1.0,1060,9123,1.0,0,0,3,7,1060,0,1952,0,98004,47.6218,-122.193,1620,9121,641200,11,7,2014,0,62,8063,7501,0,0,0
5,3.25,2180,7200,2.0,0,0,4,7,2180,0,1982,0,98034,47.7078,-122.234,1840,7644,473000,15,7,2014,0,32,5020,5804,0,0,0
3,1.75,2050,9580,1.0,0,0,3,8,1400,650,1984,0,98074,47.6212,-122.038,1740,11952,540000,1,7,2014,0,30,7530,10212,0,1,0
2,1.0,750,4500,1.0,0,0,3,6,750,0,1945,0,98122,47.607,-122.297,1540,4000,295000,4,5,2015,0,70,3750,2460,0,0,1
3,1.0,800,2296,1.0,0,0,4,6,800,0,1908,0,98103,47.6546,-122.356,1480,1472,370000,28,5,2014,0,106,1496,-8,0,0,1
4,2.25,3470,8000,1.5,0,1,3,9,2360,1110,1906,2002,98122,47.6149,-122.287,3010,8000,1730000,14,7,2014,96,108,4530,4990,1,1,1
3,1.0,900,4750,1.0,0,0,4,6,900,0,1969,0,98023,47.3026,-122.363,900,3404,89000,14,10,2014,0,45,3850,2504,0,0,0
2,1.75,1050,9800,1.5,0,0,4,6,1050,0,1975,0,98019,47.7595,-121.473,1230,12726,175000,5,8,2014,0,39,8750,11496,0,0,0
3,2.5,2410,11900,1.0,0,2,4,9,1600,810,1989,0,98023,47.3384,-122.34,3090,11902,490000,18,2,2015,0,26,9490,8812,0,1,0
3,2.25,1180,9630,2.0,0,0,3,7,1180,0,1986,0,98028,47.7352,-122.232,2660,5979,342400,15,5,2014,0,28,8450,3319,0,0,0
3,1.0,1140,4200,2.0,0,0,4,7,1140,0,1904,0,98144,47.6012,-122.296,1510,4000,345000,23,6,2014,0,110,3060,2490,0,0,1
2,1.0,700,3400,1.0,0,0,3,6,700,0,1946,0,98112,47.6212,-122.296,1570,4512,399000,25,11,2014,0,68,2700,2942,0,0,1
4,2.5,2060,9719,1.0,0,0,4,8,1320,740,1960,0,98006,47.5549,-122.176,2050,9643,550000,15,8,2014,0,54,7659,7593,0,1,0
3,2.25,2230,11835,1.0,0,0,5,8,1630,600,1974,0,98006,47.563,-122.178,2190,10384,652450,3,12,2014,0,40,9605,8194,0,1,0
3,1.75,2100,5058,1.0,0,2,3,7,1340,760,1941,0,98126,47.5743,-122.378,1640,5000,605000,3,4,2015,0,74,2958,3360,0,1,1
4,2.5,2130,11733,1.0,0,0,5,7,1330,800,1969,0,98059,47.512,-122.16,1800,9131,395000,29,9,2014,0,45,9603,7331,0,1,0
3,2.0,1880,3048,2.0,0,0,4,7,1880,0,1902,0,98122,47.6031,-122.303,1680,3600,449950,12,11,2014,0,112,1168,1920,0,0,1
4,2.5,2310,5526,2.0,0,0,3,9,2310,0,2003,0,98074,47.6299,-122.02,2500,5769,651100,30,3,2015,0,12,3216,3269,0,0,0
3,1.0,880,6050,1.0,0,0,3,6,880,0,1945,0,98178,47.4995,-122.248,1130,6050,241000,4,2,2015,0,70,5170,4920,0,0,1
2,1.5,1290,1749,1.0,0,0,3,8,660,630,1969,0,98008,47.6118,-122.116,1860,1749,268500,19,12,2014,0,45,459,-111,0,1,0
2,1.0,1010,7200,1.0,0,0,3,6,1010,0,1956,0,98166,47.4815,-122.339,1290,9000,200000,23,1,2015,0,59,6190,7710,0,0,1
4,1.75,1690,7680,1.0,0,0,5,6,890,800,1946,0,98126,47.5296,-122.375,1060,7680,400375,1,12,2014,0,68,5990,6620,0,1,1
2,1.75,1350,6315,1.0,0,0,3,8,1350,0,2005,0,98053,47.7141,-122.032,1665,5390,429000,28,5,2014,0,9,4965,3725,0,0,0
3,1.0,680,2400,1.0,0,0,4,6,680,0,1903,0,98144,47.5982,-122.299,1470,3600,230000,24,10,2014,0,111,1720,2130,0,0,1
4,2.25,2860,10702,2.0,0,0,3,10,2860,0,1982,0,98004,47.6451,-122.189,2890,10572,1200000,18,2,2015,0,33,7842,7682,0,0,0
1,1.0,610,6000,1.0,0,0,4,5,610,0,1918,0,98117,47.6911,-122.367,970,5000,314200,9,4,2015,0,97,5390,4030,0,0,1
4,2.5,2660,8887,1.0,0,0,4,8,1880,780,1967,0,98166,47.439,-122.342,1910,9620,513000,23,4,2015,0,48,6227,7710,0,1,1
2,1.0,1390,5346,1.0,0,0,5,7,960,430,1908,0,98118,47.5567,-122.279,1450,5040,535000,2,4,2015,0,107,3956,3590,0,1,1
6,3.0,2290,6344,2.0,0,0,3,7,2290,0,1980,0,98126,47.565,-122.37,1360,3202,420000,5,3,2015,0,35,4054,1842,0,0,1
3,2.5,2110,4118,2.0,0,0,3,8,2110,0,1989,0,98042,47.3878,-122.153,2110,4044,345950,23,6,2014,0,25,2008,1934,0,0,0
3,2.0,1200,2016,1.0,0,1,4,7,600,600,1931,0,98116,47.5811,-122.404,1730,4520,483500,20,8,2014,0,83,816,2790,0,1,1
4,2.25,2360,2500,2.0,0,3,3,8,1520,840,2001,0,98117,47.6771,-122.358,1810,3900,695000,8,12,2014,0,13,140,2090,0,1,1
4,2.5,2350,8906,2.0,0,0,3,7,2350,0,1993,0,98031,47.4205,-122.215,2000,8165,295000,6,10,2014,0,21,6556,6165,0,0,0
3,2.25,1590,9960,1.0,0,0,3,7,1060,530,1976,0,98155,47.7742,-122.287,1860,9760,434975,8,4,2015,0,39,8370,7900,0,1,1
3,2.5,1810,4592,2.0,0,0,3,8,1810,0,1992,0,98029,47.5764,-121.996,1810,4758,513000,8,7,2014,0,22,2782,2948,0,0,0
3,1.75,1900,11407,1.0,0,0,3,8,1900,0,1963,0,98155,47.7455,-122.294,1710,11407,360000,23,3,2015,0,52,9507,9697,0,0,1
3,1.0,1250,8000,1.0,0,0,3,7,1250,0,1956,0,98146,47.5065,-122.337,1040,6973,234900,17,3,2015,0,59,6750,5933,0,0,1
4,3.5,3280,6603,2.0,0,0,3,10,3280,0,2007,0,98027,47.5642,-122.126,3280,7333,963000,16,6,2014,0,7,3323,4053,0,0,0
2,1.5,870,4800,1.0,0,0,3,7,870,0,1924,0,98119,47.6509,-122.37,2090,4800,595000,19,8,2014,0,90,3930,2710,0,0,1
4,3.25,3570,14408,2.0,0,2,3,10,3570,0,2006,0,98065,47.536,-121.857,4100,14577,942500,24,10,2014,0,8,10838,10477,0,0,0
4,3.25,3780,11200,2.0,0,0,3,11,3780,0,2002,0,98059,47.521,-122.15,3720,11813,1030000,5,9,2014,0,12,7420,8093,0,0,0
3,1.0,1190,3600,1.5,0,0,3,6,1190,0,1904,0,98144,47.5985,-122.298,1680,3600,350000,25,3,2015,0,111,2410,1920,0,0,1
3,1.75,2870,5000,1.5,0,0,4,8,1840,1030,1907,0,98144,47.5788,-122.292,2200,5000,802000,22,6,2014,0,107,2130,2800,0,1,1
4,1.5,1520,8800,1.0,0,0,4,7,1520,0,1960,0,98002,47.3136,-122.208,1370,8800,230000,31,7,2014,0,54,7280,7430,0,0,0
3,3.0,3700,10375,2.0,0,0,3,9,3700,0,1982,0,98188,47.4286,-122.291,2130,9132,489000,2,7,2014,0,32,6675,7002,0,0,1
3,2.25,1920,7738,1.0,0,0,3,8,1520,400,1965,0,98148,47.4562,-122.33,2170,8452,250000,2,7,2014,0,49,5818,6282,0,1,1
3,3.0,2560,3600,2.0,0,0,3,10,2110,450,1994,0,98119,47.633,-122.37,2160,3600,925000,15,8,2014,0,20,1040,1440,0,1,1
4,2.5,1840,15496,2.0,0,0,3,8,1840,0,1991,0,98059,47.4683,-122.07,1840,15040,390000,23,7,2014,0,23,13656,13200,0,0,0
3,2.75,2080,9600,1.0,0,0,3,7,2080,0,1988,0,98028,47.7698,-122.238,2220,9600,415000,10,3,2015,0,27,7520,7380,0,0,0
3,2.0,1600,9638,1.0,0,0,5,7,1600,0,1952,0,98040,47.5753,-122.224,1800,11400,785000,4,4,2015,0,63,8038,9600,0,0,0
3,2.0,2168,4000,1.5,0,0,3,8,2168,0,1907,0,98105,47.6561,-122.325,1770,4000,575000,24,9,2014,0,107,1832,2230,0,0,1
2,1.0,860,8636,1.0,0,0,3,6,860,0,1924,0,98146,47.5081,-122.356,1100,8636,170000,26,1,2015,0,91,7776,7536,0,0,1
4,1.75,2100,3400,1.0,0,0,5,7,1100,1000,1915,0,98119,47.6429,-122.371,1890,3771,750000,14,10,2014,0,99,1300,1881,0,1,1
3,1.0,1140,9639,1.0,0,0,4,7,1140,0,1967,0,98001,47.3112,-122.265,1140,9639,230000,21,3,2015,0,48,8499,8499,0,0,0
4,2.0,2180,6000,1.5,0,0,3,8,2060,120,1927,0,98144,47.5958,-122.306,1370,4500,677000,30,3,2015,0,88,3820,3130,0,1,1
3,2.0,1800,5000,2.0,0,0,5,7,1600,200,1925,0,98136,47.5447,-122.389,1640,5000,575000,22,10,2014,0,89,3200,3360,0,1,1
2,1.0,1120,4590,1.0,0,0,3,7,1120,0,1924,0,98118,47.5663,-122.285,1120,5100,450000,18,2,2015,0,91,3470,3980,0,0,1
3,2.5,2980,7202,2.0,0,0,3,8,2980,0,1999,0,98033,47.6769,-122.177,2430,7280,817250,27,3,2015,0,16,4222,4850,0,0,0
2,2.0,1550,2400,1.5,0,0,4,7,1550,0,1900,0,98103,47.654,-122.346,1180,1224,526000,7,5,2014,0,114,850,44,0,0,1
3,2.25,3330,15258,2.0,0,0,3,10,3330,0,1986,0,98077,47.7262,-122.06,3360,14850,762500,25,7,2014,0,28,11928,11490,0,0,0
4,2.5,2200,7719,2.0,0,0,3,8,2200,0,2000,0,98030,47.3649,-122.194,2460,7348,325000,14,4,2015,0,15,5519,4888,0,0,0
2,1.0,840,4500,1.0,0,0,3,6,840,0,1939,0,98136,47.5441,-122.39,1300,5000,377500,3,5,2015,0,76,3660,3700,0,0,1
3,1.5,1270,7128,1.0,0,0,4,6,1270,0,1954,0,98198,47.422,-122.321,1270,7986,212500,23,9,2014,0,60,5858,6716,0,0,1
3,1.0,1780,7800,1.0,0,0,3,7,1060,720,1957,0,98178,47.4932,-122.263,1450,7800,261000,15,10,2014,0,57,6020,6350,0,1,1
4,2.5,1850,9248,2.0,0,0,3,8,1850,0,1997,0,98028,47.735,-122.244,2080,8711,515000,10,4,2015,0,18,7398,6631,0,0,0
3,2.25,2760,10160,1.0,0,0,3,8,2760,0,1969,0,98058,47.4504,-122.15,2760,9600,336000,8,7,2014,0,45,7400,6840,0,0,0
2,1.0,1090,4128,1.0,0,0,3,7,1090,0,1948,0,98115,47.696,-122.314,1090,5413,440000,25,2,2015,0,67,3038,4323,0,0,1
4,2.75,3090,6200,2.0,0,0,3,9,3090,0,2014,0,98006,47.5538,-122.189,2890,10108,908950,9,1,2015,0,1,3110,7218,0,0,0
2,1.0,820,3700,1.0,0,0,5,7,820,0,1968,0,98040,47.588,-122.251,1750,9000,554000,25,11,2014,0,46,2880,7250,0,0,0
3,2.25,1445,1606,2.0,0,0,3,7,1300,145,2003,0,98027,47.5348,-122.072,1410,1286,387000,9,5,2014,0,11,161,-124,0,1,0
4,2.25,1810,9240,2.0,0,0,3,7,1810,0,1961,0,98055,47.4362,-122.187,1660,9240,268643,5,5,2015,0,54,7430,7580,0,0,0
3,1.75,1620,5000,1.0,0,0,3,7,920,700,1954,0,98117,47.681,-122.372,1610,5000,514000,21,7,2014,0,60,3380,3390,0,1,1
2,1.75,1060,4182,2.0,0,0,3,7,1060,0,1977,0,98115,47.6787,-122.308,1760,4590,420000,23,7,2014,0,37,3122,2830,0,0,1
3,1.75,1050,9871,1.0,0,0,5,7,1050,0,1968,0,98042,47.3816,-122.087,1300,10794,199000,10,9,2014,0,46,8821,9494,0,0,0
3,1.0,1010,15701,1.0,0,0,4,7,1010,0,1949,0,98188,47.4518,-122.292,1260,9800,225000,17,3,2015,0,66,14691,8540,0,0,1
4,2.5,2050,8424,2.0,0,0,4,8,2050,0,1993,0,98022,47.196,-122.011,1970,8448,320000,19,8,2014,0,21,6374,6478,0,0,0
2,1.0,970,8185,1.0,0,0,5,6,970,0,1904,0,98031,47.4025,-122.201,1500,12541,204995,23,10,2014,0,110,7215,11041,0,0,0
3,2.0,1540,1827,2.0,0,0,3,8,1540,0,2005,0,98029,47.5479,-121.999,1560,2058,376000,29,12,2014,0,9,287,498,0,0,0
4,2.75,3000,6222,2.0,0,0,3,9,3000,0,2004,0,98029,47.5582,-122.025,3340,7222,705000,15,12,2014,0,10,3222,3882,0,0,0
4,2.5,3190,7869,2.0,0,2,3,9,3190,0,2001,0,98065,47.5317,-121.866,2630,6739,725995,2,6,2014,0,13,4679,4109,0,0,0
4,2.5,1870,8190,1.0,0,0,3,7,1100,770,1977,0,98058,47.4521,-122.161,1590,9150,285000,26,1,2015,0,38,6320,7560,0,1,0
4,2.5,2200,9397,2.0,0,0,3,8,2200,0,1987,0,98001,47.3406,-122.269,2310,9176,285000,2,5,2014,0,27,7197,6866,0,0,0
4,2.5,3070,5936,2.0,0,0,3,9,3070,0,2005,0,98075,47.5902,-121.988,3160,5936,731000,20,8,2014,0,9,2866,2776,0,0,0
4,2.5,2440,10423,1.0,0,0,3,7,2440,0,1955,1993,98034,47.725,-122.172,1990,7758,510000,6,10,2014,38,59,7983,5768,1,0,0
2,1.0,990,4332,1.0,0,0,3,7,990,0,1909,0,98103,47.6528,-122.331,1920,3420,620000,23,10,2014,0,105,3342,1500,0,0,1
4,3.5,3670,4960,2.0,0,0,3,9,2870,800,2005,0,98177,47.7022,-122.374,1520,6335,796000,22,7,2014,0,9,1290,4815,0,1,1
3,2.5,1940,4000,2.0,0,0,4,9,1940,0,2000,0,98199,47.659,-122.398,1410,4000,807000,28,4,2015,0,15,2060,2590,0,0,1
4,2.5,1780,6000,2.0,0,0,3,9,1780,0,2000,0,98038,47.3774,-122.027,2650,6000,315000,10,11,2014,0,14,4220,3350,0,0,0
3,2.25,2200,7355,2.0,0,0,4,8,2200,0,1986,0,98052,47.7266,-122.103,2290,7868,637000,27,2,2015,0,29,5155,5578,0,0,0
3,2.0,2070,10023,1.0,0,0,3,8,1220,850,1981,0,98074,47.6492,-122.062,2130,9694,490000,11,12,2014,0,33,7953,7564,0,1,0
3,1.75,2040,7281,1.0,0,0,3,7,1020,1020,1962,0,98188,47.4681,-122.282,1740,7527,253000,10,6,2014,0,52,5241,5787,0,1,1
4,2.5,2320,6270,2.0,0,0,3,8,2320,0,2004,0,98042,47.3501,-122.14,2150,6270,325900,8,5,2014,0,10,3950,4120,0,0,0
2,2.0,1440,6677,1.0,0,0,3,7,870,570,1952,0,98118,47.5513,-122.264,2020,7642,425000,15,10,2014,0,62,5237,5622,0,1,1
4,2.5,1700,6675,2.0,0,0,3,7,1700,0,1997,0,98038,47.3638,-122.053,1570,7540,215000,5,9,2014,0,17,4975,5970,0,0,0
4,2.5,1700,6675,2.0,0,0,3,7,1700,0,1997,0,98038,47.3638,-122.053,1570,7540,315000,8,4,2015,0,18,4975,5970,0,0,0
3,2.0,2050,3933,1.0,0,0,3,8,1180,870,1926,2001,98112,47.6436,-122.303,1940,4000,724800,16,5,2014,75,88,1883,2060,1,1,1
2,1.0,800,6500,1.0,0,0,4,6,800,0,1953,0,98133,47.7621,-122.358,1220,7000,295000,9,7,2014,0,61,5700,5780,0,0,1
3,1.75,1800,7620,1.0,0,0,3,8,1350,450,1951,0,98177,47.7165,-122.361,1770,7620,509007,16,3,2015,0,64,5820,5850,0,1,1
3,1.75,1290,7210,1.0,0,0,3,7,1290,0,1984,0,98023,47.2889,-122.363,1350,7509,205000,17,7,2014,0,30,5920,6159,0,0,0
3,1.5,1900,9737,1.0,0,0,4,7,1200,700,1968,0,98031,47.4125,-122.207,1670,9737,275000,31,7,2014,0,46,7837,8067,0,1,0
3,1.75,1480,7000,1.0,0,2,3,8,1480,0,1963,0,98122,47.6018,-122.291,1850,4000,685000,6,11,2014,0,51,5520,2150,0,0,1
4,2.5,2090,12833,1.0,0,0,3,7,1220,870,1969,0,98034,47.7266,-122.175,1740,11200,465000,20,4,2015,0,46,10743,9460,0,1,0
4,2.25,1950,9800,1.0,0,0,3,8,1330,620,1968,0,98033,47.666,-122.178,2170,9800,560000,8,7,2014,0,46,7850,7630,0,1,0
3,1.75,1250,9605,1.0,0,0,3,7,1250,0,1964,0,98008,47.6325,-122.121,1570,9605,458500,23,2,2015,0,51,8355,8035,0,0,0
3,1.0,990,7590,1.0,0,0,3,6,990,0,1959,0,98008,47.6228,-122.121,1100,7590,354000,31,3,2015,0,56,6600,6490,0,0,0
3,2.5,2740,7923,2.0,0,0,3,9,2740,0,1998,0,98058,47.4349,-122.105,2740,8815,441000,13,1,2015,0,17,5183,6075,0,0,0
3,1.75,1260,10488,1.0,0,0,2,7,1110,150,1952,0,98106,47.5417,-122.357,1540,9120,194000,29,8,2014,0,62,9228,7580,0,1,1
4,2.5,2150,6807,2.0,0,0,4,8,2150,0,1991,0,98031,47.4053,-122.189,1910,7240,316500,15,5,2014,0,23,4657,5330,0,0,0
3,1.75,1750,3250,1.5,0,0,4,7,1230,520,1929,0,98117,47.6807,-122.366,1480,3600,524950,25,8,2014,0,85,1500,2120,0,1,1
3,2.25,2880,6092,2.0,0,4,4,8,1920,960,1983,0,98116,47.5878,-122.381,2880,5308,1050000,27,4,2015,0,32,3212,2428,0,1,1
4,2.25,2590,13894,2.0,0,0,4,9,2590,0,1975,0,98005,47.6351,-122.165,2720,13894,925000,12,4,2015,0,40,11304,11174,0,0,0
3,1.75,2430,4524,1.5,0,0,4,7,1830,600,1924,0,98103,47.674,-122.35,1610,4100,780000,20,10,2014,0,90,2094,2490,0,1,1
2,2.0,1470,3128,2.0,0,0,3,6,1470,0,2005,0,98038,47.349,-122.021,1180,2576,241000,19,5,2014,0,9,1658,1396,0,0,0
3,2.75,2020,10744,1.0,0,0,5,7,1270,750,1954,0,98166,47.4403,-122.343,2020,11069,519000,19,6,2014,0,60,8724,9049,0,1,1
2,1.0,610,4000,1.0,0,0,4,6,610,0,1918,0,98136,47.5469,-122.391,870,5160,286000,28,8,2014,0,96,3390,4290,0,0,1
3,2.0,3000,17800,1.0,0,0,3,8,1500,1500,1962,0,98125,47.7058,-122.315,2400,8300,400000,9,10,2014,0,52,14800,5900,0,1,1
3,1.75,1070,7754,1.0,0,0,3,6,1070,0,1953,0,98146,47.5079,-122.344,950,7740,152000,21,1,2015,0,62,6684,6790,0,0,1
4,2.5,1820,3905,2.0,0,0,3,7,1820,0,2001,0,98019,47.7346,-121.985,1820,3863,330000,24,10,2014,0,13,2085,2043,0,0,0
2,1.0,1060,7193,1.0,0,0,3,7,1060,0,1926,0,98133,47.7102,-122.356,1980,7560,461000,19,5,2014,0,88,6133,5580,0,0,1
3,2.0,1610,6911,1.0,0,0,3,7,1260,350,1988,0,98034,47.7188,-122.177,1630,6911,435000,6,8,2014,0,26,5301,5281,0,1,0
5,2.75,2830,5310,2.0,0,0,3,9,2830,0,2006,0,98052,47.7074,-122.101,3150,6581,725000,16,5,2014,0,8,2480,3431,0,0,0
3,1.0,970,12300,1.0,0,0,3,7,970,0,1982,0,98028,47.7335,-122.227,2040,9994,300000,5,11,2014,0,32,11330,7954,0,0,0
3,2.5,1680,8284,2.0,0,0,3,7,1680,0,1989,0,98038,47.3609,-122.048,1550,8284,252000,11,11,2014,0,25,6604,6734,0,0,0
4,2.75,2040,8996,1.0,0,0,4,8,1260,780,1974,0,98033,47.666,-122.185,2470,9180,464625,5,10,2014,0,40,6956,6710,0,1,0
3,1.0,1450,9586,2.0,0,0,3,7,1450,0,1950,0,98155,47.7443,-122.326,1500,8592,340000,12,12,2014,0,64,8136,7092,0,0,1
4,2.25,2870,6280,1.5,0,0,4,9,1980,890,1905,0,98112,47.6329,-122.31,2370,4760,1330000,20,6,2014,0,109,3410,2390,0,1,1
5,2.0,1870,13970,1.0,0,0,4,7,1120,750,1969,0,98027,47.5243,-122.042,1860,13970,455000,6,2,2015,0,46,12100,12110,0,1,0
4,2.5,3350,4501,2.0,0,0,3,9,2640,710,2002,0,98117,47.688,-122.379,1000,4500,925000,21,4,2015,0,13,1151,3500,0,1,1
4,2.75,3190,8737,2.0,0,0,3,9,3190,0,2006,0,98065,47.523,-121.877,3240,7131,587000,11,12,2014,0,8,5547,3891,0,0,0
3,1.75,1560,5520,1.0,0,0,4,6,780,780,1944,0,98199,47.6515,-122.399,1470,6000,524000,5,5,2014,0,70,3960,4530,0,1,1
4,2.5,2750,4800,2.0,0,0,3,9,1960,790,1905,2005,98103,47.6709,-122.337,2400,5300,1030000,13,6,2014,100,109,2050,2900,1,1,1
2,1.0,920,2332,1.0,0,0,4,8,920,0,1980,0,98198,47.3779,-122.32,1310,2853,176000,30,9,2014,0,34,1412,1543,0,0,1
2,1.0,1140,5500,1.0,0,0,3,6,1140,0,1947,0,98106,47.5187,-122.363,1110,5500,249900,21,5,2014,0,67,4360,4390,0,0,1
5,3.5,3150,10542,1.0,0,0,5,9,1620,1530,1974,0,98011,47.7469,-122.217,3150,11807,600000,11,9,2014,0,40,7392,8657,0,1,0
4,2.5,2040,7800,2.0,0,0,3,7,2040,0,2003,0,98168,47.473,-122.293,1860,10954,294000,14,8,2014,0,11,5760,9094,0,0,1
3,2.5,2240,10800,2.0,0,0,3,8,2240,0,1996,0,98028,47.7433,-122.229,1900,9900,390000,15,5,2014,0,18,8560,8000,0,0,0
5,2.75,3110,6621,2.0,0,0,3,9,3110,0,2006,0,98065,47.543,-121.888,3550,7953,635000,20,4,2015,0,9,3511,4403,0,0,0
4,1.5,1850,3600,2.0,0,0,3,8,1660,190,1929,0,98112,47.6376,-122.307,1970,3600,920000,16,4,2015,0,86,1750,1630,0,1,1
3,1.75,1570,8530,1.0,0,0,4,7,1190,380,1983,0,98033,47.6881,-122.184,1530,8708,500000,4,8,2014,0,31,6960,7178,0,1,0
2,1.0,750,4515,1.0,0,0,3,6,750,0,1942,0,98106,47.5198,-122.351,1020,5000,263500,21,8,2014,0,72,3765,3980,0,0,1
4,2.25,2240,9990,2.0,0,0,4,10,2240,0,1967,0,98040,47.5516,-122.217,2600,11480,975000,13,3,2015,0,48,7750,8880,0,0,0
3,2.5,1870,3485,2.0,0,0,3,8,1870,0,2001,0,98029,47.5493,-122.004,1940,3485,575000,14,11,2014,0,13,1615,1545,0,0,0
3,1.0,1490,7200,1.0,0,0,3,7,1490,0,1954,0,98125,47.7276,-122.307,1280,7200,300000,16,1,2015,0,61,5710,5920,0,0,1
4,2.5,2340,12080,2.0,0,0,3,8,2340,0,1999,0,98019,47.7325,-121.969,2200,12403,487600,30,3,2015,0,16,9740,10203,0,0,0
4,2.0,1700,8640,1.0,0,0,3,7,850,850,1955,2010,98006,47.5774,-122.153,1620,9000,500000,7,7,2014,55,59,6940,7380,1,1,0
2,2.0,1450,989,3.0,0,0,3,9,1450,0,2014,0,98109,47.6354,-122.346,1490,1240,680000,11,9,2014,0,0,-461,-250,0,0,1
4,1.75,1520,5250,1.0,0,0,3,6,1520,0,1949,0,98199,47.6581,-122.39,1530,5250,450000,7,8,2014,0,65,3730,3720,0,0,1
5,1.75,1260,4500,1.5,0,0,3,7,1260,0,1926,0,98119,47.6452,-122.369,1410,4388,650000,18,6,2014,0,88,3240,2978,0,0,1
3,1.75,1840,8086,1.0,0,0,4,8,1840,0,1964,0,98052,47.67,-122.155,1840,8060,550000,23,6,2014,0,50,6246,6220,0,0,0
4,2.0,1750,5202,1.0,0,1,4,6,1070,680,1942,0,98108,47.5677,-122.317,2090,5400,330000,3,12,2014,0,72,3452,3310,0,1,1
4,4.0,6330,13296,2.0,0,2,3,13,4900,1430,2000,0,98033,47.6488,-122.201,2200,9196,2390000,20,11,2014,0,14,6966,6996,0,1,0
2,2.0,1260,10200,1.0,0,0,3,7,1020,240,1983,0,98003,47.2593,-122.312,1560,10200,230000,20,11,2014,0,31,8940,8640,0,1,0
4,1.75,2100,6613,2.0,0,0,3,8,2100,0,1909,2004,98116,47.567,-122.385,1630,5750,750000,4,10,2014,95,105,4513,4120,1,0,1
4,2.5,2430,5366,2.0,0,0,3,8,2430,0,2002,0,98092,47.3352,-122.19,2100,5414,321000,16,9,2014,0,12,2936,3314,0,0,0
4,3.25,4250,18000,2.0,0,3,5,10,3350,900,1980,0,98040,47.5612,-122.229,3790,14537,2200000,27,10,2014,0,34,13750,10747,0,1,0
4,2.0,1830,10416,1.0,0,0,3,7,1370,460,1958,0,98146,47.4878,-122.341,1830,9271,245000,18,3,2015,0,57,8586,7441,0,1,1
2,1.0,1310,4000,1.0,0,0,3,6,1310,0,1913,0,98103,47.6854,-122.329,1550,4000,510000,23,12,2014,0,101,2690,2450,0,0,1
4,3.25,3090,9571,2.0,0,0,3,9,2370,720,2004,0,98052,47.7058,-122.131,3630,9110,751000,24,6,2014,0,10,6481,5480,0,1,0
3,1.75,1930,13350,1.0,0,0,3,8,1930,0,1967,0,98023,47.3317,-122.365,2270,13350,295000,26,1,2015,0,48,11420,11080,0,0,0
2,1.0,1460,6000,1.0,0,0,2,7,1260,200,1925,0,98115,47.7009,-122.317,1580,6380,312000,28,10,2014,0,89,4540,4800,0,1,1
3,3.0,3460,13129,2.0,0,0,3,9,2560,900,1988,0,98077,47.7315,-122.058,3460,12568,730000,25,9,2014,0,26,9669,9108,0,1,0
5,3.5,3290,5880,2.0,0,0,3,9,2670,620,2005,0,98052,47.7067,-122.119,3090,5680,762500,2,1,2015,0,10,2590,2590,0,1,0
3,1.0,820,7680,1.5,0,0,3,6,820,0,1910,0,98106,47.528,-122.359,1470,6912,150000,28,5,2014,0,104,6860,5442,0,0,1
3,1.0,1480,7374,1.0,0,0,3,6,760,720,1954,0,98133,47.7775,-122.336,1480,8934,270000,9,3,2015,0,61,5894,7454,0,1,1
4,2.0,1420,9301,1.0,0,0,4,7,1420,0,1963,0,98008,47.6325,-122.121,1530,8075,400000,6,4,2015,0,52,7881,6545,0,0,0
3,2.5,2790,6720,2.0,0,0,3,8,2790,0,2002,0,98075,47.5958,-122.038,2620,6720,650000,26,8,2014,0,12,3930,4100,0,0,0
2,1.5,1390,5000,1.0,0,0,4,8,970,420,1954,0,98116,47.5673,-122.401,1610,5000,530000,6,10,2014,0,60,3610,3390,0,1,1
3,1.0,950,9400,1.0,0,0,4,7,950,0,1954,0,98006,47.5746,-122.136,1260,9400,248000,30,6,2014,0,60,8450,8140,0,0,0
4,3.5,3000,5300,1.0,0,0,5,7,1780,1220,1949,0,98115,47.6748,-122.279,1360,5450,760000,8,1,2015,0,66,2300,4090,0,1,1
4,1.0,1280,10521,1.5,0,0,3,7,1280,0,1960,0,98198,47.4215,-122.289,1540,9384,199000,20,2,2015,0,55,9241,7844,0,0,1
2,1.0,870,8400,1.0,0,0,3,7,870,0,1960,0,98188,47.4493,-122.282,1070,12465,240000,20,10,2014,0,54,7530,11395,0,0,1
3,1.5,1360,1795,2.0,0,0,3,7,1360,0,1945,0,98199,47.6471,-122.397,1580,1795,415000,4,5,2015,0,70,435,215,0,0,1
4,2.5,2740,12106,1.0,0,0,3,8,1980,760,1992,0,98133,47.7648,-122.355,2170,11156,525000,25,2,2015,0,23,9366,8986,0,1,1
3,1.75,1560,5223,1.0,0,0,4,7,810,750,1940,0,98125,47.7175,-122.288,1440,8491,399950,23,6,2014,0,74,3663,7051,0,1,1
4,2.5,2590,8571,2.0,0,0,3,9,2590,0,1988,0,98052,47.691,-122.105,2360,8155,781000,13,4,2015,0,27,5981,5795,0,0,0
3,2.5,1850,1330,2.5,0,0,3,9,1560,290,2004,0,98115,47.6831,-122.325,1810,2071,827000,28,4,2015,0,11,-520,261,0,1,1
5,2.25,2500,8621,1.5,0,0,4,7,2500,0,1968,0,98034,47.7379,-122.185,1980,7395,525000,16,7,2014,0,46,6121,5415,0,0,0
4,2.5,3280,5232,2.0,0,0,3,7,3280,0,2004,0,98053,47.6798,-122.033,2600,5080,671300,24,2,2015,0,11,1952,2480,0,0,0
2,1.0,670,2378,1.0,0,0,3,5,670,0,1919,0,98126,47.5769,-122.372,700,2970,175000,4,6,2014,0,95,1708,2270,0,0,1
5,2.5,3000,10560,1.0,0,0,3,8,1500,1500,1966,0,98004,47.6249,-122.206,2690,11616,800000,6,5,2015,0,49,7560,8926,0,1,0
4,2.5,1920,4600,2.0,0,0,3,7,1920,0,2002,0,98038,47.3795,-122.023,2200,6600,329950,11,7,2014,0,12,2680,4400,0,0,0
4,3.25,1960,7200,2.0,0,0,3,7,1960,0,1979,0,98034,47.7291,-122.218,1980,7529,445000,5,8,2014,0,35,5240,5549,0,0,0
3,1.75,2000,12208,1.0,0,0,3,7,1140,860,1979,0,98032,47.3752,-122.236,1060,8194,237000,19,8,2014,0,35,10208,7134,0,1,0
6,4.0,3600,6224,2.0,0,0,3,9,2610,990,1945,2006,98199,47.6531,-122.405,1430,6224,1110000,23,9,2014,61,69,2624,4794,1,1,1
4,2.5,2740,5700,2.0,0,0,3,9,2740,0,2006,0,98038,47.3535,-122.026,3010,5281,438900,10,12,2014,0,8,2960,2271,0,0,0
9,4.5,3650,5000,2.0,0,0,3,8,2530,1120,1915,2010,98105,47.6604,-122.289,2510,5000,1280000,8,8,2014,95,99,1350,2490,1,1,1
4,2.5,2310,3866,2.0,0,0,3,8,2310,0,2005,0,98029,47.5498,-121.996,1950,4023,600000,17,10,2014,0,9,1556,2073,0,0,0
4,2.5,2095,4569,2.0,0,0,3,9,2095,0,2002,0,98052,47.6603,-122.087,2095,4385,670000,20,1,2015,0,13,2474,2290,0,0,0
2,2.0,1560,4823,1.0,0,0,3,8,1560,0,2004,0,98053,47.7111,-122.032,1855,4989,519000,4,5,2015,0,11,3263,3134,0,0,0
3,2.25,1880,7350,1.0,0,0,3,8,1390,490,1984,0,98058,47.4457,-122.123,1910,8400,320000,11,3,2015,0,31,5470,6490,0,1,0
2,1.5,840,867,2.0,0,0,3,7,840,0,2005,0,98115,47.6955,-122.304,840,1322,270000,22,5,2014,0,9,27,482,0,0,1
3,2.5,2730,5832,2.0,0,0,3,9,2730,0,1998,0,98005,47.6216,-122.161,2360,5832,1000000,2,6,2014,0,16,3102,3472,0,0,0
1,1.0,860,4800,1.0,0,0,3,6,860,0,1907,0,98122,47.6146,-122.299,1380,4800,330000,15,8,2014,0,107,3940,3420,0,0,1
3,2.0,2320,10960,1.0,0,0,3,7,1510,810,1956,0,98005,47.6157,-122.174,2160,10960,657500,10,7,2014,0,58,8640,8800,0,1,0
3,2.5,1950,13227,2.0,0,0,4,9,1950,0,1978,0,98034,47.7217,-122.256,2650,12943,540000,20,2,2015,0,37,11277,10293,0,0,0
3,1.0,1010,8848,1.0,0,0,4,7,1010,0,1968,0,98003,47.2742,-122.299,1380,10650,229900,21,7,2014,0,46,7838,9270,0,0,0
4,2.5,2830,6536,2.0,0,0,3,8,2830,0,2003,0,98038,47.3888,-122.032,2830,6872,533000,6,5,2015,0,12,3706,4042,0,0,0
4,1.75,1500,12560,1.0,0,0,4,7,1000,500,1977,0,98002,47.2918,-122.197,1700,9020,239000,22,12,2014,0,37,11060,7320,0,1,0
4,2.5,3160,8726,2.0,0,0,3,9,3160,0,1999,0,98092,47.2582,-122.223,2500,8648,427500,28,10,2014,0,15,5566,6148,0,0,0
3,1.0,1110,7000,1.5,0,0,4,7,1110,0,1955,0,98133,47.754,-122.341,1800,7000,302000,22,7,2014,0,59,5890,5200,0,0,1
3,2.5,3160,4270,2.0,0,0,3,8,2650,510,2006,0,98011,47.7453,-122.194,2720,12523,555000,28,5,2014,0,8,1110,9803,0,1,0
3,2.25,2100,3000,2.0,0,0,3,7,2100,0,1996,0,98144,47.595,-122.306,1650,4500,495000,30,12,2014,0,18,900,2850,0,0,1
3,1.5,2240,13288,1.0,0,0,3,7,2240,0,1953,0,98033,47.6762,-122.17,2150,9900,495000,22,7,2014,0,61,11048,7750,0,0,0
4,2.5,1940,7040,2.0,0,0,3,8,1940,0,1998,0,98092,47.2632,-122.209,2400,7145,320000,27,3,2015,0,17,5100,4745,0,0,0
3,1.5,1840,9990,2.0,0,0,5,8,1840,0,1961,0,98177,47.7145,-122.369,2100,12474,686000,2,6,2014,0,53,8150,10374,0,0,1
4,1.75,2260,11000,1.0,0,0,3,8,1620,640,1976,0,98008,47.6224,-122.109,1960,10000,555000,1,12,2014,0,38,8740,8040,0,1,0
2,1.0,840,3860,1.0,0,0,4,6,840,0,1909,0,98117,47.6842,-122.365,1390,3860,361500,27,10,2014,0,105,3020,2470,0,0,1
5,3.0,2830,7500,2.0,0,0,3,9,2460,370,1923,0,98105,47.6579,-122.277,2900,5000,1240000,10,6,2014,0,91,4670,2100,0,1,1
4,1.0,1600,10183,1.0,0,0,4,6,1600,0,1966,0,98002,47.277,-122.211,1410,10416,154950,9,7,2014,0,48,8583,9006,0,0,0
3,1.75,1370,8719,1.0,0,0,3,7,1370,0,1982,0,98042,47.3664,-122.087,1370,7525,247200,17,6,2014,0,32,7349,6155,0,0,0
3,2.25,1960,7414,1.0,0,0,3,7,1490,470,1984,0,98023,47.2977,-122.374,1580,8038,250000,22,8,2014,0,30,5454,6458,0,1,0
3,1.5,1470,7200,2.0,0,0,4,7,1470,0,1907,0,98118,47.5602,-122.28,1530,7200,590300,19,6,2014,0,107,5730,5670,0,0,1
5,2.75,2740,8426,1.0,0,0,4,8,1370,1370,1960,0,98006,47.5563,-122.184,2020,8783,541125,5,5,2014,0,54,5686,6763,0,1,0
2,2.5,1090,923,2.0,0,0,3,7,1090,0,2004,0,98027,47.5347,-122.071,1410,1326,310000,18,2,2015,0,11,-167,-84,0,0,0
4,2.75,2460,9520,1.0,0,1,3,8,1680,780,1976,0,98034,47.7021,-122.233,2380,9600,704111,10,3,2015,0,39,7060,7220,0,1,0
4,2.75,1960,8937,1.0,0,0,5,7,980,980,1954,0,98188,47.451,-122.278,1480,10016,325000,17,2,2015,0,61,6977,8536,0,1,1
3,2.25,1760,7023,2.0,0,0,3,7,1760,0,1995,0,98019,47.7468,-121.98,1760,7082,289200,21,11,2014,0,19,5263,5322,0,0,0
1,1.0,720,5000,1.0,0,0,4,6,720,0,1908,0,98118,47.5289,-122.272,1170,5000,185000,4,9,2014,0,106,4280,3830,0,0,1
4,3.5,3470,8580,2.0,0,0,3,11,2500,970,2007,0,98199,47.6433,-122.403,1940,7920,1450000,1,4,2015,0,8,5110,5980,0,1,1
4,2.0,1370,8100,1.0,0,0,2,7,1370,0,1947,0,98155,47.749,-122.312,1280,8100,420550,18,3,2015,0,68,6730,6820,0,0,1
4,2.25,2370,11310,1.0,0,0,3,8,1550,820,1968,0,98155,47.7684,-122.289,1890,8621,603000,10,4,2015,0,47,8940,6731,0,1,1
3,1.0,1390,2640,1.5,0,0,3,7,1230,160,1903,0,98122,47.6078,-122.307,1780,3920,345000,26,11,2014,0,111,1250,2140,0,1,1
3,2.0,1840,3075,1.0,0,0,5,7,920,920,1928,0,98103,47.6894,-122.35,1480,3774,650000,16,4,2015,0,87,1235,2294,0,1,1
2,2.25,1460,1607,2.0,0,0,3,8,1460,0,2007,0,98106,47.5395,-122.369,1460,1826,309950,19,8,2014,0,7,147,366,0,0,1
4,1.5,2230,5109,1.5,0,0,3,7,1330,900,1918,0,98115,47.6996,-122.31,1630,5109,590000,29,10,2014,0,96,2879,3479,0,1,1
4,3.0,3250,2760,2.5,0,0,3,8,2420,830,1905,2007,98122,47.6104,-122.303,1260,2780,863500,28,4,2015,102,110,-490,1520,1,1,1
3,1.0,1190,7000,1.0,0,0,3,7,1190,0,1943,0,98199,47.6453,-122.403,1350,7000,517500,19,11,2014,0,71,5810,5650,0,0,1
3,3.0,2090,7440,1.5,0,0,5,7,1290,800,1922,0,98103,47.6891,-122.331,1570,4960,700000,24,12,2014,0,92,5350,3390,0,1,1
3,2.5,2580,8154,1.0,0,0,3,10,2090,490,1956,1997,98177,47.7259,-122.361,1660,8155,699000,22,7,2014,41,58,5574,6495,1,1,1
3,2.5,2100,3574,2.0,0,0,3,7,1690,410,2005,0,98019,47.7453,-121.984,1970,2962,350000,22,7,2014,0,9,1474,992,0,1,0
4,2.5,3160,16564,2.0,0,0,3,10,3160,0,1987,0,98074,47.6365,-122.04,3160,12415,795000,17,7,2014,0,27,13404,9255,0,0,0
3,2.5,2090,7640,1.0,0,0,3,7,1360,730,1962,2014,98133,47.7369,-122.338,2090,7668,543000,14,5,2014,52,52,5550,5578,1,1,1
3,2.5,1570,3143,2.0,0,0,3,7,1570,0,2001,0,98019,47.7364,-121.969,1740,3591,325000,23,2,2015,0,14,1573,1851,0,0,0
3,1.0,1020,6000,1.5,0,0,3,7,1020,0,1900,0,98108,47.5254,-122.318,1240,6000,337500,8,5,2015,0,115,4980,4760,0,0,1
2,1.0,1300,11080,1.0,0,0,4,7,1300,0,1955,0,98034,47.7281,-122.233,1600,9259,425000,27,2,2015,0,60,9780,7659,0,0,0
3,2.5,2110,9773,1.0,0,0,3,9,2110,0,1986,0,98006,47.5628,-122.115,2560,11787,780000,17,3,2015,0,29,7663,9227,0,0,0
2,1.0,1210,17389,1.0,0,0,4,5,1210,0,1948,0,98059,47.5044,-122.148,2140,14419,259000,23,7,2014,0,66,16179,12279,0,0,0
4,1.75,1990,12950,1.0,0,0,4,8,1850,140,1968,0,98006,47.5434,-122.166,2090,12850,524400,13,8,2014,0,46,10960,10760,0,1,0
3,2.0,1630,8018,1.0,0,0,3,7,1630,0,2003,0,98001,47.2638,-122.243,1610,8397,260000,27,5,2014,0,11,6388,6787,0,0,0
2,2.0,1384,1822,2.0,0,0,3,7,1384,0,1990,0,98028,47.7525,-122.244,1078,1315,273000,20,4,2015,0,25,438,237,0,0,0
4,2.5,2480,8626,2.0,0,0,3,10,2480,0,2001,0,98001,47.3185,-122.262,2990,9033,420000,26,8,2014,0,13,6146,6043,0,0,0
3,1.0,1270,8000,1.0,0,0,4,7,1270,0,1957,0,98007,47.5874,-122.136,1470,8000,510500,13,8,2014,0,57,6730,6530,0,0,0
4,1.0,1010,7200,1.5,0,0,3,6,1010,0,1947,0,98155,47.742,-122.325,1360,7200,290000,8,4,2015,0,68,6190,5840,0,0,1
3,1.75,1490,6269,1.0,0,0,4,6,990,500,1944,0,98056,47.4917,-122.188,1490,7722,226000,28,4,2015,0,71,4779,6232,0,1,0
2,1.0,820,3844,1.0,0,0,4,6,820,0,1916,0,98133,47.7049,-122.349,1520,3844,300000,29,5,2014,0,98,3024,2324,0,0,1
3,2.0,1810,10860,1.0,0,0,3,7,1810,0,1967,0,98053,47.6393,-121.967,1420,11982,407450,28,7,2014,0,47,9050,10562,0,0,0
4,2.25,3060,7920,1.0,0,0,3,7,1530,1530,1965,0,98178,47.4879,-122.245,1850,7800,390000,6,5,2015,0,50,4860,5950,0,1,1
3,2.5,1820,7242,1.0,0,0,3,7,1220,600,1959,0,98188,47.4318,-122.292,1350,8214,239975,23,1,2015,0,56,5422,6864,0,1,1
3,2.5,2320,5760,1.0,0,0,3,7,1480,840,1987,0,98178,47.504,-122.248,1660,5762,375000,7,8,2014,0,27,3440,4102,0,1,1
4,2.5,2620,4400,2.0,0,0,3,9,2620,0,2004,0,98029,47.5524,-121.991,2640,4554,742500,28,4,2015,0,11,1780,1914,0,0,0
4,1.75,2190,11625,1.0,0,0,4,8,2020,170,1956,0,98146,47.4979,-122.363,1920,8855,450000,29,4,2015,0,59,9435,6935,0,1,1
3,2.25,1780,10395,1.0,0,0,3,8,1780,0,1967,0,98058,47.4539,-122.15,2080,9360,300000,26,6,2014,0,47,8615,7280,0,0,0
3,1.75,2200,7700,1.0,0,0,3,7,1240,960,1975,0,98031,47.4119,-122.181,1770,7360,216600,1,5,2015,0,40,5500,5590,0,1,0
3,1.75,1600,6120,1.5,0,0,3,7,1600,0,1924,0,98115,47.6847,-122.291,1670,4590,525000,14,5,2014,0,90,4520,2920,0,0,1
3,1.75,1850,8667,1.0,0,0,4,7,880,970,1982,0,98033,47.7025,-122.198,1450,10530,450000,16,9,2014,0,32,6817,9080,0,1,0
4,1.0,1740,4400,1.5,0,0,3,7,1740,0,1924,0,98122,47.6058,-122.3,1590,4400,382000,2,12,2014,0,90,2660,2810,0,0,1
3,2.25,1490,9600,1.0,0,0,4,7,1170,320,1987,0,98019,47.7378,-121.977,1590,10104,287000,13,5,2014,0,27,8110,8514,0,1,0
3,2.25,1380,3015,2.0,0,0,3,7,1380,0,2009,0,98052,47.6783,-122.157,1930,3612,435000,28,10,2014,0,5,1635,1682,0,0,0
2,1.0,1510,4032,1.5,0,0,3,8,1310,200,1935,0,98199,47.6371,-122.393,1700,4042,575000,12,6,2014,0,79,2522,2342,0,1,1
3,1.5,1410,3600,1.0,0,0,3,7,1410,0,1906,0,98109,47.6402,-122.357,1370,3600,626700,4,5,2015,0,109,2190,2230,0,0,1
4,1.5,1440,8680,1.5,0,0,3,7,1440,0,1922,0,98178,47.502,-122.228,1440,9000,352000,18,3,2015,0,93,7240,7560,0,0,1
3,1.0,920,6750,1.0,0,0,4,7,920,0,1951,0,98004,47.6322,-122.212,1460,8933,650000,16,3,2015,0,64,5830,7473,0,0,0
3,1.0,1090,17630,1.0,0,0,4,7,1090,0,1962,0,98002,47.288,-122.196,1300,12000,197000,6,10,2014,0,52,16540,10700,0,0,0
8,2.75,2790,6695,1.0,0,0,3,7,1470,1320,1977,0,98133,47.7565,-122.331,1760,7624,340000,3,7,2014,0,37,3905,5864,0,1,1
3,1.75,1340,6300,1.0,0,0,3,7,1340,0,1972,0,98034,47.7186,-122.218,1780,7200,354000,7,1,2015,0,43,4960,5420,0,0,0
4,2.5,2570,9086,2.0,0,0,3,9,2570,0,1999,0,98074,47.6373,-122.064,2760,6733,670000,1,8,2014,0,15,6516,3973,0,0,0
4,3.5,3010,6202,2.0,0,0,3,9,3010,0,2005,0,98029,47.5533,-121.993,2520,5001,769000,26,1,2015,0,10,3192,2481,0,0,0
4,2.5,2160,3139,1.0,0,0,3,7,1080,1080,1940,0,98103,47.6662,-122.338,1650,3740,650000,5,9,2014,0,74,979,2090,0,1,1
3,1.75,2140,9484,1.0,0,0,3,7,1290,850,1953,0,98004,47.6234,-122.191,1960,9630,650000,15,6,2014,0,61,7344,7670,0,1,0
4,1.75,2090,7416,1.0,0,0,4,7,1050,1040,1970,0,98031,47.4107,-122.179,1710,7527,289950,12,12,2014,0,44,5326,5817,0,1,0
4,1.75,1760,5750,1.0,0,2,5,7,1070,690,1962,0,98126,47.5521,-122.373,1860,5750,471000,3,12,2014,0,52,3990,3890,0,1,1
4,2.5,2500,8540,2.0,0,0,3,9,2500,0,1990,0,98029,47.5759,-121.994,2560,8475,639000,18,7,2014,0,24,6040,5915,0,0,0
2,1.0,930,6900,1.0,0,2,3,7,930,0,1952,0,98178,47.506,-122.242,1910,7194,287000,9,10,2014,0,62,5970,5284,0,0,1
4,2.5,3030,8335,2.0,0,0,3,10,3030,0,1992,0,98075,47.578,-122.056,2850,8678,740000,1,4,2015,0,23,5305,5828,0,0,0
3,2.0,1460,3000,1.0,0,0,4,7,940,520,1990,0,98117,47.682,-122.365,1460,3000,499922,17,4,2015,0,25,1540,1540,0,1,1
4,2.5,2940,14071,2.0,0,0,3,9,2940,0,1986,0,98029,47.5627,-122.018,2670,10982,675000,19,12,2014,0,28,11131,8312,0,0,0
5,2.75,3360,9200,2.0,0,0,3,9,3360,0,2014,0,98011,47.7754,-122.173,3360,9713,738515,9,9,2014,0,0,5840,6353,0,0,0
3,1.75,2110,4800,1.0,0,0,3,8,1210,900,1956,0,98108,47.567,-122.318,1660,4800,445000,30,10,2014,0,58,2690,3140,0,1,1
4,2.25,2740,11343,1.0,0,2,5,10,1980,760,1953,0,98125,47.7117,-122.278,2790,10027,1040000,1,5,2015,0,62,8603,7237,0,1,1
2,1.0,1070,2196,1.0,0,0,4,7,880,190,1917,0,98144,47.5726,-122.308,1160,3600,346000,1,10,2014,0,97,1126,2440,0,1,1
3,2.0,1680,4886,2.0,0,0,3,7,1180,500,1940,0,98118,47.5536,-122.286,1400,4900,450000,8,4,2015,0,75,3206,3500,0,1,1
4,2.5,2260,13755,1.0,0,0,4,9,2260,0,1975,0,98042,47.3767,-122.161,2650,13650,350000,12,8,2014,0,39,11495,11000,0,0,0
4,3.5,5860,7200,2.0,0,0,5,10,3690,2170,1907,0,98112,47.6287,-122.287,4150,7200,2400000,28,7,2014,0,107,1340,3050,0,1,1
5,3.0,3320,5354,2.0,0,0,3,9,3320,0,2004,0,98103,47.6542,-122.331,2330,4040,1700000,14,5,2015,0,11,2034,1710,0,0,1
2,1.0,1050,9000,1.5,0,0,4,7,1050,0,1984,0,98003,47.2887,-122.299,1550,9600,219000,10,10,2014,0,30,7950,8050,0,0,0
4,2.5,2070,3982,2.0,0,0,3,7,2070,0,2004,0,98065,47.531,-121.854,2340,4067,450000,9,4,2015,0,11,1912,1727,0,0,0
4,2.25,1790,7311,2.0,0,0,3,7,1790,0,1992,0,98056,47.5055,-122.189,1400,7203,402000,15,4,2015,0,23,5521,5803,0,0,0
2,1.0,840,4000,1.0,0,0,3,6,840,0,1942,0,98108,47.5531,-122.307,1100,4000,275000,17,2,2015,0,73,3160,2900,0,0,1
3,1.5,990,4500,1.0,0,0,5,7,990,0,1948,0,98122,47.6051,-122.298,1490,4000,421500,1,10,2014,0,66,3510,2510,0,0,1
3,1.75,1620,9600,1.0,0,0,4,7,1620,0,1966,0,98059,47.4749,-122.155,1660,10200,314000,18,3,2015,0,49,7980,8540,0,0,0
4,2.0,1340,8190,1.0,0,0,4,7,1340,0,1942,0,98146,47.4905,-122.343,1410,9721,287000,23,4,2015,0,73,6850,8311,0,0,1
4,1.0,1500,5750,1.5,0,0,3,6,1500,0,1925,0,98055,47.4768,-122.206,1330,5750,277000,3,4,2015,0,90,4250,4420,0,0,0
2,1.0,1300,6731,1.0,0,0,3,7,1300,0,1950,0,98116,47.5697,-122.395,1240,6731,337500,22,12,2014,0,64,5431,5491,0,0,1
4,2.75,3100,10245,2.0,0,0,3,10,3100,0,1999,0,98052,47.6858,-122.107,3140,9028,792000,19,8,2014,0,15,7145,5888,0,0,0
3,2.5,3380,7074,2.0,0,0,3,8,2200,1180,1999,0,98019,47.7462,-121.978,2060,6548,435000,13,11,2014,0,15,3694,4488,0,1,0
4,2.5,2660,9030,1.0,0,0,4,7,1450,1210,1977,0,98055,47.4558,-122.212,1870,9030,313100,25,3,2015,0,38,6370,7160,0,1,0
3,2.25,1700,3333,1.5,0,0,3,7,1100,600,1924,0,98117,47.6784,-122.361,1700,3750,575000,25,6,2014,0,90,1633,2050,0,1,1
4,2.5,1840,7800,1.0,0,2,3,8,1240,600,1972,0,98177,47.7762,-122.384,2010,9100,510000,2,2,2015,0,43,5960,7090,0,1,1
2,1.0,890,5200,1.0,0,0,4,6,890,0,1941,0,98126,47.5311,-122.373,950,5200,299950,19,3,2015,0,74,4310,4250,0,0,1
3,3.0,2800,5800,1.0,0,0,3,9,1580,1220,1953,2010,98199,47.6493,-122.413,2580,5800,1030000,23,3,2015,57,62,3000,3220,1,1,1
4,1.75,2010,8625,1.0,0,0,4,7,1340,670,1957,0,98133,47.7496,-122.355,1500,8400,364000,14,5,2014,0,57,6615,6900,0,1,1
3,1.0,1380,7470,1.0,0,0,5,7,1380,0,1965,0,98133,47.7479,-122.343,1440,7473,335000,29,7,2014,0,49,6090,6033,0,0,1
3,1.0,1210,8000,1.0,0,0,3,6,1210,0,1954,0,98198,47.4211,-122.314,1430,8000,219950,9,12,2014,0,60,6790,6570,0,0,1
3,2.0,1280,6994,1.0,0,0,3,7,1280,0,1991,0,98038,47.3889,-122.048,1290,7514,215000,13,1,2015,0,24,5714,6224,0,0,0
3,1.0,1580,6300,1.0,0,0,3,7,1180,400,1925,0,98199,47.6505,-122.384,1560,1601,535000,30,6,2014,0,89,4720,41,0,1,1
4,2.0,1910,7826,1.0,0,0,4,7,1140,770,1973,0,98003,47.3493,-122.306,1540,7826,253000,19,8,2014,0,41,5916,6286,0,1,0
2,2.5,1740,2500,2.0,0,2,3,8,1210,530,1994,0,98112,47.622,-122.3,1640,2500,650000,30,5,2014,0,20,760,860,0,1,1
3,2.25,1130,4445,1.5,0,0,4,8,1130,0,1930,0,98117,47.6845,-122.375,1330,4445,672000,8,4,2015,0,85,3315,3115,0,0,1
3,1.75,1970,8540,1.0,0,3,4,8,1130,840,1950,0,98177,47.7213,-122.365,2280,8540,606000,7,10,2014,0,64,6570,6260,0,1,1
3,2.25,1780,9720,1.0,0,0,3,8,1280,500,1981,0,98059,47.4762,-122.156,1710,9790,292000,5,3,2015,0,34,7940,8080,0,1,0
3,2.0,1670,7757,1.0,0,0,3,8,1670,0,1992,0,98030,47.3802,-122.207,2290,7859,289950,4,6,2014,0,22,6087,5569,0,0,0
4,1.5,1360,9323,1.0,0,0,4,7,1360,0,1968,0,98023,47.3168,-122.401,1180,9611,257500,22,7,2014,0,46,7963,8431,0,0,0
3,2.5,1840,6985,1.0,0,0,3,7,1290,550,1971,0,98133,47.7586,-122.342,2160,7990,380000,4,11,2014,0,43,5145,5830,0,1,1
3,1.75,1255,1113,3.0,0,0,3,8,1255,0,2010,0,98103,47.6958,-122.343,1010,1038,360000,22,12,2014,0,4,-142,28,0,0,1
3,1.75,1840,7412,1.0,0,0,4,7,1240,600,1976,0,98031,47.3933,-122.188,1980,7350,269500,23,6,2014,0,38,5572,5370,0,1,0
4,2.5,2960,6031,2.0,0,0,3,9,2960,0,2005,0,98038,47.3596,-122.04,2570,5012,449000,30,6,2014,0,9,3071,2442,0,0,0
4,1.5,1430,7232,1.5,0,0,3,7,1430,0,1948,0,98125,47.7197,-122.328,1540,7232,375000,3,10,2014,0,66,5802,5692,0,0,1
5,4.75,5990,10450,2.0,1,4,3,11,4050,1940,2002,0,98027,47.5554,-122.077,3330,14810,2200000,19,6,2014,0,12,4460,11480,0,1,0
5,3.25,4260,7861,2.0,0,0,3,10,4260,0,2005,0,98074,47.611,-121.992,4020,7528,994000,18,9,2014,0,9,3601,3508,0,0,0
5,2.25,1820,10500,1.0,0,0,4,7,1080,740,1979,0,98031,47.4058,-122.177,1820,7500,275000,25,2,2015,0,36,8680,5680,0,1,0
2,1.0,1290,2482,2.0,0,0,3,7,1290,0,2008,0,98053,47.6972,-122.025,1290,2482,300000,29,4,2015,0,7,1192,1192,0,0,0
5,2.5,2130,8428,2.0,0,0,3,7,2130,0,2013,0,98168,47.4726,-122.282,1500,11810,380000,14,4,2015,0,2,6298,10310,0,0,1
3,2.0,1170,10051,1.0,0,0,4,7,1170,0,1957,0,98198,47.4229,-122.324,1440,9800,200000,2,3,2015,0,58,8881,8360,0,0,1
3,3.5,1730,1349,3.0,0,0,3,9,1350,380,2009,0,98102,47.6224,-122.326,1830,3300,635000,2,9,2014,0,5,-381,1470,0,1,1
2,1.0,880,5750,1.0,0,0,3,6,880,0,1939,0,98126,47.5642,-122.379,1190,5750,280000,6,11,2014,0,75,4870,4560,0,0,1
3,2.5,2380,6832,2.0,0,0,3,8,2380,0,2002,0,98065,47.5372,-121.876,2580,6832,574000,25,6,2014,0,12,4452,4252,0,0,0
4,1.0,1330,9729,1.0,0,0,3,6,1330,0,1952,0,98004,47.6223,-122.208,2920,10353,1050000,4,2,2015,0,63,8399,7433,0,0,0
3,1.5,1220,8400,1.0,0,0,4,7,1220,0,1962,0,98006,47.5467,-122.173,2110,9119,271950,27,3,2015,0,53,7180,7009,0,0,0
2,1.0,1180,10800,1.0,0,0,3,7,1180,0,1984,0,98011,47.7273,-122.236,1600,10800,400000,19,8,2014,0,30,9620,9200,0,0,0
4,2.5,2310,6200,2.0,0,0,3,8,2310,0,1998,0,98092,47.3321,-122.172,2480,6200,334000,10,9,2014,0,16,3890,3720,0,0,0
4,2.0,1440,4855,2.0,0,0,4,7,1440,0,1972,0,98144,47.5717,-122.287,1300,4080,332500,22,12,2014,0,42,3415,2780,0,0,1
2,1.5,1620,1444,2.0,0,0,3,9,1080,540,2007,0,98144,47.5892,-122.309,1660,1642,525000,23,9,2014,0,7,-176,-18,0,1,1
3,2.5,2620,8403,2.0,0,0,3,8,2620,0,1991,0,98038,47.3675,-122.042,2190,7842,408000,24,2,2015,0,24,5783,5652,0,0,0
4,2.5,3710,7491,2.0,0,0,3,9,3710,0,2003,0,98029,47.5596,-122.016,3040,7491,846450,27,4,2015,0,12,3781,4451,0,0,0
3,1.5,1040,10323,1.0,0,0,4,7,1040,0,1958,0,98005,47.5882,-122.155,1580,7200,411100,20,10,2014,0,56,9283,5620,0,0,0
5,3.25,3320,11340,2.0,0,0,4,8,2480,840,1999,0,98042,47.3904,-122.154,2330,8339,409124,9,7,2014,0,15,8020,6009,0,1,0
2,1.5,800,5192,1.0,0,0,5,7,800,0,1951,0,98146,47.5119,-122.386,1190,5320,335950,7,7,2014,0,63,4392,4130,0,0,1
5,2.5,2040,9597,1.0,0,0,4,7,1240,800,1963,0,98052,47.6544,-122.134,1800,8553,480000,31,3,2015,0,52,7557,6753,0,1,0
4,2.5,2670,4410,2.0,0,0,3,8,2670,0,1999,0,98075,47.5978,-122.038,2670,4410,668000,21,7,2014,0,15,1740,1740,0,0,0
4,2.5,2930,8641,2.0,0,0,3,8,2930,0,2010,0,98034,47.7199,-122.246,2120,11175,750000,27,4,2015,0,5,5711,9055,0,0,0
2,1.0,830,4000,1.0,0,0,3,6,830,0,1955,0,98117,47.6929,-122.379,950,4000,394475,14,5,2014,0,59,3170,3050,0,0,1
5,1.75,2290,4320,2.0,0,0,3,7,1980,310,1928,0,98105,47.664,-122.31,2870,4320,848000,26,3,2015,0,87,2030,1450,0,1,1
3,1.5,2510,3600,2.5,0,0,4,8,2510,0,1907,0,98112,47.6195,-122.313,1740,1885,675000,24,9,2014,0,107,1090,145,0,0,1
3,1.0,1280,7572,1.0,0,0,4,6,1280,0,1958,0,98058,47.4491,-122.176,1170,7667,175000,6,11,2014,0,56,6292,6497,0,0,0
4,1.5,1810,6000,1.0,0,1,3,8,1350,460,1952,0,98136,47.5233,-122.386,2020,6000,560000,6,11,2014,0,62,4190,3980,0,1,1
5,2.75,2080,13189,2.0,0,0,3,8,2080,0,1987,0,98074,47.6288,-122.031,2030,11847,538888,31,5,2014,0,27,11109,9817,0,0,0
4,1.75,1680,9244,2.0,0,0,3,8,1680,0,1991,0,98166,47.4612,-122.352,1840,9387,359000,8,9,2014,0,23,7564,7547,0,0,1
3,2.25,1660,5128,2.0,0,0,3,7,1660,0,2001,0,98019,47.7362,-121.967,1680,4652,300000,1,7,2014,0,13,3468,2972,0,0,0
3,2.5,1650,5994,2.0,0,0,4,7,1650,0,1989,0,98030,47.3603,-122.19,1930,6666,273000,17,9,2014,0,25,4344,4736,0,0,0
3,2.5,1420,1438,2.0,0,0,3,9,1280,140,2003,0,98102,47.6265,-122.323,1490,1439,670000,10,7,2014,0,11,18,-51,0,1,1
4,2.25,2240,8376,1.0,0,0,3,8,1740,500,1984,0,98074,47.6323,-122.029,1890,7875,530000,18,11,2014,0,30,6136,5985,0,1,0
3,1.5,1230,3060,1.0,0,0,3,7,910,320,1927,0,98103,47.667,-122.333,1260,4488,625000,11,7,2014,0,87,1830,3228,0,1,1
3,1.0,1260,6000,1.0,0,0,4,6,1260,0,1954,0,98198,47.4187,-122.323,1520,6600,248000,5,5,2015,0,61,4740,5080,0,0,1
3,2.5,2060,4812,2.0,0,0,3,8,2060,0,1990,0,98029,47.5793,-122.002,1930,5264,533000,19,8,2014,0,24,2752,3334,0,0,0
4,3.5,3090,10510,1.0,0,0,3,8,2190,900,1991,0,98034,47.7176,-122.214,2200,7408,549950,11,12,2014,0,23,7420,5208,0,1,0
4,1.75,3220,7392,1.0,0,0,4,8,2010,1210,1959,0,98177,47.7719,-122.361,1660,8363,485000,14,10,2014,0,55,4172,6703,0,1,1
3,2.5,2020,4845,2.0,0,0,3,7,2020,0,2001,0,98038,47.3848,-122.033,1930,5134,353500,6,5,2015,0,14,2825,3204,0,0,0
2,1.75,1910,12142,1.0,0,0,3,9,1910,0,1976,0,98074,47.6276,-122.053,2580,12326,435000,15,9,2014,0,38,10232,9746,0,0,0
3,1.0,1150,10000,1.0,0,0,3,6,1000,150,1951,0,98178,47.5075,-122.262,1340,10000,241000,4,11,2014,0,63,8850,8660,0,1,1
4,2.75,2730,3560,1.5,0,0,3,8,1550,1180,1921,2007,98115,47.6737,-122.304,1860,3560,885000,19,5,2014,86,93,830,1700,1,1,1
6,3.0,2890,2370,2.5,0,0,3,7,2290,600,1906,0,98102,47.6227,-122.323,2180,2460,799200,13,5,2014,0,108,-520,280,0,1,1
3,2.5,2280,12746,1.0,0,0,4,8,1490,790,1973,0,98005,47.6362,-122.175,2100,12746,760000,14,1,2015,0,42,10466,10646,0,1,0
2,1.0,1040,5700,1.0,0,0,3,6,1040,0,1922,0,98118,47.519,-122.26,1380,5700,270000,13,11,2014,0,92,4660,4320,0,0,1
4,1.75,2440,7475,1.0,0,0,4,9,2040,400,1969,0,98052,47.6339,-122.096,2040,8480,675000,17,2,2015,0,46,5035,6440,0,1,0
3,2.5,1720,5940,1.0,0,0,4,8,1000,720,1977,0,98052,47.6631,-122.129,1720,6136,499000,22,12,2014,0,37,4220,4416,0,1,0
4,2.5,2570,4865,2.0,0,0,3,8,2570,0,2005,0,98038,47.3588,-122.038,2570,4933,320000,27,6,2014,0,9,2295,2363,0,0,0
4,2.75,2060,7350,1.0,0,0,3,7,1210,850,1978,0,98001,47.3424,-122.275,1940,7420,275000,22,8,2014,0,36,5290,5480,0,1,0
4,2.5,3020,8302,2.0,0,0,4,10,3020,0,1994,0,98042,47.363,-122.127,3020,8406,490000,10,6,2014,0,20,5282,5386,0,0,0
3,2.5,2340,4200,1.5,0,0,3,7,1540,800,1906,0,98122,47.6033,-122.303,1590,4200,550000,25,7,2014,0,108,1860,2610,0,1,1
5,2.0,2400,9537,1.0,0,0,5,7,1210,1190,1959,0,98056,47.5112,-122.186,1760,9533,390000,7,5,2015,0,56,7137,7773,0,1,0
3,2.25,1610,11920,1.0,0,0,4,7,1110,500,1968,0,98032,47.3683,-122.279,1690,11839,277000,20,10,2014,0,46,10310,10149,0,1,0
3,1.75,1090,7647,1.0,0,0,3,7,1090,0,1994,0,98003,47.2613,-122.302,1660,9219,236000,17,3,2015,0,21,6557,7559,0,0,0
3,2.25,1670,6240,1.0,0,0,4,8,1240,430,1974,0,98008,47.6413,-122.113,1910,7000,545000,2,3,2015,0,41,4570,5090,0,1,0
3,2.5,1850,10109,2.0,0,0,3,8,1850,0,1991,0,98034,47.7163,-122.229,1780,9660,535000,6,5,2014,0,23,8259,7880,0,0,0
3,2.75,3940,9671,1.0,0,4,5,9,2140,1800,1967,0,98006,47.5654,-122.158,3390,9360,1450000,7,10,2014,0,47,5731,5970,0,1,0
4,3.0,2330,3497,2.0,0,0,3,9,1920,410,2003,0,98108,47.554,-122.308,2330,5242,490000,30,6,2014,0,11,1167,2912,0,1,1
4,2.5,2020,7200,1.5,0,0,4,6,2020,0,1954,0,98065,47.5223,-121.818,1440,7200,319950,8,4,2015,0,61,5180,5760,0,0,0
3,1.5,1300,7200,1.0,0,0,5,7,1300,0,1960,0,98033,47.6821,-122.196,2280,7200,625000,4,7,2014,0,54,5900,4920,0,0,0
3,1.0,1180,6947,1.0,0,0,4,7,1180,0,1968,0,98031,47.4233,-122.177,1760,8657,248000,20,2,2015,0,47,5767,6897,0,0,0
3,1.75,1320,7840,1.0,0,0,3,8,1320,0,1966,0,98007,47.6024,-122.143,2050,7644,475000,21,4,2015,0,49,6520,5594,0,0,0
6,2.75,2520,9324,1.0,0,0,4,7,1320,1200,1962,0,98155,47.7636,-122.294,1820,11000,410000,19,6,2014,0,52,6804,9180,0,1,1
3,2.5,1680,2000,3.0,0,0,3,9,1680,0,1909,1998,98105,47.6604,-122.29,1950,5000,670000,5,5,2014,89,105,320,3050,1,0,1
2,1.0,1180,4900,1.0,0,0,5,6,1180,0,1954,0,98027,47.5321,-122.029,1650,7121,313000,28,10,2014,0,60,3720,5471,0,0,0
2,2.0,1880,5400,1.5,0,0,3,8,1880,0,1902,0,98112,47.6238,-122.311,1590,5400,751750,27,5,2014,0,112,3520,3810,0,0,1
4,2.5,2990,5280,2.0,0,0,3,9,2210,780,2003,0,98027,47.5353,-122.066,2990,6299,760000,9,9,2014,0,11,2290,3309,0,1,0
4,3.0,3110,7231,2.0,0,0,3,8,3110,0,1997,0,98092,47.3279,-122.191,2820,7311,367500,2,5,2014,0,17,4121,4491,0,0,0
4,2.5,2150,5000,2.0,0,0,3,8,2150,0,2001,0,98115,47.6962,-122.314,2030,6380,580000,4,8,2014,0,13,2850,4350,0,0,1
3,2.25,1900,3960,1.5,0,0,3,8,1200,700,1905,0,98122,47.6122,-122.298,1310,3960,580000,2,7,2014,0,109,2060,2650,0,1,1
4,2.5,2720,10000,2.0,0,0,3,10,2720,0,1987,0,98074,47.6293,-122.051,2720,10020,665000,2,6,2014,0,27,7280,7300,0,0,0
3,2.25,1560,8280,2.0,0,0,4,7,1560,0,1979,0,98001,47.3393,-122.259,1920,8120,239950,5,11,2014,0,35,6720,6200,0,0,0
3,1.75,1740,3060,1.0,0,0,5,8,950,790,1930,2014,98115,47.6816,-122.31,1800,3960,733000,15,8,2014,84,84,1320,2160,1,1,1
4,2.0,2130,8400,1.0,0,0,3,7,1350,780,1962,0,98031,47.4133,-122.209,1550,8596,250000,30,1,2015,0,53,6270,7046,0,1,0
4,1.75,1510,9176,1.0,0,0,5,7,1510,0,1957,0,98133,47.7651,-122.339,1480,9176,402000,8,9,2014,0,57,7666,7696,0,0,1
5,3.5,2100,5107,2.0,0,0,3,7,1410,690,1999,0,98178,47.5108,-122.257,1410,5650,295000,11,6,2014,0,15,3007,4240,0,1,1
5,2.5,2344,8000,1.0,0,0,4,8,1560,784,1976,0,98023,47.3185,-122.377,2344,8000,355000,16,10,2014,0,38,5656,5656,0,1,0
3,2.25,1470,9140,2.0,0,2,3,7,1470,0,1982,0,98133,47.7162,-122.349,1400,8204,376000,12,11,2014,0,32,7670,6804,0,0,1
2,1.0,940,5040,1.0,0,0,3,7,940,0,1926,0,98126,47.5375,-122.374,940,5040,212700,27,6,2014,0,88,4100,4100,0,0,1
3,1.75,1780,13095,1.0,0,0,4,9,1780,0,1983,0,98042,47.367,-122.152,2750,13095,325000,27,5,2014,0,31,11315,10345,0,0,0
4,2.5,2230,5743,2.0,0,0,3,7,2230,0,2002,0,98019,47.7245,-121.957,2490,6300,415000,11,8,2014,0,12,3513,3810,0,0,0
3,2.5,3570,15151,1.0,0,0,4,8,2400,1170,1981,0,98177,47.7475,-122.364,3140,14375,935000,2,4,2015,0,34,11581,11235,0,1,1
3,2.5,1920,15260,2.0,0,0,3,7,1920,0,1990,0,98019,47.7317,-121.964,2370,15235,372000,16,1,2015,0,25,13340,12865,0,0,0
3,1.5,1290,8366,1.0,0,0,3,7,1020,270,1957,0,98168,47.4853,-122.318,1770,8400,240000,21,10,2014,0,57,7076,6630,0,1,1
3,1.75,1880,16262,1.0,0,0,5,7,1880,0,1980,0,98059,47.5089,-122.155,1900,7972,334950,15,9,2014,0,34,14382,6072,0,0,0
4,2.5,2960,4640,2.0,0,0,3,9,2960,0,2005,0,98038,47.3597,-122.04,2750,4623,426500,30,4,2015,0,10,1680,1873,0,0,0
2,1.75,1840,14874,1.0,0,2,3,8,1300,540,1952,0,98166,47.4382,-122.348,2920,15084,430000,24,2,2015,0,63,13034,12164,0,1,1
3,1.5,1890,6183,1.0,0,0,3,7,1090,800,1967,0,98118,47.5396,-122.269,1750,6183,400000,11,12,2014,0,47,4293,4433,0,1,1
3,2.25,1820,6000,1.0,0,0,4,7,1120,700,1964,0,98108,47.5684,-122.3,1970,6232,455850,28,4,2015,0,51,4180,4262,0,1,1
4,3.5,4370,8510,2.0,0,1,3,10,3610,760,2003,0,98004,47.5876,-122.204,2960,10347,1970000,2,6,2014,0,11,4140,7387,0,1,0
3,1.75,1530,10731,1.0,0,0,3,7,1530,0,1986,0,98028,47.7655,-122.244,2100,12593,400000,4,6,2014,0,28,9201,10493,0,0,0
3,1.0,1030,10480,1.0,0,0,4,7,1030,0,1954,0,98006,47.5742,-122.139,1480,12200,397500,8,8,2014,0,60,9450,10720,0,0,0
3,2.5,2000,1950,3.0,0,0,3,8,2000,0,2005,0,98109,47.6476,-122.356,1560,1340,755000,11,12,2014,0,9,-50,-220,0,0,1
5,1.5,1730,9230,1.0,0,0,3,7,1010,720,1962,0,98058,47.4646,-122.184,1730,9230,287000,9,7,2014,0,52,7500,7500,0,1,0
3,2.5,2040,9622,2.0,0,0,3,8,2040,0,1995,0,98045,47.4833,-121.8,2390,9868,490000,16,4,2015,0,20,7582,7478,0,0,0
3,2.5,2640,6715,2.0,0,0,3,8,1680,960,1991,0,98058,47.441,-122.125,2260,7373,365000,18,6,2014,0,23,4075,5113,0,1,0
3,2.5,1600,2244,2.0,0,0,3,7,1600,0,2005,0,98056,47.4899,-122.164,1600,1700,260000,24,2,2015,0,10,644,100,0,0,0
4,1.0,1480,12675,1.5,0,0,4,7,1480,0,1929,0,98133,47.763,-122.342,1820,7995,505000,14,4,2015,0,86,11195,6175,0,0,1
2,1.0,700,4800,1.0,0,0,3,7,700,0,1922,0,98122,47.6147,-122.3,1440,4800,260000,27,6,2014,0,92,4100,3360,0,0,1
2,1.0,700,4800,1.0,0,0,3,7,700,0,1922,0,98122,47.6147,-122.3,1440,4800,430000,6,1,2015,0,93,4100,3360,0,0,1
4,2.5,3520,12193,2.0,0,0,4,10,3520,0,1993,0,98027,47.5535,-122.095,3470,11318,905000,24,7,2014,0,21,8673,7848,0,0,0
3,2.0,1650,6408,2.0,0,0,4,8,1650,0,1977,0,98052,47.6638,-122.128,1750,6402,440000,3,12,2014,0,37,4758,4652,0,0,0
4,1.0,1360,5500,1.5,0,0,3,7,1360,0,1950,0,98115,47.6878,-122.285,1530,5790,439500,13,9,2014,0,64,4140,4260,0,0,1
3,2.0,1350,6696,1.0,0,0,5,6,680,670,1944,0,98056,47.4919,-122.187,1350,6700,270000,27,1,2015,0,71,5346,5350,0,1,0
3,2.5,1970,6291,2.0,0,0,4,7,1970,0,1998,0,98042,47.3627,-122.073,1980,8852,306500,29,4,2015,0,17,4321,6872,0,0,0
3,2.0,1470,1656,2.0,0,0,3,8,1310,160,2003,0,98126,47.5653,-122.369,1470,2288,380000,19,10,2014,0,11,186,818,0,1,1
4,1.75,1610,9652,1.0,0,0,5,7,1610,0,1969,0,98042,47.3281,-122.135,1220,9800,215000,22,7,2014,0,45,8042,8580,0,0,0
2,1.0,810,6150,1.0,0,0,3,7,810,0,1950,0,98133,47.7289,-122.34,1080,7200,299900,6,2,2015,0,65,5340,6120,0,0,1
4,3.5,2820,7809,2.0,0,0,3,10,2820,0,1995,0,98004,47.622,-122.195,2630,7904,1450000,27,3,2015,0,20,4989,5274,0,0,0
4,2.5,1830,7345,1.0,0,0,4,8,1540,290,1973,0,98177,47.7741,-122.373,1990,7700,494000,23,6,2014,0,41,5515,5710,0,1,1
4,1.5,1730,7700,1.0,0,0,4,7,1010,720,1963,0,98059,47.4996,-122.163,1650,8066,317500,5,1,2015,0,52,5970,6416,0,1,0
4,2.5,2110,7291,2.0,0,0,4,7,2110,0,1977,0,98033,47.6888,-122.201,2350,8625,670000,3,3,2015,0,38,5181,6275,0,0,0
3,2.5,3060,7831,2.0,0,2,3,9,3060,0,2004,0,98065,47.5401,-121.861,3140,7438,650000,20,8,2014,0,10,4771,4298,0,0,0
4,2.5,2620,7328,2.0,0,0,3,8,2620,0,1983,0,98118,47.5514,-122.263,1670,5080,852000,20,3,2015,0,32,4708,3410,0,0,1
2,1.5,1088,1360,2.0,0,0,3,7,1088,0,1983,0,98034,47.7094,-122.213,1098,1469,250000,17,6,2014,0,31,272,371,0,0,0
3,1.5,1400,10853,1.0,0,0,4,7,1400,0,1964,0,98055,47.4433,-122.194,1620,10849,264950,10,12,2014,0,50,9453,9229,0,0,0
2,2.0,1540,6804,1.0,0,0,5,7,1020,520,1942,0,98177,47.7044,-122.372,1380,6930,582500,25,9,2014,0,72,5264,5550,0,1,1
3,2.5,1540,1564,2.0,0,0,3,7,1300,240,1998,0,98144,47.586,-122.313,1540,2875,384000,11,3,2015,0,17,24,1335,0,1,1
3,1.5,2310,3360,1.5,0,0,3,8,1790,520,1926,0,98119,47.6431,-122.359,1930,4320,817000,28,10,2014,0,88,1050,2390,0,1,1
4,1.75,1730,9520,1.0,0,0,4,7,1730,0,1971,0,98059,47.4756,-122.157,1550,11211,320000,1,12,2014,0,43,7790,9661,0,0,0
2,1.0,900,4500,1.0,0,0,3,7,900,0,1951,0,98118,47.5273,-122.265,1175,5320,263300,7,3,2015,0,64,3600,4145,0,0,1
3,1.0,860,6635,1.0,0,0,3,6,860,0,1952,0,98133,47.7508,-122.339,1170,8000,215000,28,1,2015,0,63,5775,6830,0,0,1
5,4.0,2980,4500,1.5,0,0,3,7,2070,910,1921,0,98115,47.6736,-122.323,1560,4225,842500,15,11,2014,0,93,1520,2665,0,1,1
5,4.0,2980,4500,1.5,0,0,3,7,2070,910,1921,0,98115,47.6736,-122.323,1560,4225,850000,11,4,2015,0,94,1520,2665,0,1,1
5,2.5,2740,12413,2.0,0,0,3,7,2740,0,1990,0,98031,47.4199,-122.183,1900,7416,386000,1,10,2014,0,24,9673,5516,0,0,0
4,2.5,1790,5257,2.0,0,0,3,7,1790,0,1996,0,98030,47.3849,-122.204,1680,5320,251100,9,12,2014,0,18,3467,3640,0,0,0
4,4.0,3610,12811,2.0,0,0,3,10,3610,0,2000,0,98075,47.5812,-121.993,3530,11783,870000,22,9,2014,0,14,9201,8253,0,0,0
3,1.75,1570,15500,1.0,0,0,4,7,1570,0,1968,0,98052,47.6916,-122.122,1610,7500,555000,14,7,2014,0,46,13930,5890,0,0,0
3,1.0,940,2366,1.0,0,0,3,6,940,0,1916,0,98107,47.6744,-122.383,1500,5000,356000,17,3,2015,0,99,1426,3500,0,0,1
4,2.5,2920,6000,2.0,0,4,3,9,2920,0,2004,0,98065,47.5333,-121.859,3100,6001,675000,3,12,2014,0,10,3080,2901,0,0,0
4,2.25,2260,11900,2.0,0,0,3,9,2260,0,1976,0,98074,47.6415,-122.057,2470,11900,605000,26,12,2014,0,38,9640,9430,0,0,0
5,2.0,2000,4211,1.5,0,2,4,7,1280,720,1908,0,98112,47.6283,-122.301,1680,4000,690500,25,6,2014,0,106,2211,2320,0,1,1
2,1.75,1440,4225,1.0,0,0,3,8,1440,0,2005,0,98053,47.7143,-122.032,1680,6200,437000,19,6,2014,0,9,2785,4520,0,0,0
5,2.0,2310,13430,1.5,0,0,4,8,2310,0,1966,0,98004,47.6395,-122.203,2810,13906,850000,10,7,2014,0,48,11120,11096,0,0,0
4,2.25,2300,4600,1.5,0,0,4,7,1340,960,1904,0,98144,47.5895,-122.311,1540,3000,350000,12,6,2014,0,110,2300,1460,0,1,1
2,2.25,1490,6770,1.5,0,0,3,8,1490,0,1926,0,98108,47.5577,-122.297,1820,7875,480000,22,6,2014,0,88,5280,6055,0,0,1
5,4.5,4440,9784,2.0,0,0,3,10,4440,0,2012,0,98168,47.4702,-122.275,2720,10080,600000,24,9,2014,0,2,5344,7360,0,0,1
4,3.5,4970,16582,2.0,0,3,4,11,3930,1040,1992,0,98006,47.5496,-122.12,3580,13335,1440000,30,3,2015,0,23,11612,9755,0,1,0
2,1.5,1000,1075,2.0,0,0,3,7,840,160,2007,0,98144,47.5708,-122.288,1000,1083,303000,18,12,2014,0,7,75,83,0,1,1
4,2.5,4940,10037,1.0,0,4,3,9,3450,1490,1953,0,98178,47.5095,-122.247,2430,9272,800000,6,2,2015,0,62,5097,6842,0,1,1
2,2.0,1980,6000,1.5,0,0,5,7,1220,760,1906,0,98103,47.6809,-122.351,1280,3900,549000,24,7,2014,0,108,4020,2620,0,1,1
3,2.5,1560,9600,1.0,0,0,3,7,1210,350,1964,0,98188,47.457,-122.27,2070,9600,324950,26,11,2014,0,50,8040,7530,0,1,1
2,1.0,870,6537,1.0,0,0,3,6,870,0,1948,0,98168,47.4906,-122.306,1100,8701,170000,26,9,2014,0,66,5667,7601,0,0,1
3,1.0,840,6500,1.0,0,0,5,6,840,0,1969,0,98042,47.3704,-122.08,870,5200,178000,15,7,2014,0,45,5660,4330,0,0,0
3,1.0,1250,8314,1.0,0,0,3,6,1250,0,1958,0,98058,47.4522,-122.178,1188,7700,144000,21,4,2015,0,57,7064,6512,0,0,0
2,1.0,750,7000,1.0,0,0,3,6,750,0,1932,0,98024,47.5655,-121.89,1100,8777,258000,27,4,2015,0,83,6250,7677,0,0,0
3,1.75,710,5050,1.0,0,0,4,6,710,0,1950,0,98126,47.5194,-122.375,900,5050,345000,16,10,2014,0,64,4340,4150,0,0,1
3,1.75,2290,14800,1.0,0,0,3,8,1620,670,1965,0,98155,47.7735,-122.273,2320,12474,470000,10,6,2014,0,49,12510,10154,0,1,1
3,1.5,980,7790,1.0,0,0,5,7,980,0,1969,0,98034,47.7141,-122.213,1390,7280,350000,21,5,2014,0,45,6810,5890,0,0,0
2,1.75,1590,11276,1.0,0,0,4,7,1590,0,1972,0,98002,47.3177,-122.21,1750,10687,225500,26,6,2014,0,42,9686,8937,0,0,0
2,1.0,940,4000,1.0,0,0,3,6,720,220,1942,0,98199,47.6488,-122.385,1180,6000,473000,24,2,2015,0,73,3060,4820,0,1,1
3,1.75,1750,9623,1.0,0,0,3,7,1150,600,1962,0,98198,47.3997,-122.313,1820,9623,279000,26,2,2015,0,53,7873,7803,0,1,1
3,1.0,1460,8227,1.0,0,0,3,6,880,580,1948,0,98125,47.7009,-122.301,1530,8128,470000,14,4,2015,0,67,6767,6598,0,1,1
3,1.75,1540,4800,1.0,0,0,4,6,770,770,1925,0,98105,47.67,-122.284,1510,4080,565000,20,8,2014,0,89,3260,2570,0,1,1
3,2.0,2560,6800,1.0,0,1,4,8,1380,1180,1952,0,98136,47.5506,-122.395,1780,6800,695000,22,4,2015,0,63,4240,5020,0,1,1
3,2.5,1880,4499,2.0,0,0,3,8,1880,0,1993,0,98029,47.5664,-121.999,2130,5114,529000,4,3,2015,0,22,2619,2984,0,0,0
3,2.25,1840,10500,2.0,0,0,3,7,1840,0,1993,0,98034,47.7326,-122.234,1840,7374,481500,29,10,2014,0,21,8660,5534,0,0,0
3,2.0,1060,7412,1.0,0,0,3,7,1060,0,1987,0,98038,47.3897,-122.051,1080,7093,211000,27,3,2015,0,28,6352,6013,0,0,0
3,2.25,1790,7500,1.0,0,0,3,7,1390,400,1973,0,98034,47.7321,-122.198,1940,7192,455000,10,4,2015,0,42,5710,5252,0,1,0
2,1.0,810,4838,1.0,0,0,3,5,810,0,1938,0,98055,47.4909,-122.203,890,4838,238950,3,11,2014,0,76,4028,3948,0,0,0
4,3.5,2600,5100,2.0,0,0,3,8,1820,780,2003,0,98117,47.6948,-122.395,2000,6720,722500,18,9,2014,0,11,2500,4720,0,1,1
4,2.25,2240,9600,2.0,0,0,3,8,2240,0,1971,0,98032,47.361,-122.281,2050,9240,327500,7,5,2015,0,44,7360,7190,0,0,0
4,3.0,3400,5100,2.0,0,0,3,9,3400,0,2006,0,98038,47.3548,-122.002,3400,5672,585000,23,3,2015,0,9,1700,2272,0,0,0
4,2.0,3140,10875,1.0,0,1,3,7,1940,1200,1939,1969,98199,47.6656,-122.406,3300,10080,775000,13,6,2014,30,75,7735,6780,1,1,1
4,2.5,2780,4200,2.0,0,0,3,8,2780,0,2001,0,98075,47.5989,-122.039,2510,4200,645000,24,10,2014,0,13,1420,1690,0,0,0
4,2.75,2320,12368,1.0,0,0,3,8,1670,650,1968,0,98133,47.7373,-122.35,2070,9575,445000,5,1,2015,0,47,10048,7505,0,1,1
3,1.75,1370,5858,1.0,0,0,3,7,1370,0,1987,0,98198,47.3815,-122.313,1400,7500,257950,2,5,2014,0,27,4488,6100,0,0,1
5,1.75,2230,7560,1.0,0,0,3,7,1230,1000,1959,0,98178,47.5055,-122.26,1380,6570,375000,24,3,2015,0,56,5330,5190,0,1,1
3,2.5,1610,7223,2.0,0,0,3,7,1610,0,1994,0,98030,47.3661,-122.173,1610,7162,245000,9,7,2014,0,20,5613,5552,0,0,0
4,2.5,2810,4922,2.0,0,0,3,9,2810,0,2005,0,98074,47.614,-122.041,2920,4922,702000,4,3,2015,0,10,2112,2002,0,0,0
3,1.75,1850,14986,2.0,0,0,3,6,1850,0,1943,2005,98059,47.4837,-122.148,2660,10650,330000,18,8,2014,62,71,13136,7990,1,0,0
3,1.5,1790,4800,1.5,0,0,3,8,1790,0,1912,0,98119,47.6332,-122.362,1780,3600,940000,16,4,2015,0,103,3010,1820,0,0,1
3,1.0,1150,11396,1.5,0,0,4,7,1150,0,1950,0,98155,47.7435,-122.296,1600,8146,354500,5,3,2015,0,65,10246,6546,0,0,1
4,2.75,2420,8700,1.5,0,0,4,7,2420,0,1914,0,98002,47.3109,-122.229,1070,4804,279950,22,2,2015,0,101,6280,3734,0,0,0
3,2.25,1580,7034,1.0,0,0,4,7,1180,400,1989,0,98038,47.3564,-122.04,1470,7358,284000,7,5,2015,0,26,5454,5888,0,1,0
3,1.0,920,4875,1.0,0,0,4,7,920,0,1978,0,98042,47.3623,-122.09,1160,4875,152000,10,7,2014,0,36,3955,3715,0,0,0
3,1.0,960,10181,1.0,0,0,3,7,960,0,1961,0,98034,47.7231,-122.229,1740,10194,322000,27,1,2015,0,54,9221,8454,0,0,0
3,1.75,1120,4000,1.0,0,0,4,7,870,250,1916,0,98107,47.6684,-122.368,1470,4000,445000,31,7,2014,0,98,2880,2530,0,1,1
3,1.0,1560,3960,1.5,0,0,4,7,1560,0,1907,0,98144,47.5936,-122.301,1280,3960,595000,30,7,2014,0,107,2400,2680,0,0,1
3,1.0,1380,7334,1.0,0,0,3,7,980,400,1981,0,98055,47.4339,-122.192,1910,7859,165000,13,5,2015,0,34,5954,5949,0,1,0
4,2.5,1940,6206,2.0,0,0,3,7,1940,0,1990,0,98023,47.3063,-122.359,2060,7092,278500,10,6,2014,0,24,4266,5032,0,0,0
3,1.75,1810,10625,1.0,0,0,3,8,1370,440,1973,0,98027,47.5322,-122.049,2140,10922,517500,13,3,2015,0,42,8815,8782,0,1,0
2,1.0,1100,4200,1.0,0,0,3,7,1100,0,1954,0,98136,47.5312,-122.392,1240,4000,343566,18,6,2014,0,60,3100,2760,0,0,1
4,2.25,1980,9714,1.0,0,0,3,7,1170,810,1977,0,98002,47.3207,-122.209,1610,9272,286285,5,11,2014,0,37,7734,7662,0,1,0
4,1.5,1340,6200,1.0,0,0,5,6,1340,0,1959,0,98008,47.6214,-122.119,1210,7178,474905,6,2,2015,0,56,4860,5968,0,0,0
3,1.75,1680,4800,1.0,0,0,4,7,1400,280,1960,0,98126,47.5535,-122.377,1540,5000,550000,14,7,2014,0,54,3120,3460,0,1,1
4,2.5,2060,16000,2.0,0,0,3,6,2060,0,1993,0,98001,47.2849,-122.251,1530,8000,286000,29,1,2015,0,22,13940,6470,0,0,0
3,3.25,2620,7215,1.0,0,0,4,8,1770,850,1980,0,98004,47.5836,-122.2,2180,8931,900000,8,8,2014,0,34,4595,6751,0,1,0
3,2.25,1610,5159,2.0,0,0,3,7,1610,0,1985,0,98029,47.5675,-122.019,1610,5210,449950,20,8,2014,0,29,3549,3600,0,0,0
4,1.5,1490,7560,2.0,0,0,3,7,1490,0,1966,0,98198,47.3684,-122.318,1490,7689,259000,12,6,2014,0,48,6070,6199,0,0,1
3,2.25,1900,8125,1.0,0,0,3,7,1540,360,1969,0,98058,47.4564,-122.162,1480,8284,340000,2,12,2014,0,45,6225,6804,0,1,0
2,1.0,1840,3300,1.5,0,0,4,6,1130,710,1910,0,98107,47.6757,-122.362,1320,4000,490000,9,5,2014,0,104,1460,2680,0,1,1
4,2.0,2330,6250,1.0,0,0,4,7,1400,930,1941,0,98030,47.3782,-122.228,2050,9000,344950,27,5,2014,0,73,3920,6950,0,1,0
3,2.0,2250,2975,2.0,0,0,4,9,1880,370,1905,0,98112,47.6289,-122.309,2690,4800,950000,27,8,2014,0,109,725,2110,0,1,1
4,1.75,2000,3988,1.0,0,4,4,7,1000,1000,1958,0,98116,47.5925,-122.391,1690,4144,810000,9,7,2014,0,56,1988,2454,0,1,1
2,2.5,3010,16050,1.0,0,3,4,9,1260,1750,1976,0,98006,47.5643,-122.16,3010,11612,998160,9,3,2015,0,39,13040,8602,0,1,0
3,1.75,1680,7389,1.0,0,0,3,8,1150,530,1979,0,98056,47.5199,-122.184,2100,10348,377000,10,12,2014,0,35,5709,8248,0,1,0
3,2.0,1530,6773,1.0,0,0,4,8,1530,0,1984,0,98033,47.6653,-122.194,2240,7201,595000,26,8,2014,0,30,5243,4961,0,0,0
2,1.0,970,4800,1.0,0,0,3,6,970,0,1911,1940,98116,47.5754,-122.414,1180,5900,313300,18,8,2014,29,103,3830,4720,1,0,1
5,1.75,1550,5225,1.5,0,0,4,7,1550,0,1941,0,98108,47.554,-122.306,1220,5225,360000,25,7,2014,0,73,3675,4005,0,0,1
3,1.75,1660,7350,1.0,0,0,2,8,1660,0,1979,0,98023,47.3118,-122.337,1840,7673,188000,23,3,2015,0,36,5690,5833,0,0,0
5,3.5,3210,4060,2.0,0,2,3,10,2290,920,1917,2003,98117,47.6801,-122.357,1940,5000,1290000,10,9,2014,86,97,850,3060,1,1,1
3,1.0,1480,13280,2.5,0,0,3,6,1480,0,1940,0,98027,47.5378,-122.043,1510,8723,455000,14,7,2014,0,74,11800,7213,0,0,0
5,3.5,3600,9312,2.0,0,3,3,10,2680,920,2005,0,98052,47.6582,-122.122,3420,9860,817500,9,10,2014,0,9,5712,6440,0,1,0
3,2.25,1700,1481,3.0,0,0,3,8,1700,0,2002,0,98103,47.6598,-122.349,1560,1350,550000,22,9,2014,0,12,-219,-210,0,0,1
3,1.75,1680,8725,1.0,0,0,3,8,1240,440,1978,0,98023,47.3107,-122.397,2020,8352,260000,5,5,2015,0,37,7045,6332,0,1,0
3,3.25,3780,10623,1.0,0,1,3,11,2650,1130,1999,0,98006,47.5506,-122.101,3850,11170,1150000,16,9,2014,0,15,6843,7320,0,1,0
4,2.5,2360,7370,1.0,0,0,3,7,1460,900,1985,0,98125,47.7201,-122.308,1590,9906,362000,20,4,2015,0,30,5010,8316,0,1,1
3,2.5,1810,1750,2.0,0,0,3,7,1350,460,1997,0,98199,47.6513,-122.386,1640,1563,503500,23,4,2015,0,18,-60,-77,0,1,1
3,2.5,2290,3475,2.0,0,0,3,9,2290,0,2006,0,98029,47.5551,-122.001,2340,3626,653000,2,6,2014,0,8,1185,1286,0,0,0
4,2.75,3370,12447,2.0,0,0,3,10,3370,0,1991,0,98077,47.7309,-122.058,3700,13129,760000,4,6,2014,0,23,9077,9429,0,0,0
4,1.75,2090,5050,1.0,0,0,4,7,1090,1000,1916,0,98117,47.6802,-122.358,1760,5000,775000,25,11,2014,0,98,2960,3240,0,1,1
5,1.75,2060,10911,1.0,0,0,4,7,1360,700,1954,0,98177,47.7767,-122.365,2060,9688,417500,24,2,2015,0,61,8851,7628,0,1,1
3,1.5,1560,9350,1.0,0,0,4,7,1220,340,1969,0,98052,47.6729,-122.148,1870,8671,525000,11,7,2014,0,45,7790,6801,0,1,0
2,1.0,730,2400,1.0,0,1,3,4,730,0,1934,0,98198,47.35,-122.322,1220,4382,217000,14,4,2015,0,81,1670,3162,0,0,1
4,2.75,2910,6308,1.0,0,0,3,8,1640,1270,1985,0,98011,47.7352,-122.201,1970,7127,525000,9,7,2014,0,29,3398,5157,0,1,0
4,2.25,2490,8700,1.0,0,0,3,7,1890,600,1976,0,98155,47.7397,-122.324,1470,7975,442500,24,3,2015,0,39,6210,6505,0,1,1
4,1.75,1710,10440,1.0,0,0,4,7,1710,0,1955,0,98006,47.5756,-122.158,1480,10440,525000,9,7,2014,0,59,8730,8960,0,0,0
4,1.75,1520,10630,1.0,0,0,4,7,1520,0,1967,0,98034,47.7347,-122.193,1550,8039,425500,25,2,2015,0,48,9110,6489,0,0,0
4,3.0,3160,10948,1.0,0,3,3,8,1930,1230,1991,0,98070,47.3733,-122.422,2380,13623,545000,14,11,2014,0,23,7788,11243,0,1,0
3,2.25,1700,8100,1.0,0,0,3,7,1200,500,1980,0,98038,47.3601,-122.046,1700,8100,245000,22,4,2015,0,35,6400,6400,0,1,0
2,1.0,810,6697,1.0,0,0,4,6,810,0,1923,0,98002,47.3057,-122.216,1140,6695,194900,11,7,2014,0,91,5887,5555,0,0,0
4,2.5,2000,5390,2.0,0,0,3,7,2000,0,2003,0,98042,47.3732,-122.129,2330,5390,284000,6,5,2014,0,11,3390,3060,0,0,0
4,2.0,1730,5500,1.0,0,0,5,7,1010,720,1943,0,98106,47.5304,-122.353,1080,4900,360000,12,5,2014,0,71,3770,3820,0,1,1
2,1.0,720,4323,1.0,0,0,3,6,720,0,1942,0,98199,47.6604,-122.401,1460,3300,405000,5,9,2014,0,72,3603,1840,0,0,1
4,2.5,3560,13981,2.0,0,0,3,10,3560,0,2000,0,98075,47.6002,-121.98,3840,13624,865000,14,4,2015,0,15,10421,9784,0,0,0
4,2.0,1210,11100,1.0,0,0,4,7,1210,0,1955,0,98006,47.5747,-122.145,1280,11100,483300,10,6,2014,0,59,9890,9820,0,0,0
4,2.5,2130,9268,2.0,0,0,4,8,2130,0,1985,0,98092,47.262,-122.22,2100,8400,355000,18,3,2015,0,30,7138,6300,0,0,0
3,2.25,1570,8767,1.0,0,0,3,7,1180,390,1990,0,98038,47.3568,-122.038,1570,7434,274950,30,4,2015,0,25,7197,5864,0,1,0
3,4.5,3950,6134,2.0,0,3,3,11,2880,1070,1998,0,98199,47.6413,-122.405,3050,5281,1930000,5,12,2014,0,16,2184,2231,0,1,1
3,3.25,3450,15586,2.0,0,0,3,11,2690,760,1989,0,98166,47.4294,-122.343,3560,15046,755000,31,12,2014,0,25,12136,11486,0,1,1
3,1.75,1150,9600,1.0,0,0,3,7,1150,0,1979,0,98045,47.4434,-121.774,1520,9976,309212,16,6,2014,0,35,8450,8456,0,0,0
3,2.25,1500,7615,1.0,0,0,3,7,1150,350,1984,0,98023,47.3146,-122.351,1540,8649,219950,4,6,2014,0,30,6115,7109,0,1,0
3,2.5,1300,5150,1.5,0,0,4,7,1300,0,1920,0,98117,47.6838,-122.362,1400,4017,690000,23,7,2014,0,94,3850,2617,0,0,1
3,1.75,1290,4000,1.0,0,0,3,6,1170,120,1943,0,98106,47.5309,-122.354,1140,4000,250800,5,10,2014,0,71,2710,2860,0,1,1
4,1.75,2320,3825,1.5,0,0,5,8,1820,500,1926,0,98105,47.6659,-122.327,1940,3825,941000,24,6,2014,0,88,1505,1885,0,1,1
4,2.75,2030,8600,1.0,0,0,4,7,1230,800,1977,0,98042,47.3942,-122.16,1810,8600,305000,22,4,2015,0,38,6570,6790,0,1,0
4,3.0,3330,6990,1.5,0,3,5,9,2330,1000,1928,0,98144,47.5886,-122.287,2620,5310,1240000,8,9,2014,0,86,3660,2690,0,1,1
3,2.5,2110,8164,2.0,0,0,3,9,2110,0,1990,0,98056,47.5269,-122.171,2390,7499,535000,26,12,2014,0,24,6054,5109,0,0,0
3,1.0,1175,10454,1.0,0,0,4,6,1175,0,1949,0,98004,47.6388,-122.218,2010,10800,775000,21,7,2014,0,65,9279,8790,0,0,0
3,2.0,1590,8670,1.0,0,0,3,7,1590,0,1994,0,98042,47.3725,-122.073,1590,9253,255000,18,7,2014,0,20,7080,7663,0,0,0
2,1.0,1070,9750,1.0,0,0,3,7,1070,0,1947,0,98155,47.7532,-122.318,1500,8775,327000,11,8,2014,0,67,8680,7275,0,0,1
4,2.0,2720,8819,2.0,0,3,3,8,2240,480,1976,0,98003,47.338,-122.333,2960,9672,560000,20,11,2014,0,38,6099,6712,0,1,0
4,3.5,2980,6349,2.0,0,3,3,9,2980,0,1998,0,98033,47.6819,-122.208,2870,6349,1340000,30,1,2015,0,17,3369,3479,0,0,0
3,1.75,1160,5200,1.0,0,0,4,7,1160,0,1977,0,98042,47.3643,-122.09,1470,5200,199500,4,12,2014,0,37,4040,3730,0,0,0
3,2.25,3020,6000,3.0,0,2,3,8,1980,1040,1994,0,98108,47.5249,-122.319,1150,6000,439000,30,3,2015,0,21,2980,4850,0,1,1
4,2.25,2380,5250,1.0,0,0,4,7,1410,970,1961,0,98008,47.6164,-122.115,2150,8560,527000,30,9,2014,0,53,2870,6410,0,1,0
3,2.75,2270,13590,1.5,0,0,4,6,1300,970,1948,0,98022,47.2099,-122.001,1160,13545,199950,16,7,2014,0,66,11320,12385,0,1,0
3,2.25,1660,8188,2.0,0,0,4,7,1660,0,1988,0,98042,47.3766,-122.115,1660,7000,254000,4,2,2015,0,27,6528,5340,0,0,0
2,1.0,830,5000,1.0,0,0,4,7,830,0,1921,0,98103,47.6914,-122.352,1110,5000,393000,23,3,2015,0,94,4170,3890,0,0,1
5,2.25,2480,12614,1.0,0,0,4,8,1860,620,1979,0,98011,47.7393,-122.2,2470,12392,585000,21,11,2014,0,35,10134,9922,0,1,0
2,2.0,1900,7740,1.0,0,0,4,7,1150,750,1923,0,98126,47.5227,-122.372,1140,7740,450000,16,7,2014,0,91,5840,6600,0,1,1
2,1.75,1670,4008,1.0,0,0,3,9,1670,0,2005,0,98029,47.5539,-122.001,2330,3752,565000,25,6,2014,0,9,2338,1422,0,0,0
5,2.25,2000,7900,1.0,0,0,4,7,1300,700,1986,0,98188,47.4291,-122.292,2000,9132,330000,22,5,2014,0,28,5900,7132,0,1,1
4,2.5,1860,8117,1.0,0,0,4,8,1460,400,1966,0,98008,47.6228,-122.104,2040,8199,585000,23,7,2014,0,48,6257,6159,0,1,0
3,2.0,1400,7384,1.0,0,0,3,7,1150,250,1979,0,98058,47.4655,-122.174,1820,7992,225000,15,5,2014,0,35,5984,6172,0,1,0
3,2.0,1400,7384,1.0,0,0,3,7,1150,250,1979,0,98058,47.4655,-122.174,1820,7992,295000,25,3,2015,0,36,5984,6172,0,1,0
3,2.75,2850,14800,1.0,0,0,4,9,1920,930,1976,0,98006,47.559,-122.146,3300,10809,775000,26,6,2014,0,38,11950,7509,0,1,0
3,1.0,1370,11050,1.0,0,0,3,7,1370,0,1981,0,98045,47.4485,-121.776,1520,10000,280000,17,7,2014,0,33,9680,8480,0,0,0
3,2.5,2170,3200,1.5,0,0,5,7,1280,890,1923,0,98103,47.6543,-122.347,1180,1224,539000,8,9,2014,0,91,1030,44,0,1,1
4,2.25,1970,7902,1.0,0,0,3,8,1310,660,1960,0,98125,47.7249,-122.298,1860,8021,442500,5,2,2015,0,55,5932,6161,0,1,1
5,3.75,2980,4635,3.0,0,0,3,8,2980,0,1997,0,98118,47.5508,-122.268,1100,5150,598200,7,5,2015,0,18,1655,4050,0,0,1
4,2.5,2300,10843,2.0,0,0,5,8,2300,0,1955,0,98033,47.6988,-122.202,1780,10843,610000,14,10,2014,0,59,8543,9063,0,0,0
3,2.5,1990,4936,2.0,0,0,3,8,1990,0,2004,0,98075,47.5911,-122.018,2250,4815,544900,21,11,2014,0,10,2946,2565,0,0,0
3,2.5,2160,7500,1.0,0,1,3,7,1430,730,1979,0,98074,47.6188,-122.064,1560,7500,532500,11,8,2014,0,35,5340,5940,0,1,0
4,3.25,3300,15907,2.0,0,0,5,10,3300,0,1985,0,98040,47.5413,-122.216,2740,11358,1350000,9,6,2014,0,29,12607,8618,0,0,0
3,2.0,1840,2825,1.0,0,0,3,7,1040,800,1920,0,98112,47.6428,-122.302,1820,3750,750000,30,4,2015,0,95,985,1930,0,1,1
3,2.5,2030,10958,2.0,0,0,3,8,2030,0,1983,0,98052,47.7251,-122.11,1960,10282,530000,19,11,2014,0,31,8928,8322,0,0,0
3,2.5,1400,2036,2.0,0,0,3,7,1400,0,2003,0,98136,47.5516,-122.382,1500,2036,346100,17,7,2014,0,11,636,536,0,0,1
3,1.75,1410,9150,1.0,0,0,5,7,1410,0,1959,0,98006,47.5683,-122.178,1800,9940,365000,29,8,2014,0,55,7740,8140,0,0,0
4,2.5,1820,6916,2.0,0,0,3,7,1820,0,1994,0,98038,47.3862,-122.029,1680,6995,318400,24,7,2014,0,20,5096,5315,0,0,0
4,2.5,1910,7172,2.0,0,0,3,8,1910,0,1993,0,98155,47.7615,-122.309,1630,10127,498500,3,3,2015,0,22,5262,8497,0,0,1
3,1.75,1540,7490,1.0,0,0,5,7,1540,0,1971,0,98034,47.7222,-122.177,1270,7350,450000,8,4,2015,0,44,5950,6080,0,0,0
3,2.0,1430,7905,1.0,0,0,4,7,1430,0,1988,0,98092,47.2757,-122.145,1870,8400,200000,27,3,2015,0,27,6475,6530,0,0,0
3,1.0,1010,8906,1.0,0,0,5,7,1010,0,1968,0,98042,47.3627,-122.108,1150,10414,234000,9,9,2014,0,46,7896,9264,0,0,0
2,1.0,940,8384,1.0,0,0,3,5,940,0,1947,0,98146,47.5065,-122.364,1290,8384,121800,4,8,2014,0,67,7444,7094,0,0,1
3,2.75,2600,5875,1.5,0,2,5,8,1600,1000,1929,0,98116,47.5773,-122.406,2260,5492,805000,26,6,2014,0,85,3275,3232,0,1,1
4,2.25,2060,7283,1.0,0,0,3,8,1220,840,1963,2013,98155,47.7435,-122.317,1500,8134,410000,8,7,2014,50,51,5223,6634,1,1,1
3,2.5,1920,4534,2.0,0,0,3,8,1920,0,1986,0,98034,47.7144,-122.204,1380,5100,475000,18,2,2015,0,29,2614,3720,0,0,0
1,1.0,1020,7920,1.0,0,0,3,7,1020,0,1947,1983,98106,47.5385,-122.355,1000,7168,269000,18,9,2014,36,67,6900,6168,1,0,1
4,2.25,2150,9520,2.0,0,0,4,8,2150,0,1979,0,98052,47.6885,-122.113,2000,9520,573000,24,7,2014,0,35,7370,7520,0,0,0
3,2.5,1660,2890,2.0,0,0,3,7,1660,0,2001,0,98108,47.5434,-122.293,1540,2890,330000,27,3,2015,0,14,1230,1350,0,0,1
4,1.0,1230,7410,1.5,0,0,3,7,1230,0,1944,0,98166,47.4798,-122.344,1020,7648,252750,26,6,2014,0,70,6180,6628,0,0,1
2,2.5,2170,7546,1.0,0,0,3,8,2170,0,2007,0,98053,47.7242,-122.032,2170,7083,745000,6,4,2015,0,8,5376,4913,0,0,0
3,2.0,1280,7633,1.0,0,0,3,7,1280,0,1991,0,98038,47.3883,-122.05,1450,6783,280000,4,3,2015,0,24,6353,5333,0,0,0
4,2.5,2240,6920,1.0,0,0,5,8,1380,860,1974,0,98146,47.5011,-122.375,1540,7000,535000,30,4,2015,0,41,4680,5460,0,1,1
4,1.5,1780,5100,1.0,0,0,3,7,1320,460,1953,0,98115,47.6944,-122.288,1880,5100,580000,12,3,2015,0,62,3320,3220,0,1,1
3,1.75,1840,7200,1.0,0,0,4,7,1220,620,1968,0,98055,47.456,-122.209,1770,8075,301000,12,12,2014,0,46,5360,6305,0,1,0
4,1.75,1740,7700,1.0,0,0,5,7,1740,0,1968,0,98008,47.6259,-122.111,1740,8120,600000,24,6,2014,0,46,5960,6380,0,0,0
5,3.0,3040,6604,2.0,0,0,3,9,3040,0,2005,0,98106,47.548,-122.356,1650,6825,538900,11,8,2014,0,9,3564,5175,0,0,1
3,2.5,2370,4375,2.0,0,0,3,8,2370,0,2006,0,98038,47.354,-121.999,2380,4606,366000,9,2,2015,0,9,2005,2226,0,0,0
4,2.5,2100,6783,2.0,0,0,3,8,2100,0,2003,0,98042,47.3504,-122.141,2100,6192,303000,19,8,2014,0,11,4683,4092,0,0,0
3,2.25,1470,1578,2.0,0,0,3,8,1090,380,2007,0,98136,47.5388,-122.387,1470,1668,432000,22,5,2014,0,7,108,198,0,1,1
2,1.5,1300,6120,1.0,0,0,3,6,820,480,1945,0,98146,47.5088,-122.338,1250,6120,300000,9,4,2015,0,70,4820,4870,0,1,1
3,3.0,3420,7826,2.0,0,0,4,8,2430,990,1939,0,98144,47.5873,-122.29,980,6300,908800,20,10,2014,0,75,4406,5320,0,1,1
3,1.5,1190,4750,1.0,0,0,3,7,970,220,1940,0,98107,47.6726,-122.386,1460,4750,500000,25,6,2014,0,74,3560,3290,0,1,1
5,2.0,2080,16117,1.0,0,0,5,7,1740,340,1959,0,98001,47.3424,-122.289,1510,13068,254000,26,6,2014,0,55,14037,11558,0,1,0
5,1.5,2180,4268,1.5,0,0,4,7,1340,840,1924,0,98117,47.6848,-122.389,1530,3880,470000,17,9,2014,0,90,2088,2350,0,1,1
3,2.0,1460,7860,1.0,0,0,5,7,1460,0,1967,0,98008,47.6233,-122.108,1850,8148,480000,17,3,2015,0,48,6400,6298,0,0,0
3,1.75,1530,8503,1.0,0,0,4,7,1150,380,1983,0,98033,47.6872,-122.185,1610,8549,536000,30,1,2015,0,32,6973,6939,0,1,0
4,3.5,4740,8611,2.0,0,3,3,11,3640,1100,2006,0,98027,47.5375,-122.07,4042,8321,1350000,30,4,2015,0,9,3871,4279,0,1,0
3,1.75,1710,6400,1.0,0,0,4,7,1240,470,1976,0,98023,47.3036,-122.377,1600,6400,260000,2,12,2014,0,38,4690,4800,0,1,0
2,1.5,1160,982,2.0,0,0,3,7,890,270,2006,0,98155,47.7675,-122.315,1160,1008,284900,24,4,2015,0,9,-178,-152,0,1,1
3,2.5,2200,3000,2.0,0,0,3,9,1530,670,2002,0,98109,47.6451,-122.35,2200,3300,740000,29,10,2014,0,12,800,1100,0,1,1
2,1.0,1170,5000,1.0,0,0,4,7,1030,140,1920,0,98136,47.5449,-122.388,1170,5850,425000,2,10,2014,0,94,3830,4680,0,1,1
3,1.0,1120,7500,1.0,0,0,3,7,1120,0,1965,0,98146,47.5112,-122.359,1120,5000,230000,2,9,2014,0,49,6380,3880,0,0,1
3,1.5,1710,4000,2.0,0,0,3,8,1710,0,1926,0,98116,47.5714,-122.385,1910,4000,675000,13,4,2015,0,89,2290,2090,0,0,1
3,1.75,1650,7807,1.0,0,0,3,7,1650,0,1986,0,98030,47.3514,-122.167,1810,8475,267500,29,7,2014,0,28,6157,6665,0,0,0
4,2.5,2840,8820,1.0,0,2,5,8,1420,1420,1952,0,98118,47.5542,-122.265,2310,8750,814000,25,8,2014,0,62,5980,6440,0,1,1
3,2.0,1860,7232,1.0,0,0,3,7,1320,540,1985,0,98125,47.7165,-122.319,1830,7220,460000,16,9,2014,0,29,5372,5390,0,1,1
3,2.5,2250,9608,2.0,0,0,3,8,2250,0,1994,0,98045,47.4865,-121.802,2020,9834,445000,20,1,2015,0,21,7358,7814,0,0,0
3,2.5,2890,7027,2.0,0,0,3,8,2890,0,2004,0,98074,47.6111,-122.009,2890,7197,715000,24,9,2014,0,10,4137,4307,0,0,0
3,1.75,2120,5992,1.0,0,0,3,7,1060,1060,1947,0,98125,47.7083,-122.308,1840,11000,425000,19,2,2015,0,68,3872,9160,0,1,1
4,2.5,2130,4750,2.0,0,0,3,8,2130,0,2009,0,98058,47.4324,-122.184,2130,4071,370000,15,7,2014,0,5,2620,1941,0,0,0
2,1.75,1170,8200,1.0,0,0,4,6,780,390,1937,0,98003,47.3263,-122.305,1780,9020,302000,29,4,2015,0,78,7030,7240,0,1,0
4,1.75,2120,7420,1.0,0,0,4,7,1060,1060,1956,0,98008,47.6019,-122.13,1540,7420,453000,23,6,2014,0,58,5300,5880,0,1,0
3,1.75,1280,10716,1.0,0,0,4,7,1280,0,1969,0,98059,47.4755,-122.145,1440,9870,290000,20,5,2014,0,45,9436,8430,0,0,0
3,1.5,1060,5750,1.0,0,2,4,7,1060,0,1981,0,98126,47.5512,-122.371,1060,5750,354000,5,8,2014,0,33,4690,4690,0,0,1
4,1.75,1740,9344,1.0,0,0,3,7,1180,560,1978,0,98023,47.3196,-122.399,1440,12884,204950,17,6,2014,0,36,7604,11444,0,1,0
4,2.5,2990,5400,2.0,0,0,3,8,2990,0,2005,0,98074,47.6122,-122.009,2890,6538,675000,22,4,2015,0,10,2410,3648,0,0,0
5,2.0,2960,10960,1.0,0,0,4,7,1500,1460,1957,0,98005,47.6162,-122.174,2160,10960,800000,31,3,2015,0,58,8000,8800,0,1,0
3,2.5,1650,3711,2.0,0,0,3,8,1650,0,1996,0,98052,47.6863,-122.093,1760,3762,472500,9,9,2014,0,18,2061,2002,0,0,0
4,2.5,2720,13500,1.0,0,0,3,8,1510,1210,1969,0,98007,47.6191,-122.145,2510,12350,549950,2,12,2014,0,45,10780,9840,0,1,0
3,1.75,1516,2897,1.0,0,0,3,7,998,518,1925,0,98103,47.6842,-122.341,2100,3854,575575,13,10,2014,0,89,1381,1754,0,1,1
4,3.25,4386,12275,1.0,0,0,3,10,2356,2030,2006,0,98092,47.3329,-122.2,3060,10925,545000,3,3,2015,0,9,7889,7865,0,1,0
3,2.25,2580,7434,1.0,0,0,3,7,1630,950,1963,0,98133,47.7446,-122.332,1920,7737,340000,19,11,2014,0,51,4854,5817,0,1,1
3,1.0,960,5512,1.0,0,0,4,6,960,0,1963,0,98056,47.4944,-122.165,1090,5837,225000,31,3,2015,0,52,4552,4747,0,0,0
2,1.75,1460,10506,1.0,0,0,3,7,1460,0,1983,0,98031,47.4048,-122.178,1460,8153,299950,28,10,2014,0,31,9046,6693,0,0,0
4,3.5,3840,4000,2.0,0,0,3,8,2640,1200,2001,0,98105,47.6642,-122.291,1620,4000,829900,23,2,2015,0,14,160,2380,0,1,1
4,2.5,2090,4200,2.0,0,0,3,7,2090,0,2007,0,98038,47.3659,-122.017,2090,4200,340000,30,3,2015,0,8,2110,2110,0,0,0
4,2.25,2470,7800,1.0,0,0,3,8,1470,1000,1975,0,98052,47.6913,-122.115,2050,8050,515000,8,10,2014,0,39,5330,6000,0,1,0
4,2.5,2090,6906,2.0,0,0,4,8,2090,0,1992,0,98029,47.5718,-121.996,2090,6370,601000,11,7,2014,0,22,4816,4280,0,0,0
3,2.5,2070,8581,2.0,0,0,3,8,2070,0,1994,0,98059,47.5101,-122.151,2440,7849,470000,4,5,2015,0,21,6511,5409,0,0,0
3,1.0,1650,6400,1.0,0,0,4,7,980,670,1954,0,98106,47.52,-122.365,1230,6400,371500,8,7,2014,0,60,4750,5170,0,1,1
4,2.5,2060,7720,2.0,0,0,3,8,2060,0,1995,0,98023,47.2956,-122.374,1630,7720,242550,14,12,2014,0,19,5660,6090,0,0,0
3,1.5,1410,9647,1.0,0,0,3,8,1410,0,1961,0,98177,47.7608,-122.361,2090,9272,367500,6,5,2014,0,53,8237,7182,0,0,1
4,3.5,2770,8763,2.0,0,0,3,8,2100,670,1996,0,98003,47.2625,-122.308,2030,7242,359000,24,9,2014,0,18,5993,5212,0,1,0
3,2.0,1390,8245,1.0,0,0,2,7,1390,0,1984,0,98001,47.2669,-122.254,1260,8245,204900,11,3,2015,0,31,6855,6985,0,0,0
3,1.5,1280,4452,2.0,0,0,3,6,1280,0,1985,0,98002,47.3344,-122.216,1070,4366,187000,21,10,2014,0,29,3172,3296,0,0,0
4,3.5,3780,7769,2.0,0,0,3,9,3110,670,2001,0,98052,47.691,-122.129,3310,7945,782000,2,1,2015,0,14,3989,4635,0,1,0
4,2.5,2670,5974,2.0,0,0,3,8,2670,0,1999,0,98034,47.7122,-122.231,2140,5729,612000,3,11,2014,0,15,3304,3589,0,0,0
3,2.0,1350,7216,1.0,0,0,3,7,1350,0,1964,0,98177,47.7616,-122.365,1920,7600,400000,31,10,2014,0,50,5866,5680,0,0,1
5,3.5,3490,9680,2.0,0,4,3,9,2460,1030,1980,0,98177,47.7757,-122.391,3080,13489,941500,3,6,2014,0,34,6190,10409,0,1,1
2,1.5,870,747,2.0,0,0,3,8,800,70,2004,0,98103,47.6967,-122.342,1710,1280,313000,9,1,2015,0,11,-123,-430,0,1,1
4,2.25,2410,4250,1.5,0,0,5,7,1460,950,1929,0,98117,47.6849,-122.376,1360,5074,735000,9,4,2015,0,86,1840,3714,0,1,1
3,1.75,1640,10123,1.0,0,0,3,8,1340,300,1977,0,98011,47.7698,-122.167,2210,10852,471000,19,3,2015,0,38,8483,8642,0,1,0
3,1.0,1540,9800,1.0,0,0,4,7,1540,0,1950,0,98155,47.7604,-122.329,1560,9450,350000,24,2,2015,0,65,8260,7890,0,0,1
4,2.5,2370,9601,1.0,0,0,3,8,1570,800,1976,0,98027,47.5327,-122.054,2550,10500,530000,23,7,2014,0,38,7231,7950,0,1,0
4,3.0,1830,9548,2.0,0,0,3,7,1830,0,1991,0,98028,47.7379,-122.224,1740,9750,415000,7,5,2014,0,23,7718,8010,0,0,0
4,2.25,2330,8994,2.0,0,0,3,8,2330,0,1986,0,98052,47.7264,-122.104,2330,8396,639500,21,6,2014,0,28,6664,6066,0,0,0
2,2.5,1700,2513,2.0,0,0,3,8,1700,0,2009,0,98065,47.5163,-121.878,1760,2891,378000,19,11,2014,0,5,813,1131,0,0,0
3,2.25,1750,9298,1.0,0,0,4,7,1410,340,1969,0,98058,47.4579,-122.164,1720,7875,265000,15,1,2015,0,46,7548,6155,0,1,0
3,1.75,1100,9750,1.0,0,0,4,6,1100,0,1967,0,98023,47.2955,-122.362,1100,9900,212000,24,9,2014,0,47,8650,8800,0,0,0
4,2.5,2540,6491,2.0,0,0,3,8,2540,0,1997,0,98008,47.6363,-122.117,1990,8447,750000,6,2,2015,0,18,3951,6457,0,0,0
2,1.0,770,5200,1.0,0,0,5,6,770,0,1969,0,98042,47.3627,-122.087,1150,5330,176000,6,8,2014,0,45,4430,4180,0,0,0
3,2.75,2370,4632,2.0,0,0,3,7,2370,0,2002,0,98038,47.3794,-122.022,2290,5012,350000,9,9,2014,0,12,2262,2722,0,0,0
3,1.0,1200,7210,1.0,0,0,4,6,1200,0,1977,0,98030,47.3729,-122.183,1200,7650,168000,29,7,2014,0,37,6010,6450,0,0,0
4,2.0,2200,3060,1.0,0,0,3,7,1100,1100,1908,2000,98118,47.565,-122.284,1410,5100,358000,14,11,2014,92,106,860,3690,1,1,1
3,1.75,1600,10280,1.0,0,0,3,7,1050,550,1977,0,98034,47.725,-122.174,1590,8100,442500,23,6,2014,0,37,8680,6510,0,1,0
2,2.5,1330,1249,3.0,0,0,3,8,1330,0,2004,0,98105,47.6668,-122.285,1430,1328,515000,17,3,2015,0,11,-81,-102,0,0,1
5,2.5,3440,12900,1.0,0,2,4,8,1720,1720,1958,0,98166,47.4426,-122.342,2100,10751,554000,17,11,2014,0,56,9460,8651,0,1,1
3,2.5,2510,6320,2.0,0,0,3,9,2510,0,1996,0,98075,47.5868,-122.033,2518,5819,659000,10,6,2014,0,18,3810,3301,0,0,0
4,2.5,2150,10098,1.0,0,0,3,7,1090,1060,1963,0,98034,47.7166,-122.201,1880,10000,414999,17,3,2015,0,52,7948,8120,0,1,0
3,1.5,1180,10277,1.0,0,0,3,6,1180,0,1983,0,98045,47.488,-121.787,1680,11104,275000,2,5,2014,0,31,9097,9424,0,0,0
2,1.0,680,8640,1.0,0,0,4,5,680,0,1951,0,98188,47.4559,-122.289,1320,13140,193000,19,11,2014,0,63,7960,11820,0,0,1
4,2.5,2840,4750,2.0,0,0,3,9,2840,0,2002,0,98058,47.4511,-122.121,2460,4750,525000,20,8,2014,0,12,1910,2290,0,0,0
3,2.5,1820,7500,2.0,0,0,3,8,1820,0,1985,0,98052,47.7155,-122.104,2040,8304,424000,9,10,2014,0,29,5680,6264,0,0,0
2,1.0,1070,5150,1.0,0,0,4,6,870,200,1908,0,98117,47.6853,-122.366,1520,3860,455000,8,1,2015,0,107,4080,2340,0,1,1
2,1.0,1250,5650,2.0,0,1,4,7,1250,0,1943,0,98126,47.5495,-122.377,1210,5650,463000,22,8,2014,0,71,4400,4440,0,0,1
4,2.5,2190,6300,1.0,0,3,3,7,1240,950,1960,0,98033,47.6918,-122.216,2730,14659,1100000,4,5,2015,0,55,4110,11929,0,1,0
3,1.75,3000,5413,2.0,0,0,4,8,1900,1100,1963,0,98115,47.6962,-122.312,1550,5413,523000,8,12,2014,0,51,2413,3863,0,1,1
4,1.75,2270,9830,1.0,0,0,4,8,2270,0,1959,0,98005,47.5999,-122.176,2540,11990,615000,8,8,2014,0,55,7560,9450,0,0,0
4,4.0,4500,11795,2.0,0,0,3,12,4500,0,1991,0,98027,47.5533,-122.098,3930,11576,1520000,3,11,2014,0,23,7295,7646,0,0,0
5,4.0,3400,5000,2.0,0,0,3,8,2320,1080,1900,2013,98107,47.6655,-122.363,1910,5000,870000,8,8,2014,113,114,1600,3090,1,1,1
3,2.5,2830,9680,2.0,0,0,3,10,2830,0,1991,0,98074,47.6249,-122.024,2970,8691,710000,17,8,2014,0,23,6850,5721,0,0,0
3,1.0,960,9563,1.0,0,0,5,7,960,0,1967,0,98023,47.2864,-122.357,1280,9600,215000,7,7,2014,0,47,8603,8320,0,0,0
2,1.0,1530,6450,1.0,0,0,4,7,1530,0,1920,0,98117,47.6833,-122.398,1530,5000,590000,8,9,2014,0,94,4920,3470,0,0,1
5,2.5,2500,13034,1.0,0,0,3,7,1300,1200,1962,0,98092,47.3343,-122.194,2440,13300,323000,14,8,2014,0,52,10534,10860,0,1,0
4,2.0,1560,7569,1.5,0,0,4,7,1560,0,1966,0,98058,47.4496,-122.155,1480,8755,279000,22,7,2014,0,48,6009,7275,0,0,0
3,2.25,2070,7207,1.0,0,0,3,8,1720,350,1973,0,98177,47.7735,-122.371,2350,7980,535100,19,9,2014,0,41,5137,5630,0,1,1
4,2.5,3150,4203,2.0,0,0,3,9,3150,0,2002,0,98033,47.688,-122.164,3150,5169,815000,3,7,2014,0,12,1053,2019,0,0,0
3,2.25,1880,10880,1.0,0,0,3,8,1480,400,1975,0,98008,47.5937,-122.116,2120,10240,535900,9,3,2015,0,40,9000,8120,0,1,0
3,1.0,1250,8800,1.0,0,0,3,7,1250,0,1955,0,98146,47.497,-122.357,1480,8200,230000,9,3,2015,0,60,7550,6720,0,0,1
4,1.75,2290,8142,1.0,0,0,4,7,1490,800,1969,0,98055,47.4564,-122.211,1840,8142,325500,17,2,2015,0,46,5852,6302,0,1,0
3,2.25,1990,4331,2.0,0,0,3,7,1990,0,1997,0,98056,47.4917,-122.167,1690,3688,359000,30,1,2015,0,18,2341,1998,0,0,0
3,2.5,2100,5824,2.0,0,2,3,8,2100,0,1999,0,98065,47.5334,-121.867,1890,4140,505000,9,5,2014,0,15,3724,2250,0,0,0
3,1.0,940,8400,1.0,0,0,5,7,940,0,1958,0,98056,47.5112,-122.167,950,8400,253905,30,9,2014,0,56,7460,7450,0,0,0
3,1.75,1640,4860,1.0,0,0,3,8,1200,440,1965,0,98125,47.7125,-122.32,1480,7200,369950,11,7,2014,0,49,3220,5720,0,1,1
3,2.25,1860,8378,2.0,0,0,3,7,1860,0,1995,0,98038,47.3875,-122.032,1870,8378,350000,21,1,2015,0,20,6518,6508,0,0,0
4,2.25,2100,2500,3.0,0,0,3,8,2100,0,2001,0,98115,47.6726,-122.298,1660,4000,650000,7,8,2014,0,13,400,2340,0,0,1
3,1.0,1400,7410,1.0,0,0,3,6,1400,0,1944,0,98166,47.4798,-122.343,1070,7410,246000,7,5,2014,0,70,6010,6340,0,0,1
3,2.75,2600,12860,1.0,0,0,3,7,1350,1250,1965,0,98014,47.695,-121.918,2260,12954,430000,16,9,2014,0,49,10260,10694,0,1,0
3,2.0,1440,4859,2.0,0,0,2,6,1440,0,1921,0,98118,47.5503,-122.285,1360,4558,509990,23,1,2015,0,94,3419,3198,0,0,1
4,1.75,1870,9500,1.0,0,0,4,7,1090,780,1962,0,98033,47.7012,-122.187,2010,10000,490000,9,12,2014,0,52,7630,7990,0,1,0
4,2.75,2960,10454,1.0,0,1,3,8,2360,600,1979,0,98198,47.4006,-122.322,1870,10500,385000,2,12,2014,0,35,7494,8630,0,1,1
4,2.5,2440,6733,2.0,0,0,3,9,2440,0,1999,0,98074,47.6374,-122.064,2570,6496,769000,29,4,2015,0,16,4293,3926,0,0,0
2,1.0,1122,9100,1.0,0,0,4,6,1122,0,1960,0,98023,47.328,-122.341,840,9344,185000,12,2,2015,0,55,7978,8504,0,0,0
3,1.5,1060,10464,1.0,0,0,4,7,1060,0,1973,0,98034,47.7313,-122.229,1420,10464,303500,9,5,2014,0,41,9404,9044,0,0,0
4,2.5,2150,8165,1.0,0,0,3,8,1430,720,1957,0,98177,47.773,-122.371,2360,7980,468000,11,2,2015,0,58,6015,5620,0,1,1
4,2.5,3100,10000,2.0,0,0,3,9,3100,0,1978,0,98042,47.3741,-122.15,1850,9438,449950,21,7,2014,0,36,6900,7588,0,0,0
2,1.5,880,1805,2.0,0,0,3,7,880,0,1999,0,98133,47.7064,-122.342,880,5060,235000,16,6,2014,0,15,925,4180,0,0,1
2,1.0,1080,9067,1.0,0,0,3,6,1080,0,1951,0,98168,47.4815,-122.331,1080,6647,203000,6,11,2014,0,63,7987,5567,0,0,1
5,2.5,2530,10190,1.0,0,0,4,7,1290,1240,1960,0,98008,47.616,-122.115,2040,8560,657000,26,8,2014,0,54,7660,6520,0,1,0
3,1.0,1200,7800,1.0,0,0,4,7,1200,0,1954,0,98126,47.5196,-122.371,1230,7070,275000,9,7,2014,0,60,6600,5840,0,0,1
4,2.25,2850,7453,2.0,0,0,3,9,2850,0,1991,0,98072,47.7439,-122.174,2700,8468,540000,24,10,2014,0,23,4603,5768,0,0,0
4,2.5,2950,4502,2.0,0,0,3,7,2950,0,2005,0,98059,47.5002,-122.151,2360,4502,455000,24,6,2014,0,9,1552,2142,0,0,0
2,1.75,1160,6828,1.0,0,0,3,7,860,300,1941,0,98115,47.6937,-122.298,1250,6828,458500,16,10,2014,0,73,5668,5578,0,1,1
4,3.5,3420,4751,2.0,0,0,3,10,3420,0,2003,0,98055,47.4734,-122.193,3490,5700,549900,24,4,2015,0,12,1331,2210,0,0,0
3,1.75,2240,10578,2.0,0,0,5,8,1550,690,1923,0,98115,47.6954,-122.292,1570,10578,750000,2,5,2014,0,91,8338,9008,0,1,1
4,1.75,1450,8891,1.5,0,0,3,7,1180,270,1962,0,98168,47.478,-122.278,1450,9013,235000,23,6,2014,0,52,7441,7563,0,1,1
4,2.5,1820,7930,2.0,0,0,5,7,1820,0,1989,0,98038,47.359,-122.05,1490,7930,286000,11,9,2014,0,25,6110,6440,0,0,0
4,1.75,2430,14000,1.0,0,0,4,7,1580,850,1963,0,98052,47.6554,-122.134,1910,8285,602000,10,2,2015,0,52,11570,6375,0,1,0
3,1.5,1960,4080,1.5,0,0,3,7,1960,0,1915,0,98115,47.6768,-122.31,1880,4080,640000,20,8,2014,0,99,2120,2200,0,0,1
3,1.75,1440,10920,1.0,0,0,4,8,1440,0,1977,0,98030,47.3812,-122.168,1720,8260,267000,9,10,2014,0,37,9480,6540,0,0,0
4,2.5,2730,4385,2.0,0,0,3,8,2730,0,2001,0,98075,47.5975,-122.038,2670,4644,712000,21,4,2015,0,14,1655,1974,0,0,0
2,1.0,910,9000,1.0,0,0,3,5,910,0,1923,0,98065,47.526,-121.81,1290,9000,244500,10,10,2014,0,91,8090,7710,0,0,0
2,1.0,910,9000,1.0,0,0,3,5,910,0,1923,0,98065,47.526,-121.81,1290,9000,301000,12,5,2015,0,92,8090,7710,0,0,0
4,2.5,2430,6325,2.0,0,0,4,8,2020,410,1919,0,98109,47.6413,-122.354,2340,4375,990000,18,8,2014,0,95,3895,2035,0,1,1
4,2.75,3350,6500,2.0,0,0,3,10,3350,0,1999,0,98075,47.5838,-122.027,2960,6970,739999,22,4,2015,0,16,3150,4010,0,0,0
4,1.75,2320,4322,1.0,0,0,3,7,1140,1180,1910,0,98144,47.5755,-122.289,1820,4322,480000,10,6,2014,0,104,2002,2502,0,1,1
3,2.5,1260,1622,3.0,0,0,3,8,1260,0,2009,0,98133,47.7325,-122.343,1340,1188,305000,29,7,2014,0,5,362,-152,0,0,1
3,2.0,1980,3525,1.5,0,0,4,8,1590,390,1932,0,98117,47.6847,-122.368,1760,3760,703300,15,1,2015,0,83,1545,2000,0,1,1
4,1.5,1580,8468,2.0,0,0,4,7,1580,0,1971,0,98001,47.3336,-122.281,1580,8260,265000,30,3,2015,0,44,6888,6680,0,0,0
3,1.0,1400,9750,1.0,0,0,3,7,1400,0,1968,1998,98198,47.3862,-122.304,1640,8050,253000,21,7,2014,30,46,8350,6410,1,0,1
4,2.5,2410,7950,2.0,0,0,3,8,2410,0,1997,0,98034,47.7185,-122.226,1920,7713,617950,26,3,2015,0,18,5540,5793,0,0,0
4,3.25,1790,2460,2.0,0,0,4,7,1100,690,2000,0,98106,47.534,-122.346,1260,4040,385000,12,12,2014,0,14,670,2780,0,1,1
3,2.0,1640,9234,1.0,0,0,5,7,1060,580,1967,0,98118,47.5162,-122.274,2230,10354,319000,19,12,2014,0,47,7594,8124,0,1,1
3,2.5,1670,8023,1.0,0,0,5,7,1170,500,1960,0,98008,47.615,-122.117,1960,8964,696000,23,4,2015,0,55,6353,7004,0,1,0
2,1.0,970,5750,1.0,0,0,4,6,970,0,1932,0,98126,47.5518,-122.37,1650,8625,345000,30,6,2014,0,82,4780,6975,0,0,1
3,2.5,1610,1778,3.0,0,0,3,7,1610,0,2002,0,98115,47.6902,-122.306,1120,2187,380000,22,10,2014,0,12,168,1067,0,0,1
3,1.75,1400,7735,1.0,0,0,4,7,1400,0,1989,0,98038,47.357,-122.04,1530,7754,269950,19,12,2014,0,25,6335,6224,0,0,0
3,1.0,1210,9525,1.0,0,0,3,7,1210,0,1955,0,98106,47.5274,-122.345,1680,7620,299950,30,5,2014,0,59,8315,5940,0,0,1
4,3.25,3930,10929,2.0,0,0,3,10,3930,0,2006,0,98004,47.6259,-122.194,1780,9999,1880000,3,7,2014,0,8,6999,8219,0,0,0
2,1.0,990,4802,1.0,0,0,3,7,990,0,1947,0,98117,47.6876,-122.395,1180,5000,430000,2,6,2014,0,67,3812,3820,0,0,1
5,2.5,2200,4942,2.0,0,0,3,8,2200,0,1989,0,98029,47.5772,-122.001,2200,5924,495000,29,1,2015,0,26,2742,3724,0,0,0
3,1.5,1510,16200,1.0,0,0,3,7,1510,0,1970,0,98031,47.3926,-122.167,1650,13950,275000,13,11,2014,0,44,14690,12300,0,0,0
3,1.0,1620,5040,1.0,0,0,3,7,1120,500,1964,0,98118,47.5263,-122.286,1790,6178,333000,16,9,2014,0,50,3420,4388,0,1,1
3,2.25,1580,7941,2.0,0,0,4,7,1580,0,1986,0,98023,47.2843,-122.357,1730,8051,247000,19,5,2014,0,28,6361,6321,0,0,0
3,2.0,2190,13673,1.0,0,0,4,9,2190,0,1994,0,98042,47.3542,-122.098,2770,13804,432000,15,7,2014,0,20,11483,11034,0,0,0
4,2.5,2030,7140,1.0,0,0,4,7,1400,630,1968,0,98008,47.6244,-122.109,1800,7565,556300,20,3,2015,0,47,5110,5765,0,1,0
2,1.0,780,3475,1.0,0,0,4,5,780,0,1930,0,98045,47.4944,-121.789,1210,6769,286000,25,6,2014,0,84,2695,5559,0,0,0
2,1.5,1110,1200,3.0,0,0,3,8,1110,0,2000,0,98103,47.6931,-122.342,1110,1363,320000,6,9,2014,0,14,90,253,0,0,1
4,1.75,1660,10757,1.0,0,0,3,7,1000,660,1980,0,98056,47.5071,-122.194,1880,8319,385000,27,3,2015,0,35,9097,6439,0,1,0
4,1.0,3410,5000,2.0,0,0,5,8,2190,1220,1910,0,98144,47.5807,-122.291,2550,5000,1040000,8,5,2014,0,104,1590,2450,0,1,1
4,2.25,2390,13002,2.0,0,0,3,8,2390,0,1987,0,98023,47.3111,-122.35,2450,11200,350000,28,10,2014,0,27,10612,8750,0,0,0
4,2.5,1850,5880,2.0,0,0,3,8,1850,0,1998,0,98092,47.3322,-122.173,2370,6500,277000,29,7,2014,0,16,4030,4130,0,0,0
6,2.0,2500,5200,1.0,0,0,3,8,1250,1250,1966,0,98118,47.5517,-122.268,1800,5200,415000,19,2,2015,0,49,2700,3400,0,1,1
3,1.0,1000,8320,1.0,0,0,5,6,1000,0,1951,0,98155,47.7548,-122.316,1090,8450,295000,4,12,2014,0,63,7320,7360,0,0,1
4,2.0,2450,5000,2.0,0,4,5,8,2200,250,1919,0,98116,47.5619,-122.405,2360,6090,969000,5,8,2014,0,95,2550,3730,0,1,1
4,1.75,1440,6144,1.0,0,0,5,6,720,720,1947,0,98106,47.5257,-122.357,960,5160,339888,4,11,2014,0,67,4704,4200,0,1,1
3,2.25,1660,7003,2.0,0,0,3,7,1660,0,1996,0,98030,47.3599,-122.188,1840,6680,269950,22,8,2014,0,18,5343,4840,0,0,0
3,2.5,2510,4600,2.0,0,2,3,10,2510,0,2006,0,98034,47.7051,-122.223,2560,7500,1190000,1,10,2014,0,8,2090,4940,0,0,0
4,2.5,3090,12511,2.0,0,0,4,10,3090,0,1998,0,98075,47.5932,-121.983,3100,10882,780000,16,12,2014,0,16,9421,7782,0,0,0
3,1.0,860,5185,1.0,0,0,4,6,860,0,1968,0,98042,47.3634,-122.086,1120,5494,198000,8,4,2015,0,47,4325,4374,0,0,0
3,1.0,1010,7680,1.0,0,0,4,7,1010,0,1967,0,98034,47.732,-122.231,1320,7373,350000,1,12,2014,0,47,6670,6053,0,0,0
4,2.25,2390,7350,2.0,0,0,3,8,2390,0,1990,0,98023,47.2938,-122.348,2390,7350,319000,6,12,2014,0,24,4960,4960,0,0,0
4,2.25,3340,8000,2.0,0,0,4,8,3340,0,1973,0,98023,47.317,-122.385,2230,8000,311000,8,9,2014,0,41,4660,5770,0,0,0
5,3.25,3620,4650,2.0,0,0,3,8,2790,830,2004,0,98038,47.3552,-122.026,2850,4650,394000,18,10,2014,0,10,1030,1800,0,1,0
5,2.25,4200,5800,2.5,0,0,4,9,2910,1290,1906,0,98112,47.6284,-122.312,3060,5800,1340000,13,6,2014,0,108,1600,2740,0,1,1
3,1.0,1980,9540,1.0,0,0,3,7,1080,900,1949,0,98133,47.7551,-122.353,1680,9529,396000,25,11,2014,0,65,7560,7849,0,1,1
4,1.75,1790,8372,1.0,0,0,4,8,1340,450,1976,0,98033,47.6605,-122.189,2180,10500,809000,2,4,2015,0,39,6582,8320,0,1,0
3,2.0,1580,7400,1.0,0,0,3,7,1050,530,1977,0,98052,47.6715,-122.162,1560,7458,480000,22,7,2014,0,37,5820,5898,0,1,0
6,1.75,2460,6000,1.0,0,0,4,7,1230,1230,1913,0,98115,47.6721,-122.323,1560,4275,535000,9,9,2014,0,101,3540,2715,0,1,1
5,2.75,2110,5120,2.0,0,0,3,7,1870,240,1947,1983,98106,47.5294,-122.357,1580,5120,425000,13,2,2015,36,68,3010,3540,1,1,1
3,2.5,1470,1204,3.0,0,0,3,8,1470,0,2006,0,98117,47.6998,-122.366,1460,1245,408000,1,8,2014,0,8,-266,-215,0,0,1
4,2.5,3510,13100,2.0,0,0,4,10,3510,0,1966,0,98040,47.5306,-122.227,3230,12745,1260000,9,4,2015,0,49,9590,9515,0,0,0
1,0.75,520,2885,1.0,0,0,4,6,520,0,1947,0,98117,47.6886,-122.378,980,4241,310000,20,4,2015,0,68,2365,3261,0,0,1
3,2.5,1950,7421,2.0,0,0,3,8,1950,0,1996,0,98038,47.3842,-122.036,2200,4668,292000,3,11,2014,0,18,5471,2468,0,0,0
2,1.0,770,9715,1.0,0,0,4,6,770,0,1942,0,98168,47.4924,-122.312,1140,9715,217000,27,2,2015,0,73,8945,8575,0,0,1
4,2.5,2250,6064,2.0,0,0,3,8,2250,0,2005,0,98056,47.4956,-122.174,1520,7840,398500,27,1,2015,0,10,3814,6320,0,0,0
3,3.0,4040,7200,1.5,0,2,4,9,3340,700,1930,0,98112,47.6288,-122.284,3450,10800,2250000,26,3,2015,0,85,3160,7350,0,1,1
4,1.75,2360,6000,1.0,0,0,3,7,1280,1080,1955,0,98109,47.6465,-122.357,1700,3460,700000,25,3,2015,0,60,3640,1760,0,1,1
3,1.0,1720,8910,1.0,0,0,4,7,1720,0,1954,0,98155,47.7736,-122.296,1870,8640,399950,8,10,2014,0,60,7190,6770,0,0,1
3,1.75,1900,8540,1.0,0,0,3,6,950,950,1980,0,98168,47.4868,-122.303,1370,10204,235000,13,6,2014,0,34,6640,8834,0,1,1
3,1.0,1040,6800,1.0,0,0,5,6,1040,0,1951,0,98178,47.492,-122.224,1430,6080,212000,15,7,2014,0,63,5760,4650,0,0,1
3,2.0,2070,9195,1.0,0,0,3,8,1220,850,1982,0,98074,47.6491,-122.061,2080,9551,310000,21,8,2014,0,32,7125,7471,0,1,0
3,2.0,2070,9195,1.0,0,0,3,8,1220,850,1982,0,98074,47.6491,-122.061,2080,9551,539000,16,12,2014,0,32,7125,7471,0,1,0
3,3.0,1550,1608,2.0,0,0,3,8,1280,270,2001,0,98122,47.6042,-122.303,1940,1883,390000,5,12,2014,0,13,58,-57,0,1,1
3,2.5,2020,11935,1.0,0,0,4,9,2020,0,1976,0,98052,47.632,-122.092,2410,12350,560000,1,12,2014,0,38,9915,9940,0,0,0
5,2.5,3320,9024,2.0,0,0,3,9,3320,0,1999,0,98075,47.5865,-122.056,3320,7665,800000,16,9,2014,0,15,5704,4345,0,0,0
5,2.0,2030,9804,1.0,0,0,3,7,1110,920,1963,0,98008,47.6297,-122.114,1930,7990,472000,27,10,2014,0,51,7774,6060,0,1,0
3,1.75,1770,7875,1.0,0,0,4,7,1170,600,1958,0,98008,47.606,-122.125,1670,8000,502550,23,9,2014,0,56,6105,6330,0,1,0
4,3.25,3330,7809,2.0,0,0,3,9,3330,0,2004,0,98075,47.5977,-121.976,3100,6465,830000,27,3,2015,0,11,4479,3365,0,0,0
4,2.5,2260,9686,1.0,0,0,4,7,1520,740,1965,0,98002,47.286,-122.218,1750,9916,224950,23,7,2014,0,49,7426,8166,0,1,0
3,2.5,1950,6871,2.0,0,0,3,8,1950,0,1997,0,98155,47.7603,-122.307,1950,7663,375000,18,6,2014,0,17,4921,5713,0,0,1
3,2.75,1960,2500,1.5,0,0,5,7,1410,550,1926,0,98103,47.6744,-122.353,2040,5000,599000,23,5,2014,0,88,540,2960,0,1,1
4,2.5,2980,12534,2.0,0,0,3,9,2980,0,1996,0,98031,47.3999,-122.211,2630,12534,515000,9,5,2015,0,19,9554,9904,0,0,0
2,1.0,780,6685,1.0,0,0,4,5,780,0,1948,0,98002,47.305,-122.215,880,6695,135000,28,5,2014,0,66,5905,5815,0,0,0
3,2.5,1650,4218,2.0,0,0,3,8,1650,0,2000,0,98075,47.5998,-122.016,1650,4559,485000,23,10,2014,0,14,2568,2909,0,0,0
3,3.25,4030,12765,2.0,0,0,4,9,2800,1230,1975,0,98005,47.6331,-122.166,2670,13447,890000,14,7,2014,0,39,8735,10777,0,1,0
3,1.0,1010,10125,1.0,0,0,4,7,1010,0,1972,0,98042,47.3423,-122.088,1230,10125,215000,8,4,2015,0,43,9115,8895,0,0,0
3,1.0,1190,9600,1.0,0,0,3,7,1190,0,1981,0,98045,47.4805,-121.762,1360,10140,299500,17,12,2014,0,33,8410,8780,0,0,0
3,2.5,1560,4244,2.0,0,0,3,7,1560,0,2002,0,98038,47.3834,-122.027,1670,4251,275000,9,2,2015,0,13,2684,2581,0,0,0
3,1.5,1490,7800,1.0,0,0,3,7,1010,480,1963,0,98003,47.3431,-122.304,1570,7800,256400,19,2,2015,0,52,6310,6230,0,1,0
2,1.0,770,8149,1.0,0,0,4,6,770,0,1948,0,98155,47.7439,-122.301,820,8149,310000,24,2,2015,0,67,7379,7329,0,0,1
1,1.0,620,5100,1.0,0,0,3,6,620,0,1954,0,98144,47.5699,-122.287,1540,2676,385000,4,3,2015,0,61,4480,1136,0,0,1
3,1.5,1200,9120,1.0,0,0,3,7,1000,200,1963,0,98055,47.4545,-122.187,1640,9200,203000,10,3,2015,0,52,7920,7560,0,1,0
4,2.0,2120,6865,1.0,0,0,3,7,1060,1060,1954,0,98133,47.7775,-122.337,1460,7780,285000,10,3,2015,0,61,4745,6320,0,1,1
3,2.5,2330,3610,2.0,0,0,3,8,2330,0,1999,0,98074,47.6022,-122.021,1830,2948,473975,27,1,2015,0,16,1280,1118,0,0,0
3,1.75,2000,9760,1.0,0,0,4,8,1400,600,1978,0,98058,47.4417,-122.134,1890,8089,320000,14,7,2014,0,36,7760,6199,0,1,0
5,2.75,2820,4608,1.0,0,0,3,7,1450,1370,1967,0,98117,47.6886,-122.361,1620,3840,599000,12,6,2014,0,47,1788,2220,0,1,1
3,2.0,2040,4800,1.0,0,0,4,7,1020,1020,1925,0,98126,47.5561,-122.377,1640,4800,580000,14,7,2014,0,89,2760,3160,0,1,1
4,2.25,1700,7056,2.0,0,0,3,7,1700,0,1999,0,98001,47.3385,-122.262,1650,6025,269500,9,12,2014,0,15,5356,4375,0,0,0
2,1.0,820,6200,1.0,0,0,4,6,820,0,1954,0,98166,47.4163,-122.34,1410,14000,274000,17,11,2014,0,60,5380,12590,0,0,1
2,1.75,1315,2162,2.0,0,0,4,8,1315,0,1974,0,98028,47.752,-122.253,1640,2128,347000,26,3,2015,0,41,847,488,0,0,0
3,1.75,1390,10905,1.0,0,0,3,6,860,530,1957,0,98106,47.5517,-122.36,1390,10839,270000,21,5,2014,0,57,9515,9449,0,1,1
3,2.0,1890,12017,1.0,0,2,3,8,1890,0,1949,0,98004,47.6203,-122.21,2000,12210,1430000,3,3,2015,0,66,10127,10210,0,0,0
3,1.75,1460,7226,1.0,0,0,3,7,1460,0,1993,0,98198,47.3839,-122.321,1760,7226,220000,20,2,2015,0,22,5766,5466,0,0,1
3,1.0,1480,15416,1.0,0,2,4,8,1480,0,1955,0,98022,47.2142,-121.987,1190,10758,243000,4,3,2015,0,60,13936,9568,0,0,0
3,1.75,1840,4030,1.0,0,0,5,7,1050,790,1925,0,98108,47.5549,-122.311,1840,5040,457500,27,5,2014,0,89,2190,3200,0,1,1
2,1.75,1880,7208,1.0,0,0,3,7,940,940,1951,0,98115,47.6946,-122.328,1880,8051,340000,19,12,2014,0,63,5328,6171,0,1,1
4,1.5,1910,5000,1.5,0,0,3,7,1610,300,1912,0,98105,47.6597,-122.29,2170,5000,657500,18,9,2014,0,102,3090,2830,0,1,1
4,2.5,2220,4720,2.0,0,0,3,7,2220,0,1998,0,98038,47.3541,-122.024,2090,4717,332500,12,1,2015,0,17,2500,2627,0,0,0
3,2.0,1410,10015,1.0,0,3,3,6,1410,0,1993,0,98045,47.4948,-121.776,1570,10485,340000,17,7,2014,0,21,8605,8915,0,0,0
4,3.0,3380,16133,1.0,0,1,3,8,2330,1050,1959,0,98118,47.5501,-122.261,2500,11100,350000,2,9,2014,0,55,12753,8600,0,1,1
4,2.5,1950,5602,1.0,0,0,5,7,1120,830,1966,0,98118,47.5437,-122.291,2000,6050,428000,13,2,2015,0,49,3652,4050,0,1,1
4,2.5,2400,8320,2.0,0,0,3,8,2400,0,1999,0,98045,47.4808,-121.781,2430,9258,515055,4,5,2015,0,16,5920,6828,0,0,0
3,1.75,1560,8968,1.0,0,0,4,8,1560,0,1972,0,98008,47.6243,-122.1,1990,8034,450000,4,2,2015,0,43,7408,6044,0,0,0
3,1.0,1040,8910,1.0,0,0,3,6,1040,0,1943,0,98168,47.5024,-122.32,1330,9720,190000,26,2,2015,0,72,7870,8390,0,0,1
4,2.75,3090,16538,3.0,0,0,4,8,2590,500,1919,1987,98116,47.5803,-122.403,1500,5130,1000000,17,7,2014,68,95,13448,3630,1,1,1
3,2.5,1850,4600,2.0,0,0,3,7,1850,0,2005,0,98058,47.4661,-122.145,2160,4751,299000,19,11,2014,0,9,2750,2591,0,0,0
2,1.0,1200,2500,2.0,0,2,3,7,1090,110,1927,0,98112,47.6304,-122.301,2690,4800,508000,3,11,2014,0,87,1300,2110,0,1,1
4,2.25,2190,3746,2.0,0,0,3,8,2190,0,2005,0,98038,47.3896,-122.034,2200,3591,294000,1,10,2014,0,9,1556,1391,0,0,0
2,1.0,1380,5820,1.0,0,0,3,7,1380,0,1918,1976,98117,47.6875,-122.392,1540,4076,320000,24,10,2014,58,96,4440,2536,1,0,1
5,2.75,3710,8674,2.0,0,0,3,9,3710,0,1996,0,98056,47.514,-122.176,3250,8678,641000,6,4,2015,0,19,4964,5428,0,0,0
3,1.5,1110,10296,1.0,0,0,5,7,1110,0,1964,0,98042,47.422,-122.153,1330,10296,255000,24,12,2014,0,50,9186,8966,0,0,0
3,2.5,1830,4997,2.0,0,0,3,7,1830,0,2004,0,98001,47.3035,-122.283,2488,4998,286651,30,4,2015,0,11,3167,2510,0,0,0
3,1.0,1270,6500,1.0,0,0,4,7,1270,0,1956,0,98033,47.6874,-122.214,2260,7200,765000,3,2,2015,0,59,5230,4940,0,0,0
3,1.0,1130,9147,1.0,0,0,5,7,1130,0,1952,0,98033,47.7006,-122.197,1930,9906,426000,19,8,2014,0,62,8017,7976,0,0,0
3,1.75,1640,18730,1.5,0,0,4,7,1640,0,1946,0,98004,47.5975,-122.196,1670,12154,775000,25,8,2014,0,68,17090,10484,0,0,0
2,1.5,1040,8526,1.0,0,0,5,6,1040,0,1953,0,98155,47.7349,-122.295,1310,8504,343000,4,12,2014,0,61,7486,7194,0,0,1
4,2.5,2320,7800,2.0,0,0,3,8,2320,0,1986,0,98028,47.7738,-122.266,2090,5721,470101,8,9,2014,0,28,5480,3631,0,0,0
3,1.5,1200,7800,1.0,0,0,4,7,1200,0,1958,0,98002,47.3137,-122.212,1390,8415,195000,5,5,2015,0,57,6600,7025,0,0,0
4,1.0,1720,4410,1.5,0,2,3,7,1720,0,1928,0,98117,47.6791,-122.402,2140,4500,772500,3,3,2015,0,87,2690,2360,0,0,1
3,1.5,2330,11740,1.0,0,0,3,8,1330,1000,1954,0,98155,47.7481,-122.292,2630,11740,450000,25,6,2014,0,60,9410,9110,0,1,1
4,3.75,4410,9231,3.0,0,3,3,11,4410,0,2001,0,98118,47.5427,-122.265,2160,6600,1440000,2,9,2014,0,13,4821,4440,0,0,1
4,1.75,1650,8560,1.0,0,0,3,8,1650,0,1970,0,98052,47.6652,-122.146,1700,8560,525000,18,9,2014,0,44,6910,6860,0,0,0
3,1.5,1370,11400,2.0,0,0,3,7,1370,0,1980,0,98045,47.4477,-121.77,1390,9600,280000,8,10,2014,0,34,10030,8210,0,0,0
3,2.5,1770,8640,1.0,0,0,3,7,1420,350,1986,0,98001,47.326,-122.273,1894,7974,270000,18,7,2014,0,28,6870,6080,0,1,0
3,2.25,1410,1332,3.0,0,0,3,8,1410,0,2005,0,98103,47.6916,-122.34,1430,1448,406100,5,5,2014,0,9,-78,18,0,0,1
2,1.75,1710,4187,1.0,0,0,3,7,1710,0,1987,0,98055,47.4732,-122.188,1760,4084,332544,20,10,2014,0,27,2477,2324,0,0,0
2,1.0,790,8250,1.0,0,0,3,6,790,0,1947,0,98188,47.4523,-122.286,900,8250,110000,27,4,2015,0,68,7460,7350,0,0,1
6,2.25,2770,5854,1.5,0,0,3,8,2120,650,1921,0,98112,47.6466,-122.304,2300,5450,685000,9,12,2014,0,93,3084,3150,0,1,1
4,1.0,1260,8505,1.5,0,0,5,7,1260,0,1951,0,98177,47.7181,-122.371,1480,8100,461000,29,7,2014,0,63,7245,6620,0,0,1
3,2.25,2300,8067,1.0,0,0,4,8,1300,1000,1979,0,98034,47.7091,-122.198,2120,9524,615000,14,4,2015,0,36,5767,7404,0,1,0
2,1.0,1070,3000,1.0,0,0,4,7,870,200,1926,0,98103,47.6828,-122.353,1890,3300,550000,3,5,2015,0,89,1930,1410,0,1,1
4,3.5,3850,8100,2.0,0,1,3,11,2430,1420,1995,0,98033,47.6855,-122.19,2620,9346,1060000,22,10,2014,0,19,4250,6726,0,1,0
4,2.5,1830,5175,2.0,0,0,3,7,1830,0,2003,0,98038,47.3565,-122.016,1830,5175,312000,3,6,2014,0,11,3345,3345,0,0,0
3,1.75,1990,9594,1.0,0,0,3,8,1190,800,1977,0,98052,47.6617,-122.137,1930,9765,507500,1,7,2014,0,37,7604,7835,0,1,0
3,1.0,1110,9827,1.0,0,0,3,7,1110,0,1966,0,98198,47.369,-122.311,1540,10187,217000,18,9,2014,0,48,8717,8647,0,0,1
3,2.25,1830,13477,1.0,0,3,4,7,1170,660,1981,0,98034,47.7243,-122.21,1960,11344,439000,12,12,2014,0,33,11647,9384,0,1,0
6,3.5,3600,6875,2.0,0,0,3,8,2740,860,2004,0,98065,47.5401,-121.879,3150,6663,620000,26,6,2014,0,10,3275,3513,0,1,0
4,2.5,3210,8532,2.0,0,0,3,10,3210,0,1998,0,98007,47.625,-122.144,2950,6753,915000,12,8,2014,0,16,5322,3803,0,0,0
4,2.0,1490,5300,1.0,0,0,3,7,1110,380,1977,0,98144,47.5949,-122.296,1330,1499,425000,4,12,2014,0,37,3810,169,0,1,1
2,1.0,990,5643,1.0,0,0,3,7,870,120,1947,0,98115,47.6802,-122.298,1280,5700,435000,27,2,2015,0,68,4653,4420,0,1,1
3,2.25,1646,12414,2.0,0,0,3,7,1646,0,1996,0,98038,47.363,-122.035,1654,8734,305000,29,12,2014,0,18,10768,7080,0,0,0
2,1.0,720,4000,1.0,0,0,3,6,720,0,1918,0,98106,47.5346,-122.353,1630,4000,276000,26,3,2015,0,97,3280,2370,0,0,1
3,2.25,2310,7200,2.0,0,0,3,8,2310,0,1990,0,98031,47.4051,-122.193,1960,7201,327500,30,6,2014,0,24,4890,5241,0,0,0
3,2.5,2670,10481,2.0,0,0,3,9,2670,0,2003,0,98033,47.6673,-122.176,2620,8895,810000,17,6,2014,0,11,7811,6275,0,0,0
3,3.25,3060,9055,2.0,0,0,3,10,2460,600,1994,0,98052,47.6971,-122.101,2990,9598,715000,21,11,2014,0,20,5995,6608,0,1,0
3,1.5,1380,11760,1.0,0,0,4,7,1380,0,1963,0,98055,47.4243,-122.202,1650,9855,272000,5,8,2014,0,51,10380,8205,0,0,0
2,1.0,700,5559,1.0,0,0,5,6,700,0,1949,0,98155,47.7492,-122.311,1230,8100,266000,21,4,2015,0,66,4859,6870,0,0,1
3,1.5,1710,8364,2.0,0,2,3,7,1710,0,1944,0,98136,47.5175,-122.393,2430,9040,543000,27,4,2015,0,71,6654,6610,0,0,1
3,2.5,1450,8064,1.0,0,0,3,8,1450,0,1984,0,98074,47.6256,-122.037,1710,9554,400000,7,10,2014,0,30,6614,7844,0,0,0
5,2.25,2060,9000,1.0,0,0,4,7,1320,740,1961,0,98007,47.6122,-122.137,2050,8800,509500,6,8,2014,0,53,6940,6750,0,1,0
3,3.5,2380,6250,2.0,0,3,3,8,1670,710,1997,0,98118,47.5137,-122.252,2540,4010,495000,21,5,2014,0,17,3870,1470,0,1,1
4,2.5,2760,5564,2.0,0,0,3,7,2760,0,2001,0,98056,47.4814,-122.189,2670,5626,424950,13,3,2015,0,14,2804,2956,0,0,0
3,1.0,940,10875,1.0,0,0,3,7,940,0,1957,0,98056,47.5121,-122.168,1250,11200,230000,26,9,2014,0,57,9935,9950,0,0,0
4,1.5,1760,6150,1.5,0,0,3,7,1760,0,1951,0,98031,47.3871,-122.224,1760,8276,235000,6,8,2014,0,63,4390,6516,0,0,0
3,2.0,1360,8752,1.0,0,2,4,6,1360,0,1942,0,98033,47.6879,-122.208,2530,7680,763000,9,3,2015,0,73,7392,5150,0,0,0
3,1.75,2010,6150,2.0,0,0,5,7,2010,0,1939,0,98178,47.4975,-122.231,1770,7380,350000,19,9,2014,0,75,4140,5610,0,0,1
3,1.5,2160,2260,2.0,0,2,5,8,1620,540,1917,0,98119,47.6321,-122.371,2570,2400,900000,26,11,2014,0,97,100,-170,0,1,1
3,1.0,930,6060,1.0,0,0,4,6,930,0,1973,0,98118,47.5289,-122.28,1640,6364,250000,7,10,2014,0,41,5130,4724,0,0,1
3,2.5,1020,2040,2.0,0,0,3,7,720,300,2004,0,98106,47.5294,-122.361,1060,1478,225000,26,1,2015,0,11,1020,418,0,1,1
2,2.0,1360,5433,1.0,0,0,3,8,1360,0,1974,2003,98198,47.3804,-122.32,1160,5264,255000,26,12,2014,29,40,4073,4104,1,0,1
4,1.75,1720,7200,1.0,0,0,3,7,1220,500,1974,0,98023,47.306,-122.375,1790,7200,161700,4,6,2014,0,40,5480,5410,0,1,0
3,3.0,1790,13350,1.0,0,0,3,7,1190,600,1988,0,98178,47.4958,-122.262,1740,10624,336000,2,2,2015,0,27,11560,8884,0,1,1
3,1.0,1150,6800,1.0,0,0,3,7,1150,0,1954,0,98133,47.727,-122.339,1210,6800,410500,23,10,2014,0,60,5650,5590,0,0,1
3,2.5,2400,9601,1.0,0,0,5,7,1390,1010,1977,0,98034,47.7256,-122.211,2010,9943,505000,23,9,2014,0,37,7201,7933,0,1,0
3,1.0,1660,7650,1.5,0,0,3,7,1350,310,1910,0,98118,47.5576,-122.277,1750,5760,250000,16,12,2014,0,104,5990,4010,0,1,1
3,1.0,1660,7650,1.5,0,0,3,7,1350,310,1910,0,98118,47.5576,-122.277,1750,5760,570000,22,4,2015,0,105,5990,4010,0,1,1
4,2.5,2290,8796,2.0,0,0,3,8,2290,0,1994,0,98198,47.3762,-122.318,2130,8796,349900,18,3,2015,0,21,6506,6666,0,0,1
3,1.75,1800,5102,1.0,0,0,3,7,1170,630,1952,0,98199,47.6514,-122.407,1720,5102,655000,19,2,2015,0,63,3302,3382,0,1,1
4,1.75,2960,11347,1.0,0,0,4,8,1570,1390,1946,0,98166,47.4738,-122.353,1660,8911,469000,27,3,2015,0,69,8387,7251,0,1,1
3,2.25,1980,7200,1.0,0,0,3,8,1300,680,1964,0,98177,47.7625,-122.36,1820,8250,355000,9,10,2014,0,50,5220,6430,0,1,1
3,2.5,1730,2631,2.0,0,0,3,8,1730,0,2001,0,98005,47.5878,-122.165,1730,2751,596000,24,2,2015,0,14,901,1021,0,0,0
4,3.25,2830,4000,2.0,0,0,3,9,1910,920,1912,2012,98144,47.5845,-122.291,2740,4000,1030000,12,9,2014,100,102,1170,1260,1,1,1
4,1.75,2120,5400,1.0,0,0,4,8,1060,1060,1941,0,98199,47.6501,-122.395,2052,6000,710000,3,4,2015,0,74,3280,3948,0,1,1
3,2.5,2150,9266,2.0,0,0,3,8,2150,0,1988,0,98028,47.7445,-122.248,2150,12550,428040,14,8,2014,0,26,7116,10400,0,0,0
5,2.25,3510,13843,1.0,0,2,3,8,1850,1660,1959,0,98040,47.5817,-122.246,2680,8750,1370000,14,4,2015,0,56,10333,6070,0,1,0
2,1.0,970,3400,1.0,0,0,3,7,970,0,1924,0,98109,47.6444,-122.357,1180,3600,546000,5,6,2014,0,90,2430,2420,0,0,1
4,1.0,1360,5766,1.5,0,0,5,7,1360,0,1951,0,98115,47.6827,-122.289,1500,5704,540000,3,8,2014,0,63,4406,4204,0,0,1
3,2.5,1470,3000,1.0,0,0,3,7,930,540,1985,0,98115,47.6832,-122.286,1470,5588,435000,8,9,2014,0,29,1530,4118,0,1,1
4,2.25,3040,10283,1.0,0,0,4,8,1430,1610,1984,0,98074,47.6268,-122.038,1870,11074,540000,6,4,2015,0,31,7243,9204,0,1,0
2,1.0,860,7204,1.0,0,0,3,7,860,0,1918,0,98106,47.5361,-122.351,1200,7500,284000,13,11,2014,0,96,6344,6300,0,0,1
2,1.0,820,5700,1.0,0,0,5,5,820,0,1942,0,98056,47.4915,-122.184,1000,5700,208000,14,7,2014,0,72,4880,4700,0,0,0
3,1.75,1900,7076,1.0,0,0,3,7,1130,770,1977,0,98155,47.7569,-122.326,1540,10113,315000,3,12,2014,0,37,5176,8573,0,1,1
2,1.0,1330,5510,1.0,0,0,3,6,850,480,1910,0,98117,47.6901,-122.362,1200,4150,417500,31,7,2014,0,104,4180,2950,0,1,1
3,2.5,1330,1064,3.0,0,0,3,8,1330,0,2004,0,98117,47.6835,-122.387,1330,1113,375000,2,9,2014,0,10,-266,-217,0,0,1
3,1.75,1880,12821,1.0,0,0,3,7,1880,0,1959,0,98155,47.7681,-122.305,1540,12868,389800,23,6,2014,0,55,10941,11328,0,0,1
3,1.75,1890,7560,1.0,0,0,3,8,1430,460,1973,0,98034,47.7322,-122.185,1890,9095,475000,8,4,2015,0,42,5670,7205,0,1,0
3,2.5,1830,8022,2.0,0,0,3,8,1830,0,1987,0,98074,47.6198,-122.044,2030,7736,532000,29,1,2015,0,28,6192,5706,0,0,0
2,1.0,720,5000,1.0,0,0,5,6,720,0,1951,0,98126,47.5195,-122.374,810,5000,280000,11,8,2014,0,63,4280,4190,0,0,1
3,1.75,1340,12800,1.0,0,0,3,7,880,460,1981,0,98058,47.4437,-122.137,1500,7875,315000,27,10,2014,0,33,11460,6375,0,1,0
3,3.0,1740,3700,1.0,0,0,3,7,1740,0,1982,0,98122,47.6102,-122.309,1830,2480,612000,14,10,2014,0,32,1960,650,0,0,1
3,1.75,1680,2400,1.0,0,0,5,7,870,810,1922,0,98122,47.6155,-122.3,1440,3600,591000,13,5,2014,0,92,720,2160,0,1,1
4,2.25,3220,8436,2.0,0,0,3,8,3220,0,1968,0,98008,47.6381,-122.116,2500,7632,800000,11,7,2014,0,46,5216,5132,0,0,0
3,2.0,1610,8400,1.0,0,0,3,8,1610,0,1990,0,98022,47.1958,-122.009,1930,8459,225000,22,1,2015,0,25,6790,6529,0,0,0
4,2.5,2520,13156,1.0,0,0,3,8,1520,1000,1979,0,98052,47.6558,-122.135,2050,10940,565000,26,11,2014,0,35,10636,8890,0,1,0
3,1.5,2120,8448,1.0,0,0,3,7,1060,1060,1940,0,98199,47.6438,-122.403,1620,7920,650000,19,2,2015,0,75,6328,6300,0,1,1
3,2.5,2090,8505,2.0,0,0,3,8,2090,0,1951,1977,98177,47.7195,-122.371,1640,8100,499000,18,9,2014,26,63,6415,6460,1,0,1
3,2.5,2420,7500,1.0,0,2,4,8,1210,1210,1944,0,98117,47.6949,-122.389,2340,7500,649950,28,1,2015,0,71,5080,5160,0,1,1
3,1.75,1510,6360,1.0,0,0,4,7,1510,0,1954,0,98133,47.7321,-122.353,1480,7260,420000,9,7,2014,0,60,4850,5780,0,0,1
4,2.5,2120,5293,2.0,0,0,3,7,2120,0,2003,0,98031,47.4217,-122.201,1990,5313,319990,15,12,2014,0,11,3173,3323,0,0,0
3,2.0,1850,16535,1.0,0,0,3,7,1850,0,1992,0,98014,47.6565,-121.912,1528,13295,265000,12,8,2014,0,22,14685,11767,0,0,0
4,4.25,5180,13077,2.0,0,3,3,12,4280,900,1998,0,98006,47.5513,-122.109,5030,15069,1490000,18,7,2014,0,16,7897,10039,0,1,0
2,1.0,1810,8527,1.5,0,0,4,7,1810,0,1943,0,98133,47.7275,-122.336,1490,6800,375000,21,8,2014,0,71,6717,5310,0,0,1
5,3.0,2190,4900,2.0,0,0,5,7,1490,700,1940,0,98117,47.6892,-122.386,1370,4606,588000,3,7,2014,0,74,2710,3236,0,1,1
4,2.5,2500,10215,2.0,0,0,3,9,2500,0,1998,0,98075,47.5912,-121.986,2890,10240,635000,24,4,2015,0,17,7715,7350,0,0,0
4,2.5,1890,6962,2.0,0,0,3,8,1890,0,1997,0,98092,47.3328,-122.187,2170,6803,280500,3,7,2014,0,17,5072,4633,0,0,0
2,1.75,2040,8600,1.0,0,0,4,6,1430,610,1985,0,98003,47.2755,-122.308,1310,7859,210500,25,9,2014,0,29,6560,6549,0,1,0
3,2.0,1310,7000,1.0,0,0,4,7,1310,0,1979,0,98023,47.303,-122.383,1390,7500,196500,26,9,2014,0,35,5690,6110,0,0,0
5,3.5,4010,8510,2.0,0,1,5,9,2850,1160,1971,0,98105,47.6578,-122.286,2610,6128,1400000,5,5,2014,0,43,4500,3518,0,1,1
3,1.75,1780,8033,1.0,0,0,2,7,1210,570,1977,0,98034,47.7275,-122.219,1630,7508,475000,6,2,2015,0,38,6253,5878,0,1,0
3,2.5,1980,9061,2.0,0,0,4,8,1980,0,1987,0,98074,47.6366,-122.029,1930,8869,550000,4,5,2015,0,28,7081,6939,0,0,0
3,3.25,3690,7200,2.0,0,0,3,11,3690,0,2007,0,98033,47.6815,-122.2,1880,7200,1580000,21,5,2014,0,7,3510,5320,0,0,0
3,1.75,1540,6687,1.0,0,0,3,7,1200,340,1991,0,98022,47.1938,-121.981,1540,7242,240000,22,4,2015,0,24,5147,5702,0,1,0
3,1.0,1130,8100,1.5,0,0,3,6,1130,0,1934,0,98168,47.4935,-122.306,1080,8100,272000,29,4,2015,0,81,6970,7020,0,0,1
3,2.5,2580,7500,2.0,0,0,3,9,2580,0,1991,0,98116,47.5577,-122.396,910,6500,640000,18,8,2014,0,23,4920,5590,0,0,1
4,2.5,2010,7226,2.0,0,0,3,8,2010,0,1995,0,98092,47.2588,-122.21,2160,7696,316000,14,5,2014,0,19,5216,5536,0,0,0
4,2.0,2320,12000,1.0,0,0,3,7,1720,600,1943,2014,98108,47.5246,-122.325,1390,6000,299000,20,8,2014,71,71,9680,4610,1,1,1
2,2.25,1180,2090,2.0,0,0,3,7,1180,0,2004,0,98122,47.6032,-122.31,1550,2812,447500,5,3,2015,0,11,910,1262,0,0,1
5,2.5,3050,13212,1.0,0,0,4,8,1590,1460,1975,0,98006,47.5596,-122.142,2550,10826,707000,24,4,2015,0,40,10162,8276,0,1,0
4,1.75,1630,8000,1.0,0,0,3,7,1630,0,1959,0,98031,47.3948,-122.201,1630,7700,215000,29,8,2014,0,55,6370,6070,0,0,0
3,2.25,1620,6415,2.0,0,0,4,7,1620,0,1989,0,98038,47.3577,-122.038,1640,7253,275000,11,12,2014,0,25,4795,5613,0,0,0
4,2.25,2170,8240,2.0,0,1,4,8,2170,0,1983,0,98006,47.5634,-122.128,2600,9898,648000,25,3,2015,0,32,6070,7298,0,0,0
4,2.5,2150,8173,2.0,0,0,3,8,2150,0,1987,0,98059,47.511,-122.153,2080,7620,415000,28,10,2014,0,27,6023,5540,0,0,0
3,2.0,1770,1800,3.0,0,0,3,8,1770,0,1999,0,98122,47.6102,-122.314,1890,3200,690000,19,11,2014,0,15,30,1310,0,0,1
4,2.75,2110,13260,1.0,0,0,4,7,1290,820,1979,0,98058,47.4513,-122.16,1980,11016,320000,24,9,2014,0,35,11150,9036,0,1,0
3,1.75,1590,8285,1.0,0,0,4,8,1590,0,1956,0,98004,47.5855,-122.194,1970,8970,750000,2,9,2014,0,58,6695,7000,0,0,0
3,2.25,1370,1524,3.0,0,0,3,8,1370,0,2005,0,98103,47.6982,-122.347,1370,1418,355000,30,6,2014,0,9,154,48,0,0,1
3,1.75,1390,7399,1.0,0,0,4,7,1390,0,1975,0,98031,47.4183,-122.182,1460,7800,246000,8,5,2014,0,39,6009,6340,0,0,0
3,2.5,2670,12187,2.0,0,0,3,8,2670,0,1986,0,98052,47.6677,-122.15,2400,8999,744000,6,6,2014,0,28,9517,6599,0,0,0
3,2.0,1690,6750,1.0,0,0,3,7,1210,480,1977,0,98023,47.3021,-122.375,1930,7350,217000,10,12,2014,0,37,5060,5420,0,1,0
3,2.5,2600,5100,2.0,0,1,3,8,2600,0,1998,0,98056,47.5175,-122.205,2270,5400,583000,9,7,2014,0,16,2500,3130,0,0,0
2,1.5,1400,5000,1.0,0,0,4,7,1150,250,1904,0,98107,47.6681,-122.362,1530,4200,515000,11,11,2014,0,110,3600,2670,0,1,1
4,1.75,2140,8000,1.0,0,0,4,8,1410,730,1965,0,98007,47.622,-122.139,2080,8000,594000,19,3,2015,0,50,5860,5920,0,1,0
3,1.5,1640,5650,1.0,0,0,3,8,1640,0,1952,0,98178,47.509,-122.251,1640,5650,303100,22,10,2014,0,62,4010,4010,0,0,1
3,1.75,1720,15225,1.0,0,0,4,7,1020,700,1970,0,98075,47.579,-122.051,1860,13588,430000,10,10,2014,0,44,13505,11728,0,1,0
5,3.25,3060,11778,2.0,0,0,3,8,3060,0,2004,0,98034,47.7212,-122.222,1840,10403,708000,8,12,2014,0,10,8718,8563,0,0,0
3,1.0,1150,7260,1.0,0,0,3,7,1150,0,1959,0,98133,47.7344,-122.333,1200,7888,221000,13,8,2014,0,55,6110,6688,0,0,1
3,2.5,2000,7205,2.0,0,0,3,8,2000,0,1998,0,98003,47.3499,-122.302,2180,7611,325000,24,3,2015,0,17,5205,5431,0,0,0
3,1.75,1560,5950,1.0,0,0,4,6,780,780,1944,0,98125,47.719,-122.307,1320,7830,385000,19,2,2015,0,71,4390,6510,0,1,1
3,2.5,2070,4689,2.0,0,0,3,8,2070,0,2013,0,98038,47.3545,-122.056,1880,4593,359500,27,3,2015,0,2,2619,2713,0,0,0
3,2.0,1920,7200,1.0,0,0,3,7,1300,620,1984,0,98028,47.7703,-122.265,2010,7200,433000,7,8,2014,0,30,5280,5190,0,1,0
2,1.0,1000,4950,1.0,0,0,3,7,800,200,1948,0,98116,47.5671,-122.394,1060,5500,525000,23,3,2015,0,67,3950,4440,0,1,1
3,2.0,1690,10062,1.0,0,2,5,7,940,750,1928,0,98178,47.5102,-122.241,2390,6650,356200,22,7,2014,0,86,8372,4260,0,1,1
4,1.5,1790,3420,1.0,0,0,4,7,1020,770,1923,0,98103,47.6489,-122.337,1680,3420,560000,15,9,2014,0,91,1630,1740,0,1,1
4,2.0,2090,4000,1.0,0,0,3,7,1480,610,1951,0,98107,47.6751,-122.379,1510,5000,513000,27,10,2014,0,63,1910,3490,0,1,1
2,1.0,680,2550,1.0,0,0,4,5,680,0,1901,0,98117,47.6767,-122.388,1120,5100,365000,21,7,2014,0,113,1870,3980,0,0,1
4,1.75,2100,11942,1.0,0,0,3,7,1030,1070,1964,0,98106,47.55,-122.356,1170,6986,368000,8,7,2014,0,50,9842,5816,0,1,1
4,2.75,2840,4000,1.5,0,0,5,8,1960,880,1912,0,98144,47.5846,-122.291,2750,4000,870000,25,6,2014,0,102,1160,1250,0,1,1
3,2.25,1470,6808,1.0,0,0,3,7,1160,310,1984,0,98023,47.2884,-122.365,1570,7881,225000,24,7,2014,0,30,5338,6311,0,1,0
3,1.75,1150,8079,1.0,0,0,4,7,1150,0,1983,0,98030,47.3766,-122.18,1540,7399,177000,19,6,2014,0,31,6929,5859,0,0,0
3,1.5,1460,9879,1.0,0,0,3,7,1460,0,1956,0,98008,47.6346,-122.127,1610,10050,465000,27,1,2015,0,59,8419,8440,0,0,0
4,2.75,3150,6343,1.0,0,3,3,8,1810,1340,1976,0,98126,47.5424,-122.381,2250,6343,750000,27,9,2014,0,38,3193,4093,0,1,1
3,1.0,1090,2800,1.0,0,0,3,6,1090,0,1969,0,98092,47.3162,-122.183,1040,2960,149000,22,9,2014,0,45,1710,1920,0,0,0
3,2.0,2110,5800,1.5,0,0,4,7,1990,120,1927,0,98103,47.6645,-122.342,1620,4300,725000,24,10,2014,0,87,3690,2680,0,1,1
4,2.25,1770,5236,2.0,0,0,3,7,1770,0,2007,0,98056,47.5137,-122.189,2470,5064,413900,22,9,2014,0,7,3466,2594,0,0,0
3,1.5,1510,6600,1.0,0,0,3,6,1510,0,1938,0,98168,47.4821,-122.331,990,6600,199950,31,7,2014,0,76,5090,5610,0,0,1
3,1.5,2420,5000,2.0,0,0,4,8,2200,220,1925,0,98103,47.6744,-122.353,2070,5000,870000,12,8,2014,0,89,2580,2930,0,1,1
5,2.5,2490,7666,1.0,0,0,4,7,1490,1000,1989,0,98031,47.4022,-122.171,1930,7415,292000,5,6,2014,0,25,5176,5485,0,1,0
3,1.0,990,8012,1.0,0,0,4,7,990,0,1966,0,98058,47.4557,-122.181,1260,9060,225000,12,5,2014,0,48,7022,7800,0,0,0
4,2.0,1730,9139,2.0,0,0,3,8,1730,0,1957,0,98125,47.7181,-122.316,1410,7311,466750,16,3,2015,0,58,7409,5901,0,0,1
2,1.5,1440,11954,1.0,0,0,4,8,1440,0,1978,0,98002,47.2909,-122.219,1460,9730,330000,23,3,2015,0,37,10514,8270,0,0,0
7,2.25,3260,8145,2.0,0,0,5,8,3260,0,1967,0,98008,47.6336,-122.115,2340,8145,770000,2,10,2014,0,47,4885,5805,0,0,0
4,2.25,1950,7000,1.0,0,1,3,8,1450,500,1957,0,98118,47.5426,-122.262,1840,6440,802500,13,2,2015,0,58,5050,4600,0,1,1
5,2.5,2740,5400,2.0,0,0,3,8,2740,0,2005,0,98031,47.4036,-122.205,2900,5476,378800,18,7,2014,0,9,2660,2576,0,0,0
3,2.75,2940,12487,2.0,0,0,3,10,2940,0,1997,0,98075,47.5879,-121.973,3110,10837,795000,1,5,2015,0,18,9547,7727,0,0,0
3,2.0,1200,7320,1.0,0,0,3,7,1200,0,1955,0,98115,47.6986,-122.286,1750,8220,460000,22,4,2015,0,60,6120,6470,0,0,1
3,2.5,2070,10908,2.0,0,0,3,8,2070,0,1986,0,98029,47.5665,-122.023,2220,10975,567000,19,12,2014,0,28,8838,8755,0,0,0
4,1.5,1830,6985,1.0,0,0,3,7,1080,750,1967,0,98028,47.7494,-122.236,1650,9501,424500,15,12,2014,0,47,5155,7851,0,1,0
2,1.0,970,12500,1.0,0,0,3,6,970,0,1941,0,98168,47.5102,-122.33,1280,6250,261000,5,5,2015,0,74,11530,4970,0,0,1
3,2.5,2200,9696,2.0,0,0,3,8,2200,0,1987,0,98031,47.4197,-122.205,2200,9915,365000,27,8,2014,0,27,7496,7715,0,0,0
4,2.0,1930,3240,1.5,0,0,4,7,1930,0,1911,0,98122,47.6156,-122.299,1480,3600,631000,8,4,2015,0,104,1310,2120,0,0,1
3,2.5,1790,3962,2.0,0,0,3,8,1790,0,1992,0,98117,47.6894,-122.391,1340,3960,584000,8,10,2014,0,22,2172,2620,0,0,1
4,2.5,2780,7985,2.0,0,0,4,10,2780,0,1992,0,98029,47.5608,-122.016,2650,8094,717000,12,3,2015,0,23,5205,5444,0,0,0
3,1.5,1720,8100,2.0,0,0,3,8,1720,0,1907,0,98107,47.6746,-122.4,2210,8100,667000,16,6,2014,0,107,6380,5890,0,0,1
3,1.0,1640,8100,1.0,0,0,3,6,1040,600,1939,0,98146,47.482,-122.34,1600,8100,190000,30,12,2014,0,75,6460,6500,0,1,1
3,2.0,1730,9000,1.0,0,0,3,8,1370,360,1978,0,98027,47.5202,-122.047,2390,10000,430000,17,6,2014,0,36,7270,7610,0,1,0
2,1.0,740,7380,1.0,0,0,4,6,740,0,1951,0,98188,47.4481,-122.278,1500,10075,213000,24,4,2015,0,64,6640,8575,0,0,1
3,2.5,2280,3710,1.0,0,0,3,8,1550,730,1990,0,98072,47.735,-122.159,2030,3710,475000,7,10,2014,0,24,1430,1680,0,1,0
3,2.5,2550,13458,2.0,0,0,3,9,2550,0,1990,0,98006,47.5586,-122.121,3180,13458,715000,6,6,2014,0,24,10908,10278,0,0,0
3,2.5,2770,8820,1.0,0,0,3,7,1900,870,1980,2004,98038,47.3685,-122.048,1850,10920,390000,10,11,2014,24,34,6050,9070,1,1,0
4,3.0,2860,5724,1.0,0,0,3,7,1730,1130,1983,0,98108,47.5427,-122.302,2340,7200,390000,24,9,2014,0,31,2864,4860,0,1,1
4,1.75,1990,7194,1.0,0,0,4,8,1400,590,1978,0,98058,47.4417,-122.135,1820,7400,328000,29,7,2014,0,36,5204,5580,0,1,0
3,2.75,1740,8436,1.0,0,0,3,7,1140,600,1967,0,98003,47.3456,-122.305,1550,8436,239999,5,12,2014,0,47,6696,6886,0,1,0
3,2.0,1460,7740,1.0,0,0,3,7,1460,0,1968,0,98003,47.3467,-122.306,1540,7644,225000,21,10,2014,0,46,6280,6104,0,0,0
3,1.75,3670,11884,1.0,0,2,4,9,1950,1720,1979,0,98006,47.5604,-122.133,3020,9747,920000,16,10,2014,0,35,8214,6727,0,1,0
4,2.75,3270,9231,2.0,0,0,3,10,3270,0,1995,0,98052,47.6539,-122.121,3380,10154,940000,17,3,2015,0,20,5961,6774,0,0,0
3,1.0,1210,4872,1.0,0,0,4,6,1210,0,1949,0,98118,47.5551,-122.273,1070,4872,465000,1,5,2015,0,66,3662,3802,0,0,1
3,2.0,1770,7000,1.0,0,0,3,7,1770,0,1986,0,98001,47.3321,-122.261,1510,10462,241000,1,7,2014,0,28,5230,8952,0,0,0
4,2.5,1980,5909,2.0,0,0,3,8,1980,0,2003,0,98031,47.3913,-122.185,2550,5487,307550,9,6,2014,0,11,3929,2937,0,0,0
4,2.5,2650,9627,1.0,0,3,4,8,1610,1040,1976,0,98028,47.7684,-122.254,2650,9221,490000,31,10,2014,0,38,6977,6571,0,1,0
4,2.5,3040,6887,2.0,0,0,3,8,3040,0,1999,0,98074,47.6073,-122.015,2790,7196,647000,12,5,2014,0,15,3847,4406,0,0,0
3,2.5,1810,4332,2.0,0,0,3,8,1810,0,1992,0,98029,47.5776,-121.996,1740,4332,517500,14,11,2014,0,22,2522,2592,0,0,0
3,2.0,1380,8682,1.0,0,0,4,7,1380,0,1966,0,98148,47.4238,-122.322,1410,10594,295000,18,6,2014,0,48,7302,9184,0,0,1
4,1.5,1810,3400,2.0,0,0,3,8,1810,0,1926,0,98112,47.6264,-122.302,1770,3600,560000,4,12,2014,0,88,1590,1830,0,0,1
5,2.0,2250,5472,1.5,0,0,5,7,1750,500,1930,0,98002,47.3065,-122.219,1540,5472,319450,5,11,2014,0,84,3222,3932,0,1,0
4,3.25,3860,7199,2.0,0,1,3,9,2870,990,2005,0,98115,47.6855,-122.269,2940,9600,1500000,12,12,2014,0,9,3339,6660,0,1,1
3,1.0,1370,11658,1.0,0,0,4,6,1370,0,1958,0,98058,47.4576,-122.182,1080,9198,249950,15,8,2014,0,56,10288,8118,0,0,0
3,1.0,1830,3000,1.5,0,0,3,7,1430,400,1926,0,98103,47.6619,-122.351,1510,2500,499950,13,6,2014,0,88,1170,990,0,1,1
4,1.75,1440,13296,1.0,0,0,4,8,1440,0,1967,0,98004,47.634,-122.204,3520,10802,1040000,2,7,2014,0,47,11856,7282,0,0,0
4,2.5,2510,17200,1.0,0,2,4,9,1540,970,1977,0,98052,47.6287,-122.089,2370,14621,750000,16,2,2015,0,38,14690,12251,0,1,0
3,1.75,1670,7210,1.0,0,0,5,8,1670,0,1967,0,98008,47.6344,-122.116,2200,7210,678000,14,4,2015,0,48,5540,5010,0,0,0
2,1.0,780,4200,1.0,0,0,3,6,780,0,1920,0,98118,47.5381,-122.267,1620,6000,360000,29,7,2014,0,94,3420,4380,0,0,1
5,2.5,2260,10087,1.0,0,0,3,8,1520,740,1967,0,98008,47.5982,-122.128,2500,9440,632000,27,8,2014,0,47,7827,6940,0,1,0
3,1.75,1480,9375,1.0,0,0,4,7,1480,0,1957,0,98146,47.5076,-122.366,1370,9000,350000,18,12,2014,0,57,7895,7630,0,0,1
3,4.0,2550,3900,2.0,0,2,3,8,2050,500,1940,2003,98199,47.6415,-122.392,2340,6400,990000,30,7,2014,63,74,1350,4060,1,1,1
4,2.5,2286,8269,2.0,0,0,3,8,2286,0,2002,0,98056,47.5174,-122.194,2110,4711,481000,7,7,2014,0,12,5983,2601,0,0,0
3,2.5,1500,5412,1.0,0,0,5,7,900,600,1920,0,98136,47.5499,-122.394,1090,5412,485000,24,6,2014,0,94,3912,4322,0,1,1
3,2.5,1740,4960,2.0,0,0,3,8,1740,0,1992,0,98029,47.5772,-121.998,1740,5021,477000,13,4,2015,0,23,3220,3281,0,0,0
5,2.5,2880,9000,1.0,0,0,5,8,1440,1440,1966,0,98006,47.5456,-122.179,2010,9000,560000,29,7,2014,0,48,6120,6990,0,1,0
6,3.0,2600,9350,1.0,0,0,4,8,1340,1260,1963,0,98008,47.6198,-122.105,2090,9102,600000,17,11,2014,0,51,6750,7012,0,1,0
2,2.25,1660,2128,2.0,0,0,4,8,1660,0,1974,0,98028,47.7528,-122.252,1640,2128,410000,29,4,2015,0,41,468,488,0,0,0
3,2.5,1990,3644,2.0,0,0,3,7,1990,0,2010,0,98038,47.3531,-122.017,2580,3800,318200,2,4,2015,0,5,1654,1220,0,0,0
3,2.0,1680,8424,1.0,0,0,3,7,1680,0,1993,0,98022,47.1969,-122.011,1990,8545,289000,5,6,2014,0,21,6744,6555,0,0,0
3,1.75,1570,7775,2.0,0,0,3,7,1570,0,1982,0,98031,47.3876,-122.216,1580,8622,263000,20,5,2014,0,32,6205,7042,0,0,0
3,1.0,1150,4825,1.0,0,0,4,6,1150,0,1957,0,98027,47.5321,-122.029,1760,7121,240000,5,6,2014,0,57,3675,5361,0,0,0
3,1.0,1270,7500,1.0,0,0,3,7,1270,0,1953,0,98146,47.4921,-122.339,1340,3000,281500,7,4,2015,0,62,6230,1660,0,0,1
3,3.5,1890,1710,2.0,0,0,3,8,1640,250,1999,0,98103,47.6592,-122.349,1680,1562,587206,20,6,2014,0,15,-180,-118,0,1,1
2,2.25,1350,1248,2.0,0,0,3,7,1180,170,2000,0,98102,47.6399,-122.32,1760,3360,482000,30,7,2014,0,14,-102,1600,0,1,1
3,1.75,1650,9500,1.0,0,0,3,8,1650,0,1967,0,98052,47.631,-122.098,1880,9375,485000,10,3,2015,0,48,7850,7495,0,0,0
3,2.25,1640,7350,1.0,0,0,3,7,1140,500,1984,0,98003,47.2625,-122.3,1480,8041,221000,19,6,2014,0,30,5710,6561,0,1,0
3,2.5,2030,8398,2.0,0,0,4,9,2030,0,1975,0,98008,47.6272,-122.095,2450,8104,700000,13,5,2014,0,39,6368,5654,0,0,0
5,3.0,2420,7740,1.0,0,0,5,7,1360,1060,1929,1969,98106,47.536,-122.358,1840,6780,411500,29,9,2014,40,85,5320,4940,1,1,1
4,3.5,2770,10505,2.0,0,0,3,8,2770,0,1940,2015,98133,47.7412,-122.355,1760,10505,285000,28,10,2014,75,74,7735,8745,1,0,1
4,3.0,1980,7931,1.0,0,0,4,7,1160,820,1983,0,98133,47.7513,-122.334,1910,7931,395000,5,6,2014,0,31,5951,6021,0,1,1
2,1.75,1460,7926,1.0,0,0,4,7,1460,0,1987,0,98042,47.3665,-122.092,1680,8206,237950,9,7,2014,0,27,6466,6526,0,0,0
3,2.5,1610,8064,1.0,0,2,4,7,1160,450,1981,0,98033,47.6818,-122.189,2260,8328,680000,10,3,2015,0,34,6454,6068,0,1,0
2,1.0,1010,10057,1.0,0,0,3,6,1010,0,1961,0,98023,47.3286,-122.336,1040,8591,199950,26,12,2014,0,53,9047,7551,0,0,0
4,3.5,2760,4000,2.0,0,2,3,8,2000,760,1926,2014,98126,47.5687,-122.374,1690,4000,765000,12,12,2014,88,88,1240,2310,1,1,1
2,1.0,1060,4960,1.0,0,0,3,7,1060,0,1926,0,98103,47.6896,-122.331,1420,4960,515000,8,5,2014,0,88,3900,3540,0,0,1
3,1.5,1510,8000,1.0,0,0,4,7,1510,0,1956,0,98007,47.5865,-122.135,1430,8000,470000,16,6,2014,0,58,6490,6570,0,0,0
2,1.0,880,4000,1.0,0,0,3,6,780,100,1937,0,98117,47.6931,-122.379,950,4000,330000,20,8,2014,0,77,3120,3050,0,1,1
3,2.5,2150,9375,1.0,0,0,3,8,1550,600,1968,0,98188,47.4578,-122.274,1950,9100,284000,26,2,2015,0,47,7225,7150,0,1,1
3,2.5,1660,8125,1.0,0,0,3,7,1150,510,1999,0,98148,47.4373,-122.333,1250,8125,295000,12,9,2014,0,15,6465,6875,0,1,1
4,2.5,2160,10987,1.0,0,0,4,8,1440,720,1981,2003,98074,47.6333,-122.034,1280,11617,555000,30,3,2015,22,34,8827,10337,1,1,0
3,1.0,1370,8162,1.5,0,0,3,6,1370,0,1949,0,98125,47.7263,-122.289,1560,8250,350000,6,8,2014,0,65,6792,6690,0,0,1
3,2.25,1460,5818,1.0,0,0,3,7,1140,320,1986,0,98023,47.3113,-122.358,1490,6031,240000,3,12,2014,0,28,4358,4541,0,1,0
3,1.5,1450,7000,1.0,0,0,3,7,1450,0,1955,0,98007,47.5983,-122.15,1490,7245,419900,4,2,2015,0,60,5550,5755,0,0,0
3,2.0,1560,6300,1.0,0,0,3,7,1560,0,1924,0,98126,47.5407,-122.379,1620,6300,528000,30,4,2015,0,91,4740,4680,0,0,1
4,2.5,2480,9869,1.0,0,0,4,8,1240,1240,1963,0,98028,47.7612,-122.229,2230,10310,481000,11,3,2015,0,52,7389,8080,0,1,0
2,1.0,740,5995,1.0,0,0,4,7,740,0,1949,0,98133,47.7291,-122.337,1140,5995,304700,9,6,2014,0,65,5255,4855,0,0,1
4,2.5,2927,12171,2.0,0,0,3,10,2927,0,1998,0,98075,47.5948,-121.983,2967,12166,715000,4,2,2015,0,17,9244,9199,0,0,0
4,2.75,2260,12005,1.0,0,0,4,8,2260,0,1956,1989,98005,47.6342,-122.171,1870,10800,738950,20,8,2014,33,58,9745,8930,1,0,0
3,1.5,1240,9405,1.0,0,0,4,7,1240,0,1966,0,98042,47.3727,-122.162,2260,7611,215000,22,10,2014,0,48,8165,5351,0,0,0
6,2.0,2040,10812,1.0,0,0,4,5,2040,0,1943,0,98056,47.4919,-122.181,1440,10200,300000,22,5,2014,0,71,8772,8760,0,0,0
3,1.75,1270,8100,1.0,0,0,3,6,880,390,1950,0,98146,47.4828,-122.344,1650,8173,346000,23,6,2014,0,64,6830,6523,0,1,1
3,1.75,1700,6120,1.0,0,0,3,7,1700,0,1952,0,98116,47.5807,-122.397,1330,6120,500000,5,1,2015,0,63,4420,4790,0,0,1
2,1.5,1300,7632,1.0,0,2,3,7,1300,0,1943,0,98122,47.6134,-122.308,1420,1676,750000,25,9,2014,0,71,6332,256,0,0,1
4,2.0,1820,9350,1.0,0,0,4,8,1820,0,1967,0,98052,47.6288,-122.098,2260,9299,519900,20,5,2014,0,47,7530,7039,0,0,0
2,1.0,880,6171,1.0,0,0,4,7,880,0,1949,0,98125,47.7262,-122.285,2260,12769,378500,19,8,2014,0,65,5291,10509,0,0,1
3,1.75,1870,12381,1.0,0,0,4,8,1870,0,1957,0,98003,47.3358,-122.32,1950,12667,314500,7,5,2014,0,57,10511,10717,0,0,0
3,1.5,1350,9315,1.0,0,0,3,7,1350,0,1968,0,98052,47.6587,-122.124,1840,9920,499950,29,4,2015,0,47,7965,8080,0,0,0
5,3.5,4870,7700,2.5,0,3,5,10,3650,1220,1929,0,98144,47.5832,-122.29,3220,7700,1740000,3,12,2014,0,85,2830,4480,0,1,1
4,1.5,1720,6417,1.0,0,0,3,7,1720,0,1953,0,98125,47.7268,-122.311,1430,6240,360000,23,6,2014,0,61,4697,4810,0,0,1
3,1.0,1100,4046,1.5,0,4,4,6,1100,0,1922,0,98198,47.344,-122.331,2550,7847,361000,22,5,2014,0,92,2946,5297,0,0,1
3,2.25,1810,9845,1.0,0,0,4,8,1810,0,1959,1991,98040,47.5505,-122.221,1900,10083,713400,10,7,2014,32,55,8035,8183,1,0,0
2,1.0,930,3150,1.0,0,0,5,6,930,0,1918,0,98115,47.6783,-122.298,1900,5000,445000,28,10,2014,0,96,2220,3100,0,0,1
3,2.75,2710,9204,1.5,0,4,3,9,1480,1230,1975,0,98177,47.7039,-122.385,2960,10080,1430000,4,3,2015,0,40,6494,7120,0,1,1
3,1.0,1460,8400,1.0,0,0,4,6,1460,0,1962,0,98023,47.3086,-122.365,1060,8563,222000,24,4,2015,0,53,6940,7503,0,0,0
5,3.25,3400,4499,2.0,0,0,3,8,2740,660,2005,0,98065,47.5385,-121.88,3400,6163,510000,16,2,2015,0,10,1099,2763,0,1,0
5,3.0,2920,11440,2.0,0,0,3,8,2920,0,2003,0,98133,47.7607,-122.354,1720,9348,500000,4,6,2014,0,11,8520,7628,0,0,1
2,1.0,910,3600,1.0,0,0,4,7,910,0,1909,0,98119,47.6341,-122.361,1720,3600,605000,16,5,2014,0,105,2690,1880,0,0,1
3,2.0,1320,10720,2.0,0,0,3,8,1320,0,1981,0,98074,47.6203,-122.037,1910,13639,393000,20,8,2014,0,33,9400,11729,0,0,0
4,2.5,2490,5170,2.0,0,0,4,9,2490,0,2000,0,98052,47.6836,-122.162,2490,5170,725000,25,6,2014,0,14,2680,2680,0,0,0
3,1.75,2220,11646,1.0,0,0,3,7,1270,950,1950,0,98028,47.7762,-122.27,1490,10003,320000,7,7,2014,0,64,9426,8513,0,1,0
4,1.5,1130,7840,1.0,0,0,4,7,1130,0,1970,0,98023,47.2986,-122.377,1690,7840,210000,12,6,2014,0,44,6710,6150,0,0,0
4,2.5,2750,5767,2.0,0,0,3,9,2750,0,2005,0,98038,47.3595,-122.038,2800,5376,419900,29,7,2014,0,9,3017,2576,0,0,0
4,2.5,2240,4447,2.0,0,0,3,7,2240,0,2006,0,98059,47.4868,-122.159,2000,3800,410000,2,3,2015,0,9,2207,1800,0,0,0
3,2.25,2680,10440,1.0,0,1,3,8,1540,1140,1963,0,98116,47.561,-122.398,2140,7560,721000,16,12,2014,0,51,7760,5420,0,1,1
2,2.0,1270,5500,1.5,0,0,4,8,1270,0,1921,0,98122,47.6121,-122.294,1870,4400,605000,14,7,2014,0,93,4230,2530,0,0,1
3,1.75,1520,5500,1.5,0,0,5,7,1520,0,1936,0,98116,47.5839,-122.383,2310,5500,738000,3,12,2014,0,78,3980,3190,0,0,1
6,3.0,2480,12000,2.0,0,0,3,8,2480,0,1972,0,98007,47.6131,-122.145,2220,8580,725000,2,4,2015,0,43,9520,6360,0,0,0
3,2.25,1340,873,3.0,0,0,3,8,1340,0,2009,0,98133,47.7325,-122.343,1340,1186,303000,20,3,2015,0,6,-467,-154,0,0,1
3,2.5,1090,7700,1.0,0,0,4,7,1090,0,1957,0,98008,47.607,-122.12,1740,7700,394950,23,7,2014,0,57,6610,5960,0,0,0
4,3.0,2240,5580,2.0,0,0,5,7,1830,410,1949,0,98118,47.5598,-122.27,1530,4800,530000,2,9,2014,0,65,3340,3270,0,1,1
4,2.5,3740,8700,1.0,0,0,3,10,2260,1480,2004,0,98058,47.4587,-122.117,2650,6333,475000,13,5,2014,0,10,4960,3683,0,1,0
4,2.5,1800,8100,2.0,0,0,3,7,1800,0,1998,0,98038,47.3611,-122.047,1590,8100,250000,17,6,2014,0,16,6300,6510,0,0,0
3,1.0,780,3540,1.0,0,0,2,6,780,0,1920,0,98118,47.565,-122.291,1260,3540,180000,8,12,2014,0,94,2760,2280,0,0,1
2,1.0,1330,4140,1.0,0,0,4,7,930,400,1919,1940,98115,47.6802,-122.306,1410,5100,443500,4,8,2014,21,95,2810,3690,1,1,1
4,1.75,1570,7650,1.0,0,0,3,7,1100,470,1975,0,98052,47.6801,-122.106,1580,7650,430000,20,2,2015,0,40,6080,6070,0,1,0
5,4.5,3100,7260,2.0,0,0,3,8,3100,0,1963,2000,98059,47.5004,-122.162,1650,7700,460000,25,2,2015,37,52,4160,6050,1,0,0
3,3.5,2740,3785,2.0,0,0,3,9,2190,550,2001,0,98034,47.7195,-122.182,2060,3457,660000,12,3,2015,0,14,1045,1397,0,1,0
3,1.75,1570,10939,1.0,0,0,3,8,1200,370,1974,0,98052,47.6389,-122.102,1760,10200,515000,29,7,2014,0,40,9369,8440,0,1,0
3,2.0,1330,6490,1.0,0,0,4,7,1330,0,1954,0,98125,47.7181,-122.308,1580,7202,482500,21,4,2015,0,61,5160,5622,0,0,1
2,1.5,1140,2980,2.0,0,0,3,7,1140,0,1988,0,98029,47.5707,-122.018,1150,2981,305000,2,6,2014,0,26,1840,1831,0,0,0
4,2.75,1550,4000,1.5,0,0,3,9,1550,0,1930,0,98105,47.6596,-122.28,2120,4000,835000,3,6,2014,0,84,2450,1880,0,0,1
3,2.0,1290,7952,1.0,0,0,3,7,1290,0,1998,0,98030,47.3867,-122.19,1670,7280,237000,4,12,2014,0,16,6662,5610,0,0,0
2,1.5,1510,2001,2.0,0,0,4,8,1510,0,1985,0,98007,47.6211,-122.153,1510,2055,445000,26,11,2014,0,29,491,545,0,0,0
4,2.5,2720,8000,1.0,0,0,4,7,1360,1360,1955,0,98136,47.5237,-122.391,1790,8000,710000,6,4,2015,0,60,5280,6210,0,1,1
3,1.0,840,5700,1.0,0,0,4,5,840,0,1945,0,98038,47.3948,-122.028,1430,12600,180000,21,8,2014,0,69,4860,11170,0,0,0
3,2.5,1850,8770,2.0,0,0,3,8,1850,0,1996,0,98022,47.2091,-122.009,2350,8606,280017,23,10,2014,0,18,6920,6256,0,0,0
4,2.5,2290,11173,2.0,0,0,4,8,2290,0,1988,0,98058,47.4314,-122.164,2290,10404,436500,30,6,2014,0,26,8883,8114,0,0,0
4,2.5,3200,7535,2.0,0,0,3,9,3200,0,2006,0,98105,47.666,-122.276,1650,6850,1260000,15,5,2014,0,8,4335,5200,0,0,1
3,2.25,1800,9800,1.0,0,0,4,7,1300,500,1959,0,98028,47.7393,-122.244,1680,9545,420000,18,12,2014,0,55,8000,7865,0,1,0
3,1.0,860,7467,1.0,0,0,3,6,860,0,1944,0,98178,47.4947,-122.237,1280,7467,205000,19,7,2014,0,70,6607,6187,0,0,1
3,1.5,1980,10203,1.0,0,0,4,7,1680,300,1946,0,98010,47.3402,-122.046,1980,13664,570000,2,9,2014,0,68,8223,11684,0,1,0
4,1.75,2140,7102,1.0,0,0,4,7,1070,1070,1948,0,98177,47.7042,-122.37,1950,7102,565000,11,7,2014,0,66,4962,5152,0,1,1
2,2.5,2410,7500,1.0,0,0,3,7,1550,860,1978,0,98023,47.3078,-122.374,1840,8800,287000,11,12,2014,0,36,5090,6960,0,1,0
4,1.75,1650,7276,1.0,0,0,3,7,1010,640,1977,0,98011,47.7721,-122.206,1840,8550,260000,23,9,2014,0,37,5626,6710,0,1,0
4,1.75,1650,7276,1.0,0,0,3,7,1010,640,1977,0,98011,47.7721,-122.206,1840,8550,470000,6,2,2015,0,38,5626,6710,0,1,0
3,2.5,2410,9916,2.0,0,0,4,10,2410,0,1989,0,98052,47.6911,-122.103,2310,8212,700000,5,9,2014,0,25,7506,5902,0,0,0
3,1.75,1520,7500,1.0,0,0,3,8,1520,0,1985,0,98092,47.2646,-122.219,2180,7506,249000,25,2,2015,0,30,5980,5326,0,0,0
4,1.0,1720,4011,1.5,0,0,4,7,1720,0,1904,0,98107,47.6719,-122.396,1580,3784,500000,6,6,2014,0,110,2291,2204,0,0,1
5,2.5,2390,8775,1.0,0,0,4,7,1270,1120,1980,0,98058,47.4639,-122.17,1800,8000,358000,26,11,2014,0,34,6385,6200,0,1,0
3,2.5,1680,6755,2.0,0,0,3,8,1680,0,1994,0,98092,47.3293,-122.17,1860,7257,225000,28,5,2014,0,20,5075,5397,0,0,0
3,1.0,1060,7246,1.0,0,0,4,6,1060,0,1981,0,98056,47.4936,-122.165,1090,6694,275500,26,2,2015,0,34,6186,5604,0,0,0
3,2.5,1860,3150,2.0,0,0,3,8,1860,0,2001,0,98034,47.719,-122.182,2050,3375,495000,2,2,2015,0,14,1290,1325,0,0,0
5,2.25,1750,5000,1.0,0,0,3,8,960,790,1940,0,98105,47.6589,-122.276,2580,5000,758800,26,3,2015,0,75,3250,2420,0,1,1
3,1.75,1480,8165,1.0,0,0,4,7,1480,0,1985,0,98042,47.3624,-122.079,1450,7939,280000,3,4,2015,0,30,6685,6489,0,0,0
3,2.5,1900,7361,2.0,0,0,3,8,1900,0,1994,0,98055,47.4324,-122.191,2100,7361,380500,25,2,2015,0,21,5461,5261,0,0,0
7,4.5,6210,8856,2.5,0,2,5,11,4760,1450,1910,0,98109,47.6307,-122.354,2940,5400,3200000,7,5,2014,0,104,2646,2460,0,1,1
3,1.75,1440,12888,1.0,0,2,3,7,1090,350,1958,0,98168,47.471,-122.262,1710,12888,260000,17,6,2014,0,56,11448,11178,0,1,1
4,2.5,1910,1502,3.0,0,0,3,8,1910,0,2014,0,98107,47.6747,-122.393,1520,3888,630000,5,8,2014,0,0,-408,2368,0,0,1
3,2.0,2010,4000,1.0,0,0,5,7,1210,800,1915,0,98103,47.6638,-122.329,1770,4000,875000,20,8,2014,0,99,1990,2230,0,1,1
3,1.0,960,4600,1.5,0,0,4,6,960,0,1927,0,98118,47.5553,-122.286,1380,5175,457500,3,4,2015,0,88,3640,3795,0,0,1
2,1.0,1240,5500,1.0,0,0,3,7,1240,0,1954,0,98102,47.6461,-122.317,2080,4400,900000,19,11,2014,0,60,4260,2320,0,0,1
2,2.0,870,6450,1.0,0,0,4,6,740,130,1954,0,98118,47.5354,-122.278,1640,5775,235000,28,10,2014,0,60,5580,4135,0,1,1
3,3.0,1850,9600,1.0,0,0,3,7,1230,620,1981,0,98028,47.7717,-122.25,1970,10000,355000,27,8,2014,0,33,7750,8030,0,1,0
4,4.0,4270,6002,2.0,0,3,3,10,3180,1090,2004,0,98029,47.5443,-121.994,4280,5942,1300000,6,6,2014,0,10,1732,1662,0,1,0
3,1.75,2260,8512,1.0,0,0,3,7,1130,1130,1948,0,98125,47.7129,-122.304,2240,8040,467500,29,9,2014,0,66,6252,5800,0,1,1
4,4.5,2690,7350,1.5,0,0,5,7,2690,0,1949,0,98125,47.7062,-122.311,1660,9000,500000,25,11,2014,0,65,4660,7340,0,0,1
4,3.5,2780,9550,2.0,0,4,5,10,2530,250,1978,0,98166,47.454,-122.373,2724,10634,995000,16,4,2015,0,37,6770,7910,0,1,1
3,1.0,1140,8144,1.0,0,0,3,7,1140,0,1956,0,98155,47.7464,-122.317,1150,8144,277000,27,8,2014,0,58,7004,6994,0,0,1
4,2.25,2900,9680,2.0,0,0,3,7,1990,910,1947,0,98125,47.7037,-122.308,1850,7540,630000,17,12,2014,0,67,6780,5690,0,1,1
5,2.75,2830,11795,1.0,0,0,4,7,1710,1120,1960,0,98008,47.5828,-122.118,2460,10880,628000,21,11,2014,0,54,8965,8420,0,1,0
2,1.0,1240,9900,1.0,0,0,3,7,940,300,1950,0,98168,47.4862,-122.326,1050,9375,170000,22,1,2015,0,65,8660,8325,0,1,1
4,2.5,2100,10750,1.0,0,2,4,8,2100,0,1967,0,98023,47.3338,-122.337,2310,10425,352500,17,12,2014,0,47,8650,8115,0,0,0
3,1.0,970,6600,1.0,0,0,3,7,970,0,1965,0,98168,47.4836,-122.332,1200,6600,165000,10,6,2014,0,49,5630,5400,0,0,1
4,2.5,2300,15188,2.0,0,0,4,7,2300,0,1966,0,98042,47.3683,-122.164,1820,10125,243500,23,9,2014,0,48,12888,8305,0,0,0
2,1.5,950,676,2.0,0,0,3,7,850,100,2003,0,98144,47.6005,-122.306,950,1280,304000,6,8,2014,0,11,-274,330,0,1,1
3,1.5,2110,5195,1.0,0,0,3,7,1210,900,1959,0,98118,47.5283,-122.286,1950,5195,369000,16,10,2014,0,55,3085,3245,0,1,1
4,2.75,2990,4298,2.0,0,0,3,9,2990,0,2014,0,98052,47.7101,-122.108,2990,4837,779950,7,10,2014,0,0,1308,1847,0,0,0
4,2.5,1860,8709,2.0,0,0,3,8,1860,0,1994,0,98092,47.3289,-122.17,1990,6825,292500,23,12,2014,0,20,6849,4835,0,0,0
2,1.75,1820,6050,1.0,0,0,3,7,910,910,1950,0,98115,47.6928,-122.323,1730,6050,500007,23,3,2015,0,65,4230,4320,0,1,1
4,2.5,1950,4947,2.0,0,0,3,8,1950,0,2000,0,98056,47.5042,-122.193,1760,5611,449999,29,4,2015,0,15,2997,3851,0,0,0
4,2.5,1890,7867,2.0,0,0,3,8,1890,0,1996,0,98038,47.3788,-122.031,2250,7867,355000,27,6,2014,0,18,5977,5617,0,0,0
4,3.0,2710,7199,1.0,0,0,4,7,1710,1000,1967,0,98030,47.3789,-122.213,2070,9271,258000,25,11,2014,0,47,4489,7201,0,1,0
4,2.5,2580,11780,2.0,0,0,3,9,2580,0,2003,0,98038,47.3658,-122.04,2410,8403,456500,14,5,2015,0,12,9200,5993,0,0,0
4,2.0,1540,10212,1.5,0,0,5,7,1540,0,1948,0,98022,47.2056,-121.999,1480,10212,259950,25,8,2014,0,66,8672,8732,0,0,0
2,1.0,1050,6600,1.5,0,0,3,6,1050,0,1964,0,98168,47.4828,-122.324,1330,6600,123000,2,7,2014,0,50,5550,5270,0,0,1
3,2.25,1210,1250,3.0,0,0,3,8,1210,0,2014,0,98107,47.6722,-122.384,1780,5000,520000,30,7,2014,0,0,40,3220,0,0,1
4,2.25,2040,12000,1.0,0,0,4,7,1300,740,1963,0,98028,47.7362,-122.241,1930,12000,506000,16,4,2015,0,52,9960,10070,0,1,0
3,1.0,980,4800,1.5,0,0,3,7,980,0,1926,0,98118,47.5663,-122.274,2030,7200,425000,30,7,2014,0,88,3820,5170,0,0,1
5,2.5,1990,6840,2.0,0,0,4,7,1990,0,1974,0,98034,47.7162,-122.166,1990,7150,438000,5,12,2014,0,40,4850,5160,0,0,0
4,2.0,1240,3000,1.0,0,0,3,7,1040,200,1908,0,98122,47.6076,-122.298,1480,3500,375000,16,6,2014,0,106,1760,2020,0,1,1
3,2.25,1530,6600,1.0,0,0,4,7,1240,290,1968,0,98055,47.462,-122.188,1500,7700,337500,29,4,2015,0,47,5070,6200,0,1,0
4,2.25,2080,7700,1.0,0,0,3,7,1450,630,1968,0,98058,47.4349,-122.17,1900,7980,300000,30,9,2014,0,46,5620,6080,0,1,0
5,3.25,3570,5425,2.0,0,0,3,7,3570,0,2005,0,98075,47.5933,-122.007,2690,5347,627000,28,7,2014,0,9,1855,2657,0,0,0
5,4.25,4230,6907,2.0,0,0,3,10,3450,780,2008,0,98033,47.6866,-122.205,2650,8076,1400000,22,10,2014,0,6,2677,5426,0,1,0
4,2.5,2700,10160,2.0,0,0,3,9,2700,0,1988,0,98029,47.5685,-122.012,2760,9219,674725,12,5,2015,0,27,7460,6459,0,0,0
3,2.75,2200,7000,1.0,0,0,4,7,1280,920,1977,0,98058,47.4574,-122.169,1670,7000,325000,18,6,2014,0,37,4800,5330,0,1,0
5,2.0,1210,12538,2.0,0,0,3,7,1210,0,1982,0,98023,47.2848,-122.361,1510,7700,230000,2,4,2015,0,33,11328,6190,0,0,0
4,2.5,2740,8400,1.5,0,2,3,8,2740,0,1993,0,98022,47.1947,-122.008,2030,8638,315000,23,9,2014,0,21,5660,6608,0,0,0
3,2.75,1370,1193,3.0,0,0,3,8,1370,0,2003,0,98107,47.67,-122.392,1320,1180,560000,3,4,2015,0,12,-177,-140,0,0,1
4,3.0,2800,7198,2.0,0,0,3,8,2800,0,2002,0,98038,47.3538,-122.013,3610,7845,444000,12,8,2014,0,12,4398,4235,0,0,0
3,1.5,1060,7488,1.0,0,0,5,7,1060,0,1977,0,98106,47.5549,-122.356,1300,6780,325000,7,5,2015,0,38,6428,5480,0,0,1
2,1.0,790,7153,1.0,0,0,4,6,790,0,1944,0,98168,47.4869,-122.324,810,7128,118125,16,9,2014,0,70,6363,6318,0,0,1
2,1.0,790,7153,1.0,0,0,4,6,790,0,1944,0,98168,47.4869,-122.324,810,7128,212000,14,1,2015,0,71,6363,6318,0,0,1
4,2.5,2820,5056,2.0,0,0,3,9,2820,0,2006,0,98038,47.3591,-122.038,2820,5150,428900,9,3,2015,0,9,2236,2330,0,0,0
3,2.0,1850,9600,1.0,0,0,3,7,1850,0,1968,1998,98011,47.7671,-122.225,1770,9600,510000,23,1,2015,30,47,7750,7830,1,0,0
3,1.5,1110,9762,1.0,0,0,4,7,1110,0,1963,0,98052,47.676,-122.15,1900,9720,416000,23,5,2014,0,51,8652,7820,0,0,0
3,1.5,1460,7140,1.0,0,0,4,7,980,480,1980,0,98031,47.3954,-122.191,1400,8572,204000,27,2,2015,0,35,5680,7172,0,1,0
4,2.5,3480,13421,2.0,0,0,3,11,3480,0,1995,0,98027,47.5504,-122.097,3290,9642,878000,7,10,2014,0,19,9941,6352,0,0,0
4,3.0,3560,4000,3.0,0,2,3,9,2970,590,1996,0,98112,47.6265,-122.3,1190,4000,1050000,26,8,2014,0,18,440,2810,0,1,1
2,1.0,840,5551,1.0,0,0,3,6,840,0,1952,0,98118,47.5354,-122.28,1270,4652,350000,30,1,2015,0,63,4711,3382,0,0,1
3,1.75,1820,5500,1.0,0,0,4,8,1620,200,1957,0,98115,47.6737,-122.283,2330,6050,659500,10,6,2014,0,57,3680,3720,0,1,1
3,2.5,1630,15200,1.0,0,0,3,7,1120,510,1988,0,98072,47.7454,-122.103,2050,15200,395000,13,3,2015,0,27,13570,13150,0,1,0
4,2.5,1920,8562,2.0,0,2,4,7,1920,0,1994,0,98022,47.1932,-122.008,1820,8628,308950,8,7,2014,0,20,6642,6808,0,0,0
3,2.0,1750,2550,1.0,0,0,3,7,1750,0,1955,0,98133,47.7329,-122.343,1370,1533,410000,1,5,2015,0,60,800,163,0,0,1
4,3.0,2750,7500,1.0,0,0,5,8,1630,1120,1966,0,98177,47.7134,-122.361,2440,7500,710000,16,10,2014,0,48,4750,5060,0,1,1
1,1.0,620,8685,1.0,0,0,4,5,620,0,1976,0,98198,47.4095,-122.29,1300,12150,175000,28,4,2015,0,39,8065,10850,0,0,1
3,2.0,1720,10098,1.0,0,0,4,8,1140,580,1981,0,98074,47.6231,-122.043,1840,10098,508800,27,3,2015,0,34,8378,8258,0,1,0
3,3.0,1800,5000,1.5,0,2,3,8,1500,300,1929,0,98119,47.6475,-122.371,1670,5000,606400,9,10,2014,0,85,3200,3330,0,1,1
3,1.75,1300,7958,1.0,0,0,3,7,1300,0,1996,0,98092,47.3162,-122.194,1640,8698,245100,28,5,2014,0,18,6658,7058,0,0,0
3,2.5,1970,14876,1.0,0,0,3,7,1320,650,1981,0,98146,47.5031,-122.372,2030,8008,540000,1,5,2015,0,34,12906,5978,0,1,1
3,1.5,1740,9046,1.0,0,0,3,7,1740,0,1956,0,98028,47.7402,-122.255,1830,9513,415000,7,5,2015,0,59,7306,7683,0,0,0
4,2.75,1930,13041,1.0,0,0,4,8,1180,750,1980,0,98072,47.7502,-122.085,1880,10234,469500,5,1,2015,0,35,11111,8354,0,1,0
3,1.75,1190,14777,1.0,0,0,4,7,1190,0,1965,0,98023,47.2933,-122.377,2240,8325,195000,6,11,2014,0,49,13587,6085,0,0,0
4,3.25,4250,12281,2.0,0,4,3,12,3020,1230,1996,0,98006,47.5507,-122.113,4940,12941,1620000,6,10,2014,0,18,8031,8001,0,1,0
3,2.5,3420,16622,1.0,0,4,3,10,2410,1010,1991,0,98006,47.5638,-122.105,3460,14566,1200000,30,10,2014,0,23,13202,11106,0,1,0
4,3.75,4260,9800,2.0,0,0,3,10,4260,0,2008,0,98033,47.6739,-122.172,1950,8970,1070000,9,7,2014,0,6,5540,7020,0,0,0
2,1.0,920,10000,1.0,0,0,4,7,920,0,1981,0,98033,47.6938,-122.21,1340,10000,555500,7,5,2015,0,34,9080,8660,0,0,0
3,1.0,1040,4000,1.0,0,0,3,7,1040,0,1950,0,98122,47.6178,-122.292,1170,4000,440000,12,5,2015,0,65,2960,2830,0,0,1
3,1.0,1260,7250,1.0,0,2,3,7,960,300,1940,0,98115,47.6947,-122.311,1540,7250,485000,23,4,2015,0,75,5990,5710,0,1,1
3,2.5,2460,12028,2.0,0,0,3,9,2460,0,1996,0,98052,47.691,-122.095,2540,12229,693000,31,5,2014,0,18,9568,9689,0,0,0
3,1.0,830,3386,1.0,0,0,3,6,830,0,1942,1989,98133,47.7027,-122.355,1300,3844,295000,24,7,2014,47,72,2556,2544,1,0,1
3,2.5,2060,10650,1.0,0,0,5,8,1050,1010,1976,0,98006,47.5627,-122.137,2690,8850,700000,30,3,2015,0,39,8590,6160,0,1,0
2,1.75,2210,9374,1.0,0,3,4,8,1560,650,1951,0,98107,47.6634,-122.359,2140,5640,767500,16,12,2014,0,63,7164,3500,0,1,1
4,2.5,2790,5450,2.0,0,0,3,10,1930,860,1925,2000,98112,47.6453,-122.303,2320,5450,1160000,17,9,2014,75,89,2660,3130,1,1,1
2,1.0,1570,8210,1.0,0,0,4,8,1150,420,1952,0,98177,47.7221,-122.371,1680,8196,506000,19,6,2014,0,62,6640,6516,0,1,1
4,1.75,2030,15400,1.0,0,1,3,9,1130,900,1975,0,98166,47.4603,-122.365,2040,12425,474950,11,3,2015,0,40,13370,10385,0,1,1
3,2.5,2570,5500,1.0,0,0,4,7,1320,1250,1961,0,98199,47.6417,-122.397,1460,6250,654000,11,12,2014,0,53,2930,4790,0,1,1
2,1.0,1210,6000,1.0,0,0,4,7,1000,210,1942,0,98199,47.6482,-122.402,1840,6000,710000,11,9,2014,0,72,4790,4160,0,1,1
4,2.25,1530,7845,1.0,0,0,4,7,1030,500,1981,0,98027,47.5589,-122.082,1710,7627,620000,11,8,2014,0,33,6315,5917,0,1,0
3,2.0,1510,10827,2.0,0,0,3,7,1510,0,1984,0,98052,47.654,-122.127,1900,10908,390000,28,10,2014,0,30,9317,9008,0,0,0
3,2.25,1720,9600,1.0,0,0,4,7,1220,500,1967,0,98052,47.6581,-122.126,1720,9600,550000,30,6,2014,0,47,7880,7880,0,1,0
3,1.75,2190,7021,1.0,0,2,4,7,1390,800,1953,0,98178,47.5033,-122.232,2180,7155,353000,2,10,2014,0,61,4831,4975,0,1,1
3,2.0,1410,6600,1.0,0,0,4,7,1410,0,1990,0,98042,47.3596,-122.089,1750,7150,279900,28,1,2015,0,25,5190,5400,0,0,0
4,1.0,1980,10350,1.0,0,0,4,7,1430,550,1968,0,98027,47.5226,-122.045,1890,13140,395000,19,6,2014,0,46,8370,11250,0,1,0
4,2.5,1900,9428,2.0,0,0,3,8,1900,0,1978,0,98028,47.7628,-122.244,1830,10480,375000,10,9,2014,0,36,7528,8650,0,0,0
4,1.0,1720,2800,1.5,0,0,4,7,1200,520,1926,0,98115,47.6743,-122.299,1530,3500,547000,17,6,2014,0,88,1080,1970,0,1,1
5,3.25,2480,10277,2.0,0,0,5,8,1640,840,1993,0,98155,47.7726,-122.286,2270,10277,525000,3,4,2015,0,22,7797,8007,0,1,1
3,1.0,1210,4731,1.5,0,0,3,7,1210,0,1901,0,98117,47.6865,-122.397,1450,5264,285000,19,6,2014,0,113,3521,3814,0,0,1
2,1.75,1540,4025,1.0,0,0,4,7,1190,350,1908,0,98116,47.5876,-122.391,1950,4420,570000,20,5,2014,0,106,2485,2470,0,1,1
3,2.5,2740,9168,2.0,0,0,3,9,2740,0,1991,0,98042,47.3835,-122.148,2690,10554,409000,24,3,2015,0,24,6428,7864,0,0,0
4,2.5,1811,4381,2.0,0,0,3,8,1811,0,2007,0,98055,47.454,-122.19,1811,4150,260000,8,6,2014,0,7,2570,2339,0,0,0
4,2.5,2720,7697,1.0,0,0,4,8,2120,600,1987,0,98058,47.4391,-122.161,2340,7700,348000,16,9,2014,0,27,4977,5360,0,1,0
4,1.0,1520,9800,1.5,0,0,4,7,1520,0,1971,0,98034,47.7303,-122.236,1540,7700,389000,6,8,2014,0,43,8280,6160,0,0,0
4,2.75,2160,7200,1.0,0,0,4,7,1220,940,1976,0,98034,47.7177,-122.224,1790,7614,445000,17,12,2014,0,38,5040,5824,0,1,0
3,1.75,1390,4602,1.0,0,0,3,7,930,460,1981,0,98117,47.6944,-122.366,1230,4800,400000,21,7,2014,0,33,3212,3570,0,1,1
4,2.5,1740,7895,2.0,0,0,3,7,1740,0,1999,0,98001,47.3401,-122.282,1720,6813,302000,15,9,2014,0,15,6155,5093,0,0,0
3,2.5,2849,9588,2.0,0,0,3,10,2849,0,2001,0,98074,47.6487,-122.079,3190,8897,798000,21,10,2014,0,13,6739,5707,0,0,0
2,1.0,1440,8842,1.0,0,0,3,7,840,600,1950,0,98155,47.7443,-122.325,1650,8461,335000,24,7,2014,0,64,7402,6811,0,1,1
4,2.5,3000,6892,2.0,0,0,3,8,3000,0,2005,0,98072,47.7623,-122.165,3000,6589,585000,7,1,2015,0,10,3892,3589,0,0,0
4,2.25,1720,2300,1.0,0,0,3,7,860,860,1940,2014,98116,47.5762,-122.412,1720,4680,555000,1,12,2014,74,74,580,2960,1,1,1
3,3.0,3920,13085,2.0,1,4,4,11,3920,0,1996,0,98040,47.5716,-122.204,3450,13287,3100000,25,8,2014,0,18,9165,9837,0,0,0
3,2.5,1500,3060,2.0,0,0,3,7,1500,0,1994,0,98006,47.5605,-122.117,2700,7734,295000,18,2,2015,0,21,1560,5034,0,0,0
4,1.5,2050,7100,1.0,0,0,3,7,1050,1000,1963,0,98001,47.3395,-122.28,1950,7350,265000,18,6,2014,0,51,5050,5400,0,1,0
4,2.0,1180,7275,1.0,0,0,3,7,1180,0,1965,0,98034,47.7301,-122.2,1210,7275,330000,5,1,2015,0,50,6095,6065,0,0,0
4,1.5,1600,5750,2.0,0,0,4,6,1600,0,1902,0,98118,47.5437,-122.28,1690,5750,286000,18,2,2015,0,113,4150,4060,0,0,1
3,2.5,1260,895,3.0,0,0,3,7,1160,100,2009,0,98133,47.7072,-122.336,1190,1095,305000,31,3,2015,0,6,-365,-95,0,1,1
2,1.0,1290,5376,1.0,0,0,3,6,1290,0,1945,0,98115,47.6966,-122.315,1180,5376,970000,3,4,2015,0,70,4086,4196,0,0,1
4,2.0,2680,14157,1.0,0,0,3,8,1460,1220,1966,0,98188,47.4286,-122.292,2100,9199,525000,14,4,2015,0,49,11477,7099,0,1,1
3,1.75,2370,9750,1.0,0,0,4,7,1280,1090,1979,0,98045,47.4459,-121.773,1230,9775,355000,2,12,2014,0,35,7380,8545,0,1,0
5,2.5,2310,8303,1.0,0,0,3,7,1300,1010,1975,0,98034,47.7212,-122.211,1930,8303,469950,10,10,2014,0,39,5993,6373,0,1,0
4,1.0,1450,8800,1.0,0,0,4,7,1450,0,1954,0,98006,47.5746,-122.135,1260,8942,435000,2,5,2014,0,60,7350,7682,0,0,0
4,2.5,2680,7700,2.0,0,0,4,8,2680,0,1990,0,98031,47.4094,-122.17,2400,7700,363500,22,9,2014,0,24,5020,5300,0,0,0
2,1.5,1030,4500,1.0,0,0,3,7,830,200,1924,0,98109,47.6455,-122.352,1250,4000,595000,23,5,2014,0,90,3470,2750,0,1,1
3,1.0,1320,11090,1.0,0,0,3,7,1320,0,1955,0,98155,47.7748,-122.304,1320,8319,275000,12,11,2014,0,59,9770,6999,0,0,1
2,1.0,670,7952,1.0,0,0,4,6,670,0,1942,0,98146,47.5124,-122.372,1080,9525,295000,8,4,2015,0,73,7282,8445,0,0,1
5,2.5,3370,8113,2.0,0,0,3,9,3370,0,2005,0,98004,47.5812,-122.196,2470,8113,1250000,15,12,2014,0,9,4743,5643,0,0,0
2,1.0,940,5413,1.0,0,0,3,7,940,0,1923,0,98115,47.6956,-122.304,1340,5296,340500,29,1,2015,0,92,4473,3956,0,0,1
3,1.0,1100,5132,1.0,0,0,3,6,840,260,1948,0,98103,47.7011,-122.336,1280,5132,280000,10,10,2014,0,66,4032,3852,0,1,1
2,1.75,1400,4720,1.0,0,0,4,7,820,580,1927,0,98116,47.5705,-122.392,1330,6786,483000,28,10,2014,0,87,3320,5456,0,1,1
3,1.75,1880,9360,1.0,0,0,4,7,940,940,1941,0,98125,47.7131,-122.283,1390,7200,445500,20,11,2014,0,73,7480,5810,0,1,1
5,3.5,2800,7350,2.0,0,0,3,7,2800,0,1995,0,98106,47.5273,-122.345,2190,7620,379900,17,6,2014,0,19,4550,5430,0,0,1
4,3.5,2500,3080,2.0,0,0,3,8,1810,690,2008,0,98052,47.6749,-122.14,2060,3295,599950,2,7,2014,0,6,580,1235,0,1,0
3,1.0,810,5240,1.0,0,0,3,6,810,0,1942,0,98166,47.4734,-122.35,1700,5245,215000,9,10,2014,0,72,4430,3545,0,0,1
3,2.5,1720,6847,2.0,0,0,3,7,1720,0,1987,0,98001,47.3266,-122.272,1610,7790,263000,18,7,2014,0,27,5127,6180,0,0,0
4,1.0,2170,12100,1.0,0,0,5,7,2170,0,1961,0,98033,47.6893,-122.164,1270,12844,565000,9,2,2015,0,54,9930,11574,0,0,0
4,1.0,1440,8320,1.5,0,0,3,7,1440,0,1946,0,98155,47.7529,-122.318,1440,9230,395000,9,9,2014,0,68,6880,7790,0,0,1
4,3.25,2850,4100,2.0,0,3,3,10,1820,1030,1908,2003,98122,47.6147,-122.285,2130,4200,1540000,30,12,2014,95,106,1250,2070,1,1,1
4,2.5,2620,14126,1.0,0,4,4,8,1620,1000,1941,0,98117,47.6983,-122.397,2620,8905,922000,29,10,2014,0,73,11506,6285,0,1,1
3,1.75,1910,8329,1.0,0,0,3,8,1910,0,2004,0,98022,47.19,-122.016,2510,9259,323000,9,12,2014,0,10,6419,6749,0,0,0
2,2.0,1670,4996,1.0,0,0,3,8,1670,0,2004,0,98053,47.7141,-122.031,1670,4996,554000,10,7,2014,0,10,3326,3326,0,0,0
3,2.0,2050,11454,1.0,0,0,3,8,2050,0,1987,0,98052,47.6389,-122.11,1980,11424,500000,10,4,2015,0,28,9404,9444,0,0,0
4,1.75,1800,5210,1.0,0,0,5,7,1080,720,1979,0,98118,47.5298,-122.28,1870,5365,340000,15,7,2014,0,35,3410,3495,0,1,1
4,1.75,2230,6838,1.0,0,0,3,7,1320,910,1985,0,98008,47.5742,-122.118,1580,7500,560000,6,4,2015,0,30,4608,5920,0,1,0
3,2.5,1670,5298,2.0,0,0,3,8,1670,0,2002,0,98042,47.3925,-122.165,1920,5298,304000,6,4,2015,0,13,3628,3378,0,0,0
3,1.0,1400,10800,1.0,0,0,3,6,1400,0,1962,0,98034,47.719,-122.202,1430,10000,279900,7,11,2014,0,52,9400,8570,0,0,0
5,3.0,2110,10766,2.0,0,0,3,7,2110,0,2005,0,98030,47.3599,-122.176,1460,10400,315000,4,3,2015,0,10,8656,8940,0,0,0
4,2.0,2160,6300,1.5,0,1,4,8,2160,0,1928,0,98116,47.5662,-122.404,1980,5152,849000,21,6,2014,0,86,4140,3172,0,0,1
3,1.75,2420,14862,1.0,0,0,3,8,1380,1040,1977,0,98023,47.3301,-122.365,2550,14675,325000,10,2,2015,0,38,12442,12125,0,1,0
4,3.5,3320,8808,2.0,0,0,3,9,3320,0,2005,0,98075,47.592,-121.989,3160,9226,786000,26,9,2014,0,9,5488,6066,0,0,0
5,2.75,3220,8160,2.0,0,0,3,9,3220,0,1999,0,98001,47.3154,-122.254,2876,11521,384000,15,9,2014,0,15,4940,8645,0,0,0
3,1.5,1340,6000,1.5,0,1,3,9,1340,0,1927,0,98105,47.66,-122.282,2600,6000,907000,24,11,2014,0,87,4660,3400,0,0,1
3,2.0,1640,8395,1.0,0,0,4,7,1640,0,1991,0,98038,47.348,-122.035,1510,7180,269500,26,8,2014,0,23,6755,5670,0,0,0
3,2.25,1420,7297,1.0,0,0,3,7,1130,290,1984,0,98031,47.4046,-122.194,1730,7419,269000,22,2,2015,0,31,5877,5689,0,1,0
3,2.75,1580,4007,2.0,0,0,3,7,1580,0,2001,0,98019,47.7367,-121.969,1770,3799,325000,16,3,2015,0,14,2427,2029,0,0,0
3,1.5,2170,16600,1.0,1,2,3,10,1130,1040,1979,0,98052,47.6307,-122.088,3130,13875,1150000,6,6,2014,0,35,14430,10745,0,1,0
3,1.5,1370,7853,1.0,0,0,4,7,1370,0,1962,0,98056,47.5409,-122.18,1730,9465,406000,16,12,2014,0,52,6483,7735,0,0,0
4,2.5,2840,9354,2.0,0,0,3,10,2840,0,1990,0,98074,47.6274,-122.04,2540,10200,650000,6,6,2014,0,24,6514,7660,0,0,0
3,1.75,1940,7500,1.5,0,0,4,8,1940,0,1918,1985,98022,47.2062,-121.993,1650,7500,295000,7,7,2014,67,96,5560,5850,1,0,0
2,1.0,980,5100,1.0,0,0,4,6,980,0,1907,0,98117,47.6824,-122.38,1190,5100,395000,27,2,2015,0,108,4120,3910,0,0,1
6,3.0,2470,9267,2.0,0,0,3,8,2470,0,1982,0,98007,47.6025,-122.152,2470,9151,609000,31,12,2014,0,32,6797,6681,0,0,0
3,1.75,1610,11950,1.0,0,2,3,7,1210,400,1984,0,98052,47.6705,-122.138,1610,9363,510000,10,9,2014,0,30,10340,7753,0,1,0
3,2.25,1590,11745,1.0,0,0,3,7,1090,500,1978,0,98001,47.3553,-122.28,1540,12530,190000,30,5,2014,0,36,10155,10990,0,1,0
1,1.0,780,1033,1.0,0,0,3,7,780,0,1922,1985,98122,47.6155,-122.306,1040,1319,250000,5,8,2014,63,92,253,279,1,0,1
3,1.5,720,7450,1.0,0,1,1,5,720,0,1924,0,98126,47.584,-122.375,2600,7360,295000,7,11,2014,0,90,6730,4760,0,0,1
3,1.5,1630,4080,1.5,0,0,4,8,1630,0,1927,0,98115,47.6756,-122.308,1950,4080,740000,21,4,2015,0,88,2450,2130,0,0,1
3,1.0,1590,7759,2.0,0,0,4,7,1590,0,1912,1984,98065,47.5217,-121.819,1600,7200,323000,17,2,2015,72,103,6169,5600,1,0,0
3,2.75,2310,1850,2.0,0,0,3,10,2020,290,2011,0,98027,47.5304,-122.073,2340,2155,713000,3,3,2015,0,4,-460,-185,0,1,0
3,1.75,2320,6090,2.0,0,3,3,8,2040,280,1939,0,98199,47.643,-122.412,3110,7052,1070000,5,11,2014,0,75,3770,3942,0,1,1
3,1.75,1660,9900,2.0,0,0,3,8,1660,0,1978,0,98033,47.6704,-122.184,1720,6600,460000,27,10,2014,0,36,8240,4880,0,0,0
3,1.75,2070,5000,1.5,0,0,3,8,2070,0,1920,0,98144,47.5828,-122.291,2630,5000,880000,7,4,2015,0,95,2930,2370,0,0,1
4,1.75,2500,7000,1.0,0,0,3,7,1250,1250,1947,0,98199,47.648,-122.386,1680,7000,585000,2,3,2015,0,68,4500,5320,0,1,1
2,1.0,940,8532,1.0,0,0,4,7,940,0,1959,0,98166,47.4814,-122.343,1050,8100,249950,22,5,2014,0,55,7592,7050,0,0,1
3,2.5,1990,3478,2.0,0,0,3,10,1520,470,1990,0,98199,47.6361,-122.399,1710,6157,450000,7,11,2014,0,24,1488,4447,0,1,1
3,2.5,2620,14096,2.0,0,0,4,9,2620,0,1989,0,98042,47.3513,-122.1,3010,14096,450000,26,9,2014,0,25,11476,11086,0,0,0
4,3.25,3730,7071,3.0,0,2,3,11,3730,0,1985,0,98109,47.6292,-122.355,3730,7680,1780000,7,1,2015,0,30,3341,3950,0,0,1
3,3.25,1600,1298,3.0,0,0,3,8,1600,0,1999,0,98117,47.6954,-122.375,1600,1348,350000,23,9,2014,0,15,-302,-252,0,0,1
3,2.5,2095,3438,2.0,0,0,3,7,2095,0,2008,0,98002,47.3523,-122.213,1805,3402,292500,25,3,2015,0,7,1343,1597,0,0,0
4,2.5,3200,7500,1.5,0,1,5,8,1860,1340,1948,0,98115,47.6826,-122.274,2500,6500,1180000,12,6,2014,0,66,4300,4000,0,1,1
4,2.75,2020,8093,1.0,0,0,5,7,1300,720,1961,0,98133,47.7685,-122.332,1920,8089,366000,20,11,2014,0,53,6073,6169,0,1,1
3,1.0,1320,7200,1.0,0,0,4,7,1320,0,1959,0,98056,47.5048,-122.19,1720,7249,300000,23,3,2015,0,56,5880,5529,0,0,0
2,1.75,1270,7800,1.0,0,0,4,7,890,380,1981,0,98058,47.4438,-122.134,2020,8025,299000,8,4,2015,0,34,6530,6005,0,1,0
4,1.75,1980,2700,1.5,0,0,3,8,1210,770,1931,0,98115,47.6865,-122.32,1720,2910,560000,14,7,2014,0,83,720,1190,0,1,1
3,1.0,1040,8892,1.0,0,0,4,6,800,240,1958,0,98023,47.3273,-122.349,820,9000,183500,8,7,2014,0,56,7852,8180,0,1,0
3,1.75,1900,3000,1.5,0,0,5,7,1070,830,1903,0,98118,47.5255,-122.265,1130,6000,311000,19,6,2014,0,111,1100,4870,0,1,1
3,1.75,1660,7210,1.0,0,0,4,7,1660,0,1977,0,98032,47.3609,-122.274,2150,7350,263000,21,10,2014,0,37,5550,5200,0,0,0
3,1.75,1530,7930,1.0,0,0,5,7,1530,0,1986,0,98038,47.3609,-122.05,1610,7930,269000,24,2,2015,0,29,6400,6320,0,0,0
4,3.5,4280,9583,2.0,0,0,3,11,4280,0,2005,0,98004,47.5979,-122.197,2360,10031,1600000,6,6,2014,0,9,5303,7671,0,0,0
4,2.5,2870,6658,2.0,0,0,3,8,2870,0,2004,0,98065,47.5394,-121.878,2770,6658,564000,3,3,2015,0,11,3788,3888,0,0,0
3,2.5,2540,5612,2.0,0,0,3,9,2540,0,1999,0,98059,47.4965,-122.157,2380,6303,425000,20,6,2014,0,15,3072,3923,0,0,0
4,2.75,2100,4480,1.5,0,0,4,7,1780,320,1928,0,98105,47.6691,-122.294,2050,4480,679000,9,7,2014,0,86,2380,2430,0,1,1
3,2.0,1740,9300,1.0,0,0,4,7,1740,0,1952,0,98166,47.4526,-122.357,1540,9638,410000,26,8,2014,0,62,7560,8098,0,0,1
4,2.5,2441,7316,2.0,0,0,3,8,2441,0,2007,0,98023,47.3237,-122.337,2724,7357,340000,20,10,2014,0,7,4875,4633,0,0,0
3,1.75,1810,7200,1.0,0,0,5,7,1030,780,1959,0,98146,47.4993,-122.364,1950,8384,360000,11,5,2015,0,56,5390,6434,0,1,1
4,2.75,3160,8429,1.0,0,3,4,7,1620,1540,1982,0,98178,47.511,-122.251,1760,6780,552000,26,3,2015,0,33,5269,5020,0,1,1
4,2.0,2930,12840,1.5,0,0,4,8,2930,0,1965,0,98092,47.2957,-122.187,1960,10920,294000,5,8,2014,0,49,9910,8960,0,0,0
2,1.0,1310,5200,1.0,0,0,3,7,910,400,1946,0,98115,47.6784,-122.304,1320,4794,663500,13,3,2015,0,69,3890,3474,0,1,1
6,4.5,4800,9097,2.0,0,0,3,10,3580,1220,2007,0,98112,47.6259,-122.291,2180,6037,1980000,10,7,2014,0,7,4297,3857,0,1,1
4,1.5,1450,5530,1.0,0,0,4,6,1450,0,1969,0,98042,47.3613,-122.087,1060,5200,175409,8,10,2014,0,45,4080,4140,0,0,0
4,3.0,1900,9077,2.0,0,0,3,7,1900,0,1954,2015,98155,47.7684,-122.304,1900,12868,459000,23,1,2015,61,61,7177,10968,1,0,1
3,1.0,1050,5402,1.5,0,0,4,7,1050,0,1906,0,98144,47.5867,-122.311,1510,4685,339950,14,5,2014,0,108,4352,3175,0,0,1
5,1.75,1610,15246,1.0,0,0,3,6,1610,0,1936,0,98024,47.5654,-121.894,1410,10500,393000,29,10,2014,0,78,13636,9090,0,0,0
2,1.0,720,11400,1.0,0,0,5,6,720,0,1951,0,98133,47.7641,-122.341,1690,8075,275500,27,6,2014,0,63,10680,6385,0,0,1
3,1.0,1020,9835,1.0,0,0,5,7,1020,0,1955,0,98006,47.5728,-122.179,1210,9622,485000,13,4,2015,0,60,8815,8412,0,0,0
3,1.0,1250,7920,1.0,0,0,4,7,1250,0,1960,0,98059,47.4853,-122.126,1440,9648,250000,22,7,2014,0,54,6670,8208,0,0,0
4,3.5,3200,8049,1.0,0,0,3,8,2700,500,1980,0,98005,47.5841,-122.172,1640,8506,935100,30,10,2014,0,34,4849,6866,0,1,0
3,1.0,990,9599,1.0,0,0,4,6,990,0,1959,0,98002,47.2934,-122.215,1216,10364,245000,14,4,2015,0,56,8609,9148,0,0,0
2,2.5,2310,3313,2.0,0,0,3,9,2310,0,2006,0,98119,47.6318,-122.365,2700,5670,1250000,8,10,2014,0,8,1003,2970,0,0,1
3,1.75,1490,8000,1.0,0,0,4,7,1200,290,1978,0,98092,47.3187,-122.18,1540,8000,203000,27,8,2014,0,36,6510,6460,0,1,0
4,2.5,1840,4011,2.0,0,0,3,9,1840,0,2005,0,98052,47.6662,-122.083,2120,4011,583000,1,9,2014,0,9,2171,1891,0,0,0
3,1.0,1740,9163,1.0,0,0,3,7,1740,0,1954,0,98125,47.705,-122.299,1490,6509,575000,2,4,2015,0,61,7423,5019,0,0,1
4,3.5,3280,3800,2.0,0,0,3,11,2880,400,2011,0,98112,47.6299,-122.28,2050,3800,2580000,22,9,2014,0,3,520,1750,0,1,1
4,2.5,2160,8755,2.0,0,0,3,7,2160,0,1993,0,98030,47.3585,-122.195,1990,7971,312500,16,4,2015,0,22,6595,5981,0,0,0
5,3.0,3650,16600,1.0,0,3,4,9,1860,1790,1978,0,98006,47.56,-122.144,3150,10400,1310000,25,11,2014,0,36,12950,7250,0,1,0
4,2.25,1750,6120,1.0,0,0,3,7,1150,600,1962,0,98115,47.6958,-122.29,1350,6120,605000,16,3,2015,0,53,4370,4770,0,1,1
3,1.75,1940,7306,1.0,0,0,3,8,1470,470,1982,0,98052,47.6632,-122.153,2360,8865,630000,27,4,2015,0,33,5366,6505,0,1,0
4,3.75,3280,6000,2.0,0,0,3,9,3280,0,2014,0,98006,47.554,-122.19,2900,10108,928950,9,1,2015,0,1,2720,7208,0,0,0
3,1.75,2480,10804,1.0,0,0,3,8,1800,680,1976,0,98177,47.7721,-122.367,2480,10400,489950,10,10,2014,0,38,8324,7920,0,1,1
3,2.25,2120,18255,1.0,0,0,3,8,1590,530,1984,0,98074,47.6279,-122.037,2120,12997,550000,15,4,2015,0,31,16135,10877,0,1,0
3,2.0,1710,7920,1.0,0,0,3,8,1260,450,1968,0,98003,47.3473,-122.305,1760,8120,237000,5,8,2014,0,46,6210,6360,0,1,0
3,2.5,1690,10113,1.0,0,0,3,7,1310,380,1991,0,98028,47.7381,-122.223,1690,10113,390000,7,8,2014,0,23,8423,8423,0,1,0
3,2.5,2190,10370,2.0,0,0,3,9,2190,0,1987,0,98074,47.6218,-122.03,2470,10472,665000,28,5,2014,0,27,8180,8002,0,0,0
4,3.0,1960,5160,1.0,0,0,3,7,1170,790,2001,0,98106,47.5313,-122.36,1960,5160,277000,10,2,2015,0,14,3200,3200,0,1,1
3,1.0,1510,5000,1.5,0,0,3,7,1510,0,1909,0,98105,47.6708,-122.297,1680,4000,545000,12,6,2014,0,105,3490,2320,0,0,1
3,2.5,1490,1410,2.0,0,0,3,10,1300,190,2008,0,98199,47.6478,-122.383,1490,1715,615000,7,4,2015,0,7,-80,225,0,1,1
3,1.75,2210,7920,1.0,0,0,3,7,1400,810,1966,0,98178,47.4968,-122.237,2220,7920,343000,15,4,2015,0,49,5710,5700,0,1,1
4,2.5,2340,7877,2.0,0,0,3,9,2340,0,2004,0,98125,47.73,-122.315,1920,9116,597000,30,7,2014,0,10,5537,7196,0,0,1
3,1.75,1470,6018,1.0,0,0,3,8,1470,0,1987,0,98074,47.6171,-122.044,1720,6584,479000,13,3,2015,0,28,4548,4864,0,0,0
3,1.75,1650,14633,1.0,0,0,4,7,1650,0,1958,0,98056,47.4984,-122.176,1370,12495,292000,16,12,2014,0,56,12983,11125,0,0,0
3,1.5,1400,6527,1.0,0,0,3,7,1110,290,1957,0,98166,47.4535,-122.358,1690,7597,265000,12,9,2014,0,57,5127,5907,0,1,1
3,2.0,1900,8100,1.0,0,0,4,7,950,950,1940,0,98115,47.6997,-122.319,1400,6380,520500,15,6,2014,0,74,6200,4980,0,1,1
4,1.0,2290,6300,1.5,0,4,4,7,2150,140,1921,0,98144,47.5917,-122.29,2390,6300,825000,24,9,2014,0,93,4010,3910,0,1,1
3,1.75,1690,7953,1.0,0,0,3,7,1690,0,1986,0,98030,47.3556,-122.175,1680,7425,259900,28,9,2014,0,28,6263,5745,0,0,0
5,2.75,3090,12031,1.0,0,0,5,9,1600,1490,1968,0,98040,47.5342,-122.226,2280,10800,1170000,2,4,2015,0,47,8941,8520,0,1,0
2,1.0,1120,5650,1.0,0,1,3,6,720,400,1904,0,98118,47.5155,-122.255,2160,6480,245000,23,9,2014,0,110,4530,4320,0,1,1
3,2.5,2680,4990,1.0,0,0,5,8,1440,1240,1951,0,98199,47.6538,-122.393,2320,6000,830200,20,3,2015,0,64,2310,3680,0,1,1
4,2.5,2400,7351,2.0,0,0,3,9,2400,0,1990,0,98029,47.5707,-122.022,2330,7756,650000,23,6,2014,0,24,4951,5426,0,0,0
4,2.0,1610,6250,1.0,0,0,4,7,1610,0,1952,0,98118,47.5293,-122.271,1310,6000,305000,22,1,2015,0,63,4640,4690,0,0,1
5,2.5,3470,12003,2.0,0,0,3,8,3470,0,1978,0,98074,47.624,-122.048,2220,12283,599000,5,3,2015,0,37,8533,10063,0,0,0
4,2.5,2070,6175,2.0,0,0,3,8,2070,0,1993,0,98092,47.3262,-122.174,1940,6175,272000,26,9,2014,0,21,4105,4235,0,0,0
3,2.5,2420,10733,2.0,0,0,3,8,2420,0,1996,0,98038,47.3835,-122.035,1950,8534,415000,13,11,2014,0,18,8313,6584,0,0,0
4,2.25,2380,7400,1.0,0,0,4,8,1760,620,1979,0,98042,47.3555,-122.149,1940,7400,319000,21,11,2014,0,35,5020,5460,0,1,0
4,1.75,2120,15920,1.0,0,0,4,7,1060,1060,1960,0,98028,47.771,-122.258,2200,12580,425000,24,7,2014,0,54,13800,10380,0,1,0
4,2.5,2190,8100,1.0,0,0,4,8,1250,940,1978,0,98023,47.3131,-122.392,2100,8840,297500,28,4,2015,0,37,5910,6740,0,1,0
4,2.5,2740,12899,2.0,0,0,4,10,2740,0,1990,0,98075,47.5811,-122.028,2830,9453,725000,27,5,2014,0,24,10159,6623,0,0,0
3,2.5,1830,7585,2.0,0,0,4,8,1830,0,1995,0,98042,47.3893,-122.154,2070,7585,325000,7,1,2015,0,20,5755,5515,0,0,0
3,1.75,1370,8467,1.0,0,0,4,7,970,400,1972,0,98052,47.6644,-122.145,1650,8472,460000,5,8,2014,0,42,7097,6822,0,1,0
3,1.0,2050,4800,2.0,0,0,3,8,1950,100,1922,0,98112,47.6315,-122.311,2220,4800,1030000,5,3,2015,0,93,2750,2580,0,1,1
3,2.75,1750,9166,1.0,0,0,4,7,1170,580,1979,0,98155,47.7696,-122.325,1810,8760,370000,20,11,2014,0,35,7416,6950,0,1,1
3,1.0,1620,13803,1.0,0,0,4,6,1620,0,1969,0,98038,47.3631,-122.028,1260,10370,260656,16,4,2015,0,46,12183,9110,0,0,0
3,2.5,1710,12677,2.0,0,0,3,8,1710,0,1996,0,98028,47.75,-122.234,1610,12160,431000,15,7,2014,0,18,10967,10550,0,0,0
3,1.0,1060,5000,1.0,0,0,3,7,1060,0,1958,0,98106,47.5294,-122.354,1220,4600,320000,13,1,2015,0,57,3940,3380,0,0,1
3,2.75,2170,7900,1.0,0,0,4,8,1380,790,1978,0,98032,47.362,-122.277,2170,7700,296500,19,5,2014,0,36,5730,5530,0,1,0
4,2.5,3080,8451,1.0,0,0,3,7,1540,1540,1969,0,98052,47.674,-122.154,1550,8125,679000,9,3,2015,0,46,5371,6575,0,1,0
3,3.0,1320,1071,2.0,0,0,3,7,1080,240,2003,0,98144,47.5942,-122.296,1780,7715,359000,1,8,2014,0,11,-249,5935,0,1,1
4,3.0,1920,12040,1.0,0,0,3,7,1920,0,1962,0,98168,47.4805,-122.301,1530,10230,330000,2,4,2015,0,53,10120,8700,0,0,1
4,2.5,2440,4000,2.0,0,0,3,7,2440,0,2009,0,98038,47.3841,-122.036,2410,4502,350000,16,5,2014,0,5,1560,2092,0,0,0
3,1.5,1640,8922,1.0,0,0,4,7,1640,0,1963,0,98146,47.495,-122.342,1540,9040,242000,22,10,2014,0,51,7282,7500,0,0,1
2,1.5,1190,3400,1.0,0,0,3,7,990,200,1919,0,98115,47.6726,-122.32,1410,3150,441000,30,6,2014,0,95,2210,1740,0,1,1
4,2.5,2910,15016,2.0,0,0,3,10,2910,0,1990,0,98052,47.69,-122.097,2870,13992,765000,12,12,2014,0,24,12106,11122,0,0,0
2,1.0,1010,4050,1.0,0,0,3,7,1010,0,1950,0,98116,47.5838,-122.382,2310,5000,375000,3,9,2014,0,64,3040,2690,0,0,1
3,1.75,2080,7800,1.0,0,0,5,7,1220,860,1955,0,98166,47.4536,-122.355,1770,7860,365000,26,3,2015,0,60,5720,6090,0,1,1
2,1.5,1990,6000,1.0,0,0,3,6,1430,560,1944,0,98199,47.6521,-122.398,1350,6000,580000,8,9,2014,0,70,4010,4650,0,1,1
4,3.5,3920,19088,1.0,0,1,3,10,2240,1680,2005,0,98040,47.576,-122.214,3800,13749,1610000,10,4,2015,0,10,15168,9949,0,1,0
4,2.5,3080,13870,2.0,0,0,4,9,3080,0,1981,0,98007,47.6197,-122.149,2920,12221,841000,19,2,2015,0,34,10790,9301,0,0,0
5,3.0,2670,11761,1.0,0,0,3,7,1370,1300,1981,0,98052,47.6895,-122.129,2580,10703,515000,21,4,2015,0,34,9091,8123,0,1,0
2,1.5,1200,6380,1.0,0,0,3,7,1200,0,1929,0,98115,47.697,-122.319,1290,6598,365000,15,12,2014,0,85,5180,5308,0,0,1
3,1.5,1640,7222,2.0,0,0,4,7,1640,0,1908,0,98108,47.5215,-122.33,1240,5100,295000,7,7,2014,0,106,5582,3860,0,0,1
2,1.0,870,5750,1.0,0,0,4,7,870,0,1947,0,98116,47.5637,-122.395,1100,5750,406500,30,6,2014,0,67,4880,4650,0,0,1
3,2.5,2410,7225,2.0,0,0,3,8,2410,0,1991,0,98125,47.7211,-122.31,1940,8347,614905,12,2,2015,0,24,4815,6407,0,0,1
2,1.0,990,10556,2.0,0,0,3,7,990,0,1981,0,98056,47.5118,-122.188,1350,7295,250000,16,7,2014,0,33,9566,5945,0,0,0
5,1.0,1500,3978,2.0,0,0,3,7,1500,0,1929,0,98117,47.6811,-122.383,1350,4080,549000,12,11,2014,0,85,2478,2730,0,0,1
4,2.5,1790,6590,2.0,0,0,3,7,1790,0,2005,0,98059,47.4829,-122.128,1950,5180,397000,20,8,2014,0,9,4800,3230,0,0,0
3,1.75,1490,10125,1.0,0,0,4,7,1490,0,1962,0,98001,47.3075,-122.284,2488,4981,184000,5,5,2014,0,52,8635,2493,0,0,0
4,3.25,3960,16224,2.0,0,2,3,12,3100,860,1938,0,98105,47.6701,-122.259,3960,15050,2500000,5,5,2015,0,77,12264,11090,0,1,1
3,1.5,1620,5108,1.0,0,0,3,7,1620,0,1954,0,98115,47.6978,-122.316,1380,6130,499100,28,7,2014,0,60,3488,4750,0,0,1
4,1.5,2270,6010,1.0,0,0,3,8,1290,980,1954,0,98115,47.6743,-122.269,2120,5987,676101,25,9,2014,0,60,3740,3867,0,1,1
3,1.0,1150,8145,1.0,0,0,4,6,990,160,1932,0,98155,47.7471,-122.317,1200,8145,290000,23,6,2014,0,82,6995,6945,0,1,1
4,1.75,2180,7560,1.0,0,0,4,7,1560,620,1962,0,98133,47.757,-122.336,1810,7352,390000,4,3,2015,0,53,5380,5542,0,1,1
3,1.0,910,4500,1.0,0,0,3,7,910,0,1948,0,98117,47.6828,-122.395,1370,5000,465000,4,6,2014,0,66,3590,3630,0,0,1
3,1.0,940,7590,1.0,0,0,4,6,940,0,1959,0,98008,47.6231,-122.12,1250,7590,435000,19,2,2015,0,56,6650,6340,0,0,0
3,1.75,2410,8944,1.0,0,0,4,8,1860,550,1967,0,98058,47.4494,-122.139,2750,9600,415000,27,6,2014,0,47,6534,6850,0,1,0
3,2.0,1010,2820,1.5,0,0,3,7,1010,0,1905,0,98122,47.6066,-122.304,1330,3000,450000,25,2,2015,0,110,1810,1670,0,0,1
4,2.0,1530,6375,2.0,0,0,3,7,1530,0,1942,1983,98058,47.4692,-122.162,1500,8712,231000,29,5,2014,41,72,4845,7212,1,0,0
3,1.0,1040,11900,1.0,0,0,5,6,1040,0,1972,0,98070,47.4332,-122.446,1250,9600,330000,15,8,2014,0,42,10860,8350,0,0,0
2,1.5,1160,1848,2.0,0,0,3,7,1160,0,1972,0,98034,47.7366,-122.176,1160,1566,229950,20,11,2014,0,42,688,406,0,0,0
2,1.5,1430,8137,1.0,0,0,3,7,1130,300,1934,0,98125,47.7307,-122.29,1430,8137,403250,16,10,2014,0,80,6707,6707,0,1,1
3,2.5,2280,6134,2.0,0,0,3,8,2280,0,2004,0,98065,47.5335,-121.854,2640,6167,470000,12,9,2014,0,10,3854,3527,0,0,0
3,1.0,1200,7810,1.0,0,0,4,7,1200,0,1967,0,98038,47.3631,-122.05,1590,7800,239000,25,4,2015,0,48,6610,6210,0,0,0
4,1.5,2480,6000,1.0,0,0,3,8,1520,960,1955,0,98136,47.5233,-122.386,1810,6000,579000,27,3,2015,0,60,3520,4190,0,1,1
3,2.0,1270,1348,3.0,0,0,3,8,1270,0,2003,0,98103,47.6929,-122.342,1180,1360,380500,18,3,2015,0,12,78,180,0,0,1
5,2.75,2730,6401,2.0,0,0,3,8,2730,0,2015,0,98072,47.7685,-122.16,2520,6126,614285,31,12,2014,0,-1,3671,3606,0,0,0
2,2.0,1340,1635,2.0,0,0,3,8,1340,0,2003,0,98029,47.5476,-122.005,1410,1375,376000,7,4,2015,0,12,295,-35,0,0,0
3,1.0,1240,9300,1.0,0,0,3,7,1240,0,1954,0,98148,47.4363,-122.333,1250,9300,290000,17,2,2015,0,61,8060,8050,0,0,1
4,2.25,2400,7000,1.0,0,0,4,8,1800,600,1965,0,98034,47.7207,-122.184,2210,7210,487000,29,1,2015,0,50,4600,5000,0,1,0
4,2.0,1220,7489,2.0,0,0,3,7,1220,0,1903,0,98122,47.6133,-122.306,1220,3750,935000,19,2,2015,0,112,6269,2530,0,0,1
4,2.5,2163,5882,2.0,0,0,3,7,2163,0,2006,0,98001,47.2736,-122.251,1760,9600,255000,27,3,2015,0,9,3719,7840,0,0,0
2,2.5,1860,3504,2.0,0,0,3,7,1860,0,2000,0,98028,47.776,-122.239,1860,4246,380000,26,8,2014,0,14,1644,2386,0,0,0
2,1.0,810,4368,1.0,0,0,3,6,810,0,1958,0,98115,47.6915,-122.312,1890,5253,450000,24,4,2015,0,57,3558,3363,0,0,1
3,2.5,1950,7481,2.0,0,0,3,8,1950,0,1987,0,98027,47.564,-122.091,1980,8479,622000,10,10,2014,0,27,5531,6499,0,0,0
3,2.25,1390,6004,2.0,0,0,3,8,1390,0,1993,0,98038,47.3536,-122.047,1630,6397,292500,23,3,2015,0,22,4614,4767,0,0,0
4,3.0,2120,3600,2.0,0,3,4,8,1830,290,1908,1996,98119,47.6344,-122.369,2120,3600,1320000,20,12,2014,88,106,1480,1480,1,1,1
4,2.0,1510,3240,1.0,0,0,5,7,870,640,1901,0,98144,47.5972,-122.296,1420,5160,410000,6,2,2015,0,114,1730,3740,0,1,1
3,1.75,1010,5355,1.0,0,0,3,6,1010,0,1950,0,98106,47.5202,-122.351,750,4515,160000,24,10,2014,0,64,4345,3765,0,0,1
4,1.5,1840,4337,2.0,0,0,4,8,1840,0,1917,0,98112,47.6312,-122.307,2250,4337,809000,2,6,2014,0,97,2497,2087,0,0,1
5,2.75,1650,5453,1.0,0,0,3,7,1650,0,1970,0,98118,47.5293,-122.285,1670,5885,183750,12,3,2015,0,45,3803,4215,0,0,1
3,1.75,2650,5512,2.0,0,0,3,9,2250,400,1984,0,98112,47.6265,-122.295,1440,5100,1050000,9,2,2015,0,31,2862,3660,0,1,1
2,1.0,1100,4160,1.0,0,0,3,7,1100,0,1919,0,98109,47.6352,-122.352,1900,4000,625000,22,8,2014,0,95,3060,2100,0,0,1
3,2.25,1646,9519,2.0,0,0,3,7,1646,0,1994,0,98038,47.3646,-122.036,1975,8889,305000,19,8,2014,0,20,7873,6914,0,0,0
3,1.5,1390,8300,1.0,0,0,4,7,1390,0,1974,0,98019,47.7383,-121.983,1470,7500,317000,11,3,2015,0,41,6910,6030,0,0,0
2,1.0,780,6380,1.0,0,0,3,6,780,0,1947,0,98106,47.5423,-122.351,1270,6960,165000,20,1,2015,0,68,5600,5690,0,0,1
2,1.0,1490,6000,1.0,0,0,3,7,1090,400,1946,0,98112,47.6296,-122.3,1590,6000,575000,15,5,2014,0,68,4510,4410,0,1,1
3,1.0,970,7742,1.0,0,0,4,6,970,0,1967,0,98003,47.3173,-122.327,970,7650,219900,10,6,2014,0,47,6772,6680,0,0,0
4,3.25,3730,7200,2.0,0,0,3,10,2810,920,2006,0,98033,47.6824,-122.199,2490,7200,1490000,1,10,2014,0,8,3470,4710,0,1,0
3,1.0,1090,9900,1.0,0,0,4,7,1090,0,1955,0,98052,47.6755,-122.16,1720,10419,300000,20,5,2014,0,59,8810,8699,0,0,0
4,2.25,1780,8820,1.0,0,0,4,8,1480,300,1966,0,98032,47.3618,-122.289,1780,8625,310000,7,5,2015,0,49,7040,6845,0,1,0
3,2.0,1190,6445,1.0,0,0,3,7,1190,0,1996,0,98056,47.5057,-122.172,1920,8195,322500,23,2,2015,0,19,5255,6275,0,0,0
4,2.25,2000,10374,2.0,0,1,4,7,2000,0,1967,0,98023,47.3342,-122.34,2170,10374,320000,17,4,2015,0,48,8374,8204,0,0,0
3,2.5,1390,4997,2.0,0,0,3,7,1390,0,2004,0,98065,47.5303,-121.855,2340,4125,440000,3,4,2015,0,11,3607,1785,0,0,0
3,1.0,1500,4500,1.0,0,0,3,7,1120,380,1938,0,98117,47.6873,-122.385,1440,4500,578000,18,8,2014,0,76,3000,3060,0,1,1
2,1.5,1070,877,3.0,0,0,3,8,1070,0,2005,0,98107,47.6699,-122.393,1320,1193,382000,19,11,2014,0,9,-193,-127,0,0,1
3,2.5,1720,4006,2.0,0,0,3,8,1720,0,1994,0,98029,47.569,-122.007,1780,3974,535000,28,5,2014,0,20,2286,2194,0,0,0
4,2.5,3680,7236,2.0,0,0,3,10,3680,0,2006,0,98038,47.3543,-122.005,3310,7180,679000,8,5,2015,0,9,3556,3870,0,0,0
3,2.25,1400,10436,1.0,0,0,4,7,1040,360,1985,0,98058,47.4261,-122.144,1860,9318,258900,1,12,2014,0,29,9036,7458,0,1,0
3,1.5,1730,9509,2.0,0,0,3,8,1270,460,1955,0,98125,47.7067,-122.282,1810,8795,563000,16,3,2015,0,60,7779,6985,0,1,1
5,3.0,2795,15101,2.0,0,0,3,8,2795,0,1996,0,98019,47.7301,-121.972,2750,14567,562000,18,6,2014,0,18,12306,11817,0,0,0
4,1.75,2000,3750,1.0,0,0,5,8,1120,880,1950,0,98117,47.6816,-122.374,1370,5000,725000,5,1,2015,0,65,1750,3630,0,1,1
3,2.5,1830,8372,2.0,0,0,3,8,1830,0,1987,0,98023,47.3116,-122.4,1770,8372,236775,20,2,2015,0,28,6542,6602,0,0,0
4,3.5,3380,8098,1.0,0,1,5,9,1690,1690,1952,0,98033,47.6839,-122.19,1890,8400,860000,11,9,2014,0,62,4718,6510,0,1,0
3,1.5,1500,6337,1.0,0,0,5,7,1500,0,1953,0,98125,47.7276,-122.312,1420,6337,270000,9,5,2014,0,61,4837,4917,0,0,1
4,2.75,1950,6930,1.0,0,2,4,7,1250,700,1960,0,98008,47.616,-122.113,1950,8560,621000,30,12,2014,0,54,4980,6610,0,1,0
3,2.5,2490,5928,2.0,0,2,3,8,2490,0,1998,0,98065,47.5385,-121.87,2420,6381,527900,27,3,2015,0,17,3438,3961,0,0,0
3,2.0,1110,10500,1.0,0,0,5,7,1110,0,1978,0,98045,47.4456,-121.773,1230,10395,320000,22,5,2014,0,36,9390,9165,0,0,0
4,2.5,2500,4750,2.0,0,0,3,8,2500,0,2003,0,98042,47.3666,-122.122,2690,4750,300000,16,4,2015,0,12,2250,2060,0,0,0
3,1.75,1480,7225,1.0,0,0,4,7,1480,0,1965,0,98056,47.513,-122.185,1430,7201,320000,20,5,2014,0,49,5745,5771,0,0,0
2,1.0,810,5060,1.0,0,0,3,6,810,0,1941,0,98116,47.5635,-122.394,900,5060,505000,10,4,2015,0,74,4250,4160,0,0,1
4,2.5,2700,10814,1.0,0,0,4,8,1560,1140,1966,0,98030,47.369,-122.177,2460,6310,300000,13,6,2014,0,48,8114,3850,0,1,0
4,2.5,2180,9281,2.0,0,0,3,8,2180,0,2004,0,98042,47.3673,-122.072,2520,9520,363000,12,2,2015,0,11,7101,7000,0,0,0
4,3.5,4330,15335,2.0,0,0,4,11,3230,1100,1988,0,98040,47.5315,-122.231,3840,14311,1700000,8,8,2014,0,26,11005,10471,0,1,0
4,3.5,4210,10308,2.0,0,0,3,10,4210,0,2006,0,98008,47.5905,-122.117,3860,10200,1150000,15,5,2014,0,8,6098,6340,0,0,0
4,2.5,2880,9202,1.0,0,0,3,8,1780,1100,1977,0,98052,47.6658,-122.139,2500,10265,680000,17,3,2015,0,38,6322,7765,0,1,0
5,2.25,2610,4080,2.0,0,0,5,7,1750,860,1909,0,98115,47.6757,-122.309,2160,4080,678940,9,12,2014,0,105,1470,1920,0,1,1
3,1.75,2010,8065,1.0,0,0,4,7,1090,920,1984,0,98031,47.4171,-122.202,1560,8065,299000,20,1,2015,0,31,6055,6505,0,1,0
4,1.75,1500,11600,1.0,0,0,4,7,1000,500,1955,0,98028,47.7373,-122.241,1740,11600,379900,6,5,2014,0,59,10100,9860,0,1,0
3,1.0,1290,6566,1.0,0,0,5,7,1290,0,1976,0,98023,47.3004,-122.377,1690,6860,205000,13,6,2014,0,38,5276,5170,0,0,0
4,1.0,1320,4440,1.5,0,0,3,7,1320,0,1929,0,98122,47.6145,-122.295,1260,4440,387500,20,5,2014,0,85,3120,3180,0,0,1
3,1.0,1290,4720,1.0,0,0,3,6,790,500,1948,0,98106,47.5186,-122.358,1110,4720,256000,4,2,2015,0,67,3430,3610,0,1,1
4,2.5,2440,11005,2.0,0,0,3,9,2440,0,1994,0,98056,47.5318,-122.176,2590,14754,548000,1,7,2014,0,20,8565,12164,0,0,0
3,1.75,1290,4811,1.0,0,0,3,7,1290,0,1996,0,98032,47.3912,-122.234,1310,4811,163000,24,2,2015,0,19,3521,3501,0,0,0
2,2.0,1030,600,2.0,0,0,3,8,680,350,2004,0,98116,47.5788,-122.41,1120,1267,367500,22,1,2015,0,11,-430,147,0,1,1
3,2.25,1640,2875,2.0,0,0,3,6,1240,400,1983,0,98118,47.5686,-122.286,1500,3960,390000,14,7,2014,0,31,1235,2460,0,1,1
4,2.5,1160,16008,1.0,0,0,4,7,1160,0,1989,0,98155,47.7643,-122.295,1570,12645,415000,1,8,2014,0,25,14848,11075,0,0,1
4,2.25,2230,8440,2.0,0,0,4,8,2230,0,1968,0,98011,47.7558,-122.217,2160,9412,449000,22,10,2014,0,46,6210,7252,0,0,0
5,2.0,1910,12264,1.0,0,0,4,7,1010,900,1963,0,98007,47.601,-122.134,1700,9179,460000,16,7,2014,0,51,10354,7479,0,1,0
4,2.0,1980,15354,1.0,0,0,3,7,1980,0,1977,0,98053,47.638,-121.968,1420,12300,395000,23,12,2014,0,37,13374,10880,0,0,0
3,2.0,1470,16500,1.0,0,0,3,7,1470,0,1961,0,98042,47.3617,-122.061,1720,14406,300000,20,1,2015,0,54,15030,12686,0,0,0
3,1.75,1520,7439,1.0,0,0,4,7,1520,0,1969,0,98055,47.457,-122.208,1650,7500,345000,11,3,2015,0,46,5919,5850,0,0,0
3,1.75,1930,8442,1.0,0,0,4,7,1930,0,1953,0,98004,47.6313,-122.204,1790,8442,825000,2,1,2015,0,62,6512,6652,0,0,0
3,2.5,1330,2180,3.0,0,0,3,8,1330,0,2014,0,98117,47.6987,-122.365,1330,5000,539950,27,3,2015,0,1,850,3670,0,0,1
4,2.0,1580,9581,1.0,0,0,3,7,1580,0,1953,0,98033,47.692,-122.165,1580,10552,410000,16,6,2014,0,61,8001,8972,0,0,0
3,1.0,1370,6000,1.0,0,0,3,7,1370,0,1955,0,98146,47.4879,-122.339,1370,9520,245000,1,8,2014,0,59,4630,8150,0,0,1
4,2.75,3010,15750,1.0,0,0,4,8,1560,1450,1973,0,98034,47.7336,-122.183,2110,9450,482000,19,8,2014,0,41,12740,7340,0,1,0
3,1.75,1390,9000,1.0,0,0,4,7,1390,0,1978,0,98045,47.4469,-121.772,1400,9697,270000,11,8,2014,0,36,7610,8297,0,0,0
3,1.75,1330,14560,1.0,0,0,3,7,1330,0,1983,0,98052,47.6599,-122.135,1510,9890,475000,26,12,2014,0,31,13230,8380,0,0,0
3,2.0,1320,6500,1.0,0,0,3,7,1320,0,1947,0,98125,47.7119,-122.319,1110,6592,445800,14,10,2014,0,67,5180,5482,0,0,1
4,3.0,2430,11670,1.0,0,0,4,7,1330,1100,1978,0,98034,47.7307,-122.228,1580,10464,518000,19,2,2015,0,37,9240,8884,0,1,0
2,0.75,1260,4800,1.5,0,2,4,6,1080,180,1942,0,98033,47.6843,-122.212,2660,7200,785000,12,8,2014,0,72,3540,4540,0,1,0
3,2.5,1690,1310,2.0,0,0,3,8,1140,550,2004,0,98136,47.5404,-122.387,1640,1321,430000,26,2,2015,0,11,-380,-319,0,1,1
4,1.75,3420,7200,1.0,0,3,5,8,1770,1650,1947,0,98125,47.7081,-122.277,2450,6200,715000,30,5,2014,0,67,3780,3750,0,1,1
3,1.5,2790,6900,1.0,0,2,3,8,1700,1090,1955,0,98125,47.7328,-122.288,2410,8100,560000,9,10,2014,0,59,4110,5690,0,1,1
3,1.75,1270,6600,1.5,0,0,5,7,1270,0,1903,0,98144,47.5976,-122.295,1490,3600,449000,7,11,2014,0,111,5330,2110,0,0,1
4,2.5,2910,9000,2.0,0,0,3,9,2910,0,1989,0,98006,47.5451,-122.142,2530,9000,805000,8,10,2014,0,25,6090,6470,0,0,0
3,2.5,1560,5845,2.0,0,0,3,7,1560,0,2003,0,98038,47.3851,-122.029,1860,5752,296000,24,9,2014,0,11,4285,3892,0,0,0
2,1.0,770,4840,1.0,0,0,4,7,770,0,1927,0,98126,47.551,-122.376,930,4840,275000,25,6,2014,0,87,4070,3910,0,0,1
3,1.75,1770,16909,1.0,0,0,5,8,1770,0,1977,0,98058,47.4458,-122.134,1960,9100,419950,12,1,2015,0,38,15139,7140,0,0,0
3,1.75,1100,1307,2.0,0,0,3,7,780,320,2008,0,98106,47.5601,-122.363,1170,4800,285000,2,10,2014,0,6,207,3630,0,1,1
3,2.5,2890,8470,2.0,0,0,3,10,2890,0,1996,0,98075,47.5785,-122.054,3000,8879,775000,21,7,2014,0,18,5580,5879,0,0,0
3,1.75,2110,15400,1.0,0,0,3,7,1380,730,1963,0,98178,47.4861,-122.226,2110,9800,288250,28,4,2015,0,52,13290,7690,0,1,1
2,1.75,1220,2268,1.0,0,0,4,6,610,610,1909,0,98144,47.592,-122.295,1240,1675,257000,27,4,2015,0,106,1048,435,0,1,1
1,1.0,950,10585,1.5,0,0,3,6,950,0,1929,0,98115,47.6968,-122.297,1400,7056,377000,25,8,2014,0,85,9635,5656,0,0,1
2,1.0,1420,3100,1.0,0,0,3,7,820,600,1924,0,98107,47.6737,-122.365,1420,3915,550000,12,5,2015,0,91,1680,2495,0,1,1
3,1.0,1100,4128,1.0,0,0,4,7,720,380,1942,0,98126,47.5296,-122.379,1510,4538,339000,24,6,2014,0,72,3028,3028,0,1,1
3,1.75,2140,6000,1.0,0,0,3,7,1070,1070,1948,0,98117,47.6913,-122.366,1240,4650,481500,6,11,2014,0,66,3860,3410,0,1,1
3,1.75,1300,7735,1.0,0,0,4,7,1300,0,1980,0,98022,47.1983,-122.0,1300,8941,224500,7,11,2014,0,34,6435,7641,0,0,0
3,1.0,1790,11884,1.0,0,0,3,7,1790,0,1951,0,98031,47.3887,-122.22,1660,11513,260000,26,8,2014,0,63,10094,9853,0,0,0
2,1.0,1470,5400,1.5,0,0,3,8,1470,0,1912,0,98119,47.6391,-122.36,1760,3573,865000,23,4,2015,0,103,3930,1813,0,0,1
5,3.0,2500,11779,1.0,0,0,4,8,1550,950,1971,0,98006,47.5696,-122.127,2580,12055,730000,5,5,2015,0,44,9279,9475,0,1,0
2,1.0,980,3080,1.5,0,0,3,7,980,0,1910,1946,98103,47.6646,-122.339,1450,3333,550000,26,3,2015,36,105,2100,1883,1,0,1
3,2.0,2130,4000,2.0,0,0,3,7,2130,0,1908,0,98115,47.6741,-122.323,2010,4000,645000,20,8,2014,0,106,1870,1990,0,0,1
3,1.75,1360,16000,1.0,0,0,3,7,1360,0,1978,0,98155,47.7583,-122.306,1360,12939,250000,8,10,2014,0,36,14640,11579,0,0,1
3,3.5,1630,1329,2.0,0,0,3,9,1360,270,2000,0,98122,47.6159,-122.306,1580,1319,507200,22,1,2015,0,15,-301,-261,0,1,1
4,2.5,2500,11070,1.0,0,2,4,8,1300,1200,1964,0,98003,47.336,-122.334,2500,11070,380000,12,8,2014,0,50,8570,8570,0,1,0
3,2.5,2300,6009,1.0,0,0,3,8,2300,0,2005,0,98053,47.7067,-122.013,1640,5931,738500,17,6,2014,0,9,3709,4291,0,0,0
3,1.0,1060,10350,1.0,0,0,4,7,1060,0,1980,0,98038,47.365,-122.028,1500,9660,206000,29,1,2015,0,35,9290,8160,0,0,0
2,1.0,940,9458,1.0,0,0,3,6,940,0,1948,0,98155,47.7523,-122.311,1450,9458,265000,17,3,2015,0,67,8518,8008,0,0,1
3,1.0,1200,9087,1.0,0,0,5,7,1200,0,1969,0,98056,47.5234,-122.177,1250,11826,339900,28,6,2014,0,45,7887,10576,0,0,0
6,2.5,2590,10890,1.0,0,0,4,7,1340,1250,1970,0,98042,47.4126,-122.165,2474,10454,250000,26,12,2014,0,44,8300,7980,0,1,0
3,1.0,1100,4184,1.0,0,0,4,7,1100,0,1965,0,98136,47.5309,-122.382,1630,4366,416500,1,8,2014,0,49,3084,2736,0,0,1
4,2.5,2890,9775,2.0,0,2,3,8,2890,0,2004,0,98065,47.5339,-121.854,2640,7184,575000,7,4,2015,0,11,6885,4544,0,0,0
3,1.75,1230,7500,1.0,0,0,3,7,1230,0,1987,0,98034,47.7316,-122.224,1930,8747,385000,9,6,2014,0,27,6270,6817,0,0,0
3,1.0,1030,6250,1.0,0,0,3,7,1030,0,1960,1997,98056,47.4988,-122.168,1160,7250,253000,9,10,2014,37,54,5220,6090,1,0,0
3,1.0,1140,4600,1.0,0,0,3,7,1140,0,1942,0,98103,47.6897,-122.337,1370,5000,460000,2,9,2014,0,72,3460,3630,0,0,1
4,2.5,3200,3600,3.0,0,3,4,9,2600,600,1997,0,98119,47.632,-122.369,2490,4080,1450000,7,8,2014,0,17,400,1590,0,1,1
2,1.0,950,6000,1.0,0,0,3,7,950,0,1942,0,98115,47.6897,-122.294,1440,6000,492000,4,3,2015,0,73,5050,4560,0,0,1
2,1.0,1080,7775,1.0,0,0,3,6,1080,0,1955,0,98136,47.5447,-122.394,1730,7350,345000,1,7,2014,0,59,6695,5620,0,0,1
5,2.5,2570,17234,1.0,0,0,3,7,1300,1270,1959,0,98133,47.7753,-122.355,1760,7969,275000,4,5,2015,0,56,14664,6209,0,1,1
6,4.5,3300,7561,2.0,0,0,3,8,3300,0,1980,0,98052,47.6795,-122.104,2470,7561,510000,22,7,2014,0,34,4261,5091,0,0,0
4,3.5,4350,6000,2.0,0,0,5,10,2970,1380,1908,0,98112,47.6277,-122.286,4190,7200,2540000,1,4,2015,0,107,1650,3010,0,1,1
4,2.5,2260,5172,2.0,0,0,3,9,2260,0,2004,0,98052,47.7047,-122.128,2680,5172,640000,21,11,2014,0,10,2912,2492,0,0,0
4,2.75,3880,15025,2.0,0,0,3,7,3880,0,2004,0,98053,47.6777,-122.035,2620,5300,702000,14,10,2014,0,10,11145,2680,0,0,0
3,2.5,2010,6857,1.0,0,0,4,9,1450,560,1955,0,98102,47.6402,-122.314,2380,6370,960000,19,11,2014,0,59,4847,3990,0,1,1
3,1.0,950,7610,1.0,0,0,3,7,950,0,1983,0,98092,47.3188,-122.174,1360,7938,190000,29,4,2015,0,32,6660,6578,0,0,0
3,2.25,1730,13040,1.0,0,0,4,8,1290,440,1988,0,98052,47.6809,-122.119,1730,11016,500000,9,10,2014,0,26,11310,9286,0,1,0
3,1.75,1500,8173,1.0,0,0,3,7,1500,0,1997,0,98034,47.7293,-122.227,1970,8173,435000,13,6,2014,0,17,6673,6203,0,0,0
3,1.75,2160,5760,1.0,0,0,4,8,1260,900,1954,0,98136,47.5346,-122.391,2090,5760,670000,3,3,2015,0,61,3600,3670,0,1,1
3,2.25,1960,1985,2.0,0,0,3,7,1750,210,2003,0,98118,47.5419,-122.289,1760,1985,365000,7,5,2015,0,12,25,225,0,1,1
5,3.0,3950,9520,1.0,0,0,3,9,2250,1700,1953,2002,98004,47.6363,-122.207,1890,9520,1270000,4,12,2014,49,61,5570,7630,1,1,0
3,1.5,1400,7582,1.0,0,0,3,7,1400,0,1956,0,98148,47.4536,-122.33,1280,7872,285000,7,1,2015,0,59,6182,6592,0,0,1
3,1.0,1020,4960,1.5,0,0,3,6,920,100,1926,0,98118,47.5328,-122.275,1230,7335,219950,5,2,2015,0,89,3940,6105,0,1,1
3,1.5,1600,10548,1.0,0,0,4,7,1600,0,1962,0,98001,47.2925,-122.284,2880,13609,220000,17,11,2014,0,52,8948,10729,0,0,0
6,4.5,4230,6420,2.0,0,3,4,8,2360,1870,1916,0,98119,47.6301,-122.369,3450,4085,1470000,9,7,2014,0,98,2190,635,0,1,1
5,3.5,3090,3600,2.0,0,0,3,9,2060,1030,2000,0,98112,47.6217,-122.309,2240,3904,1110000,20,10,2014,0,14,510,1664,0,1,1
2,2.5,2320,9311,1.0,0,0,3,8,2320,0,2007,0,98053,47.7226,-122.03,1680,4765,694000,17,4,2015,0,8,6991,3085,0,0,0
3,2.5,2440,10363,2.0,0,0,3,9,2440,0,1988,0,98029,47.5634,-122.016,2500,10728,620000,3,4,2015,0,27,7923,8228,0,0,0
4,1.75,2260,6600,1.0,0,0,5,8,1220,1040,1948,0,98115,47.6753,-122.278,2240,6600,864000,15,7,2014,0,66,4340,4360,0,1,1
5,2.0,2020,4000,2.0,0,0,3,7,2020,0,1950,0,98144,47.5799,-122.305,1960,4000,385000,4,12,2014,0,64,1980,2040,0,0,1
4,2.25,2030,11585,1.0,0,0,4,7,1590,440,1967,0,98052,47.6561,-122.13,1960,8977,545000,17,6,2014,0,47,9555,7017,0,1,0
3,1.75,1730,9893,1.0,0,0,4,9,1730,0,1988,0,98042,47.3747,-122.164,2120,9108,299900,11,4,2015,0,27,8163,6988,0,0,0
3,1.75,2010,8072,1.0,0,0,4,8,2010,0,1974,0,98052,47.6327,-122.097,2030,8055,639500,7,5,2015,0,41,6062,6025,0,0,0
4,1.5,1540,7168,1.0,0,0,3,7,1160,380,1964,0,98055,47.455,-122.198,1540,7176,345000,17,3,2015,0,51,5628,5636,0,1,0
2,1.0,960,2700,1.0,0,0,3,6,780,180,1904,0,98144,47.6013,-122.299,1400,3000,345000,16,3,2015,0,111,1740,1600,0,1,1
3,2.0,1460,2800,1.0,0,0,4,7,730,730,1921,0,98105,47.67,-122.295,1780,4560,600000,21,4,2015,0,94,1340,2780,0,1,1
4,1.75,2160,7417,1.0,0,0,4,7,1360,800,1983,0,98056,47.5122,-122.181,1880,8022,355000,4,11,2014,0,31,5257,6142,0,1,0
3,2.75,2640,11957,1.5,0,0,3,9,2260,380,1978,0,98052,47.6491,-122.12,2640,12641,698000,9,9,2014,0,36,9317,10001,0,1,0
4,2.25,2170,7737,2.0,0,0,3,8,2170,0,1987,0,98074,47.637,-122.029,1850,8869,566000,16,6,2014,0,27,5567,7019,0,0,0
3,2.5,1530,3840,2.0,0,0,3,8,1530,0,1994,0,98029,47.5691,-122.007,1720,3985,449950,23,7,2014,0,20,2310,2265,0,0,0
3,1.0,1570,7727,1.0,0,2,4,8,1270,300,1958,0,98056,47.4821,-122.192,2440,7727,404600,16,1,2015,0,57,6157,5287,0,1,0
3,1.0,1490,7435,1.0,0,0,3,7,1120,370,1969,0,98198,47.368,-122.314,1490,7530,258000,24,6,2014,0,45,5945,6040,0,1,1
4,2.0,1960,10559,2.0,0,0,4,7,1960,0,1955,0,98133,47.7494,-122.337,1580,7769,415000,29,4,2015,0,60,8599,6189,0,0,1
4,2.25,2190,9020,2.0,0,0,3,8,2190,0,1978,0,98032,47.3742,-122.284,2170,8400,320000,12,8,2014,0,36,6830,6230,0,0,0
3,2.5,1690,4102,2.0,0,0,3,7,1690,0,2003,0,98038,47.3552,-122.015,1830,4733,295000,26,11,2014,0,11,2412,2903,0,0,0
5,2.0,2330,10750,1.0,0,0,4,7,1190,1140,1962,0,98028,47.7325,-122.245,1830,10180,389000,27,5,2014,0,52,8420,8350,0,1,0
3,2.5,2550,5349,2.0,0,0,3,7,2550,0,2004,0,98038,47.3504,-122.026,2640,5400,394000,15,4,2015,0,11,2799,2760,0,0,0
4,2.0,2130,5500,1.5,0,0,5,7,2130,0,1939,0,98033,47.6807,-122.199,1490,6000,762000,2,2,2015,0,76,3370,4510,0,0,0
2,1.0,800,5600,1.0,0,0,5,6,800,0,1955,0,98056,47.4959,-122.172,1100,6000,189900,8,10,2014,0,59,4800,4900,0,0,0
3,2.75,3470,9610,3.0,1,4,3,11,3470,0,1989,2000,98034,47.7205,-122.26,4130,11875,2150000,5,1,2015,11,26,6140,7745,1,0,0
3,1.5,1030,6969,1.0,0,0,4,6,1030,0,1921,0,98108,47.5492,-122.3,1420,6000,345000,18,11,2014,0,93,5939,4580,0,0,1
3,2.0,1630,7800,1.0,0,0,5,7,1630,0,1950,0,98125,47.7326,-122.307,1470,7800,376500,29,7,2014,0,64,6170,6330,0,0,1
3,2.0,2010,7017,2.0,0,3,3,7,2010,0,1951,1988,98115,47.6828,-122.267,2450,6045,775000,24,10,2014,37,63,5007,3595,1,0,1
3,1.0,1360,3737,1.5,0,0,4,6,1360,0,1910,0,98107,47.6751,-122.362,1820,4500,450000,16,10,2014,0,104,2377,2680,0,0,1
4,2.25,2040,8315,1.0,0,0,4,8,1480,560,1958,0,98177,47.7077,-122.371,2330,8940,760000,10,12,2014,0,56,6275,6610,0,1,1
4,2.5,2830,10954,2.0,0,0,3,8,2830,0,2003,0,98065,47.5396,-121.882,2470,10443,569000,7,10,2014,0,11,8124,7973,0,0,0
3,1.5,2040,6750,1.0,0,0,3,7,1280,760,1950,0,98117,47.7013,-122.369,1970,6750,500000,17,9,2014,0,64,4710,4780,0,1,1
2,2.0,1340,5350,1.5,0,0,3,8,1340,0,1941,0,98199,47.6384,-122.403,2210,5350,592500,11,12,2014,0,73,4010,3140,0,0,1
4,2.5,2130,9139,2.0,0,0,3,9,2130,0,1988,0,98029,47.5648,-122.01,2150,8178,620000,4,3,2015,0,27,7009,6028,0,0,0
5,4.25,3920,16258,2.0,0,0,3,9,2900,1020,1990,0,98004,47.5871,-122.192,2540,12131,1000000,15,5,2014,0,24,12338,9591,0,1,0
3,2.5,2415,2186,2.0,0,1,3,9,2415,0,1981,0,98033,47.6506,-122.202,2660,2165,815000,19,3,2015,0,34,-229,-495,0,0,0
5,2.75,3750,12077,2.0,0,4,3,10,3750,0,2005,0,98038,47.3525,-122.002,3120,7255,775000,23,3,2015,0,10,8327,4135,0,0,0
3,1.0,1010,7500,1.0,0,0,4,7,1010,0,1975,0,98074,47.6169,-122.062,1230,7500,340000,16,7,2014,0,39,6490,6270,0,0,0
2,1.75,990,5850,1.0,0,0,4,6,990,0,1942,0,98125,47.7132,-122.321,840,6110,458000,15,9,2014,0,72,4860,5270,0,0,1
2,1.5,1200,5773,2.0,0,0,3,7,1200,0,1985,0,98055,47.4723,-122.19,1530,4576,250000,17,9,2014,0,29,4573,3046,0,0,0
2,1.0,1060,16988,1.0,0,0,3,6,1060,0,1954,0,98058,47.4305,-122.157,2320,10580,151600,9,10,2014,0,60,15928,8260,0,0,0
4,2.5,3200,6473,2.0,0,0,3,7,3200,0,2005,0,98059,47.5012,-122.15,2480,6140,515000,27,5,2014,0,9,3273,3660,0,0,0
2,1.0,1810,10360,1.0,0,0,3,6,1010,800,1946,0,98178,47.5039,-122.266,1810,10360,216000,27,3,2015,0,69,8550,8550,0,1,1
3,2.75,1850,16960,1.0,0,2,4,8,1850,0,1953,0,98177,47.7128,-122.365,2470,13761,645000,25,6,2014,0,61,15110,11291,0,0,1
3,1.0,1100,5000,1.0,0,0,3,7,1100,0,1960,0,98118,47.5433,-122.283,1020,5000,249900,3,9,2014,0,54,3900,3980,0,0,1
3,1.75,1660,6250,1.0,0,0,3,7,830,830,1980,0,98116,47.5859,-122.385,1660,5750,410000,9,7,2014,0,34,4590,4090,0,1,1
6,1.75,2400,7500,1.5,0,0,3,7,1400,1000,1975,0,98155,47.7661,-122.313,1980,7500,499000,13,3,2015,0,40,5100,5520,0,1,1
5,3.25,2900,12160,1.0,0,0,4,8,1890,1010,1967,0,98005,47.6154,-122.168,2590,12160,790000,29,5,2014,0,47,9260,9570,0,1,0
1,2.25,2140,10350,1.0,0,0,3,7,1470,670,1976,0,98072,47.7352,-122.17,1980,8400,458000,20,5,2014,0,38,8210,6420,0,1,0
4,2.5,2670,5100,2.0,0,0,3,8,1940,730,1929,2010,98117,47.6768,-122.39,1470,4080,925000,5,8,2014,81,85,2430,2610,1,1,1
3,1.0,1090,3264,1.0,0,0,4,6,1090,0,1969,0,98092,47.3155,-122.182,1090,3330,152000,25,6,2014,0,45,2174,2240,0,0,0
3,2.5,1970,12205,2.0,0,0,4,8,1970,0,1990,0,98011,47.7397,-122.209,2640,9636,402000,23,9,2014,0,24,10235,6996,0,0,0
2,2.0,1250,1178,2.0,0,0,3,7,980,270,1996,0,98136,47.5426,-122.387,1270,1242,340000,26,3,2015,0,19,-72,-28,0,1,1
4,2.5,4040,11350,2.0,0,2,4,10,3690,350,1984,0,98006,47.559,-122.162,3770,12382,1250000,26,3,2015,0,31,7310,8612,0,1,0
2,1.0,1310,2814,1.0,0,0,3,6,810,500,1944,0,98126,47.5185,-122.376,1300,1344,299800,19,3,2015,0,71,1504,44,0,1,1
4,2.25,2060,8400,1.0,0,0,3,7,1300,760,1960,0,98178,47.4984,-122.23,1990,7383,340000,8,9,2014,0,54,6340,5393,0,1,1
3,2.25,1750,1572,2.5,0,0,3,9,1470,280,2005,0,98102,47.6498,-122.321,2410,3050,626000,2,5,2014,0,9,-178,640,0,1,1
2,1.0,1150,9186,1.0,0,0,3,7,1150,0,1946,0,98168,47.5081,-122.33,1390,10690,324950,7,10,2014,0,68,8036,9300,0,0,1
3,2.5,2050,4976,2.0,0,0,3,8,2050,0,1994,0,98029,47.5689,-121.995,2050,5153,535500,23,2,2015,0,21,2926,3103,0,0,0
3,3.25,3230,7639,2.0,0,0,3,10,3230,0,1999,0,98074,47.6338,-122.063,3230,7772,817500,5,9,2014,0,15,4409,4542,0,0,0
4,3.5,4170,4322,2.0,0,0,3,9,2940,1230,2005,0,98074,47.6136,-122.041,2970,4922,810000,12,8,2014,0,9,152,1952,0,1,0
5,1.5,1940,3430,1.5,0,0,4,6,1220,720,1926,0,98117,47.6853,-122.362,1830,4120,565000,8,4,2015,0,89,1490,2290,0,1,1
3,1.5,2390,4000,1.5,0,0,3,9,1690,700,1936,0,98105,47.6604,-122.28,2350,4000,978000,25,11,2014,0,78,1610,1650,0,1,1
4,2.5,2230,6487,2.0,0,0,3,7,2230,0,2003,0,98092,47.3287,-122.169,2230,6882,305000,7,10,2014,0,11,4257,4652,0,0,0
3,2.5,1210,1420,3.0,0,0,3,8,1210,0,2008,0,98103,47.6977,-122.349,1190,1407,345000,9,6,2014,0,6,210,217,0,0,1
2,2.0,750,6553,1.5,0,2,3,7,750,0,1945,0,98178,47.4982,-122.221,1140,7500,258000,19,2,2015,0,70,5803,6360,0,0,1
4,1.0,1770,7345,1.5,0,0,3,7,1770,0,1966,0,98106,47.5393,-122.351,1580,7345,275000,30,3,2015,0,49,5575,5765,0,0,1
3,2.0,2050,9000,1.0,0,0,4,7,2050,0,1951,0,98040,47.5885,-122.245,2910,8856,713250,3,6,2014,0,63,6950,5946,0,0,0
3,1.75,2180,7200,1.0,0,3,4,8,1090,1090,1954,0,98178,47.5044,-122.235,2180,7140,472000,11,9,2014,0,60,5020,4960,0,1,1
3,1.0,920,4429,1.0,0,0,3,7,920,0,1952,0,98118,47.5369,-122.291,1320,7860,250000,11,7,2014,0,62,3509,6540,0,0,1
3,1.5,1870,15685,1.0,0,0,3,7,1470,400,1936,0,98133,47.723,-122.353,1340,7620,460000,15,1,2015,0,79,13815,6280,0,1,1
2,1.0,1110,6800,1.0,0,0,5,7,1000,110,1947,0,98133,47.7184,-122.355,1410,6963,440150,2,6,2014,0,67,5690,5553,0,1,1
3,1.75,2200,8036,1.0,0,0,3,7,1270,930,1978,0,98011,47.7763,-122.209,1850,7563,390000,4,11,2014,0,36,5836,5713,0,1,0
2,1.0,790,5120,1.0,0,0,3,6,790,0,1950,0,98136,47.557,-122.395,1250,5120,375000,4,5,2015,0,65,4330,3870,0,0,1
3,1.5,1630,9282,1.0,0,0,4,7,1630,0,1963,0,98022,47.2021,-122.002,1420,9282,224950,11,12,2014,0,51,7652,7862,0,0,0
4,2.75,2690,5400,2.0,0,0,3,7,2210,480,1940,2009,98117,47.6963,-122.367,1620,5400,721000,26,3,2015,69,75,2710,3780,1,1,1
2,1.0,600,4854,1.0,0,0,5,6,600,0,1922,0,98168,47.4927,-122.28,1470,5000,174000,26,8,2014,0,92,4254,3530,0,0,1
2,1.0,810,9882,1.0,0,0,3,6,810,0,1944,0,98178,47.4925,-122.239,950,7200,170000,19,11,2014,0,70,9072,6250,0,0,1
3,1.5,1660,3190,1.5,0,0,3,7,1660,0,1919,0,98109,47.6368,-122.351,2200,3240,658000,15,1,2015,0,96,1530,1040,0,0,1
3,2.0,1880,8494,1.0,0,0,4,7,1200,680,1968,0,98004,47.6217,-122.192,1290,9128,860000,27,3,2015,0,47,6614,7838,0,1,0
4,3.0,3130,12381,2.0,0,0,3,9,3130,0,1995,0,98006,47.5599,-122.118,3250,10049,920000,7,4,2015,0,20,9251,6799,0,0,0
2,1.0,860,10400,1.0,0,0,4,6,860,0,1983,0,98042,47.3682,-122.096,1390,9086,195000,10,7,2014,0,31,9540,7696,0,0,0
3,1.0,990,9950,1.0,0,0,5,7,990,0,1961,0,98056,47.5104,-122.171,1370,9260,269950,18,7,2014,0,53,8960,7890,0,0,0
3,2.25,1780,1429,3.0,0,0,3,8,1570,210,2007,0,98109,47.6413,-122.346,1470,1799,620000,10,9,2014,0,7,-351,329,0,1,1
2,2.0,1480,6075,1.0,0,0,5,7,740,740,1919,0,98118,47.5317,-122.276,1230,6053,276000,9,12,2014,0,95,4595,4823,0,1,1
3,1.0,1140,5258,1.5,0,0,3,6,1140,0,1911,0,98146,47.5122,-122.383,1140,5280,329000,6,8,2014,0,103,4118,4140,0,0,1
3,1.5,1230,7500,1.0,0,0,3,7,1230,0,1962,0,98198,47.4202,-122.331,1260,7800,270000,7,10,2014,0,52,6270,6540,0,0,1
4,2.5,3080,10646,2.0,0,0,3,9,3080,0,1993,0,98042,47.3828,-122.148,2740,9994,440000,13,11,2014,0,21,7566,7254,0,0,0
4,2.5,1990,8034,2.0,0,0,4,10,1990,0,1989,0,98029,47.561,-122.018,2580,8034,639000,3,10,2014,0,25,6044,5454,0,0,0
1,1.0,700,5621,1.0,0,0,4,6,700,0,1945,0,98133,47.734,-122.353,1020,5621,403500,10,10,2014,0,69,4921,4601,0,0,1
3,2.5,1700,1156,2.0,0,2,3,9,1320,380,2002,0,98119,47.6373,-122.369,1710,1686,585000,1,10,2014,0,12,-544,-24,0,1,1
2,1.0,860,9000,1.0,0,0,4,6,860,0,1942,0,98168,47.4801,-122.315,990,9975,216000,26,8,2014,0,72,8140,8985,0,0,1
4,2.5,3000,9460,2.0,0,0,3,9,3000,0,2001,0,98031,47.3959,-122.211,3000,8450,430000,14,11,2014,0,13,6460,5450,0,0,0
2,1.0,1670,8195,1.0,0,0,3,7,1670,0,1954,1975,98033,47.6627,-122.192,1980,7500,660000,24,3,2015,21,61,6525,5520,1,0,0
2,1.0,690,6400,1.0,0,0,3,6,690,0,1943,0,98126,47.5287,-122.367,1000,6400,338000,13,4,2015,0,72,5710,5400,0,0,1
4,2.75,1240,3867,1.0,0,0,3,7,800,440,1987,0,98125,47.7157,-122.284,1150,7733,400000,29,5,2014,0,27,2627,6583,0,1,1
2,1.0,900,5000,1.0,0,0,5,6,900,0,1930,1990,98022,47.2008,-121.995,1150,5000,210000,20,2,2015,60,85,4100,3850,1,0,0
4,1.75,2200,8100,1.5,0,0,5,6,1400,800,1942,0,98168,47.4945,-122.303,1520,8100,305000,22,5,2014,0,72,5900,6580,0,1,1
5,2.75,2130,6222,1.0,0,0,3,7,1300,830,1991,0,98118,47.5272,-122.276,2130,6222,325000,29,6,2014,0,23,4092,4092,0,1,1
4,1.75,2020,8800,1.0,0,0,4,8,2020,0,1969,0,98023,47.3202,-122.384,2320,8000,245000,10,12,2014,0,45,6780,5680,0,0,0
3,1.0,1060,7350,1.0,0,0,4,7,1060,0,1959,0,98032,47.3809,-122.287,1060,7350,182000,26,9,2014,0,55,6290,6290,0,0,0
2,1.0,1230,6600,1.0,0,0,3,7,1130,100,1906,0,98118,47.5573,-122.282,1260,5060,440000,3,6,2014,0,108,5370,3800,0,1,1
3,2.25,2510,12013,2.0,0,0,3,8,2510,0,1988,0,98003,47.3473,-122.314,1870,8017,225000,31,7,2014,0,26,9503,6147,0,0,0
3,2.25,2510,12013,2.0,0,0,3,8,2510,0,1988,0,98003,47.3473,-122.314,1870,8017,358000,14,1,2015,0,27,9503,6147,0,0,0
5,2.5,2720,5000,1.5,0,0,4,7,1530,1190,1939,0,98117,47.6827,-122.376,1210,5000,580000,2,12,2014,0,75,2280,3790,0,1,1
3,1.5,1070,8886,1.0,0,0,4,7,1070,0,1984,0,98030,47.3516,-122.166,1730,9461,240000,22,4,2015,0,31,7816,7731,0,0,0
4,2.5,2230,8500,2.0,0,0,3,8,2230,0,1994,0,98022,47.2082,-122.009,2270,8770,325000,29,7,2014,0,20,6270,6500,0,0,0
4,2.25,2500,10890,1.0,0,0,5,7,1800,700,1978,0,98034,47.7318,-122.239,2500,7467,488000,14,11,2014,0,36,8390,4967,0,1,0
4,1.0,1670,4600,1.5,0,0,5,8,1670,0,1906,0,98103,47.6838,-122.332,1820,4600,875000,10,9,2014,0,108,2930,2780,0,0,1
4,2.5,2150,9070,2.0,0,0,4,8,2150,0,1985,0,98052,47.7279,-122.107,2230,8995,615000,2,6,2014,0,29,6920,6765,0,0,0
3,2.5,2020,4183,2.0,0,0,3,7,2020,0,2012,0,98038,47.3658,-122.017,2030,4140,321000,20,11,2014,0,2,2163,2110,0,0,0
3,2.5,2230,5750,2.0,0,0,3,9,2230,0,2003,0,98033,47.6938,-122.213,1900,8238,1040000,2,6,2014,0,11,3520,6338,0,0,0
2,1.0,740,6300,1.0,0,0,3,6,740,0,1942,0,98126,47.5158,-122.376,740,6300,299500,24,4,2015,0,73,5560,5560,0,0,1
4,1.5,2020,9583,2.0,0,0,4,7,2020,0,1963,0,98034,47.7283,-122.238,1770,8625,459000,14,4,2015,0,52,7563,6855,0,0,0
3,2.5,1730,4065,2.0,0,0,3,8,1730,0,1996,0,98029,47.5668,-122.005,1730,4094,435000,12,9,2014,0,18,2335,2364,0,0,0
3,1.75,1370,8280,1.0,0,0,4,7,1370,0,1980,0,98031,47.4096,-122.172,1850,7820,222000,10,10,2014,0,34,6910,5970,0,0,0
4,1.0,1210,6380,1.5,0,0,3,7,1210,0,1936,0,98115,47.6924,-122.321,1340,6380,485000,27,10,2014,0,78,5170,5040,0,0,1
5,3.5,2160,2323,3.0,0,0,3,9,2160,0,2007,0,98107,47.6726,-122.39,1750,4650,750000,29,4,2015,0,8,163,2900,0,0,1
3,2.25,1550,6022,2.0,0,0,3,8,1550,0,1989,0,98003,47.3525,-122.304,1650,5627,266000,22,12,2014,0,25,4472,3977,0,0,0
2,1.0,1170,6000,1.0,0,0,4,7,970,200,1941,0,98103,47.6994,-122.354,2130,6002,455000,2,6,2014,0,73,4830,3872,0,1,1
3,1.75,1740,8625,1.0,0,0,4,7,1240,500,1978,0,98023,47.3054,-122.38,1980,8625,280000,30,4,2015,0,37,6885,6645,0,1,0
4,3.25,3100,3900,2.0,0,2,5,9,2090,1010,1923,0,98109,47.6385,-122.348,2110,3900,1450000,5,8,2014,0,91,800,1790,0,1,1
5,3.0,2400,10126,2.0,0,3,3,8,2400,0,1981,0,98126,47.5726,-122.373,2250,3946,745000,17,4,2015,0,34,7726,1696,0,0,1
3,2.5,2290,9142,1.0,0,0,3,8,2290,0,1972,0,98117,47.691,-122.387,1770,8035,685900,7,8,2014,0,42,6852,6265,0,0,1
3,1.75,1610,7392,1.0,0,0,4,7,1610,0,1964,0,98001,47.3413,-122.28,1450,7392,160000,1,8,2014,0,50,5782,5942,0,0,0
4,2.5,2240,9934,1.0,0,0,4,8,1490,750,1968,0,98005,47.6147,-122.166,2640,11622,650000,29,4,2015,0,47,7694,8982,0,1,0
2,1.0,850,6370,1.0,0,0,3,6,850,0,1951,0,98126,47.5198,-122.373,850,5170,250000,19,2,2015,0,64,5520,4320,0,0,1
2,1.5,920,1458,2.0,0,0,3,7,920,0,1995,0,98133,47.7081,-122.342,1110,1598,265000,18,2,2015,0,20,538,488,0,0,1
5,3.25,2590,6180,1.0,0,0,3,7,1330,1260,1960,0,98118,47.551,-122.272,1560,6180,599000,5,11,2014,0,54,3590,4620,0,1,1
3,1.0,1340,7260,1.5,0,0,3,6,1340,0,1944,0,98178,47.4934,-122.237,1210,7260,199950,5,11,2014,0,70,5920,6050,0,0,1
4,2.75,2420,11201,1.0,0,1,3,8,1420,1000,1948,1999,98118,47.5459,-122.265,3170,9385,712500,28,4,2015,51,67,8781,6215,1,1,1
2,1.0,1420,4305,1.0,0,0,4,7,920,500,1941,0,98115,47.6864,-122.311,1420,4305,490000,22,10,2014,0,73,2885,2885,0,1,1
4,1.0,1360,6000,1.5,0,0,3,7,1360,0,1917,0,98115,47.6854,-122.288,1710,6000,511500,20,6,2014,0,97,4640,4290,0,0,1
3,1.0,1510,6200,1.0,0,0,3,6,1010,500,1955,0,98118,47.5293,-122.274,1710,8623,299000,19,3,2015,0,60,4690,6913,0,1,1
4,2.0,2120,4000,1.5,0,0,4,7,1720,400,1927,0,98117,47.688,-122.383,1760,4000,597000,25,8,2014,0,87,1880,2240,0,1,1
3,1.0,1200,7200,1.0,0,0,3,6,1200,0,1977,0,98030,47.3746,-122.183,1200,7420,210000,8,9,2014,0,37,6000,6220,0,0,0
4,2.5,3190,11375,1.0,0,0,5,8,2210,980,1946,0,98125,47.704,-122.3,1100,8500,659000,30,5,2014,0,68,8185,7400,0,1,1
3,1.0,1050,4160,1.0,0,0,4,7,1050,0,1925,0,98115,47.6756,-122.3,1580,3680,540000,4,6,2014,0,89,3110,2100,0,0,1
5,2.5,2990,7500,1.0,0,2,3,9,1800,1190,1972,0,98177,47.7707,-122.369,2800,9860,575000,14,7,2014,0,42,4510,7060,0,1,1
4,2.75,2440,7042,1.5,0,2,4,7,1640,800,1941,0,98116,47.5731,-122.408,2170,7900,725000,31,7,2014,0,73,4602,5730,0,1,1
4,1.0,1170,5400,1.0,0,0,5,6,1170,0,1953,0,98056,47.492,-122.172,1100,5400,299950,17,9,2014,0,61,4230,4300,0,0,0
3,1.5,1280,5525,1.0,0,0,3,7,1280,0,1962,0,98133,47.7339,-122.336,1330,5286,342450,18,11,2014,0,52,4245,3956,0,0,1
4,2.5,1950,3225,2.0,0,0,3,7,1950,0,2002,0,98178,47.5014,-122.226,1980,3225,315000,29,10,2014,0,12,1275,1245,0,0,1
4,2.75,1930,3840,1.0,0,0,3,7,1170,760,1997,0,98106,47.5303,-122.346,1610,3840,328000,22,12,2014,0,17,1910,2230,0,1,1
4,2.75,1970,7213,1.0,0,0,3,8,1170,800,1977,0,98058,47.4424,-122.126,1980,7045,323000,9,5,2014,0,37,5243,5065,0,1,0
4,3.0,1820,3120,1.0,0,0,3,7,1000,820,1997,0,98118,47.5468,-122.274,1600,5001,320000,22,10,2014,0,17,1300,3401,0,1,1
2,1.0,950,4080,1.0,0,0,4,7,950,0,1924,0,98117,47.6765,-122.384,1120,4080,550000,29,12,2014,0,90,3130,2960,0,0,1
4,3.5,4560,16643,1.0,0,3,3,12,2230,2330,1995,0,98006,47.5521,-122.115,4060,15177,1210000,20,5,2014,0,19,12083,11117,0,1,0
4,3.5,4560,16643,1.0,0,3,3,12,2230,2330,1995,0,98006,47.5521,-122.115,4060,15177,1200000,27,8,2014,0,19,12083,11117,0,1,0
3,1.0,1150,8924,1.0,0,0,3,6,1150,0,1943,0,98030,47.3865,-122.217,1492,8924,120000,21,1,2015,0,72,7774,7432,0,0,0
3,1.0,1150,8924,1.0,0,0,3,6,1150,0,1943,0,98030,47.3865,-122.217,1492,8924,175000,30,4,2015,0,72,7774,7432,0,0,0
3,1.0,910,5800,1.5,0,0,4,5,910,0,1900,0,98022,47.2068,-121.992,1400,6766,169900,16,9,2014,0,114,4890,5366,0,0,0
6,2.75,2890,7500,1.0,0,0,4,8,1830,1060,1976,0,98034,47.7099,-122.23,1880,7500,508000,11,8,2014,0,38,4610,5620,0,1,0
2,1.0,1070,6678,1.0,0,0,4,7,1070,0,1951,0,98133,47.7315,-122.357,1680,7788,335000,11,12,2014,0,63,5608,6108,0,0,1
3,2.75,2050,3320,1.5,0,0,4,7,1580,470,1927,0,98105,47.6719,-122.301,1760,4150,613200,10,9,2014,0,87,1270,2390,0,1,1
2,1.5,1040,3500,1.5,0,0,4,6,1040,0,1904,0,98144,47.588,-122.304,1340,1213,420000,7,5,2014,0,110,2460,-127,0,0,1
4,3.25,3320,8587,3.0,0,0,3,11,2950,370,2008,0,98103,47.691,-122.337,1860,5668,1000000,25,8,2014,0,6,5267,3808,0,1,1
2,1.0,740,6180,1.0,0,0,3,6,740,0,1948,0,98118,47.5517,-122.272,1330,4635,342000,17,6,2014,0,66,5440,3305,0,0,1
2,1.75,1210,4141,1.0,0,0,4,7,910,300,1942,0,98117,47.686,-122.382,1310,4141,582000,18,12,2014,0,72,2931,2831,0,1,1
3,2.5,2480,6031,2.0,0,0,3,8,2480,0,2001,0,98155,47.772,-122.297,1850,7704,475000,31,10,2014,0,13,3551,5854,0,0,1
3,2.25,2010,6000,1.0,0,0,3,8,1330,680,1975,0,98052,47.6912,-122.115,2080,8260,570000,5,5,2014,0,39,3990,6180,0,1,0
4,3.25,3230,5000,1.5,0,0,4,7,1750,1480,1916,0,98105,47.6702,-122.3,1730,4000,826600,24,3,2015,0,99,1770,2270,0,1,1
2,2.5,1170,1394,2.0,0,0,3,8,1170,0,2001,0,98122,47.6131,-122.297,1250,3136,387000,21,10,2014,0,13,224,1886,0,0,1
3,1.0,1250,9126,1.0,0,0,3,7,1250,0,1969,0,98077,47.7554,-122.076,1440,10620,330000,21,5,2014,0,45,7876,9180,0,0,0
2,1.0,1050,3088,1.0,0,0,3,7,1050,0,2005,0,98029,47.5471,-121.996,1890,2772,285000,11,9,2014,0,9,2038,882,0,0,0
3,1.0,1400,7800,1.0,0,0,3,7,1400,0,1962,0,98059,47.4789,-122.159,1400,7800,217000,14,8,2014,0,52,6400,6400,0,0,0
3,1.0,1120,12500,1.0,0,0,4,7,1120,0,1977,0,98033,47.6842,-122.2,2380,10000,615000,23,2,2015,0,38,11380,7620,0,0,0
4,2.5,3150,5886,2.0,0,0,3,8,3150,0,2014,0,98059,47.4787,-122.122,2650,5886,580135,3,6,2014,0,0,2736,3236,0,0,0
3,2.0,1400,8821,1.0,0,0,3,7,1400,0,1991,0,98022,47.1949,-121.989,1450,8721,231200,29,10,2014,0,23,7421,7271,0,0,0
4,2.75,2500,4950,2.0,0,0,3,8,2500,0,2010,0,98053,47.6964,-122.017,2500,4950,680000,16,6,2014,0,4,2450,2450,0,0,0
3,1.5,1390,2153,2.0,0,0,3,7,1390,0,2001,0,98118,47.5506,-122.29,1100,2617,267500,25,7,2014,0,13,763,1517,0,0,1
3,1.75,1310,8065,1.0,0,0,4,6,1310,0,1948,0,98117,47.701,-122.368,1420,8100,435000,19,6,2014,0,66,6755,6680,0,0,1
2,1.0,1740,3622,1.0,0,0,4,7,950,790,1924,0,98118,47.5541,-122.29,1270,3800,315000,10,6,2014,0,90,1882,2530,0,1,1
3,2.5,1490,1709,3.0,0,0,3,8,1490,0,2004,0,98125,47.7173,-122.299,1364,1709,354901,13,5,2014,0,10,219,345,0,0,1
2,2.0,1300,6515,1.0,0,0,3,8,1300,0,2005,0,98053,47.7078,-122.013,1640,6009,439888,14,10,2014,0,9,5215,4369,0,0,0
4,1.0,1460,3840,1.5,0,0,3,8,1340,120,1928,0,98106,47.533,-122.347,990,4200,360000,22,1,2015,0,87,2380,3210,0,1,1
4,1.0,1030,6621,1.0,0,0,4,6,1030,0,1955,0,98055,47.4857,-122.221,1420,6631,205000,31,12,2014,0,59,5591,5211,0,0,0
3,2.5,1970,7500,2.0,0,0,3,8,1970,0,1988,0,98092,47.2658,-122.218,1950,8220,299995,12,6,2014,0,26,5530,6270,0,0,0
2,1.0,790,7275,1.0,0,0,4,6,790,0,1944,0,98058,47.4771,-122.174,850,7399,150000,23,9,2014,0,70,6485,6549,0,0,0
3,2.0,2168,12616,2.0,0,1,4,7,2168,0,1950,0,98146,47.4933,-122.367,2168,9750,625000,5,5,2015,0,65,10448,7582,0,0,1
4,3.5,4140,13392,2.0,0,0,3,11,4140,0,2000,0,98059,47.5261,-122.144,4140,11529,950000,29,5,2014,0,14,9252,7389,0,0,0
4,2.5,2440,7797,1.0,0,0,3,8,1560,880,1965,0,98031,47.3895,-122.222,2090,8100,278800,10,2,2015,0,50,5357,6010,0,1,0
3,2.0,1720,4200,2.0,0,0,3,8,1720,0,1908,1992,98112,47.6285,-122.301,1720,4200,713500,10,11,2014,84,106,2480,2480,1,0,1
4,2.25,3020,11489,1.5,1,3,5,10,2110,910,1916,1988,98040,47.5395,-122.21,3890,11489,1900000,25,3,2015,72,99,8469,7599,1,1,0
5,2.0,2610,5009,1.0,0,0,3,7,1710,900,1988,0,98117,47.6969,-122.366,1600,5040,439000,28,10,2014,0,26,2399,3440,0,1,1
3,2.0,1500,8086,1.0,0,0,3,7,1060,440,1981,0,98027,47.5584,-122.081,1550,8086,425000,26,9,2014,0,33,6586,6536,0,1,0
4,2.5,2600,11280,1.5,0,0,3,7,1570,1030,1961,0,98003,47.336,-122.304,1660,11200,252500,25,8,2014,0,53,8680,9540,0,1,0
3,1.5,1370,8470,1.0,0,0,4,7,1370,0,1961,0,98092,47.2874,-122.192,1710,8800,185000,12,5,2014,0,53,7100,7090,0,0,0
5,2.75,2400,15781,1.0,0,0,4,7,1200,1200,1974,0,98074,47.622,-122.059,2390,7500,406550,23,9,2014,0,40,13381,5110,0,1,0
2,1.5,1068,1758,2.0,0,0,3,7,1068,0,1990,0,98028,47.7527,-122.244,1078,1315,243000,30,6,2014,0,24,690,237,0,0,0
3,1.5,2220,8994,1.0,0,0,4,8,1110,1110,1962,0,98006,47.5473,-122.172,2220,8994,500000,1,12,2014,0,52,6774,6774,0,1,0
2,1.0,880,7575,1.0,0,0,4,7,880,0,1942,0,98198,47.3757,-122.304,1800,7575,204750,13,5,2015,0,73,6695,5775,0,0,1
3,1.5,1310,9273,1.0,0,0,4,7,1310,0,1968,0,98042,47.3683,-122.147,1710,9600,222000,9,9,2014,0,46,7963,7890,0,0,0
3,2.25,1400,1320,3.0,0,2,3,8,1400,0,2006,0,98133,47.7147,-122.356,1490,1449,367000,21,10,2014,0,8,-80,-41,0,0,1
3,1.0,1170,7320,1.0,0,0,3,7,1170,0,1962,0,98188,47.4685,-122.282,2040,7320,183000,14,5,2015,0,53,6150,5280,0,0,1
3,2.5,1020,1570,2.0,0,0,3,7,720,300,2004,0,98144,47.5871,-122.317,1470,1249,300000,10,12,2014,0,10,550,-221,0,1,1
3,1.75,1300,3844,1.0,0,0,3,7,1300,0,1985,0,98133,47.7024,-122.355,1290,3844,369000,19,8,2014,0,29,2544,2554,0,0,1
3,2.0,2010,16736,2.0,0,0,4,6,2010,0,1929,0,98133,47.7643,-122.352,1890,11477,380000,31,7,2014,0,85,14726,9587,0,0,1
3,2.0,1590,5009,2.0,0,0,4,6,1590,0,1985,0,98125,47.7012,-122.322,1730,6380,463000,3,2,2015,0,30,3419,4650,0,0,1
3,1.0,1470,9750,1.0,0,0,3,7,1470,0,1963,0,98034,47.7155,-122.194,1300,9750,475000,8,12,2014,0,51,8280,8450,0,0,0
3,1.75,1580,14400,1.0,0,0,4,7,1580,0,1981,0,98001,47.2598,-122.281,1480,9600,225000,24,3,2015,0,34,12820,8120,0,0,0
3,1.75,1970,9512,1.0,0,0,3,8,1970,0,1968,0,98058,47.4545,-122.146,2250,10573,371000,11,5,2015,0,47,7542,8323,0,0,0
3,2.5,2330,3141,2.0,0,0,3,8,2330,0,2003,0,98116,47.5622,-122.392,1980,5265,625000,27,8,2014,0,11,811,3285,0,0,1
6,5.0,7100,18200,2.5,0,0,3,13,5240,1860,1933,2002,98199,47.6427,-122.408,3130,6477,3200000,23,9,2014,69,81,11100,3347,1,1,1
3,1.75,1230,10725,1.0,0,0,3,7,1230,0,1980,0,98045,47.4431,-121.772,1250,10170,329000,29,1,2015,0,35,9495,8920,0,0,0
3,1.75,2570,13000,2.0,0,0,4,7,2570,0,1962,0,98177,47.7705,-122.371,2570,8521,634000,10,2,2015,0,53,10430,5951,0,0,1
4,2.5,3440,6915,2.0,0,0,3,10,3440,0,2006,0,98038,47.3538,-122.004,3200,6915,616000,7,11,2014,0,8,3475,3715,0,0,0
4,2.25,1780,2684,2.0,0,0,3,7,1780,0,2002,0,98072,47.7642,-122.149,1670,2426,435000,19,3,2015,0,13,904,756,0,0,0
4,2.5,2110,6295,2.0,0,0,3,8,2110,0,2000,0,98030,47.3641,-122.193,2720,6311,320000,15,4,2015,0,15,4185,3591,0,0,0
4,3.5,2770,8049,2.0,0,0,3,9,2770,0,2002,0,98074,47.6469,-122.081,3410,7447,820000,14,1,2015,0,13,5279,4037,0,0,0
3,2.5,1590,3359,2.0,0,0,3,7,1590,0,2000,0,98019,47.7349,-121.986,1820,3383,310000,22,8,2014,0,14,1769,1563,0,0,0
3,2.25,1460,968,2.0,0,0,3,7,1140,320,2003,0,98199,47.6601,-122.4,1460,1531,443750,2,12,2014,0,11,-492,71,0,1,1
4,2.25,2070,13084,1.0,0,0,4,8,1700,370,1967,0,98040,47.5606,-122.222,2520,10180,795000,5,6,2014,0,47,11014,7660,0,1,0
5,1.75,2000,3750,2.0,0,0,4,7,2000,0,1921,0,98103,47.6618,-122.355,1520,3750,585000,15,5,2014,0,93,1750,2230,0,0,1
2,1.0,1010,7338,2.0,0,0,4,7,1010,0,1981,0,98056,47.5123,-122.19,1220,7719,315000,29,7,2014,0,33,6328,6499,0,0,0
4,2.5,3050,7238,2.0,0,0,3,8,3050,0,1989,0,98029,47.5772,-122.013,2580,7228,635000,17,9,2014,0,25,4188,4648,0,0,0
3,1.0,1160,11776,1.0,0,0,3,7,1160,0,1968,0,98077,47.7427,-122.074,1160,10050,305000,28,5,2014,0,46,10616,8890,0,0,0
3,2.0,2180,5440,1.0,0,0,5,7,1100,1080,1904,0,98103,47.657,-122.345,1470,4109,785000,16,5,2014,0,110,3260,2639,0,1,1
3,1.75,1560,6000,1.0,0,0,3,6,780,780,1944,0,98199,47.6501,-122.384,1560,1734,525000,24,10,2014,0,70,4440,174,0,1,1
4,1.75,1580,3635,1.0,0,0,4,7,790,790,1910,0,98117,47.6795,-122.371,1190,3638,537000,20,1,2015,0,105,2055,2448,0,1,1
3,1.75,1660,8303,1.0,0,0,3,7,1380,280,1974,0,98058,47.4366,-122.171,1740,8320,279950,17,2,2015,0,41,6643,6580,0,1,0
4,2.0,2350,9329,2.0,0,0,3,8,2350,0,1977,0,98005,47.583,-122.17,1640,9403,659000,8,12,2014,0,37,6979,7763,0,0,0
2,1.0,1440,6650,1.0,0,0,3,7,970,470,1980,0,98023,47.2896,-122.369,1600,6847,203000,21,8,2014,0,34,5210,5247,0,1,0
4,2.5,2930,7806,2.0,0,0,3,9,2930,0,2005,0,98074,47.6219,-122.024,2600,6051,782500,9,9,2014,0,9,4876,3451,0,0,0
3,1.75,1590,7560,1.0,0,0,3,7,1130,460,1984,0,98031,47.4016,-122.18,1500,7560,250000,10,6,2014,0,30,5970,6060,0,1,0
3,1.0,1400,9450,1.0,0,0,4,7,1060,340,1955,0,98056,47.5051,-122.194,1400,8108,279000,5,8,2014,0,59,8050,6708,0,1,0
6,2.5,3190,12196,2.0,0,0,4,8,3190,0,1979,0,98052,47.6309,-122.103,2790,13068,664000,25,11,2014,0,35,9006,10278,0,0,0
4,3.25,4580,4838,2.0,0,3,4,11,3080,1500,1991,0,98109,47.6305,-122.354,3540,6483,2900000,17,9,2014,0,23,258,2943,0,1,1
4,2.0,1830,6000,1.0,0,0,5,7,1070,760,1953,0,98118,47.5453,-122.279,1830,5500,378500,30,3,2015,0,62,4170,3670,0,1,1
3,2.0,1520,4000,1.0,0,0,5,6,800,720,1943,0,98106,47.531,-122.351,1430,4000,369950,4,5,2015,0,72,2480,2570,0,1,1
3,2.5,2150,14092,2.0,0,0,3,8,2150,0,1991,0,98058,47.4621,-122.129,2400,10699,360000,4,5,2015,0,24,11942,8299,0,0,0
3,1.5,1170,7645,1.0,0,0,4,7,1170,0,1955,0,98004,47.6077,-122.194,1870,7678,760000,5,8,2014,0,59,6475,5808,0,0,0
3,1.75,1830,5488,1.0,0,2,4,7,1010,820,1939,0,98115,47.6914,-122.309,1200,5488,450000,16,9,2014,0,75,3658,4288,0,1,1
4,2.5,2730,12261,2.0,0,0,3,9,2730,0,1991,0,98011,47.7419,-122.205,2730,10872,612500,2,5,2014,0,23,9531,8142,0,0,0
3,1.0,1090,10710,1.0,0,0,4,7,1090,0,1962,0,98056,47.5,-122.169,1090,10440,280000,1,7,2014,0,52,9620,9350,0,0,0
3,2.5,2560,9182,2.0,0,0,3,9,2560,0,1993,0,98027,47.5361,-122.051,2800,8784,750000,14,4,2015,0,22,6622,5984,0,0,0
3,1.0,1160,6132,1.0,0,0,4,7,1160,0,1958,0,98056,47.5015,-122.173,1280,6132,237000,15,7,2014,0,56,4972,4852,0,0,0
2,1.75,1010,4000,1.5,0,0,5,7,1010,0,1919,0,98105,47.6665,-122.287,1470,4000,441500,14,10,2014,0,95,2990,2530,0,0,1
3,2.0,1650,7930,1.0,0,0,4,7,1650,0,1989,0,98038,47.3617,-122.05,1510,7930,251000,26,1,2015,0,26,6280,6420,0,0,0
1,1.0,960,2640,1.0,0,0,3,7,760,200,1908,0,98112,47.6223,-122.294,1620,3759,332000,16,6,2014,0,106,1680,2139,0,1,1
3,2.5,1509,1114,3.0,0,0,3,8,1509,0,2014,0,98133,47.7048,-122.34,1509,2431,401500,26,8,2014,0,0,-395,922,0,0,1
4,2.5,1954,4805,2.0,0,0,3,8,1954,0,2005,0,98055,47.4297,-122.19,1714,3259,340000,2,7,2014,0,9,2851,1545,0,0,0
3,3.5,2800,7694,1.0,0,0,3,9,2800,0,2005,0,98053,47.7095,-122.022,2420,7694,920000,12,1,2015,0,10,4894,5274,0,0,0
3,1.0,1270,6405,1.5,0,0,3,6,1270,0,1944,0,98178,47.4959,-122.241,1110,6405,153000,13,6,2014,0,70,5135,5295,0,0,1
4,2.25,1810,7601,1.0,0,0,3,7,1080,730,1986,0,98023,47.2857,-122.358,1570,7601,299950,5,1,2015,0,29,5791,6031,0,1,0
4,2.5,2410,7517,2.0,0,0,3,8,2410,0,1983,0,98058,47.4388,-122.142,2420,8095,440000,12,5,2015,0,32,5107,5675,0,0,0
3,2.5,1690,17383,2.0,0,0,3,7,1690,0,2003,0,98038,47.3691,-122.031,2610,7999,293000,15,9,2014,0,11,15693,5389,0,0,0
3,1.75,1190,6000,1.0,0,0,3,7,1190,0,1952,2015,98178,47.5026,-122.236,1200,6000,203000,29,3,2015,63,63,4810,4800,1,0,1
2,1.75,1280,6774,1.0,0,0,3,7,1280,0,1991,0,98002,47.2925,-122.219,1450,7810,193000,20,3,2015,0,24,5494,6360,0,0,0
3,1.75,1460,7862,1.0,0,0,3,7,1460,0,1965,0,98155,47.7755,-122.299,2200,9293,305000,16,3,2015,0,50,6402,7093,0,0,1
4,1.75,1600,6380,1.0,0,0,3,8,1130,470,1959,0,98125,47.701,-122.306,1090,6380,495000,2,5,2014,0,55,4780,5290,0,1,1
3,1.75,1770,6000,1.0,0,0,3,7,1130,640,1952,0,98125,47.7135,-122.315,1900,7200,420000,2,9,2014,0,62,4230,5300,0,1,1
4,2.5,2800,8190,1.0,0,0,3,8,1700,1100,1971,0,98177,47.7695,-122.368,2460,8165,569500,5,9,2014,0,43,5390,5705,0,1,1
4,2.5,2680,9185,2.0,0,0,3,9,2680,0,1989,0,98029,47.5738,-121.992,2810,8505,620000,15,5,2014,0,25,6505,5695,0,0,0
3,1.75,1680,9460,1.0,0,0,4,7,1680,0,1959,0,98006,47.5525,-122.182,1690,9448,466000,11,12,2014,0,55,7780,7758,0,0,0
3,1.0,1120,10032,1.0,0,0,3,7,1120,0,1962,0,98034,47.7182,-122.194,1210,9918,355500,24,3,2015,0,53,8912,8708,0,0,0
2,1.0,1040,7200,1.0,0,0,4,6,1040,0,1955,0,98033,47.6823,-122.203,1640,7200,687500,8,5,2015,0,60,6160,5560,0,0,0
3,2.25,1790,2240,2.0,0,0,4,8,1790,0,1975,0,98052,47.6343,-122.106,1780,2560,432100,11,4,2015,0,40,450,780,0,0,0
5,3.25,3370,7313,2.0,0,0,4,8,2140,1230,1988,0,98029,47.5632,-122.015,2990,7806,690000,10,10,2014,0,26,3943,4816,0,1,0
2,1.0,800,5150,1.0,0,0,4,6,800,0,1949,0,98118,47.5525,-122.274,1280,5150,350000,2,1,2015,0,66,4350,3870,0,0,1
2,1.0,1380,5000,1.0,0,0,3,7,870,510,1943,0,98108,47.5339,-122.293,1450,5000,268000,10,6,2014,0,71,3620,3550,0,1,1
4,2.5,1800,9229,2.0,0,0,3,7,1800,0,1994,0,98022,47.1927,-122.015,1970,9231,285000,18,2,2015,0,21,7429,7261,0,0,0
4,1.5,1820,12327,1.0,0,0,4,7,1380,440,1955,0,98006,47.5767,-122.144,1450,9256,365000,8,10,2014,0,59,10507,7806,0,1,0
3,2.5,2620,6842,2.0,0,0,3,7,2620,0,2002,0,98053,47.6846,-122.037,2280,4800,635000,8,4,2015,0,13,4222,2520,0,0,0
2,2.5,2290,3507,2.0,0,0,3,9,2290,0,2005,0,98029,47.5545,-122.002,2290,3640,630000,8,7,2014,0,9,1217,1350,0,0,0
4,3.0,2200,4466,2.0,0,0,3,7,2200,0,1968,0,98103,47.7005,-122.339,1780,2250,450000,5,3,2015,0,47,2266,470,0,0,1
4,2.5,2940,12600,1.0,0,0,4,8,1850,1090,1974,0,98074,47.6294,-122.062,2030,11770,590000,4,3,2015,0,41,9660,9740,0,1,0
2,1.75,1700,3618,1.0,0,1,3,8,1260,440,1950,0,98199,47.6336,-122.397,2200,5000,895000,9,9,2014,0,64,1918,2800,0,1,1
3,1.0,860,11900,1.0,0,0,4,6,860,0,1963,0,98030,47.3574,-122.186,1660,10248,160000,14,5,2014,0,51,11040,8588,0,0,0
2,1.0,910,5000,1.0,0,0,3,7,910,0,1924,0,98107,47.6733,-122.37,1050,5000,520000,30,9,2014,0,90,4090,3950,0,0,1
4,3.25,2820,13059,2.0,0,0,4,8,2820,0,1976,0,98058,47.4508,-122.132,2360,8600,432000,6,8,2014,0,38,10239,6240,0,0,0
2,1.0,930,4743,1.0,0,0,4,5,930,0,1942,0,98056,47.4966,-122.187,930,4779,141800,19,5,2014,0,72,3813,3849,0,0,0
4,2.0,2190,4560,2.5,0,0,5,8,2190,0,1910,0,98103,47.662,-122.329,2190,4560,980000,14,7,2014,0,104,2370,2370,0,0,1
4,2.5,3430,7200,2.0,0,0,3,9,3430,0,2014,0,98033,47.6842,-122.196,1530,7800,1290000,16,4,2015,0,1,3770,6270,0,0,0
4,2.75,2560,6900,1.0,0,0,3,8,1480,1080,1959,0,98115,47.686,-122.297,2600,7200,740000,17,11,2014,0,55,4340,4600,0,1,1
2,1.0,770,6450,1.0,0,0,4,6,770,0,1948,0,98106,47.531,-122.358,780,6063,230000,10,10,2014,0,66,5680,5283,0,0,1
3,2.25,2440,9689,1.0,0,2,4,8,1830,610,1974,0,98008,47.6141,-122.111,2730,9689,954500,8,4,2015,0,41,7249,6959,0,1,0
3,1.5,1650,3150,1.5,0,0,4,8,1650,0,1929,0,98122,47.6156,-122.297,1650,4500,622000,16,3,2015,0,86,1500,2850,0,0,1
1,1.0,780,4000,1.0,0,0,3,5,780,0,1905,0,98108,47.5424,-122.321,1150,4000,90000,3,3,2015,0,110,3220,2850,0,0,1
3,3.0,1260,1634,3.0,0,0,3,8,1260,0,1998,0,98103,47.697,-122.349,1260,1135,342000,29,10,2014,0,16,374,-125,0,0,1
4,2.5,2320,4683,2.0,0,0,3,7,2320,0,2007,0,98042,47.3349,-122.059,2230,5750,305000,29,7,2014,0,7,2363,3520,0,0,0
4,2.75,1560,8820,1.0,0,3,3,7,1060,500,1979,0,98001,47.3382,-122.257,2140,7800,259900,20,8,2014,0,35,7260,5660,0,1,0
3,2.0,2330,6346,1.5,0,0,3,6,1600,730,1934,2014,98146,47.5135,-122.38,1380,8400,420000,27,8,2014,80,80,4016,7020,1,1,1
3,1.5,1450,6875,1.0,0,0,4,7,1450,0,1961,0,98198,47.4205,-122.316,1270,8000,249950,23,3,2015,0,54,5425,6730,0,0,1
2,1.0,1140,15120,1.0,0,0,4,6,990,150,1932,0,98055,47.4521,-122.196,2320,11250,199000,17,2,2015,0,83,13980,8930,0,1,0
3,1.0,1120,7320,1.0,0,0,4,7,1120,0,1954,0,98146,47.5103,-122.382,1410,6328,355200,7,4,2015,0,61,6200,4918,0,0,1
3,1.0,1110,7128,1.0,0,0,3,7,1110,0,1980,0,98052,47.6968,-122.124,1510,7107,379500,12,11,2014,0,34,6018,5597,0,0,0
4,2.5,3070,6923,2.0,0,0,3,9,3070,0,2009,0,98033,47.669,-122.172,2190,9218,860000,19,8,2014,0,5,3853,7028,0,0,0
3,2.5,1940,4927,2.0,0,0,3,8,1940,0,2004,0,98058,47.4479,-122.12,2070,4892,335000,12,5,2014,0,10,2987,2822,0,0,0
3,2.5,3050,12558,2.0,0,0,3,10,3050,0,1997,0,98074,47.6549,-122.089,3543,12558,865000,5,11,2014,0,17,9508,9015,0,0,0
3,1.0,1240,3600,1.5,0,0,3,7,1240,0,1902,0,98144,47.5986,-122.298,1680,3600,390000,8,4,2015,0,113,2360,1920,0,0,1
5,4.25,3380,7805,2.0,0,0,3,8,3380,0,2014,0,98148,47.4349,-122.328,2790,7805,569950,9,9,2014,0,0,4425,5015,0,0,1
3,2.5,3190,7828,2.0,0,0,3,9,3190,0,2006,0,98059,47.5047,-122.144,2970,7828,495500,5,2,2015,0,9,4638,4858,0,0,0
4,1.75,1670,10200,1.0,0,0,3,7,1390,280,1953,0,98118,47.5524,-122.267,1720,6860,476500,11,12,2014,0,61,8530,5140,0,1,1
3,1.0,1660,11200,1.0,0,0,3,7,1660,0,1957,0,98056,47.5121,-122.168,1380,10875,261000,12,8,2014,0,57,9540,9495,0,0,0
4,2.0,2070,9822,1.0,0,0,5,7,2070,0,1955,0,98006,47.566,-122.14,1300,9572,375000,22,8,2014,0,59,7752,8272,0,0,0
4,2.0,2070,9822,1.0,0,0,5,7,2070,0,1955,0,98006,47.566,-122.14,1300,9572,550000,22,4,2015,0,60,7752,8272,0,0,0
2,1.0,1430,4000,1.0,0,0,3,7,930,500,1949,0,98118,47.5233,-122.284,1110,4000,230000,23,7,2014,0,65,2570,2890,0,1,1
5,2.5,2270,10700,1.0,0,0,4,8,1570,700,1963,0,98028,47.741,-122.256,2020,10230,526750,4,2,2015,0,52,8430,8210,0,1,0
3,2.0,1980,7680,1.5,0,0,4,6,1070,910,1911,0,98033,47.6839,-122.195,1330,8704,606000,4,3,2015,0,104,5700,7374,0,1,0
4,1.0,1390,9023,1.5,0,0,3,7,1390,0,1955,0,98155,47.7754,-122.296,1760,9023,342000,22,4,2015,0,60,7633,7263,0,0,1
4,1.75,2120,8520,1.0,0,0,3,7,1600,520,1978,0,98023,47.302,-122.373,2160,8400,278100,27,3,2015,0,37,6400,6240,0,1,0
4,2.75,1540,4840,1.0,0,2,4,7,850,690,1929,0,98126,47.5491,-122.375,1180,4840,450000,28,10,2014,0,85,3300,3660,0,1,1
4,2.5,2000,5006,2.0,0,0,3,7,2000,0,2005,0,98058,47.466,-122.147,2410,4889,349950,25,8,2014,0,9,3006,2479,0,0,0
4,2.5,2400,6053,2.0,0,0,3,8,2400,0,2001,0,98038,47.3869,-122.033,2460,6519,425000,10,4,2015,0,14,3653,4059,0,0,0
4,2.75,2110,8751,1.0,0,0,3,7,1510,600,1962,0,98011,47.7617,-122.215,1660,10295,435000,26,6,2014,0,52,6641,8635,0,1,0
4,1.75,1440,8114,1.0,0,0,4,7,1440,0,1963,0,98155,47.7639,-122.332,1940,7208,323000,22,12,2014,0,51,6674,5268,0,0,1
2,1.0,810,6827,1.0,0,0,3,6,810,0,1944,0,98106,47.5495,-122.357,990,6827,325000,30,4,2015,0,71,6017,5837,0,0,1
2,1.75,1170,4635,1.0,0,0,4,6,690,480,1924,0,98117,47.6842,-122.359,1240,4120,480000,13,8,2014,0,90,3465,2880,0,1,1
3,2.5,3590,8400,1.0,0,0,3,9,2950,640,1958,2007,98005,47.595,-122.173,1620,7875,1330000,30,4,2015,49,57,4810,6255,1,1,0
4,1.75,2090,6485,1.0,0,0,3,7,1280,810,1956,0,98178,47.4958,-122.265,2190,9600,210000,27,4,2015,0,59,4395,7410,0,1,1
5,4.5,3820,5750,2.0,0,3,3,9,2830,990,2000,0,98116,47.5581,-122.385,1750,5750,920000,1,4,2015,0,15,1930,4000,0,1,1
3,1.0,1460,8290,1.0,0,0,3,8,1460,0,1959,0,98125,47.7246,-122.3,1470,8290,399000,2,12,2014,0,55,6830,6820,0,0,1
3,1.75,2360,4063,1.0,0,0,5,7,1180,1180,1940,0,98117,47.6902,-122.382,1660,4063,631750,18,8,2014,0,74,1703,2403,0,1,1
3,1.0,1100,8680,1.0,0,0,3,6,1100,0,1962,0,98023,47.3072,-122.363,1100,9220,184000,26,3,2015,0,53,7580,8120,0,0,0
4,2.5,2100,7208,2.0,0,0,3,8,2100,0,1974,0,98058,47.4478,-122.128,2060,7480,333000,16,4,2015,0,41,5108,5420,0,0,0
2,2.0,1310,2841,2.0,0,0,3,6,1310,0,2004,0,98038,47.3502,-122.022,1360,2550,218000,20,6,2014,0,10,1531,1190,0,0,0
2,1.5,750,2964,1.0,0,0,5,5,750,0,1919,0,98118,47.5518,-122.277,1350,3090,258305,24,2,2015,0,96,2214,1740,0,0,1
5,1.5,1720,5000,1.5,0,0,3,8,1720,0,1915,0,98103,47.6627,-122.355,1720,5000,775000,15,7,2014,0,99,3280,3280,0,0,1
2,1.5,1200,1259,2.0,0,0,3,8,1000,200,2015,0,98144,47.6001,-122.298,1320,1852,455000,24,6,2014,0,-1,59,532,0,1,1
3,2.5,1830,6807,2.5,0,0,5,7,1830,0,1954,0,98155,47.7613,-122.322,1340,6807,440000,18,2,2015,0,61,4977,5467,0,0,1
3,3.5,3870,3819,2.0,0,0,3,11,2760,1110,2002,0,98102,47.6452,-122.317,2530,5500,1440000,19,6,2014,0,12,-51,2970,0,1,1
3,2.25,2220,3707,2.0,0,0,4,8,1620,600,1919,0,98122,47.617,-122.286,2030,4850,850000,14,7,2014,0,95,1487,2820,0,1,1
3,1.75,1970,7100,1.0,0,0,3,7,1590,380,1976,0,98072,47.7353,-122.172,1790,7455,408000,12,9,2014,0,38,5130,5665,0,1,0
5,1.75,2170,9752,1.0,0,0,3,7,1100,1070,1962,0,98003,47.3355,-122.331,1810,10609,278000,20,8,2014,0,52,7582,8799,0,1,0
3,3.0,2350,1620,2.0,0,0,3,9,1560,790,2001,0,98112,47.6308,-122.279,2000,4380,1200000,22,1,2015,0,14,-730,2380,0,1,1
4,2.25,2440,5000,2.0,0,0,3,7,2440,0,2007,0,98065,47.5407,-121.89,2440,5212,499000,5,5,2015,0,8,2560,2772,0,0,0
5,3.0,3480,6625,2.0,0,0,3,8,3480,0,2012,0,98059,47.4815,-122.153,2800,9400,590000,18,2,2015,0,3,3145,6600,0,0,0
3,3.5,1900,4805,2.0,0,0,3,8,1560,340,1999,0,98108,47.5686,-122.315,1360,4800,385000,30,7,2014,0,15,2905,3440,0,1,1
4,3.25,3160,10043,2.0,0,2,3,9,3160,0,2011,0,98034,47.7001,-122.238,3450,10043,1250000,24,9,2014,0,3,6883,6593,0,0,0
2,1.75,1330,2159,1.0,0,0,4,8,1330,0,1979,0,98198,47.3822,-122.32,1220,3679,202200,24,9,2014,0,35,829,2459,0,0,1
3,2.25,1420,13468,1.0,0,0,3,7,960,460,1976,0,98033,47.6693,-122.176,1480,10980,450000,11,3,2015,0,39,12048,9500,0,1,0
3,2.25,2470,5650,1.0,0,2,3,7,1550,920,1973,0,98178,47.5072,-122.252,1660,5650,361000,4,5,2015,0,42,3180,3990,0,1,1
4,2.25,2590,12600,2.0,0,0,3,9,2590,0,1979,0,98006,47.5566,-122.162,2620,11050,760000,20,1,2015,0,36,10010,8430,0,0,0
4,2.5,3030,8507,2.0,0,0,3,9,3030,0,2003,0,98033,47.6675,-122.176,2570,8830,902000,16,6,2014,0,11,5477,6260,0,0,0
3,1.75,1240,4550,1.5,0,0,4,7,1240,0,1951,0,98116,47.5803,-122.398,2110,5700,505000,11,4,2015,0,64,3310,3590,0,0,1
3,1.0,1040,8925,1.0,0,0,4,6,1040,0,1961,0,98023,47.3265,-122.335,1040,8925,200000,25,2,2015,0,54,7885,7885,0,0,0
5,2.25,2320,6375,1.0,0,0,4,7,1270,1050,1967,0,98001,47.3351,-122.282,1760,7600,260000,4,2,2015,0,48,4055,5840,0,1,0
2,1.0,1190,5100,1.5,0,0,2,7,1190,0,1928,0,98117,47.6773,-122.382,1920,5100,417000,25,9,2014,0,86,3910,3180,0,0,1
3,2.25,2030,8690,1.0,0,0,4,8,1360,670,1986,0,98023,47.3185,-122.391,1720,8800,287500,2,2,2015,0,29,6660,7080,0,1,0
3,1.5,1390,10530,1.0,0,0,3,7,1390,0,1961,0,98033,47.7025,-122.196,1750,10530,450000,7,4,2015,0,54,9140,8780,0,0,0
2,1.75,2050,4000,1.5,0,2,3,8,2050,0,1979,0,98119,47.6415,-122.373,1940,4000,825000,30,1,2015,0,36,1950,2060,0,0,1
4,3.0,3050,6179,2.0,0,0,4,9,2330,720,1926,0,98112,47.6253,-122.284,3020,6505,1480000,27,8,2014,0,88,3129,3485,0,1,1
2,1.0,1240,5500,1.5,0,0,3,6,1240,0,1921,0,98118,47.5257,-122.263,1520,5500,319950,25,2,2015,0,94,4260,3980,0,0,1
3,1.75,1930,6000,1.0,0,0,3,8,1130,800,1956,0,98119,47.6516,-122.375,1870,6000,560000,6,5,2015,0,59,4070,4130,0,1,1
3,1.75,1490,10344,1.0,0,0,3,7,1490,0,1985,0,98155,47.7517,-122.326,1450,8632,350000,30,12,2014,0,29,8854,7182,0,0,1
3,2.0,1510,10215,1.0,0,0,4,7,1510,0,1995,0,98022,47.2078,-122.003,1370,8902,270000,28,10,2014,0,19,8705,7532,0,0,0
4,2.5,2330,4606,2.0,0,0,3,8,2330,0,2004,0,98031,47.3934,-122.184,2330,5783,308000,14,7,2014,0,10,2276,3453,0,0,0
4,2.0,2240,7725,1.0,0,0,5,7,1120,1120,1956,0,98106,47.5331,-122.365,1340,6300,450000,29,5,2014,0,58,5485,4960,0,1,1
4,1.5,1680,11123,1.0,0,0,3,7,1130,550,1959,0,98177,47.7565,-122.361,1770,10103,380000,10,6,2014,0,55,9443,8333,0,1,1
1,1.0,670,7957,1.0,0,0,4,6,670,0,1978,0,98038,47.3594,-122.056,1600,7957,118000,21,10,2014,0,36,7287,6357,0,0,0
4,1.75,1730,7210,1.0,0,0,4,7,1010,720,1968,0,98003,47.354,-122.315,1620,7210,280400,23,4,2015,0,47,5480,5590,0,1,0
3,1.75,1330,7500,1.0,0,0,3,8,1330,0,1961,0,98004,47.6074,-122.195,1690,7800,787000,5,5,2014,0,53,6170,6110,0,0,0
4,2.5,1990,2660,2.0,0,0,3,8,1990,0,2012,0,98034,47.732,-122.178,1990,2665,537000,30,3,2015,0,3,670,675,0,0,0
2,1.5,1900,4450,1.0,0,0,5,7,1500,400,1916,0,98144,47.5834,-122.293,2130,5000,650000,3,11,2014,0,98,2550,2870,0,1,1
4,1.0,1310,8640,1.0,0,0,3,6,910,400,1948,0,98146,47.5104,-122.342,1310,8640,154200,6,1,2015,0,67,7330,7330,0,1,1
4,2.5,1690,7260,1.0,0,0,3,7,1080,610,1979,0,98023,47.3001,-122.368,1690,7700,238000,15,1,2015,0,36,5570,6010,0,1,0
3,1.0,1040,8199,1.0,0,0,3,7,1040,0,1953,0,98155,47.7348,-122.302,1420,8200,285650,4,8,2014,0,61,7159,6780,0,0,1
2,1.5,1340,1286,2.0,0,0,3,8,1190,150,2006,0,98122,47.617,-122.309,1460,1245,485500,7,8,2014,0,8,-54,-215,0,1,1
2,1.0,1120,7350,1.0,0,0,3,7,1120,0,1942,0,98155,47.7648,-122.31,1320,7545,315000,26,1,2015,0,73,6230,6225,0,0,1
5,6.75,9640,13068,1.0,1,4,3,12,4820,4820,1983,2009,98040,47.557,-122.21,3270,10454,4670000,17,6,2014,26,31,3428,7184,1,1,0
3,2.0,2310,10525,2.0,0,0,5,7,2310,0,1965,0,98033,47.6727,-122.174,1430,10523,627000,17,11,2014,0,49,8215,9093,0,0,0
3,3.25,1220,1281,2.0,0,0,3,8,930,290,2014,0,98105,47.67,-122.317,1303,3810,526000,19,9,2014,0,0,61,2507,0,1,1
3,1.5,1200,3060,1.0,0,0,4,7,1060,140,1910,0,98115,47.679,-122.315,1410,3060,480000,27,3,2015,0,105,1860,1650,0,1,1
4,2.5,2460,9973,1.0,0,0,4,8,1560,900,1965,0,98177,47.7133,-122.361,1830,7200,640000,11,8,2014,0,49,7513,5370,0,1,1
3,2.5,1630,7950,1.0,0,0,3,8,1320,310,1985,0,98042,47.4224,-122.159,1650,7952,279000,27,6,2014,0,29,6320,6302,0,1,0
2,2.0,970,9750,1.0,0,0,5,6,970,0,1940,0,98146,47.5073,-122.372,1850,9000,303000,10,7,2014,0,74,8780,7150,0,0,1
4,2.0,1780,5336,1.5,0,0,5,6,930,850,1918,0,98178,47.5094,-122.263,1910,10304,315000,25,6,2014,0,96,3556,8394,0,1,1
4,1.75,1760,7268,1.0,0,0,4,7,1080,680,1979,0,98058,47.4267,-122.148,1830,8786,336500,25,3,2015,0,36,5508,6956,0,1,0
2,1.0,770,8150,1.0,0,0,3,6,770,0,1951,0,98118,47.5324,-122.275,1140,8550,163250,13,11,2014,0,63,7380,7410,0,0,1
3,1.0,1760,6927,1.0,0,0,3,7,1050,710,1962,0,98011,47.7623,-122.2,2060,9120,444950,18,2,2015,0,53,5167,7060,0,1,0
2,1.0,990,2446,2.0,0,0,3,7,990,0,1998,0,98144,47.5919,-122.297,1260,2805,285000,1,8,2014,0,16,1456,1545,0,0,1
2,1.0,1250,4960,1.0,0,0,3,7,940,310,1938,0,98115,47.6893,-122.325,2030,7440,370000,17,3,2015,0,77,3710,5410,0,1,1
3,2.25,1440,5150,2.0,0,0,3,7,1440,0,1997,0,98106,47.5456,-122.356,1530,5238,330000,15,12,2014,0,17,3710,3708,0,0,1
2,2.0,1960,4018,1.0,0,0,5,7,980,980,1950,0,98108,47.5629,-122.32,1240,4641,395000,20,8,2014,0,64,2058,3401,0,1,1
6,3.0,2510,5310,1.0,0,0,4,7,1460,1050,1944,0,98108,47.5533,-122.304,1390,5407,440000,16,4,2015,0,71,2800,4017,0,1,1
4,2.75,2920,6605,2.0,0,0,3,8,2920,0,2012,0,98059,47.4909,-122.144,3030,6605,625000,3,5,2014,0,2,3685,3575,0,0,0
3,2.5,1570,2577,2.0,0,0,3,7,1570,0,2005,0,98019,47.7456,-121.984,1970,2952,299950,18,11,2014,0,9,1007,982,0,0,0
2,1.75,970,4233,1.0,0,0,4,7,970,0,1944,0,98199,47.6384,-122.4,1340,4233,560000,29,9,2014,0,70,3263,2893,0,0,1
4,3.0,2800,9764,2.0,0,0,3,8,2800,0,2002,0,98038,47.3543,-122.012,3610,8194,380000,20,5,2014,0,12,6964,4584,0,0,0
4,2.0,1580,7800,2.0,0,0,2,6,1580,0,1906,0,98144,47.5848,-122.302,1190,4440,333000,19,5,2014,0,108,6220,3250,0,0,1
2,1.0,1220,3000,1.0,0,0,3,7,920,300,1926,0,98117,47.6823,-122.365,1270,3000,499000,10,6,2014,0,88,1780,1730,0,1,1
3,1.5,1550,8000,1.0,0,0,3,6,1330,220,1980,0,98118,47.5536,-122.286,1150,5150,386000,24,2,2015,0,35,6450,4000,0,1,1
3,2.0,1220,7620,1.0,0,0,3,6,720,500,1947,2014,98166,47.4564,-122.352,1640,7620,320600,22,9,2014,67,67,6400,5980,1,1,1
7,4.0,3150,7800,2.0,0,0,3,8,3150,0,2013,0,98118,47.5259,-122.279,1880,6000,450000,9,9,2014,0,1,4650,4120,0,0,1
2,1.0,800,7150,1.0,0,0,3,5,800,0,1933,0,98030,47.3788,-122.224,1220,8019,175000,18,12,2014,0,81,6350,6799,0,0,0
5,2.75,3190,5857,2.0,0,0,3,9,3190,0,2004,0,98058,47.4575,-122.119,3100,5857,544800,21,4,2015,0,11,2667,2757,0,0,0
3,1.75,1720,7587,1.0,0,0,4,7,1140,580,1981,0,98092,47.3175,-122.182,1120,7287,220000,21,1,2015,0,34,5867,6167,0,1,0
2,2.25,1100,1695,2.0,0,0,3,9,1100,0,2009,0,98118,47.5663,-122.289,1100,3082,374000,5,9,2014,0,5,595,1982,0,0,1
3,2.0,1010,7896,1.0,0,0,3,7,1010,0,1984,0,98031,47.4046,-122.181,1540,7896,200000,27,2,2015,0,31,6886,6356,0,0,0
3,2.0,1010,7896,1.0,0,0,3,7,1010,0,1984,0,98031,47.4046,-122.181,1540,7896,259950,6,5,2015,0,31,6886,6356,0,0,0
4,2.75,1760,9222,1.0,0,0,3,7,1140,620,1971,0,98023,47.3099,-122.362,1800,9222,255000,22,7,2014,0,43,7462,7422,0,1,0
3,1.75,1400,6750,1.0,0,0,3,7,1040,360,1975,0,98034,47.717,-122.226,1860,7480,447000,23,3,2015,0,40,5350,5620,0,1,0
3,2.5,1820,8722,1.5,0,0,3,7,1820,0,1926,2008,98022,47.2137,-121.989,1480,12285,287000,19,3,2015,82,89,6902,10805,1,0,0
3,2.0,1470,6950,1.0,0,0,5,6,1470,0,1932,0,98133,47.7619,-122.343,1660,5065,344950,30,9,2014,0,82,5480,3405,0,0,1
2,1.0,770,7000,1.0,0,0,3,6,770,0,1921,0,98024,47.5654,-121.89,1100,8777,212000,10,10,2014,0,93,6230,7677,0,0,0
5,2.75,1340,11583,1.0,0,0,3,7,1190,150,1962,0,98034,47.709,-122.214,1950,10514,425000,23,7,2014,0,52,10243,8564,0,1,0
1,1.0,480,4560,1.0,0,0,3,5,480,0,1922,0,98065,47.5253,-121.826,890,4803,170000,4,9,2014,0,92,4080,3913,0,0,0
3,1.0,1260,4080,1.5,0,0,4,7,1260,0,1928,0,98103,47.6893,-122.354,1130,3876,565000,12,2,2015,0,87,2820,2746,0,0,1
2,1.0,870,11100,1.0,0,0,3,6,870,0,1940,0,98146,47.5038,-122.364,1370,10404,234000,23,6,2014,0,74,10230,9034,0,0,1
3,2.5,4010,12105,1.0,0,3,5,11,2600,1410,1983,0,98006,47.554,-122.151,4010,15081,1510000,9,10,2014,0,31,8095,11071,0,1,0
3,2.5,2340,8414,1.0,0,0,3,7,1280,1060,1993,0,98188,47.4685,-122.265,2340,7268,345000,26,1,2015,0,22,6074,4928,0,1,1
3,2.75,1770,3172,2.0,0,0,3,8,1770,0,2009,0,98065,47.5164,-121.878,1760,2891,415000,27,4,2015,0,6,1402,1131,0,0,0
5,1.75,2660,10637,1.5,0,0,5,7,1670,990,1922,0,98115,47.6945,-122.292,1570,6825,760000,10,10,2014,0,92,7977,5255,0,1,1
2,1.75,1230,1107,2.0,0,0,3,8,1230,0,2006,0,98029,47.5475,-121.999,1380,1107,360000,26,9,2014,0,8,-123,-273,0,0,0
3,2.0,1900,6660,1.0,0,0,5,7,950,950,1966,0,98038,47.3594,-122.054,1690,8111,250000,16,5,2014,0,48,4760,6421,0,1,0
2,2.0,1750,2731,2.0,0,0,3,8,1750,0,2012,0,98065,47.5169,-121.878,1650,2731,394000,21,4,2015,0,3,981,1081,0,0,0
4,3.5,3380,11270,2.0,0,1,3,9,2160,1220,2007,0,98074,47.6124,-122.06,2910,11214,865000,22,1,2015,0,8,7890,8304,0,1,0
2,2.0,2090,6000,2.0,0,1,3,7,2090,0,1918,1985,98116,47.5732,-122.413,1600,5400,477500,12,9,2014,67,96,3910,3800,1,0,1
4,2.75,4120,12500,1.0,0,4,4,8,2060,2060,1947,0,98116,47.5914,-122.385,3680,5000,1250000,17,12,2014,0,67,8380,1320,0,1,1
3,1.75,1260,7500,1.0,0,0,3,6,840,420,1947,0,98155,47.772,-122.323,1340,7500,270000,27,8,2014,0,67,6240,6160,0,1,1
3,2.25,1800,6875,1.0,0,0,4,8,1230,570,1974,0,98052,47.6773,-122.11,1800,8749,567000,28,4,2015,0,41,5075,6949,0,1,0
3,2.5,1960,7200,1.0,0,0,4,8,980,980,1940,0,98118,47.5655,-122.27,1440,7200,635000,2,6,2014,0,74,5240,5760,0,1,1
6,2.75,4460,6952,2.5,0,2,4,10,3460,1000,1930,0,98105,47.6626,-122.269,2750,4769,1870000,11,9,2014,0,84,2492,2019,0,1,1
3,1.75,1330,9200,1.0,0,0,4,7,1330,0,1973,0,98092,47.2916,-122.185,1590,9200,183000,10,6,2014,0,41,7870,7610,0,0,0
4,2.75,3360,9100,1.0,0,0,4,8,1760,1600,1973,0,98006,47.5641,-122.149,2620,8925,945800,25,3,2015,0,42,5740,6305,0,1,0
3,1.0,1460,10200,1.0,0,0,4,7,1460,0,1957,0,98055,47.4238,-122.197,1460,8500,220000,14,8,2014,0,57,8740,7040,0,0,0
3,2.25,1790,9927,1.0,0,2,4,7,1240,550,1969,0,98075,47.5822,-122.077,2610,10700,650000,22,4,2015,0,46,8137,8090,0,1,0
4,3.5,3100,7600,2.0,0,0,3,10,3100,0,2005,0,98031,47.3892,-122.215,3350,7638,511000,3,2,2015,0,10,4500,4288,0,0,0
2,1.75,1530,5000,2.0,0,0,4,7,1260,270,1989,0,98107,47.6755,-122.37,1470,5000,576250,3,4,2015,0,26,3470,3530,0,1,1
2,3.25,2070,3128,2.0,1,3,3,9,1760,310,1988,0,98075,47.5686,-122.06,2740,3568,1450000,19,3,2015,0,27,1058,828,0,1,0
3,2.0,1340,4320,1.0,0,0,3,5,920,420,1912,1993,98002,47.299,-122.228,980,6480,186000,19,6,2014,81,102,2980,5500,1,1,0
1,1.0,1220,4160,1.0,0,0,3,7,1220,0,1922,0,98115,47.6746,-122.315,1970,4200,655100,5,5,2015,0,93,2940,2230,0,0,1
4,2.5,2370,6500,2.0,0,0,3,9,2370,0,1998,0,98092,47.3328,-122.173,2590,6137,328000,5,5,2014,0,16,4130,3547,0,0,0
3,2.5,1890,11036,1.0,0,0,3,8,1460,430,1973,0,98133,47.7426,-122.354,2040,7524,441000,10,3,2015,0,42,9146,5484,0,1,1
3,1.75,1480,7725,1.5,0,0,4,7,1480,0,1981,0,98059,47.483,-122.163,1720,8379,370000,14,4,2015,0,34,6245,6659,0,0,0
2,1.0,1050,8382,1.0,0,0,3,7,1050,0,1959,0,98040,47.5627,-122.221,2400,9525,630000,13,4,2015,0,56,7332,7125,0,0,0
4,2.25,2070,14000,1.0,0,0,3,7,1720,350,1958,0,98028,47.7484,-122.237,1690,14444,470500,14,4,2015,0,57,11930,12754,0,1,0
2,1.0,1170,6000,1.0,0,0,3,6,1170,0,1948,0,98168,47.5033,-122.331,1130,7500,285950,13,4,2015,0,67,4830,6370,0,0,1
3,1.5,1090,7200,1.0,0,0,4,7,1090,0,1958,0,98040,47.5817,-122.241,2010,8982,698000,24,3,2015,0,57,6110,6972,0,0,0
3,2.5,1650,6684,2.0,0,0,3,7,1650,0,1991,0,98031,47.4051,-122.184,1850,7048,268000,26,6,2014,0,23,5034,5198,0,0,0
4,3.75,4410,8112,3.0,0,4,3,11,3570,840,2003,0,98116,47.5888,-122.392,2770,5750,1630000,12,2,2015,0,12,3702,2980,0,1,1
4,2.5,1780,15000,2.0,0,0,2,7,1780,0,1993,0,98058,47.4239,-122.153,2005,9680,355000,30,3,2015,0,22,13220,7675,0,0,0
3,1.0,1550,8778,1.0,0,0,3,7,1250,300,1952,0,98118,47.5413,-122.281,2120,7268,299000,17,9,2014,0,62,7228,5148,0,1,1
4,2.75,2290,6120,2.0,0,0,4,7,2170,120,1926,0,98115,47.6746,-122.327,1910,4590,1000000,21,5,2014,0,88,3830,2680,0,1,1
4,2.0,2220,8229,1.5,0,0,4,7,2220,0,1958,0,98030,47.3722,-122.22,1660,8396,275000,20,4,2015,0,57,6009,6736,0,0,0
3,1.75,1150,10240,1.0,0,0,3,6,1030,120,1918,0,98106,47.5222,-122.357,1270,2566,475000,3,5,2015,0,97,9090,1296,0,1,1
2,1.75,1270,7560,1.5,0,0,4,7,1270,0,1932,0,98133,47.7083,-122.357,1480,7560,416000,18,7,2014,0,82,6290,6080,0,0,1
5,1.0,1810,11205,1.5,0,2,3,7,1810,0,1915,0,98178,47.5099,-122.262,1860,7965,495000,19,11,2014,0,99,9395,6105,0,0,1
3,1.0,1450,8100,1.0,0,0,3,6,1450,0,1952,0,98125,47.7027,-122.289,1450,7800,357500,14,1,2015,0,63,6650,6350,0,0,1
2,1.5,1170,1079,3.0,0,0,3,7,1170,0,2003,0,98103,47.6607,-122.333,1170,1116,459500,25,8,2014,0,11,-91,-54,0,0,1
3,2.5,1730,6930,2.0,0,0,3,8,1730,0,1994,0,98003,47.2621,-122.308,1780,6930,258000,3,9,2014,0,20,5200,5150,0,0,0
3,1.5,1020,10152,1.0,0,0,5,6,1020,0,1959,0,98056,47.4971,-122.168,1320,8892,165000,3,10,2014,0,55,9132,7572,0,0,0
5,2.5,1970,8605,2.0,0,0,4,7,1970,0,1994,0,98022,47.1944,-122.013,1970,8460,297000,18,5,2014,0,20,6635,6490,0,0,0
2,1.0,830,5100,1.0,0,0,4,7,830,0,1942,0,98126,47.5259,-122.379,1220,5100,350000,23,10,2014,0,72,4270,3880,0,0,1
4,4.5,5030,11023,2.0,0,2,3,11,3250,1780,2008,0,98040,47.5722,-122.236,3640,11490,2450000,13,5,2014,0,6,5993,7850,0,1,0
2,1.0,800,9450,1.0,0,0,3,6,800,0,1958,0,98058,47.4563,-122.184,1090,9450,180000,13,5,2015,0,57,8650,8360,0,0,0
3,1.75,1330,12092,1.0,0,0,4,6,720,610,1981,0,98168,47.5102,-122.324,1770,11770,339950,7,4,2015,0,34,10762,10000,0,1,1
3,1.0,1030,4700,1.0,0,0,3,7,1030,0,1952,0,98146,47.5118,-122.377,1030,4700,365000,27,1,2015,0,63,3670,3670,0,0,1
3,2.5,2330,1987,2.0,0,4,3,9,1410,920,2004,0,98107,47.6735,-122.405,2640,5250,732000,27,5,2014,0,10,-343,2610,0,1,1
3,1.75,1540,10800,1.0,0,0,5,6,770,770,1947,0,98040,47.5763,-122.222,2020,10800,500000,16,6,2014,0,67,9260,8780,0,1,0
6,2.75,2040,8560,1.0,0,2,4,7,1100,940,1961,0,98008,47.616,-122.115,2230,8560,610000,13,2,2015,0,54,6520,6330,0,1,0
3,2.0,1540,7800,1.0,0,0,3,8,1540,0,2004,0,98125,47.7041,-122.288,1510,7800,525000,4,6,2014,0,10,6260,6290,0,0,1
4,1.0,1920,13787,1.0,0,0,4,7,1220,700,1966,0,98188,47.4502,-122.277,1490,11200,170000,17,6,2014,0,48,11867,9710,0,1,1
3,2.5,1870,3439,2.0,0,0,3,7,1870,0,2005,0,98042,47.3992,-122.163,2190,4029,300000,13,7,2014,0,9,1569,1839,0,0,0
5,3.5,2960,12527,2.0,0,0,3,9,1940,1020,1986,0,98023,47.3134,-122.35,2210,10952,389500,29,10,2014,0,28,9567,8742,0,1,0
3,1.5,1690,10250,1.0,0,0,4,7,1690,0,1955,0,98166,47.4531,-122.344,1990,11084,330000,19,2,2015,0,60,8560,9094,0,0,1
3,2.25,1610,7187,2.0,0,0,3,7,1610,0,1988,0,98042,47.3764,-122.117,1640,7194,269950,14,11,2014,0,26,5577,5554,0,0,0
2,1.0,670,4720,1.0,0,0,4,6,670,0,1948,0,98106,47.5243,-122.358,1480,4720,107000,28,8,2014,0,66,4050,3240,0,0,1
3,1.0,1752,14626,2.0,0,2,3,8,1752,0,2005,0,98032,47.3755,-122.278,1800,9000,249000,2,12,2014,0,9,12874,7200,0,0,0
4,2.0,1540,5920,1.5,0,0,5,7,1540,0,1935,0,98125,47.7148,-122.301,1630,6216,442500,18,8,2014,0,79,4380,4586,0,0,1
3,1.5,1370,7500,1.0,0,0,3,7,1080,290,1958,0,98198,47.4167,-122.322,1400,7500,203000,19,11,2014,0,56,6130,6100,0,1,1
2,1.0,860,5800,1.0,0,0,5,5,860,0,1942,0,98056,47.4979,-122.183,900,6000,222900,9,9,2014,0,72,4940,5100,0,0,0
4,1.75,1820,7381,1.0,0,0,5,7,1150,670,1962,0,98058,47.4567,-122.171,1610,8462,320000,6,4,2015,0,53,5561,6852,0,1,0
3,1.5,2120,4370,1.5,0,0,3,8,2120,0,1904,0,98122,47.606,-122.307,1960,5120,733500,10,12,2014,0,110,2250,3160,0,0,1
3,2.25,2520,6170,2.0,0,0,3,7,1850,670,2003,0,98038,47.3522,-122.042,2260,6967,364950,15,12,2014,0,11,3650,4707,0,1,0
3,1.75,1560,9247,1.0,0,0,3,7,1160,400,1989,0,98033,47.6954,-122.174,1690,8772,490000,20,11,2014,0,25,7687,7082,0,1,0
5,1.75,2250,13526,1.0,0,1,3,8,1350,900,1957,0,98125,47.7108,-122.279,2580,10078,688000,27,4,2015,0,58,11276,7498,0,1,1
2,1.0,640,7768,1.0,0,0,3,6,640,0,1942,0,98106,47.515,-122.359,840,7424,165000,11,7,2014,0,72,7128,6584,0,0,1
5,3.75,3880,8370,2.0,0,0,4,7,3880,0,2004,0,98056,47.4811,-122.179,2160,4651,506000,13,11,2014,0,10,4490,2491,0,0,0
3,2.25,3360,7108,2.0,0,0,3,10,2770,590,1905,2004,98112,47.6187,-122.284,3450,8558,2190000,9,12,2014,99,109,3748,5108,1,1,1
5,1.75,2350,7800,1.0,0,0,4,8,1510,840,1968,0,98008,47.6225,-122.107,2220,8400,754000,29,4,2015,0,47,5450,6180,0,1,0
5,2.5,2340,1989,2.0,1,4,3,8,2340,0,1959,0,98118,47.5193,-122.257,2200,3230,949950,17,4,2015,0,56,-351,1030,0,0,1
3,2.5,1430,1056,3.0,0,0,3,8,1430,0,2003,0,98117,47.684,-122.388,1310,2135,443600,22,8,2014,0,11,-374,825,0,0,1
3,2.5,1920,12244,2.0,0,0,3,7,1920,0,1998,0,98019,47.7256,-121.97,1920,11859,380600,14,8,2014,0,16,10324,9939,0,0,0
3,3.25,4330,14600,2.0,0,0,3,10,3630,700,1985,0,98074,47.6341,-122.044,3220,12672,722800,26,1,2015,0,30,10270,9452,0,1,0
2,1.0,790,5150,1.0,0,0,4,6,790,0,1948,0,98118,47.5528,-122.272,1460,5150,342888,10,2,2015,0,67,4360,3690,0,0,1
4,1.75,2350,5946,1.0,0,2,3,8,1350,1000,1957,0,98115,47.6879,-122.298,2060,6000,555000,16,9,2014,0,57,3596,3940,0,1,1
3,2.5,1350,3068,2.0,0,0,3,7,1350,0,1991,0,98122,47.6099,-122.293,1900,4000,613000,3,6,2014,0,23,1718,2100,0,0,1
3,2.0,1470,10052,1.0,0,0,4,8,1470,0,1956,0,98125,47.726,-122.316,1480,9780,480000,2,7,2014,0,58,8582,8300,0,0,1
6,1.5,1680,5202,1.5,0,0,2,7,1680,0,1911,0,98033,47.6798,-122.206,1890,5500,619500,16,3,2015,0,104,3522,3610,0,0,0
4,2.5,1890,8505,1.0,0,0,3,8,1290,600,1980,0,98052,47.6796,-122.115,1720,9600,437000,24,6,2014,0,34,6615,7880,0,1,0
4,2.5,2030,9905,1.0,0,0,4,8,2030,0,1959,0,98006,47.5518,-122.184,2130,10008,621000,8,4,2015,0,56,7875,7878,0,0,0
4,1.75,1760,4080,1.5,0,0,4,8,1760,0,1906,0,98103,47.675,-122.331,1760,6120,810000,14,7,2014,0,108,2320,4360,0,0,1
3,2.25,1950,8868,1.0,0,0,3,7,1350,600,1964,0,98155,47.7538,-122.312,1300,8880,415000,27,5,2014,0,50,6918,7580,0,1,1
4,1.0,1440,7404,1.0,0,0,3,6,1080,360,1918,0,98126,47.5328,-122.379,1620,7436,250000,13,11,2014,0,96,5964,5816,0,1,1
3,1.5,2230,6000,1.0,0,1,3,8,1260,970,1968,0,98136,47.5373,-122.395,2120,7200,585000,13,4,2015,0,47,3770,5080,0,1,1
3,1.0,1180,5002,1.5,0,0,3,7,1180,0,1946,0,98155,47.7529,-122.324,1470,8410,220000,28,5,2014,0,68,3822,6940,0,0,1
5,2.5,2500,11900,1.0,0,0,3,7,1400,1100,1963,0,98007,47.5915,-122.132,2820,11900,580000,22,4,2015,0,52,9400,9080,0,1,0
4,2.5,2040,9225,1.0,0,0,5,8,1610,430,1968,0,98052,47.636,-122.097,1730,9225,675000,1,8,2014,0,46,7185,7495,0,1,0
4,2.75,2660,7389,2.0,0,0,3,9,2660,0,2002,0,98075,47.5993,-121.977,2820,7388,695000,29,10,2014,0,12,4729,4568,0,0,0
5,2.75,2580,7630,1.0,0,0,4,7,1730,850,1954,0,98004,47.6226,-122.205,2040,7717,915000,9,12,2014,0,60,5050,5677,0,1,0
3,1.0,1000,6947,1.0,0,0,4,7,1000,0,1947,0,98125,47.7142,-122.319,1000,6947,375000,21,11,2014,0,67,5947,5947,0,0,1
3,1.5,1330,1265,2.0,0,0,3,8,1140,190,2008,0,98116,47.5773,-122.409,1330,1264,500000,7,4,2015,0,7,-65,-66,0,1,1
2,2.0,1420,5185,1.0,0,0,3,7,1420,0,2004,0,98038,47.3543,-122.022,2140,4890,335000,26,12,2014,0,10,3765,2750,0,0,0
5,2.5,2200,8500,1.0,0,0,4,7,1400,800,1971,0,98010,47.3073,-122.006,1360,8855,320900,29,4,2015,0,44,6300,7495,0,1,0
3,1.75,1800,8462,1.0,0,0,3,8,1440,360,1978,0,98052,47.6623,-122.141,2210,8436,508000,6,3,2015,0,37,6662,6226,0,1,0
3,1.75,1200,9085,1.0,0,0,4,7,1200,0,1968,0,98023,47.2795,-122.353,1200,9085,228950,8,7,2014,0,46,7885,7885,0,0,0
4,2.0,1840,4760,1.5,0,0,4,6,1080,760,1929,0,98106,47.5297,-122.349,1170,5950,433000,7,5,2015,0,86,2920,4780,0,1,1
2,1.0,960,5150,1.0,0,0,5,6,960,0,1951,0,98126,47.5201,-122.372,1010,5000,267500,8,9,2014,0,63,4190,3990,0,0,1
4,1.5,2890,9000,2.0,0,4,3,8,2090,800,1939,0,98118,47.5682,-122.274,2550,8400,910000,8,10,2014,0,75,6110,5850,0,1,1
3,1.75,1290,10117,1.0,0,0,3,7,1290,0,1984,0,98072,47.7598,-122.146,1770,11839,370000,3,3,2015,0,31,8827,10069,0,0,0
2,1.0,1140,3834,1.5,0,0,3,6,1140,0,1911,0,98126,47.5642,-122.378,1190,5750,320000,6,12,2014,0,103,2694,4560,0,0,1
3,1.75,1750,5200,1.0,0,1,4,8,1750,0,1956,0,98117,47.6995,-122.383,2060,5200,660000,1,10,2014,0,58,3450,3140,0,0,1
4,2.5,2650,5880,2.0,0,0,3,9,2650,0,2005,0,98042,47.3509,-122.165,2610,6490,329000,18,12,2014,0,9,3230,3880,0,0,0
2,1.0,1470,6398,1.0,0,0,4,7,970,500,1941,0,98105,47.6716,-122.279,1950,6398,602000,3,12,2014,0,73,4928,4448,0,1,1
3,2.0,1640,9750,1.0,0,0,3,7,1640,0,1959,0,98028,47.7425,-122.241,1340,9750,375000,6,11,2014,0,55,8110,8410,0,0,0
1,1.0,620,7620,1.0,0,0,3,6,620,0,1926,0,98166,47.4697,-122.349,1160,7620,212000,5,5,2015,0,89,7000,6460,0,0,1
3,1.5,1440,8370,1.0,0,0,3,7,1440,0,1977,0,98118,47.5418,-122.275,1440,8370,224000,22,8,2014,0,37,6930,6930,0,0,1
3,2.0,1160,10079,1.0,0,0,3,7,1160,0,1986,0,98019,47.7341,-121.976,1130,10087,315500,10,3,2015,0,29,8919,8957,0,0,0
2,1.0,1070,2880,1.0,0,0,3,7,1070,0,1902,0,98102,47.6261,-122.324,2030,2880,350000,28,1,2015,0,113,1810,850,0,0,1
6,4.5,3560,14010,2.0,0,0,3,7,3560,0,1989,0,98002,47.3244,-122.217,1710,11116,389000,6,5,2015,0,26,10450,9406,0,0,0
3,1.75,1720,13104,1.0,0,0,4,7,1720,0,1962,0,98168,47.4709,-122.26,1840,13104,285000,13,7,2014,0,52,11384,11264,0,0,1
3,1.75,1530,9800,1.0,0,0,5,8,1530,0,1958,0,98133,47.7655,-122.336,1660,9800,425000,1,12,2014,0,56,8270,8140,0,0,1
3,1.75,1270,7875,1.0,0,0,4,7,1270,0,1980,0,98030,47.3696,-122.17,1830,7210,190000,9,3,2015,0,35,6605,5380,0,0,0
2,1.0,880,5500,1.0,0,0,3,6,880,0,1904,0,98118,47.5573,-122.289,1080,5500,292000,7,8,2014,0,110,4620,4420,0,0,1
5,1.75,2020,5100,1.5,0,0,5,7,1320,700,1911,0,98103,47.6915,-122.345,1130,5100,475000,11,5,2015,0,104,3080,3970,0,1,1
3,2.5,1410,2675,1.0,0,0,3,7,820,590,1985,0,98117,47.6786,-122.371,1410,4013,546500,30,3,2015,0,30,1265,2603,0,1,1
3,1.0,860,10426,1.0,0,0,3,6,860,0,1954,0,98146,47.4987,-122.341,1140,11250,82000,5,11,2014,0,60,9566,10110,0,0,1
3,1.0,860,10426,1.0,0,0,3,6,860,0,1954,0,98146,47.4987,-122.341,1140,11250,219900,8,4,2015,0,61,9566,10110,0,0,1
3,1.0,1210,5750,1.5,0,0,4,7,1210,0,1910,0,98136,47.5403,-122.391,1160,5000,440000,12,6,2014,0,104,4540,3840,0,0,1
6,3.25,2120,6893,1.0,0,0,4,7,1060,1060,1983,0,98106,47.5508,-122.355,1380,6986,330000,12,8,2014,0,31,4773,5606,0,1,1
3,2.75,2540,8604,2.0,0,0,3,8,2540,0,1991,0,98092,47.3209,-122.185,2260,7438,359950,21,7,2014,0,23,6064,5178,0,0,0
4,2.5,2490,12929,2.0,0,0,3,9,2490,0,1983,0,98074,47.6161,-122.021,2440,12929,616000,17,6,2014,0,31,10439,10489,0,0,0
2,1.0,670,2356,1.0,0,0,5,6,670,0,1960,0,98144,47.5918,-122.295,1220,1740,245000,7,11,2014,0,54,1686,520,0,0,1
2,2.0,1320,2040,3.0,0,0,3,7,1320,0,1997,0,98125,47.7224,-122.291,1430,2040,296000,3,11,2014,0,17,720,610,0,0,1
2,1.0,950,9000,1.0,0,0,3,6,950,0,1924,0,98106,47.5219,-122.361,1000,8280,193000,6,11,2014,0,90,8050,7280,0,0,1
3,2.0,1870,8442,1.5,0,0,5,7,1060,810,1927,0,98117,47.6964,-122.365,1640,6174,456000,28,8,2014,0,87,6572,4534,0,1,1
4,1.75,1840,9250,1.0,0,0,4,7,980,860,1956,0,98133,47.708,-122.337,1520,9250,480000,27,4,2015,0,59,7410,7730,0,1,1
3,3.25,1410,1253,3.0,0,0,3,8,1410,0,2005,0,98103,47.6981,-122.34,1410,1253,382000,9,5,2014,0,9,-157,-157,0,0,1
2,1.0,1050,2542,1.0,0,0,3,7,880,170,1904,0,98122,47.6172,-122.298,1620,1809,650000,28,6,2014,0,110,1492,189,0,1,1
2,2.0,1400,10052,1.0,0,0,3,8,1400,0,1957,0,98125,47.7262,-122.316,1400,8785,431750,25,11,2014,0,57,8652,7385,0,0,1
3,2.5,1630,1755,2.0,0,0,3,8,1320,310,1997,0,98033,47.691,-122.176,1920,14550,419900,11,5,2015,0,18,125,12630,0,1,0
3,2.0,1900,9513,1.0,0,0,3,8,1900,0,1995,0,98023,47.2843,-122.357,1790,8028,315000,29,12,2014,0,19,7613,6238,0,0,0
3,2.5,1980,11900,2.0,0,0,3,8,1980,0,1990,0,98092,47.2656,-122.217,2130,9933,220000,1,4,2015,0,25,9920,7803,0,0,0
4,2.5,3020,8750,1.0,0,0,3,8,1710,1310,1960,0,98188,47.4298,-122.29,1900,8750,340000,13,4,2015,0,55,5730,6850,0,1,1
5,1.75,3290,11900,1.5,0,0,3,8,3290,0,1973,0,98052,47.6626,-122.141,2210,8549,602000,19,5,2014,0,41,8610,6339,0,0,0
3,1.75,1580,11750,1.0,0,0,4,7,1180,400,1951,0,98118,47.5368,-122.265,2150,11750,575000,13,5,2014,0,63,10170,9600,0,1,1
3,2.5,2090,10834,1.0,0,0,4,8,1360,730,1987,0,98003,47.3537,-122.303,1750,8595,285000,2,5,2014,0,27,8744,6845,0,1,0
3,1.5,1100,8140,1.0,0,0,4,7,1100,0,1965,0,98059,47.5004,-122.162,1430,7700,306500,20,2,2015,0,50,7040,6270,0,0,0
3,2.5,1870,3480,2.0,0,0,3,7,1870,0,2002,0,98056,47.4831,-122.183,2160,3480,325000,2,1,2015,0,13,1610,1320,0,0,0
3,2.0,1320,8568,1.0,0,0,3,7,1320,0,1993,0,98042,47.3904,-122.164,1600,8463,256500,11,3,2015,0,22,7248,6863,0,0,0
5,3.5,3430,6872,2.0,0,0,3,10,2830,600,2002,0,98031,47.4065,-122.207,3650,6600,473000,17,11,2014,0,12,3442,2950,0,1,0
3,2.5,2250,9235,2.0,0,0,3,8,2250,0,1985,0,98052,47.7268,-122.105,2290,8187,549000,29,10,2014,0,29,6985,5897,0,0,0
3,1.0,1710,19115,1.0,0,0,3,6,1710,0,1986,0,98014,47.656,-121.913,1650,15144,305000,17,3,2015,0,29,17405,13494,0,0,0
4,2.5,2160,8049,2.0,0,0,3,9,2160,0,1988,0,98001,47.3337,-122.26,2490,8995,317000,4,2,2015,0,27,5889,6505,0,0,0
3,1.75,1400,13775,1.0,0,0,3,8,1400,0,1963,0,98028,47.7413,-122.259,2200,10450,450000,1,7,2014,0,51,12375,8250,0,0,0
2,2.5,1560,5333,1.0,0,0,3,5,780,780,1947,0,98055,47.4749,-122.213,1010,4800,225000,9,4,2015,0,68,3773,3790,0,1,0
5,2.0,2300,7897,2.5,0,0,4,8,2300,0,1956,0,98133,47.7556,-122.356,2030,7902,500000,12,2,2015,0,59,5597,5872,0,0,1
2,1.0,820,4860,1.0,0,0,5,6,820,0,1955,0,98118,47.5298,-122.271,1240,6000,207000,12,8,2014,0,59,4040,4760,0,0,1
3,1.0,1630,8308,1.5,0,0,3,7,1630,0,1948,0,98146,47.5075,-122.378,1170,8308,474900,18,8,2014,0,66,6678,7138,0,0,1
3,2.5,2010,7200,2.0,0,0,3,8,2010,0,1994,0,98028,47.7372,-122.223,1970,7202,515000,1,7,2014,0,20,5190,5232,0,0,0
4,1.0,1540,5000,1.5,0,0,4,7,1090,450,1922,0,98115,47.6754,-122.294,1590,5000,542000,12,2,2015,0,93,3460,3410,0,1,1
4,2.75,2420,10962,1.0,0,0,3,8,1530,890,1977,0,98007,47.6218,-122.152,2620,13200,725000,5,6,2014,0,37,8542,10580,0,1,0
3,2.5,1690,4533,2.0,0,0,3,7,1690,0,2003,0,98038,47.3575,-122.016,1830,5175,314950,9,3,2015,0,12,2843,3345,0,0,0
3,2.0,1410,10078,1.0,0,0,4,6,1410,0,1983,0,98072,47.7587,-122.144,2090,9202,375000,6,11,2014,0,31,8668,7112,0,0,0
3,1.75,2200,9840,1.0,0,0,5,8,1500,700,1978,0,98006,47.559,-122.136,2410,9623,689000,24,6,2014,0,36,7640,7213,0,1,0
3,2.25,1290,1182,2.0,0,0,3,8,1000,290,2006,0,98102,47.637,-122.327,1300,1169,525000,9,12,2014,0,8,-108,-131,0,1,1
3,1.5,1060,6232,1.0,0,0,4,7,1060,0,1968,0,98118,47.5329,-122.271,1120,5379,360000,4,5,2015,0,47,5172,4259,0,0,1
3,1.0,1240,5750,1.0,0,0,4,6,1240,0,1948,0,98116,47.564,-122.398,1240,5750,425000,20,8,2014,0,66,4510,4510,0,0,1
2,1.0,1280,5500,1.0,0,0,3,7,1280,0,1949,0,98118,47.5179,-122.264,1270,5500,239950,4,3,2015,0,66,4220,4230,0,0,1
2,2.5,2330,3000,2.0,0,3,3,8,2330,0,1915,1994,98144,47.5953,-122.294,1760,4000,577500,2,4,2015,79,100,670,2240,1,0,1
3,1.75,2360,7291,1.0,0,0,4,8,1360,1000,1948,0,98136,47.5274,-122.384,1860,5499,615000,2,5,2014,0,66,4931,3639,0,1,1
4,2.75,2210,10800,1.0,0,0,4,8,1170,1040,1997,0,98074,47.6086,-122.059,2210,10800,516000,27,8,2014,0,17,8590,8590,0,1,0
4,2.75,3670,15400,2.0,0,3,4,10,3670,0,1986,0,98006,47.5581,-122.156,3370,13300,1220000,13,8,2014,0,28,11730,9930,0,0,0
4,3.5,3080,4815,2.0,0,3,3,10,2300,780,1937,2009,98199,47.6417,-122.411,2910,5350,1660000,27,5,2014,72,77,1735,2440,1,1,1
2,1.0,770,6731,1.0,0,0,4,6,770,0,1943,0,98155,47.7505,-122.312,1120,9212,315000,1,5,2015,0,72,5961,8092,0,0,1
4,2.0,2600,9000,1.0,0,0,3,8,1410,1190,1959,0,98032,47.381,-122.299,2600,7200,250000,21,10,2014,0,55,6400,4600,0,1,0
4,1.5,1220,4900,1.0,0,0,3,6,1220,0,1942,0,98118,47.5292,-122.269,1410,3000,250000,13,11,2014,0,72,3680,1590,0,0,1
3,1.0,1150,4681,1.0,0,0,3,7,1150,0,1955,0,98133,47.7284,-122.336,1150,6800,358000,25,8,2014,0,59,3531,5650,0,0,1
3,2.5,1700,6200,2.0,0,0,3,8,1700,0,1997,0,98092,47.2621,-122.221,1720,6205,262000,26,9,2014,0,17,4500,4485,0,0,0
3,1.75,1220,7370,1.0,0,0,4,7,1220,0,1964,0,98008,47.6334,-122.12,1580,8213,500000,15,10,2014,0,50,6150,6633,0,0,0
5,1.0,1670,6400,1.5,0,0,3,8,1670,0,1919,0,98119,47.6542,-122.373,1910,2983,1300000,15,7,2014,0,95,4730,1073,0,0,1
3,2.25,2610,9002,2.0,0,0,3,9,2610,0,1988,0,98052,47.6909,-122.104,2320,8306,675000,2,6,2014,0,26,6392,5986,0,0,0
3,1.0,960,5030,1.0,0,0,3,7,960,0,1955,0,98118,47.5611,-122.28,1460,5400,235000,26,9,2014,0,59,4070,3940,0,0,1
3,1.0,960,5030,1.0,0,0,3,7,960,0,1955,0,98118,47.5611,-122.28,1460,5400,545000,18,3,2015,0,60,4070,3940,0,0,1
3,1.0,1010,9360,1.0,0,0,3,6,1010,0,1981,0,98033,47.6874,-122.168,1470,9360,350000,7,5,2014,0,33,8350,7890,0,0,0
2,2.25,1550,1827,2.0,0,0,3,8,1550,0,2008,0,98106,47.5394,-122.368,1420,1826,320000,25,11,2014,0,6,277,406,0,0,1
5,2.5,5067,13315,1.0,0,2,3,9,3154,1913,1968,0,98003,47.3391,-122.325,2860,13957,452000,18,3,2015,0,47,8248,11097,0,1,0
3,2.0,2350,6000,1.5,0,0,4,8,1990,360,1922,0,98102,47.6476,-122.32,2010,5040,875000,25,7,2014,0,92,3650,3030,0,1,1
3,1.5,1310,2998,2.0,0,0,3,7,1310,0,1998,0,98144,47.5873,-122.299,1310,2997,325000,8,11,2014,0,16,1688,1687,0,0,1
4,2.25,2160,5600,1.0,0,0,5,7,1080,1080,1947,0,98119,47.6442,-122.372,1850,5150,756000,19,6,2014,0,67,3440,3300,0,1,1
4,2.5,2510,7992,1.0,0,0,3,8,1610,900,1978,0,98032,47.3715,-122.285,2030,7992,319000,24,6,2014,0,36,5482,5962,0,1,0
3,1.75,890,3800,1.5,0,0,3,7,750,140,1926,0,98115,47.6803,-122.291,1280,3800,455000,21,1,2015,0,89,2910,2520,0,1,1
2,1.0,1129,3840,1.0,0,0,3,7,1129,0,1953,0,98106,47.5313,-122.351,1300,3880,330000,9,4,2015,0,62,2711,2580,0,0,1
4,3.25,1980,9988,1.0,0,0,3,8,1340,640,1980,0,98052,47.6883,-122.111,1980,8972,510000,8,1,2015,0,35,8008,6992,0,1,0
3,1.0,2360,5012,1.0,0,0,3,7,1560,800,1964,0,98116,47.5705,-122.384,1690,4800,532000,16,4,2015,0,51,2652,3110,0,1,1
3,2.5,2480,5007,2.0,0,0,3,8,1960,520,2014,0,98117,47.6974,-122.369,1650,7806,775000,20,1,2015,0,1,2527,6156,0,1,1
3,1.75,2160,4000,1.0,0,0,3,7,1080,1080,1953,0,98144,47.5721,-122.309,1260,3200,410000,17,4,2015,0,62,1840,1940,0,1,1
2,1.75,1740,5100,1.0,0,0,3,6,580,1160,1915,0,98108,47.5211,-122.33,1440,5100,205000,18,3,2015,0,100,3360,3660,0,1,1
4,2.5,2430,6766,2.0,0,0,3,8,2430,0,1999,0,98177,47.7294,-122.358,1820,6772,585000,12,12,2014,0,15,4336,4952,0,0,1
2,1.75,1950,8200,1.0,0,0,3,8,1950,0,1975,0,98023,47.3161,-122.382,2370,8000,255000,10,3,2015,0,40,6250,5630,0,0,0
2,1.0,910,3750,1.0,0,0,3,7,910,0,1904,0,98117,47.6772,-122.369,1160,4000,415000,11,9,2014,0,110,2840,2840,0,0,1
4,2.0,2360,7080,1.0,0,0,5,6,1180,1180,1925,0,98126,47.5261,-122.376,1340,7200,459000,2,4,2015,0,90,4720,5860,0,1,1
3,1.0,1130,11250,1.0,0,0,3,7,1130,0,1965,0,98034,47.7254,-122.227,1410,11250,354000,11,12,2014,0,49,10120,9840,0,0,0
3,2.5,2150,5193,2.0,0,0,3,8,2150,0,1995,0,98033,47.6952,-122.187,2150,7172,587000,15,7,2014,0,19,3043,5022,0,0,0
3,1.5,1300,7287,1.0,0,0,4,7,1300,0,1965,0,98033,47.6889,-122.187,1300,9129,570000,4,5,2015,0,50,5987,7829,0,0,0
3,1.0,1050,6002,1.0,0,0,3,7,840,210,1941,0,98115,47.6988,-122.316,1180,6003,414500,5,2,2015,0,74,4952,4823,0,1,1
4,1.0,1380,6700,1.0,0,0,3,7,1190,190,1928,0,98168,47.4871,-122.281,1380,8292,185000,6,8,2014,0,86,5320,6912,0,1,1
3,1.5,1610,10291,1.0,0,0,4,7,1610,0,1961,0,98022,47.2025,-121.999,1410,7729,262500,1,10,2014,0,53,8681,6319,0,0,0
3,1.0,1520,9507,1.0,0,0,3,7,1520,0,1954,0,98125,47.7162,-122.324,1360,7219,362500,5,1,2015,0,61,7987,5859,0,0,1
3,2.5,1990,7397,2.0,0,0,3,9,1990,0,1993,0,98072,47.7703,-122.165,2210,7397,536000,4,3,2015,0,22,5407,5187,0,0,0
5,2.0,2500,7804,1.5,0,0,3,7,1570,930,1921,0,98146,47.5031,-122.348,1170,7676,425000,21,4,2015,0,94,5304,6506,0,1,1
3,2.25,1890,7200,1.0,0,0,4,7,1230,660,1973,0,98125,47.7156,-122.317,1970,8101,435000,9,6,2014,0,41,5310,6131,0,1,1
5,2.0,1840,9240,1.0,0,0,4,7,1540,300,1942,1958,98133,47.7308,-122.34,1200,5250,435000,5,5,2014,16,72,7400,4050,1,1,1
2,1.0,1220,6300,1.0,0,0,3,7,760,460,1942,0,98136,47.5299,-122.387,1850,4886,400000,12,3,2015,0,73,5080,3036,0,1,1
2,1.5,1370,1221,2.0,0,0,3,8,1080,290,2008,0,98122,47.6039,-122.307,1560,2081,446000,26,6,2014,0,6,-149,521,0,1,1
3,2.5,2710,13120,1.0,0,0,3,10,2710,0,1959,0,98105,47.6718,-122.256,3130,13566,1250000,26,1,2015,0,56,10410,10436,0,0,1
3,2.25,1760,5421,2.0,0,0,3,7,1760,0,1991,0,98038,47.3484,-122.037,1570,6000,300000,20,11,2014,0,23,3661,4430,0,0,0
2,1.0,800,5080,1.0,0,0,3,7,800,0,1938,0,98115,47.6978,-122.314,1560,5110,404500,6,8,2014,0,76,4280,3550,0,0,1
3,2.25,1780,6120,1.5,0,0,4,9,1390,390,1927,0,98122,47.6025,-122.286,1960,5568,771000,13,5,2014,0,87,4340,3608,0,1,1
4,2.5,2610,4781,2.0,0,0,3,8,2610,0,2009,0,98001,47.2649,-122.292,2583,4796,335000,5,6,2014,0,5,2171,2213,0,0,0
3,1.75,1850,15170,1.0,0,0,3,7,1850,0,1965,0,98045,47.4991,-121.774,1160,14175,390000,4,8,2014,0,49,13320,13015,0,0,0
3,2.25,1560,9706,1.0,0,0,4,7,1560,0,1963,0,98002,47.3191,-122.213,1510,9706,288000,28,4,2015,0,52,8146,8196,0,0,0
3,1.75,1270,10790,1.0,0,0,3,7,1270,0,1956,0,98033,47.6647,-122.177,1270,10790,403000,14,10,2014,0,58,9520,9520,0,0,0
3,2.25,1420,1309,3.0,0,0,3,8,1420,0,2006,0,98103,47.6534,-122.346,1500,1282,510000,24,6,2014,0,8,-111,-218,0,0,1
6,3.0,2880,6800,2.0,0,0,3,7,2880,0,1980,0,98144,47.5873,-122.299,1640,4000,751000,19,2,2015,0,35,3920,2360,0,0,1
3,1.0,1420,8000,1.0,0,4,3,7,1420,0,1950,0,98118,47.5169,-122.255,1780,8295,408000,3,2,2015,0,65,6580,6515,0,0,1
3,1.0,1640,12855,1.5,0,0,5,6,1500,140,1920,0,98004,47.6169,-122.212,2190,11262,1010000,1,7,2014,0,94,11215,9072,0,1,0
3,2.0,1730,9030,1.0,0,0,4,7,1730,0,1956,0,98007,47.5875,-122.134,1470,9030,575000,24,4,2015,0,59,7300,7560,0,0,0
3,1.75,1250,8100,1.0,0,0,3,7,1250,0,1951,2004,98146,47.5016,-122.348,1300,8175,330000,17,4,2015,53,64,6850,6875,1,0,1
3,2.25,1520,1221,3.0,0,0,3,8,1520,0,2013,0,98107,47.674,-122.377,1550,4750,565000,16,5,2014,0,1,-299,3200,0,0,1
3,2.5,1820,2935,2.0,0,0,3,8,1820,0,1999,0,98074,47.6018,-122.021,1820,2936,456000,13,4,2015,0,16,1115,1116,0,0,0
4,2.5,2700,9122,2.0,0,0,3,9,2700,0,1990,0,98029,47.5771,-121.994,2500,9122,652500,15,6,2014,0,24,6422,6622,0,0,0
3,1.75,1820,3140,2.0,0,0,5,8,1820,0,1949,1990,98136,47.5271,-122.384,2030,5499,582000,31,12,2014,41,65,1320,3469,1,0,1
4,2.5,2770,5686,2.0,0,0,3,9,2770,0,2004,0,98075,47.5997,-121.973,2910,5000,700000,25,6,2014,0,10,2916,2090,0,0,0
2,1.0,1270,9182,1.5,0,0,3,6,1270,0,1917,0,98126,47.5365,-122.378,1760,9100,235000,15,10,2014,0,97,7912,7340,0,0,1
3,2.25,1820,8008,1.0,0,0,3,8,1240,580,1981,0,98052,47.7206,-122.11,2030,8750,475000,22,5,2014,0,33,6188,6720,0,1,0
2,2.0,1870,6275,1.0,0,0,3,8,1870,0,2003,0,98053,47.7108,-122.031,1670,5200,579000,9,6,2014,0,11,4405,3530,0,0,0
4,2.0,1360,2746,1.5,0,0,3,7,1360,0,1945,2011,98107,47.6736,-122.39,1960,2746,507000,10,11,2014,66,69,1386,786,1,0,1
3,2.5,1040,2643,2.0,0,0,3,7,720,320,2004,0,98118,47.5165,-122.268,1540,5110,210000,12,5,2014,0,10,1603,3570,0,1,1
4,2.75,2140,10316,2.0,0,0,3,8,2140,0,1993,0,98001,47.3537,-122.274,1920,11337,359500,30,6,2014,0,21,8176,9417,0,0,0
3,1.75,1330,9831,1.0,0,0,3,7,1330,0,1987,0,98001,47.3304,-122.277,1330,7500,248000,7,11,2014,0,27,8501,6170,0,0,0
3,1.0,1070,5750,1.0,0,0,3,7,1070,0,1952,0,98178,47.5071,-122.255,1420,6500,239300,22,10,2014,0,62,4680,5080,0,0,1
3,2.25,1370,1533,3.0,0,0,3,8,1370,0,2009,0,98133,47.7326,-122.343,1370,1125,315000,16,12,2014,0,5,163,-245,0,0,1
4,3.0,3510,12410,2.0,0,0,4,9,3510,0,1976,0,98005,47.6381,-122.166,3000,13209,970000,26,2,2015,0,39,8900,10209,0,0,0
3,1.5,1730,6240,1.0,0,1,3,8,1000,730,1954,0,98136,47.5282,-122.391,1620,6240,510000,17,3,2015,0,61,4510,4620,0,1,1
4,1.5,1550,9176,1.0,0,0,3,7,1000,550,1956,0,98008,47.6005,-122.129,1730,8539,418000,21,6,2014,0,58,7626,6809,0,1,0
4,2.5,2150,8536,1.0,0,3,4,8,1400,750,1967,0,98006,47.5663,-122.163,2800,9500,871000,21,3,2015,0,48,6386,6700,0,1,0
3,1.75,1410,5100,1.0,0,0,4,7,1110,300,1954,0,98125,47.7026,-122.29,1600,7800,445000,9,12,2014,0,60,3690,6200,0,1,1
4,2.75,3090,6600,1.0,0,2,3,9,1800,1290,1956,0,98199,47.6339,-122.396,2380,5000,1110000,25,2,2015,0,59,3510,2620,0,1,1
3,1.5,1690,9600,1.0,0,0,3,7,1210,480,1976,0,98038,47.3857,-122.079,1450,9647,212000,27,10,2014,0,38,7910,8197,0,1,0
4,2.5,2870,11304,2.0,0,0,3,9,2870,0,1980,0,98006,47.5547,-122.154,2690,9940,710000,12,1,2015,0,35,8434,7250,0,0,0
4,1.0,1100,7110,1.0,0,0,4,7,880,220,1907,0,98030,47.3858,-122.227,1150,7110,225800,31,3,2015,0,108,6010,5960,0,1,0
4,2.0,2080,13510,1.0,0,0,3,7,1040,1040,1950,0,98178,47.4918,-122.258,2010,11625,248000,19,6,2014,0,64,11430,9615,0,1,1
4,2.5,2230,7200,1.0,0,0,4,7,1220,1010,1957,0,98005,47.589,-122.156,1920,7200,556000,16,10,2014,0,57,4970,5280,0,1,0
5,1.75,1710,11900,1.0,0,0,3,7,1070,640,1958,0,98146,47.506,-122.365,1030,10360,319950,12,5,2015,0,57,10190,9330,0,1,1
4,2.75,1640,3000,1.0,0,0,3,7,1000,640,1984,0,98118,47.5625,-122.283,1150,4545,320000,31,3,2015,0,31,1360,3395,0,1,1
3,2.5,1600,2788,2.0,0,0,4,7,1600,0,1992,0,98031,47.4034,-122.187,1720,3605,245000,8,7,2014,0,22,1188,1885,0,0,0
5,2.75,2600,8160,2.0,0,0,3,8,2600,0,2015,0,98133,47.7348,-122.34,1600,8160,628000,12,3,2015,0,0,5560,6560,0,0,1
3,2.0,1380,4800,1.0,0,0,3,7,1380,0,1948,0,98199,47.651,-122.369,1740,5640,640000,17,6,2014,0,66,3420,3900,0,0,1
4,1.75,1320,4978,1.0,0,0,4,7,940,380,1942,0,98126,47.5266,-122.379,1260,4693,420000,28,4,2015,0,73,3658,3433,0,1,1
3,2.5,1420,1162,3.0,0,0,3,8,1420,0,2002,0,98103,47.6982,-122.349,1430,1560,349950,8,10,2014,0,12,-258,130,0,0,1
4,2.75,2420,8438,2.0,0,0,3,8,2420,0,1996,0,98022,47.2091,-122.009,2420,8580,307999,14,7,2014,0,18,6018,6160,0,0,0
4,2.75,2600,6050,2.0,0,0,5,8,1960,640,1949,0,98116,47.5656,-122.4,1990,6050,749950,7,5,2014,0,65,3450,4060,0,1,1
2,1.0,840,3844,1.0,0,0,4,6,840,0,1919,0,98133,47.7048,-122.347,1040,3844,290000,11,7,2014,0,95,3004,2804,0,0,1
3,1.75,1420,7920,1.0,0,0,4,7,1420,0,1962,0,98092,47.2931,-122.188,1420,7920,235000,12,7,2014,0,52,6500,6500,0,0,0
3,1.0,1790,6120,1.0,0,0,3,6,1790,0,1937,1964,98146,47.508,-122.337,830,6120,225000,3,9,2014,27,77,4330,5290,1,0,1
3,1.0,1790,6120,1.0,0,0,3,6,1790,0,1937,1964,98146,47.508,-122.337,830,6120,302100,24,4,2015,27,78,4330,5290,1,0,1
2,1.0,1340,6380,1.0,0,0,3,7,890,450,1939,0,98115,47.697,-122.313,1380,6380,520000,12,2,2015,0,76,5040,5000,0,1,1
2,1.0,1010,7200,1.0,0,0,3,7,1010,0,1975,0,98155,47.7651,-122.291,1890,9248,285000,26,6,2014,0,39,6190,7358,0,0,1
5,2.75,2980,8500,1.0,0,0,3,8,1540,1440,1982,0,98032,47.3641,-122.278,2310,8500,374900,19,3,2015,0,33,5520,6190,0,1,0
3,2.0,1370,7200,1.0,0,0,3,7,1130,240,1926,1955,98125,47.7329,-122.308,1300,7208,377500,6,10,2014,29,88,5830,5908,1,1,1
3,2.25,2190,8775,1.5,0,1,4,8,2190,0,1927,0,98125,47.7303,-122.287,1910,8145,587450,27,4,2015,0,88,6585,6235,0,0,1
3,2.25,1530,12000,1.0,0,0,3,7,1070,460,1979,0,98023,47.2715,-122.338,2140,13636,245000,21,1,2015,0,36,10470,11496,0,1,0
3,2.0,1290,5757,1.0,0,0,3,7,1290,0,1994,0,98092,47.3175,-122.17,1580,6798,200000,29,7,2014,0,20,4467,5218,0,0,0
3,2.5,2470,9226,2.0,0,0,3,9,2470,0,1991,0,98072,47.7439,-122.17,2820,11013,607000,9,11,2014,0,23,6756,8193,0,0,0
1,1.25,1810,5070,1.5,1,4,4,8,1230,580,1967,0,98075,47.5814,-122.081,2280,5070,1250000,14,4,2015,0,48,3260,2790,0,1,0
4,2.5,2230,14694,1.0,0,0,4,7,1180,1050,1981,0,98074,47.6305,-122.034,1470,13458,549950,10,3,2015,0,34,12464,11988,0,1,0
3,3.0,2300,7701,1.0,0,0,3,7,2300,0,1960,0,98056,47.5102,-122.18,1570,8116,250000,18,11,2014,0,54,5401,6546,0,0,0
3,2.5,2030,6970,2.0,0,0,4,8,2030,0,1991,0,98029,47.5718,-121.999,2000,6140,525000,9,5,2014,0,23,4940,4140,0,0,0
3,1.75,2000,9900,1.0,0,2,4,8,1480,520,1957,0,98166,47.4436,-122.339,2310,10200,440000,24,6,2014,0,57,7900,7890,0,1,1
5,2.5,3290,5029,2.0,0,0,3,8,3290,0,2004,0,98075,47.5773,-122.056,2990,6441,739900,1,7,2014,0,10,1739,3451,0,0,0
3,2.0,1300,3731,1.0,0,0,3,7,900,400,1993,0,98118,47.5374,-122.27,1300,3731,315000,28,5,2014,0,21,2431,2431,0,1,1
5,1.0,1880,3774,1.5,0,0,3,6,1360,520,1917,0,98126,47.566,-122.37,1420,2550,340000,3,3,2015,0,98,1894,1130,0,1,1
4,2.75,2170,9743,2.0,0,0,3,7,2170,0,1995,0,98038,47.3814,-122.024,1670,7734,366000,1,5,2015,0,20,7573,6064,0,0,0
3,1.75,1680,7250,1.0,0,0,3,7,930,750,1952,0,98133,47.7201,-122.35,1340,7250,315000,21,10,2014,0,62,5570,5910,0,1,1
3,1.5,1190,9135,1.0,0,0,4,7,1190,0,1959,0,98056,47.5164,-122.189,1520,9146,299000,27,10,2014,0,55,7945,7626,0,0,0
2,1.0,940,5000,1.0,0,0,3,7,940,0,1950,0,98155,47.7518,-122.279,1800,7400,350000,13,11,2014,0,64,4060,5600,0,0,1
2,1.75,1010,1461,1.0,0,0,3,7,670,340,2003,0,98199,47.6515,-122.4,1500,2499,340000,5,11,2014,0,11,451,999,0,1,1
3,1.75,1290,8580,1.0,0,0,4,7,1290,0,1962,0,98033,47.6707,-122.174,1840,8580,460000,30,12,2014,0,52,7290,6740,0,0,0
3,1.5,1480,10588,1.0,0,0,3,7,1480,0,1957,0,98002,47.2872,-122.212,1370,10588,224000,31,7,2014,0,57,9108,9218,0,0,0
2,1.0,900,6400,1.0,0,0,2,6,900,0,1940,0,98118,47.5287,-122.281,1350,6405,140000,11,8,2014,0,74,5500,5055,0,0,1
4,2.0,1400,7632,1.5,0,0,5,6,1400,0,1930,0,98166,47.4625,-122.345,1400,7632,246000,13,10,2014,0,84,6232,6232,0,0,1
3,2.5,2040,14071,2.0,0,0,3,7,2040,0,1995,0,98019,47.7278,-121.963,1890,14040,330000,27,1,2015,0,20,12031,12150,0,0,0
3,1.0,1450,7200,1.0,0,0,3,7,1010,440,1969,0,98034,47.7311,-122.199,1500,6767,306000,9,7,2014,0,45,5750,5267,0,1,0
3,1.0,1210,7440,1.0,0,0,3,7,1210,0,1949,0,98155,47.7402,-122.323,1120,7440,324950,4,6,2014,0,65,6230,6320,0,0,1
3,1.0,1490,8995,1.0,0,0,4,7,1490,0,1954,0,98168,47.4901,-122.303,1490,9000,207000,8,5,2014,0,60,7505,7510,0,0,1
3,1.0,1240,5700,1.5,0,0,5,6,1240,0,1953,0,98056,47.4927,-122.169,1140,5700,238000,27,8,2014,0,61,4460,4560,0,0,0
3,2.0,2632,18743,2.0,0,3,3,10,2632,0,2000,0,98070,47.3743,-122.421,1970,14171,695000,1,4,2015,0,15,16111,12201,0,0,0
3,2.5,2150,15304,2.0,0,0,4,9,2150,0,1979,0,98006,47.5573,-122.136,2540,10507,649950,11,9,2014,0,35,13154,7967,0,0,0
3,2.75,1710,9448,1.0,0,0,3,7,1010,700,1947,0,98105,47.6693,-122.267,1960,8951,515000,14,4,2015,0,68,7738,6991,0,1,1
3,2.5,1530,5032,2.0,0,0,3,7,1530,0,1998,0,98103,47.6985,-122.349,1450,2136,452000,1,10,2014,0,16,3502,686,0,0,1
4,2.5,1630,3060,2.0,0,0,3,7,1630,0,2003,0,98146,47.5072,-122.336,1270,4590,236000,30,10,2014,0,11,1430,3320,0,0,1
4,3.5,4080,14450,2.0,0,2,3,12,3210,870,1998,0,98006,47.5519,-122.106,4080,12114,1290000,30,7,2014,0,16,10370,8034,0,1,0
3,1.75,1000,14061,1.0,0,0,4,7,1000,0,1967,0,98072,47.7417,-122.093,1260,12635,410988,2,4,2015,0,48,13061,11375,0,0,0
4,2.5,3180,13118,2.0,0,0,4,11,3180,0,1986,0,98040,47.5382,-122.23,3070,12861,1200000,21,10,2014,0,28,9938,9791,0,0,0
4,3.25,3020,13457,1.0,0,0,5,9,3020,0,1956,0,98133,47.7174,-122.336,2120,7553,808100,7,11,2014,0,58,10437,5433,0,0,1
3,1.75,1330,6301,1.0,0,0,3,7,1330,0,1998,0,98002,47.3411,-122.219,1330,6144,236000,9,6,2014,0,16,4971,4814,0,0,0
4,1.75,1720,8300,1.0,0,0,4,8,1720,0,1965,0,98055,47.4654,-122.194,1840,8300,330000,13,5,2015,0,50,6580,6460,0,0,0
4,3.5,2540,5808,2.0,0,0,5,8,1820,720,1910,1986,98117,47.6857,-122.376,1520,5461,799990,27,1,2015,76,105,3268,3941,1,1,1
3,2.5,1530,9406,1.0,0,0,3,7,1270,260,1993,0,98059,47.4852,-122.162,1700,7682,332000,17,6,2014,0,21,7876,5982,0,1,0
5,3.5,4380,14925,2.0,0,0,3,11,4380,0,2003,0,98075,47.5848,-121.969,4310,14633,945000,1,4,2015,0,12,10545,10323,0,0,0
3,1.0,1140,8366,1.0,0,0,5,6,1140,0,1943,0,98058,47.4768,-122.177,960,7200,239950,17,6,2014,0,71,7226,6240,0,0,0
5,1.75,2110,5000,1.5,0,0,4,7,1250,860,1946,0,98115,47.6745,-122.287,1720,5000,674000,3,3,2015,0,69,2890,3280,0,1,1
3,1.0,1050,5000,1.0,0,0,4,6,1050,0,1967,0,98056,47.4923,-122.165,1050,5200,200000,20,5,2014,0,47,3950,4150,0,0,0
3,1.75,1600,7232,1.0,0,0,3,8,1600,0,1966,0,98008,47.6293,-122.121,1970,8120,453000,5,3,2015,0,49,5632,6150,0,0,0
3,1.75,1430,8865,1.0,0,0,3,7,1430,0,1950,0,98125,47.7331,-122.299,1250,8154,330000,14,6,2014,0,64,7435,6904,0,0,1
4,2.5,1996,4547,2.0,0,0,3,7,1996,0,2009,0,98042,47.3365,-122.051,2180,5127,285000,16,4,2015,0,6,2551,2947,0,0,0
4,1.75,1530,8152,1.0,0,0,5,6,910,620,1948,0,98155,47.7557,-122.328,1310,8152,338000,6,11,2014,0,66,6622,6842,0,1,1
2,1.0,1000,6000,1.0,0,0,3,6,1000,0,1951,0,98126,47.5208,-122.372,1250,6000,264950,24,4,2015,0,64,5000,4750,0,0,1
4,2.0,2530,10800,1.0,0,0,5,8,1350,1180,1954,0,98040,47.5705,-122.225,2960,12150,880000,11,3,2015,0,61,8270,9190,0,1,0
3,1.5,970,5488,1.0,0,0,3,7,970,0,1976,0,98106,47.5366,-122.359,1040,5488,209500,6,4,2015,0,39,4518,4448,0,0,1
4,2.5,2400,9398,1.0,0,0,4,7,1310,1090,1958,0,98056,47.4952,-122.178,1330,8249,380000,25,4,2015,0,57,6998,6919,0,1,0
3,2.0,1830,12891,1.0,0,0,3,7,1830,0,1994,0,98031,47.3924,-122.192,2320,8709,336500,17,12,2014,0,20,11061,6389,0,0,0
3,2.25,2130,8466,1.0,0,0,3,7,1290,840,1983,0,98055,47.4537,-122.211,2250,9682,360000,14,7,2014,0,31,6336,7432,0,1,0
2,1.0,560,7560,1.0,0,0,3,6,560,0,1944,0,98126,47.5271,-122.375,990,7560,249900,24,11,2014,0,70,7000,6570,0,0,1
4,1.0,1210,6250,1.0,0,0,3,7,1210,0,1962,0,98168,47.5008,-122.333,1210,8291,175000,23,9,2014,0,52,5040,7081,0,0,1
3,2.5,2380,2500,3.0,0,3,3,9,2380,0,1988,0,98126,47.5734,-122.375,2270,5000,549950,13,11,2014,0,26,120,2730,0,0,1
3,1.75,1370,10866,1.0,0,0,4,6,1370,0,1945,0,98052,47.6774,-122.164,1580,14250,225000,21,10,2014,0,69,9496,12670,0,0,0
3,1.75,1370,10866,1.0,0,0,4,6,1370,0,1945,0,98052,47.6774,-122.164,1580,14250,270000,22,12,2014,0,69,9496,12670,0,0,0
3,2.25,1740,11040,2.0,0,0,3,8,1740,0,1980,0,98028,47.7376,-122.242,1720,11778,400000,19,8,2014,0,34,9300,10058,0,0,0
2,1.0,790,5240,1.0,0,0,4,6,790,0,1925,0,98118,47.5303,-122.288,1430,5320,299800,21,5,2014,0,89,4450,3890,0,0,1
3,2.5,2480,8676,2.0,0,0,4,8,2480,0,1989,0,98056,47.53,-122.172,2540,9496,555000,6,8,2014,0,25,6196,6956,0,0,0
3,2.5,1920,9180,2.0,0,0,3,8,1920,0,1988,0,98055,47.4818,-122.231,1930,7252,230000,7,5,2014,0,26,7260,5322,0,0,0
4,2.5,2750,6259,2.0,0,0,3,9,2750,0,2002,0,98092,47.3304,-122.179,2810,6824,360000,10,12,2014,0,12,3509,4014,0,0,0
2,1.0,880,3200,1.0,0,0,3,7,880,0,1910,1970,98199,47.6575,-122.402,1880,6000,415000,3,9,2014,60,104,2320,4120,1,0,1
4,1.75,2160,8000,1.0,0,0,4,9,1660,500,1976,0,98023,47.3165,-122.382,2350,8200,355000,18,8,2014,0,38,5840,5850,0,1,0
5,2.75,2130,5000,1.0,0,0,5,7,1100,1030,1978,0,98118,47.5271,-122.274,1340,6837,353000,2,12,2014,0,36,2870,5497,0,1,1
3,1.5,1780,10196,1.0,0,0,4,7,1270,510,1967,0,98001,47.3375,-122.291,1320,7875,265000,22,4,2015,0,48,8416,6555,0,1,0
4,1.75,1910,8250,1.0,0,0,4,7,1910,0,1959,0,98008,47.6131,-122.123,1500,8250,250000,26,3,2015,0,56,6340,6750,0,0,0
2,1.0,1170,7142,1.0,0,0,3,7,1170,0,1951,0,98155,47.7497,-122.313,1170,7615,225000,20,8,2014,0,63,5972,6445,0,0,1
2,1.0,900,5000,1.0,0,0,3,7,900,0,1944,0,98117,47.6883,-122.395,1280,5000,553000,3,5,2014,0,70,4100,3720,0,0,1
5,2.5,2650,11455,1.0,0,0,3,7,1400,1250,1961,0,98008,47.6141,-122.116,1960,9880,565000,4,6,2014,0,53,8805,7920,0,1,0
2,1.0,1170,5150,1.0,0,0,3,6,980,190,1907,0,98118,47.5503,-122.283,1660,5150,312000,18,8,2014,0,107,3980,3490,0,1,1
4,2.75,2150,9163,1.0,0,0,3,8,1340,810,1992,0,98003,47.266,-122.307,2260,7750,320000,6,11,2014,0,22,7013,5490,0,1,0
3,2.0,1430,9583,1.0,0,0,4,7,1430,0,1964,0,98034,47.7206,-122.197,1890,11100,453000,25,8,2014,0,50,8153,9210,0,0,0
3,1.0,960,6180,1.0,0,0,4,6,960,0,1910,0,98118,47.5518,-122.279,1250,4120,320000,25,3,2015,0,105,5220,2870,0,0,1
4,2.75,2640,8400,1.0,0,2,3,8,1440,1200,1947,0,98144,47.5882,-122.29,2610,6000,610000,22,1,2015,0,68,5760,3390,0,1,1
3,1.5,1490,9630,1.0,0,0,4,8,1490,0,1959,0,98028,47.7623,-122.256,1960,10469,385000,20,5,2014,0,55,8140,8509,0,0,0
3,1.75,1210,8075,1.0,0,0,4,6,1210,0,1983,0,98001,47.2666,-122.254,1310,8025,215000,28,5,2014,0,31,6865,6715,0,0,0
4,1.5,1860,5040,1.5,0,0,5,8,1860,0,1920,0,98022,47.2077,-121.993,1680,5800,215000,9,7,2014,0,94,3180,4120,0,0,0
3,2.5,1980,4274,2.0,0,0,3,7,1980,0,2003,0,98028,47.7767,-122.239,2000,4394,415000,30,12,2014,0,11,2294,2394,0,0,0
1,1.0,900,6380,1.0,0,0,3,6,900,0,1947,0,98125,47.7019,-122.311,1830,6380,350000,14,8,2014,0,67,5480,4550,0,0,1
1,1.0,900,6380,1.0,0,0,3,6,900,0,1947,0,98125,47.7019,-122.311,1830,6380,395000,28,4,2015,0,68,5480,4550,0,0,1
2,1.75,1490,9874,1.0,0,0,4,7,1490,0,1963,0,98004,47.6246,-122.199,2280,9869,898000,10,11,2014,0,51,8384,7589,0,0,0
3,2.5,2980,7338,2.0,0,0,3,8,2980,0,2006,0,98055,47.437,-122.207,3010,5267,480000,18,12,2014,0,8,4358,2257,0,0,0
3,2.5,2660,1973,3.0,0,3,3,9,1870,790,2007,0,98119,47.6264,-122.364,1640,1369,1240000,10,11,2014,0,7,-687,-271,0,1,1
4,3.0,2800,9127,2.0,0,0,3,9,2800,0,1999,0,98074,47.6123,-122.007,2780,8165,770000,8,5,2015,0,16,6327,5385,0,0,0
3,2.25,1590,8520,2.0,0,0,4,8,1590,0,1980,0,98004,47.6477,-122.216,2470,12005,1210000,13,3,2015,0,35,6930,9535,0,0,0
4,2.25,3240,11131,1.0,0,0,4,9,2080,1160,1953,0,98004,47.6182,-122.215,2300,12150,1590000,16,1,2015,0,62,7891,9850,0,1,0
3,2.0,1510,7884,1.0,0,0,3,6,1510,0,1942,2014,98166,47.4683,-122.348,1050,7620,332000,20,6,2014,72,72,6374,6570,1,0,1
3,1.75,1750,7200,1.0,0,0,3,7,1750,0,1966,0,98008,47.6289,-122.119,1810,7590,445000,6,11,2014,0,48,5450,5780,0,0,0
4,1.5,1650,2970,1.5,0,0,3,7,1650,0,1903,0,98102,47.6233,-122.319,1670,2970,752000,11,12,2014,0,111,1320,1300,0,0,1
9,7.5,4050,6504,2.0,0,0,3,7,4050,0,1996,0,98144,47.5923,-122.301,1448,3866,450000,11,8,2014,0,18,2454,2418,0,0,1
3,1.0,1320,5500,1.0,0,0,3,7,1320,0,1955,0,98116,47.5705,-122.398,1480,5250,420000,18,9,2014,0,59,4180,3770,0,0,1
4,2.5,2310,6320,2.0,0,0,3,8,2310,0,1997,0,98092,47.3287,-122.167,1850,6181,330000,17,3,2015,0,18,4010,4331,0,0,0
3,1.75,1440,9065,1.0,0,0,4,8,1440,0,1972,0,98133,47.7163,-122.333,1990,8812,409000,3,12,2014,0,42,7625,6822,0,0,1
5,1.75,2330,14322,1.0,0,0,4,7,1180,1150,1968,0,98059,47.4768,-122.155,1690,10010,350000,27,6,2014,0,46,11992,8320,0,1,0
3,1.0,1390,8333,1.0,0,0,3,7,1390,0,1982,0,98155,47.7652,-122.31,1320,7090,315000,16,9,2014,0,32,6943,5770,0,0,1
2,1.0,1150,15000,1.0,0,0,3,6,1060,90,1930,2013,98168,47.4935,-122.316,1350,15000,224000,6,10,2014,83,84,13850,13650,1,1,1
4,1.75,2120,9706,1.0,0,0,3,7,1370,750,1965,0,98168,47.4939,-122.297,1730,11337,293550,6,10,2014,0,49,7586,9607,0,1,1
4,2.75,2300,3175,1.5,0,0,3,6,1340,960,1966,0,98144,47.5732,-122.305,1260,3175,350000,3,10,2014,0,48,875,1915,0,1,1
4,2.5,3320,9380,2.0,0,3,3,10,3320,0,1988,0,98006,47.5655,-122.114,2870,11779,1110000,16,9,2014,0,26,6060,8909,0,0,0
4,2.5,2400,7092,2.0,0,0,3,7,2400,0,1997,0,98133,47.7522,-122.338,2350,8310,442500,19,3,2015,0,18,4692,5960,0,0,1
3,2.5,2100,9040,1.0,0,0,3,8,1700,400,1989,0,98056,47.5329,-122.173,2430,8809,506400,19,11,2014,0,25,6940,6379,0,1,0
3,2.25,1550,4411,2.0,0,0,3,7,1550,0,2001,0,98019,47.7373,-121.966,1620,4621,324000,22,12,2014,0,13,2861,3001,0,0,0
3,1.5,1570,6450,1.5,0,0,4,6,1570,0,1931,0,98022,47.2021,-121.996,1400,6450,169000,5,8,2014,0,83,4880,5050,0,0,0
3,2.0,1480,5000,1.0,0,0,4,7,750,730,1928,0,98117,47.6859,-122.37,1250,4000,595000,29,5,2014,0,86,3520,2750,0,1,1
3,2.5,2720,6014,2.0,0,0,3,7,2720,0,2002,0,98092,47.3344,-122.174,2760,6537,299900,21,5,2014,0,12,3294,3777,0,0,0
3,2.25,2270,8876,1.0,0,0,3,7,1380,890,1977,0,98058,47.4653,-122.176,2150,7455,332000,29,5,2014,0,37,6606,5305,0,1,0
4,1.75,2410,8400,1.0,0,0,3,7,1600,810,1978,0,98011,47.7341,-122.2,1850,8400,432000,20,10,2014,0,36,5990,6550,0,1,0
4,2.75,2730,9112,1.0,0,2,3,9,1740,990,1996,0,98198,47.4005,-122.312,3050,10454,510000,2,10,2014,0,18,6382,7404,0,1,1
3,2.5,1540,7739,2.0,0,0,4,7,1540,0,1986,0,98030,47.3511,-122.169,1720,7200,270000,1,5,2015,0,29,6199,5480,0,0,0
2,1.5,1480,3120,1.0,0,0,3,7,930,550,1914,2007,98105,47.6684,-122.323,1000,3780,509250,14,10,2014,93,100,1640,2780,1,1,1
3,1.0,860,5200,1.0,0,0,5,6,860,0,1969,0,98042,47.3677,-122.078,1010,5200,189000,19,2,2015,0,46,4340,4190,0,0,0
4,2.5,2180,3893,2.0,0,0,3,8,2180,0,1999,0,98117,47.6886,-122.388,1710,4550,726500,8,12,2014,0,15,1713,2840,0,0,1
3,2.0,1300,11374,1.5,0,0,5,7,1300,0,1933,0,98168,47.4839,-122.302,1480,9670,287000,19,6,2014,0,81,10074,8190,0,0,1
3,2.25,2130,8721,1.0,0,0,3,8,1570,560,1987,0,98031,47.4202,-122.204,2130,9477,316000,2,6,2014,0,27,6591,7347,0,1,0
4,1.75,2560,8270,1.0,0,0,3,7,1480,1080,1979,0,98072,47.7572,-122.147,2320,8450,448000,7,10,2014,0,35,5710,6130,0,1,0
2,1.0,1040,5527,1.0,0,0,3,7,1040,0,1951,0,98115,47.6774,-122.284,2080,7020,535000,27,5,2014,0,63,4487,4940,0,0,1
4,3.0,3080,9601,2.0,0,1,3,10,3080,0,1990,0,98003,47.334,-122.332,3200,9375,560000,16,1,2015,0,25,6521,6175,0,0,0
4,2.25,2670,14255,1.0,0,0,4,8,1610,1060,1975,0,98006,47.5623,-122.175,2470,10290,437850,2,10,2014,0,39,11585,7820,0,1,0
4,2.5,2610,8031,2.0,0,0,3,8,2610,0,1998,0,98155,47.7717,-122.27,2320,8031,510000,19,6,2014,0,16,5421,5711,0,0,1
2,1.5,1930,3521,2.0,0,0,3,8,1930,0,1989,0,98007,47.6092,-122.146,1840,3576,509000,3,7,2014,0,25,1591,1736,0,0,0
3,1.0,1220,5652,1.0,0,0,3,6,1220,0,1905,0,98116,47.5767,-122.408,1490,2467,575000,6,4,2015,0,110,4432,977,0,0,1
4,2.5,2030,7210,1.0,0,0,5,7,1330,700,1969,0,98059,47.5067,-122.16,1980,7560,365000,22,4,2015,0,46,5180,5580,0,1,0
3,2.5,1870,4060,2.0,0,0,3,7,1870,0,2005,0,98042,47.3986,-122.163,2190,4060,285000,11,6,2014,0,9,2190,1870,0,0,0
4,2.5,2880,8400,2.0,0,4,3,8,2050,830,1955,1987,98177,47.7704,-122.386,2880,7440,775000,14,7,2014,32,59,5520,4560,1,1,1
4,3.0,1810,5012,2.0,0,0,4,7,1810,0,1997,0,98108,47.5691,-122.292,1670,5161,400000,6,10,2014,0,17,3202,3491,0,0,1
4,2.5,2590,8483,2.0,0,0,3,9,2590,0,1991,0,98011,47.738,-122.221,2660,8717,570000,1,7,2014,0,23,5893,6057,0,0,0
5,3.25,3830,6507,2.0,0,0,3,9,3830,0,2014,0,98053,47.6843,-122.016,3950,6723,955990,20,10,2014,0,0,2677,2773,0,0,0
2,1.75,1220,8382,1.0,0,0,3,6,1220,0,1942,0,98146,47.5033,-122.359,1100,8382,245000,19,2,2015,0,73,7162,7282,0,0,1
3,1.5,1280,974,3.0,0,0,3,7,1280,0,2003,0,98125,47.7162,-122.293,1420,1422,281000,8,9,2014,0,11,-306,2,0,0,1
3,0.75,770,7000,1.0,0,0,3,4,770,0,1942,0,98024,47.5661,-121.887,950,10500,205000,22,10,2014,0,72,6230,9550,0,0,0
4,2.5,2080,11176,1.0,0,0,5,8,2080,0,1954,0,98125,47.7107,-122.289,1390,7928,635000,26,2,2015,0,61,9096,6538,0,0,1
1,1.0,570,6000,1.0,0,0,2,5,570,0,1918,0,98136,47.5517,-122.385,1530,6000,310000,3,9,2014,0,96,5430,4470,0,0,1
4,2.0,1500,3659,1.0,0,0,3,7,830,670,1906,0,98122,47.6088,-122.293,1560,3706,470000,14,1,2015,0,109,2159,2146,0,1,1
2,2.5,2510,14878,2.0,0,0,3,10,2510,0,1990,0,98011,47.7525,-122.205,3080,13594,600000,1,7,2014,0,24,12368,10514,0,0,0
4,2.0,1980,10051,1.0,0,0,3,7,1980,0,1969,2003,98092,47.3231,-122.103,1520,10125,279000,17,12,2014,34,45,8071,8605,1,0,0
3,3.5,2500,4270,2.0,0,0,3,8,2500,0,2000,0,98065,47.536,-121.877,2420,4205,538500,4,8,2014,0,14,1770,1785,0,0,0
4,2.5,2720,10006,2.0,0,0,3,9,2720,0,1989,0,98074,47.6295,-122.042,2720,10759,594950,9,7,2014,0,25,7286,8039,0,0,0
3,1.75,1480,7040,1.0,0,0,3,7,1480,0,1974,0,98033,47.6723,-122.169,2040,7810,510000,6,6,2014,0,40,5560,5770,0,0,0
4,2.25,2470,8686,1.0,0,0,4,7,1270,1200,1974,0,98058,47.4371,-122.166,1900,7350,360000,29,9,2014,0,40,6216,5450,0,1,0
2,1.0,1650,5106,1.0,0,0,3,7,1090,560,1960,0,98115,47.6992,-122.309,1300,6947,435000,21,7,2014,0,54,3456,5647,0,1,1
3,1.75,1700,6500,1.0,0,0,3,8,1700,0,1967,0,98115,47.6837,-122.284,1880,6000,559000,24,3,2015,0,48,4800,4120,0,0,1
4,2.5,2980,10459,2.0,0,0,3,9,2980,0,2001,0,98019,47.7354,-121.974,2920,7700,565000,12,3,2015,0,14,7479,4780,0,0,0
3,1.75,1730,6130,1.0,0,0,3,7,1480,250,1941,0,98115,47.6978,-122.316,1730,6131,575700,13,2,2015,0,74,4400,4401,0,1,1
3,3.25,2420,1923,2.0,0,2,3,10,1840,580,2006,0,98109,47.637,-122.341,1840,2890,1010000,17,6,2014,0,8,-497,1050,0,1,1
5,4.0,1400,8580,1.0,0,0,5,7,900,500,1954,0,98188,47.456,-122.292,1220,8832,265000,18,8,2014,0,60,7180,7612,0,1,1
4,2.0,2070,7830,1.0,0,1,5,7,1180,890,1941,0,98125,47.7058,-122.278,2390,7830,699950,11,8,2014,0,73,5760,5440,0,1,1
3,1.5,1460,11407,1.0,0,0,3,7,1460,0,1954,0,98155,47.746,-122.294,1470,11407,381000,11,6,2014,0,60,9947,9937,0,0,1
5,2.25,2140,8700,1.0,0,2,3,8,1220,920,1962,0,98115,47.6969,-122.31,1720,6670,564000,14,4,2015,0,53,6560,4950,0,1,1
2,1.0,740,6250,1.0,0,0,3,6,740,0,1942,0,98146,47.506,-122.335,980,6957,114975,10,7,2014,0,72,5510,5977,0,0,1
1,0.75,410,8636,1.0,0,0,2,4,410,0,1953,0,98146,47.5077,-122.357,1190,8636,325000,30,1,2015,0,62,8226,7446,0,0,1
5,2.75,2860,5280,2.0,0,0,3,9,2860,0,2006,0,98052,47.707,-122.102,3150,6442,751000,13,5,2015,0,9,2420,3292,0,0,0
3,2.25,1400,6970,2.0,0,0,3,8,1400,0,1984,0,98006,47.542,-122.184,1800,8140,425000,31,12,2014,0,30,5570,6340,0,0,0
3,1.75,2700,5040,1.0,0,2,3,8,1560,1140,1947,0,98144,47.5834,-122.29,3010,5000,665000,14,1,2015,0,68,2340,1990,0,1,1
7,1.5,2670,11250,1.5,0,0,4,8,2320,350,1948,0,98133,47.7121,-122.332,2030,9000,575000,28,10,2014,0,66,8580,6970,0,1,1
3,1.75,1520,9600,1.0,0,0,4,7,1520,0,1967,0,98059,47.473,-122.149,1590,10183,190000,25,11,2014,0,47,8080,8593,0,0,0
3,1.75,1520,9600,1.0,0,0,4,7,1520,0,1967,0,98059,47.473,-122.149,1590,10183,314950,23,2,2015,0,48,8080,8593,0,0,0
2,2.0,1660,5200,1.0,0,0,5,7,1120,540,1906,0,98103,47.6871,-122.334,1260,5160,601150,3,12,2014,0,108,3540,3900,0,1,1
2,1.0,860,8308,1.0,0,0,3,7,860,0,1948,0,98146,47.508,-122.378,1200,8308,315000,12,12,2014,0,66,7448,7108,0,0,1
2,1.5,2340,13380,1.0,0,0,4,7,1280,1060,1954,0,98146,47.5017,-122.377,1490,8100,545000,2,4,2015,0,61,11040,6610,0,1,1
4,2.25,2110,10698,2.0,0,0,4,8,2110,0,1979,0,98027,47.5614,-122.082,2220,8252,565000,19,5,2014,0,35,8588,6032,0,0,0
3,1.0,1010,7034,1.0,0,0,3,7,1010,0,1954,0,98055,47.49,-122.22,1440,10994,175000,6,5,2014,0,60,6024,9554,0,0,0
3,1.75,1610,7900,1.0,0,0,4,8,1310,300,1960,0,98177,47.7588,-122.36,2210,7700,430000,7,10,2014,0,54,6290,5490,0,1,1
3,1.75,1460,8372,1.0,0,0,4,7,1460,0,1981,0,98042,47.3683,-122.087,1220,7803,225000,30,10,2014,0,33,6912,6583,0,0,0
5,4.0,2900,9779,2.0,0,0,4,7,1950,950,1937,0,98168,47.5003,-122.306,1360,8000,312000,17,7,2014,0,77,6879,6640,0,1,1
3,1.0,1260,7980,1.0,0,0,3,7,1260,0,1951,0,98177,47.7013,-122.373,1760,7606,380000,2,3,2015,0,64,6720,5846,0,0,1
2,1.0,1210,10000,1.0,0,0,3,7,1210,0,1953,0,98148,47.4402,-122.333,1620,10959,222200,17,4,2015,0,62,8790,9339,0,0,1
5,3.5,3420,8000,2.0,0,0,3,10,3420,0,2006,0,98040,47.5736,-122.212,1900,8000,1440000,1,12,2014,0,8,4580,6100,0,0,0
4,2.5,2120,4558,2.0,0,0,3,7,2120,0,2002,0,98038,47.3795,-122.022,2370,5506,329950,2,7,2014,0,12,2438,3136,0,0,0
3,2.5,2460,10300,1.0,0,0,3,10,2460,0,1992,0,98117,47.6999,-122.391,2410,5250,995000,23,9,2014,0,22,7840,2840,0,0,1
3,3.5,3790,10829,2.0,0,0,3,11,3790,0,1993,0,98027,47.5525,-122.098,3620,10989,929950,14,7,2014,0,21,7039,7369,0,0,0
4,2.5,2350,9779,1.0,0,0,3,10,2350,0,1987,0,98074,47.6411,-122.065,2700,10441,692000,27,3,2015,0,28,7429,7741,0,0,0
2,1.0,620,2475,1.0,0,0,5,6,620,0,1911,0,98107,47.6655,-122.371,1290,2475,402000,26,6,2014,0,103,1855,1185,0,0,1
3,1.0,1050,8498,1.0,0,0,4,7,1050,0,1959,0,98031,47.4043,-122.202,1050,8498,249000,19,6,2014,0,55,7448,7448,0,0,0
3,1.5,1360,9980,1.0,0,0,4,7,1360,0,1966,0,98031,47.4143,-122.206,1360,9750,244900,2,12,2014,0,48,8620,8390,0,0,0
3,1.0,1180,7068,1.0,0,0,3,6,1180,0,1944,0,98178,47.4947,-122.238,1180,7068,289900,19,2,2015,0,71,5888,5888,0,0,1
4,1.0,1560,7980,1.0,0,0,4,7,1170,390,1939,0,98146,47.5093,-122.387,1570,7980,552500,31,3,2015,0,76,6420,6410,0,1,1
2,2.75,1100,1088,2.0,0,0,3,7,750,350,2006,0,98102,47.6405,-122.324,2090,4125,440000,27,10,2014,0,8,-12,2035,0,1,1
3,1.0,1200,4592,1.0,0,0,3,6,800,400,1950,0,98106,47.519,-122.352,940,4440,260000,5,9,2014,0,64,3392,3500,0,1,1
2,2.25,1330,10838,2.0,0,0,3,8,1330,0,1985,0,98028,47.7689,-122.241,1390,10310,355000,27,6,2014,0,29,9508,8920,0,0,0
3,1.75,1570,12506,1.0,0,0,4,8,1570,0,1959,0,98003,47.3365,-122.319,2120,13243,318000,30,1,2015,0,56,10936,11123,0,0,0
4,2.25,1810,7068,2.0,0,0,5,7,1810,0,1976,0,98034,47.7319,-122.204,1460,7274,485000,1,4,2015,0,39,5258,5814,0,0,0
3,1.5,1780,4200,1.5,0,0,4,8,1780,0,1916,0,98103,47.662,-122.349,1380,3333,588000,16,9,2014,0,98,2420,1953,0,0,1
3,2.5,3050,7410,1.5,0,0,5,8,1950,1100,1950,0,98115,47.6772,-122.296,1890,5814,975000,15,7,2014,0,64,4360,3924,0,1,1
3,2.0,1540,1827,2.0,0,0,3,8,1540,0,2005,0,98029,47.5479,-121.998,1540,1827,402000,23,5,2014,0,9,287,287,0,0,0
3,1.0,1380,9875,1.0,0,0,3,7,1380,0,1959,0,98168,47.5131,-122.334,1200,6250,245000,1,5,2015,0,56,8495,5050,0,0,1
3,1.75,1570,8459,1.0,0,0,3,7,1570,0,1991,0,98022,47.2016,-122.006,1650,8844,195000,25,5,2014,0,23,6889,7194,0,0,0
5,2.0,2540,11750,1.0,0,0,3,7,1480,1060,1962,0,98155,47.7754,-122.291,2000,12000,385000,12,1,2015,0,53,9210,10000,0,1,1
3,1.5,1520,7903,1.0,0,0,4,7,1000,520,1955,0,98006,47.5659,-122.141,1520,9830,450000,16,7,2014,0,59,6383,8310,0,1,0
4,2.5,2780,6837,2.0,0,0,3,9,2780,0,2004,0,98033,47.666,-122.201,1160,6837,1090000,28,10,2014,0,10,4057,5677,0,0,0
2,1.0,1730,6375,2.0,0,0,4,6,1730,0,1945,0,98126,47.5357,-122.368,1180,6250,396675,20,5,2014,0,69,4645,5070,0,0,1
5,2.25,2340,7494,1.0,0,0,3,7,1170,1170,1951,0,98188,47.448,-122.28,1650,10125,242000,2,10,2014,0,63,5154,8475,0,1,1
3,1.75,1300,12378,1.0,0,0,4,6,1300,0,1943,0,98045,47.4996,-121.778,1300,11596,380000,31,10,2014,0,71,11078,10296,0,0,0
2,1.0,1420,4635,2.0,0,0,4,7,1420,0,1941,1973,98115,47.68,-122.304,1810,4635,496000,3,12,2014,32,73,3215,2825,1,0,1
3,2.5,1470,4488,2.0,0,0,5,7,1470,0,1980,0,98034,47.723,-122.162,1400,4441,399950,8,12,2014,0,34,3018,3041,0,0,0
4,2.5,2850,8526,2.0,0,0,3,9,2850,0,1998,0,98033,47.6747,-122.191,2440,7072,895000,4,3,2015,0,17,5676,4632,0,0,0
3,2.0,2360,6149,2.0,0,3,3,8,1560,800,1926,1989,98136,47.5433,-122.384,2000,6149,690000,4,11,2014,63,88,3789,4149,1,1,1
3,1.5,1610,8375,2.0,0,0,3,7,1610,0,1927,0,98155,47.7527,-122.306,1610,9107,270000,2,9,2014,0,87,6765,7497,0,0,1
3,2.5,1470,1741,2.0,0,0,3,8,1170,300,2004,0,98029,47.5464,-121.999,1470,1583,454280,4,5,2015,0,11,271,113,0,1,0
3,1.75,1840,14005,1.0,0,0,3,8,1840,0,1983,0,98023,47.3124,-122.345,2170,7992,275000,15,1,2015,0,32,12165,5822,0,0,0
4,2.5,2450,8932,2.0,0,0,3,8,2450,0,1990,0,98023,47.3093,-122.345,2410,8775,300000,29,4,2015,0,25,6482,6365,0,0,0
3,1.75,1500,6000,1.0,0,0,5,7,850,650,1940,0,98199,47.6474,-122.402,1700,6000,700000,8,5,2015,0,75,4500,4300,0,1,1
3,1.75,2080,6609,1.0,0,0,3,7,1280,800,1950,0,98115,47.6883,-122.3,1680,6270,520000,18,12,2014,0,64,4529,4590,0,1,1
3,2.5,2370,4324,2.0,0,0,3,8,2370,0,2006,0,98038,47.3515,-121.999,2370,4348,404000,20,4,2015,0,9,1954,1978,0,0,0
6,2.75,4430,6440,2.0,0,3,3,10,2680,1750,1964,2015,98118,47.5462,-122.265,3530,7314,1490000,6,5,2015,51,51,2010,3784,1,1,1
4,1.75,1550,6000,1.0,0,0,5,7,1550,0,1944,0,98199,47.6567,-122.399,1550,6000,557800,9,4,2015,0,71,4450,4450,0,0,1
4,2.25,2290,9900,1.0,0,2,4,8,1550,740,1959,0,98166,47.4434,-122.343,2320,9900,571000,13,4,2015,0,56,7610,7580,0,1,1
4,2.5,2560,4020,2.0,0,0,3,9,2560,0,2006,0,98038,47.3533,-122.027,3010,4916,410000,8,7,2014,0,8,1460,1906,0,0,0
3,1.5,1240,5506,1.0,0,0,4,7,1240,0,1971,0,98118,47.5294,-122.285,1670,5589,225000,13,3,2015,0,44,4266,3919,0,0,1
4,2.5,2590,4498,2.0,0,0,3,9,2590,0,2004,0,98052,47.7047,-122.128,2660,5238,700000,16,7,2014,0,10,1908,2578,0,0,0
3,1.0,1370,3500,1.5,0,0,3,7,1370,0,1905,1985,98103,47.6857,-122.348,1590,4500,500000,9,2,2015,80,110,2130,2910,1,0,1
2,2.0,1360,1860,1.0,0,0,4,7,680,680,1925,0,98107,47.6727,-122.396,1440,5000,536500,28,4,2015,0,90,500,3560,0,1,1
3,1.75,1120,15210,1.0,0,0,5,7,1120,0,1976,0,98042,47.3659,-122.113,1710,8470,249950,11,2,2015,0,39,14090,6760,0,0,0
4,1.75,1630,8410,1.5,0,0,5,7,1630,0,1943,0,98188,47.4538,-122.288,1390,8410,249000,15,10,2014,0,71,6780,7020,0,0,1
3,1.75,1590,7535,1.5,0,0,5,6,1590,0,1909,0,98032,47.3769,-122.234,1110,6000,249000,8,4,2015,0,106,5945,4890,0,0,0
4,1.75,2480,9195,1.0,0,0,3,7,1390,1090,1950,0,98004,47.584,-122.195,2440,9195,780000,8,5,2014,0,64,6715,6755,0,1,0
4,2.5,2700,4275,2.0,0,0,3,9,2700,0,2004,0,98115,47.6725,-122.327,1810,4500,1200000,5,7,2014,0,10,1575,2690,0,0,1
3,1.75,1930,7210,1.0,0,0,3,7,1110,820,1975,0,98072,47.735,-122.174,1870,7877,434500,15,9,2014,0,39,5280,6007,0,1,0
2,1.0,1000,4000,1.0,0,0,3,6,1000,0,1910,0,98107,47.6742,-122.396,1490,5000,417200,19,2,2015,0,105,3000,3510,0,0,1
4,2.25,2130,11900,2.0,0,0,3,9,2130,0,1976,0,98074,47.6408,-122.058,2590,11900,649990,24,9,2014,0,38,9770,9310,0,0,0
2,1.0,1060,3588,1.0,0,0,4,7,960,100,1926,0,98107,47.6721,-122.395,1570,3741,506000,2,12,2014,0,88,2528,2171,0,1,1
3,2.5,1730,4004,2.0,0,0,3,7,1730,0,1999,0,98148,47.4317,-122.328,1730,5523,348000,21,4,2015,0,16,2274,3793,0,0,1
4,2.5,2810,6146,2.0,0,0,3,9,2810,0,1998,0,98031,47.4045,-122.208,2810,6180,301000,28,7,2014,0,16,3336,3370,0,0,0
2,1.0,880,4000,1.0,0,0,3,7,880,0,1940,0,98117,47.6848,-122.386,1150,4000,427550,8,7,2014,0,74,3120,2850,0,0,1
3,1.0,1040,6720,1.5,0,0,3,7,1040,0,1951,0,98155,47.7444,-122.294,1880,11407,361000,1,5,2015,0,64,5680,9527,0,0,1
2,2.5,1830,8107,1.0,0,0,5,7,930,900,1946,0,98125,47.701,-122.305,1260,6960,460000,21,8,2014,0,68,6277,5700,0,1,1
4,3.5,1800,6400,2.0,0,2,3,8,1800,0,1984,2011,98112,47.625,-122.3,1700,4736,958000,10,7,2014,27,30,4600,3036,1,0,1
5,1.75,2460,6846,1.5,0,0,5,7,1340,1120,1911,0,98108,47.5445,-122.321,1410,4800,445000,12,6,2014,0,103,4386,3390,0,1,1
3,2.5,1670,3565,2.0,0,0,3,7,1670,0,1999,0,98072,47.7623,-122.161,1510,3770,373000,19,5,2014,0,15,1895,2260,0,0,0
4,2.25,2660,7957,1.0,0,0,4,8,1750,910,1977,0,98011,47.7351,-122.199,1890,8250,525000,14,4,2015,0,38,5297,6360,0,1,0
3,2.5,2850,12593,2.0,0,0,3,9,2850,0,1997,0,98023,47.2848,-122.345,2850,9435,364988,26,8,2014,0,17,9743,6585,0,0,0
2,1.0,820,8370,1.0,0,0,4,7,820,0,1941,0,98177,47.7256,-122.361,1410,8370,324000,14,8,2014,0,73,7550,6960,0,0,1
4,3.0,2350,5627,1.0,0,0,5,8,1490,860,1960,0,98118,47.5514,-122.268,2020,5627,625000,5,3,2015,0,55,3277,3607,0,1,1
3,1.75,1480,7830,1.0,0,0,3,7,1480,0,1980,0,98022,47.1967,-121.998,1130,7553,237500,8,9,2014,0,34,6350,6423,0,0,0
6,2.25,2930,15949,1.0,0,0,4,8,1730,1200,1965,0,98034,47.7188,-122.185,1730,8550,429300,6,8,2014,0,49,13019,6820,0,1,0
3,1.0,1250,6250,1.0,0,0,2,7,1030,220,1949,0,98108,47.5292,-122.323,1130,6250,155000,29,5,2014,0,65,5000,5120,0,1,1
4,2.75,2760,8160,1.5,0,2,4,8,1780,980,1940,0,98177,47.7248,-122.365,2720,8160,614000,23,2,2015,0,75,5400,5440,0,1,1
3,2.5,2380,3332,2.0,0,0,3,9,2380,0,2014,0,98034,47.7194,-122.199,2590,4382,650000,31,3,2015,0,1,952,1792,0,0,0
3,2.0,1730,12219,1.0,0,0,4,7,1730,0,1986,0,98004,47.5825,-122.189,2470,13594,625000,21,7,2014,0,28,10489,11124,0,0,0
3,2.25,1670,6414,1.0,0,0,4,8,1670,0,1961,0,98117,47.6921,-122.386,2130,7035,587100,25,3,2015,0,54,4744,4905,0,0,1
2,1.0,930,5760,1.0,0,0,3,6,730,200,1917,0,98118,47.5598,-122.266,1970,5760,479500,5,5,2015,0,98,4830,3790,0,1,1
1,1.0,620,2380,1.0,0,0,3,6,620,0,1900,0,98115,47.6746,-122.326,980,3570,382888,17,3,2015,0,115,1760,2590,0,0,1
4,4.25,1960,3565,2.0,0,0,3,7,1960,0,1940,2003,98116,47.5849,-122.384,1920,5750,540000,27,5,2014,63,74,1605,3830,1,0,1
4,2.75,2550,8632,1.0,0,0,3,8,1700,850,1972,0,98033,47.6477,-122.197,2550,9534,691000,21,5,2014,0,42,6082,6984,0,1,0
3,2.0,1990,3990,1.0,0,0,5,7,1130,860,1912,0,98103,47.6572,-122.333,1710,4000,760500,4,6,2014,0,102,2000,2290,0,1,1
4,2.5,3550,10968,2.0,0,0,3,9,3550,0,2006,0,98065,47.5431,-121.886,3550,8583,685000,30,4,2015,0,9,7418,5033,0,0,0
3,3.0,2031,7702,2.0,0,0,3,9,2031,0,1988,0,98023,47.3058,-122.348,2390,7700,335000,24,7,2014,0,26,5671,5310,0,0,0
4,2.25,3010,12202,1.0,0,0,4,9,3010,0,1959,0,98005,47.6387,-122.174,2480,10143,830000,25,3,2015,0,56,9192,7663,0,0,0
3,2.5,2610,8481,2.0,0,0,3,10,2610,0,1993,0,98006,47.5535,-122.115,3140,10008,810000,28,1,2015,0,22,5871,6868,0,0,0
3,2.25,1440,15661,1.0,0,0,3,8,1180,260,1988,0,98074,47.6225,-122.038,1440,13963,500000,13,1,2015,0,27,14221,12523,0,1,0
3,1.75,1920,5405,1.0,0,2,4,7,960,960,1947,0,98126,47.5583,-122.38,1190,5405,490000,30,5,2014,0,67,3485,4215,0,1,1
2,1.75,1670,4200,2.0,0,0,3,7,1670,0,1912,0,98116,47.5862,-122.387,1340,2875,490000,28,10,2014,0,102,2530,1535,0,0,1
4,1.75,1390,10660,1.0,0,0,4,7,1030,360,1960,0,98198,47.4128,-122.323,1800,11960,272000,18,9,2014,0,54,9270,10160,0,1,1
3,2.25,2140,7200,2.0,0,0,4,7,2140,0,1979,0,98031,47.3913,-122.191,1890,7455,280000,10,9,2014,0,35,5060,5565,0,0,0
3,1.0,1250,6180,1.5,0,0,3,7,1250,0,1955,0,98155,47.7474,-122.327,1490,6180,233000,25,6,2014,0,59,4930,4690,0,0,1
3,1.0,1080,6000,1.0,0,0,4,7,1080,0,1952,0,98133,47.7579,-122.33,1200,7210,275000,23,6,2014,0,62,4920,6010,0,0,1
3,3.25,2760,6420,2.0,0,2,3,9,2110,650,1991,0,98031,47.3895,-122.221,2030,7725,375000,28,7,2014,0,23,3660,5695,0,1,0
3,2.75,2180,3703,2.0,0,0,3,8,2180,0,2004,0,98011,47.776,-122.169,2190,3963,445000,26,8,2014,0,10,1523,1773,0,0,0
3,2.5,1260,1125,3.0,0,0,3,8,1260,0,2002,0,98107,47.6706,-122.381,1360,1250,437500,19,9,2014,0,12,-135,-110,0,0,1
4,1.0,1610,6000,1.5,0,0,4,7,1510,100,1905,0,98118,47.5261,-122.266,1430,6000,426250,11,5,2015,0,110,4390,4570,0,1,1
3,1.5,2450,12497,1.0,0,0,4,7,2450,0,1967,0,98065,47.5317,-121.834,1560,11700,358000,26,6,2014,0,47,10047,10140,0,0,0
2,1.0,960,8276,1.0,0,0,3,5,960,0,1939,0,98027,47.5322,-122.033,1620,6000,305000,30,4,2015,0,76,7316,4380,0,0,0
2,1.75,1340,4664,1.0,0,0,3,8,1340,0,2004,0,98053,47.7182,-122.034,1350,4236,415000,30,5,2014,0,10,3324,2886,0,0,0
11,3.0,3000,4960,2.0,0,0,3,7,2400,600,1918,1999,98106,47.556,-122.363,1420,4960,520000,21,8,2014,81,96,1960,3540,1,1,1
4,3.5,3080,5974,2.0,0,0,3,9,3080,0,2003,0,98075,47.6007,-121.974,2950,5425,733000,13,10,2014,0,11,2894,2475,0,0,0
3,1.0,1130,8159,1.0,0,0,4,7,1130,0,1954,0,98133,47.7362,-122.333,1570,8162,411500,9,3,2015,0,61,7029,6592,0,0,1
3,1.75,2280,16671,1.5,0,0,4,6,1760,520,1909,0,98034,47.7096,-122.219,1850,9351,540000,19,9,2014,0,105,14391,7501,0,1,0
3,1.5,1952,8613,1.0,0,0,4,7,1652,300,1960,0,98032,47.3715,-122.29,1400,8712,270500,24,2,2015,0,55,6661,7312,0,1,0
2,1.5,1280,1256,2.0,0,0,3,8,1200,80,1998,0,98107,47.6741,-122.375,1390,1256,422250,10,4,2015,0,17,-24,-134,0,1,1
5,3.25,3690,12353,2.0,0,0,5,9,3690,0,1977,0,98155,47.7672,-122.292,2290,9082,655000,16,5,2014,0,37,8663,6792,0,0,1
5,3.25,4610,10576,2.0,0,3,3,11,3310,1300,2006,0,98027,47.5373,-122.07,4042,8321,1200000,7,8,2014,0,8,5966,4279,0,1,0
2,2.25,1230,929,2.0,0,0,3,8,1020,210,2004,0,98122,47.6191,-122.301,1270,1370,460000,6,5,2014,0,10,-301,100,0,1,1
4,1.5,1580,6200,1.0,0,0,3,6,790,790,1944,0,98178,47.4971,-122.24,1320,6499,159075,25,10,2014,0,70,4620,5179,0,1,1
2,1.0,1220,4000,1.5,0,0,4,6,1220,0,1908,0,98103,47.6801,-122.354,1580,4000,470000,9,12,2014,0,106,2780,2420,0,0,1
2,1.0,1020,7920,1.0,0,0,3,6,1020,0,1939,0,98108,47.5558,-122.31,1530,6900,235000,8,7,2014,0,75,6900,5370,0,0,1
2,1.5,1510,9843,1.0,0,0,4,7,1510,0,1961,0,98188,47.4419,-122.27,1590,9368,309950,18,9,2014,0,53,8333,7778,0,0,1
4,1.75,1830,9600,1.0,0,0,4,7,1010,820,1966,0,98006,47.5728,-122.125,1910,11100,433000,23,5,2014,0,48,7770,9190,0,1,0
3,2.5,2750,10000,1.0,0,3,3,8,1650,1100,1967,0,98006,47.5644,-122.153,2490,10000,895000,3,2,2015,0,48,7250,7510,0,1,0
2,1.0,1360,5000,1.0,0,0,3,7,1200,160,1936,0,98199,47.6372,-122.392,1540,4000,640000,9,1,2015,0,79,3640,2460,0,1,1
3,2.25,2340,14279,1.0,0,0,3,8,1340,1000,1965,0,98006,47.5715,-122.124,2340,13600,438000,26,1,2015,0,50,11939,11260,0,1,0
4,2.5,2600,9935,2.0,0,0,3,8,2600,0,2005,0,98059,47.4865,-122.142,2830,7620,540000,22,7,2014,0,9,7335,4790,0,0,0
4,2.5,2090,7434,1.0,0,0,3,7,1090,1000,1993,0,98146,47.4962,-122.349,1260,8404,325000,9,3,2015,0,22,5344,7144,0,1,1
4,1.75,2260,7200,1.5,0,0,5,7,1360,900,1924,0,98056,47.5122,-122.186,1410,7465,380000,26,1,2015,0,91,4940,6055,0,1,0
2,1.0,1390,5544,1.0,0,0,3,7,930,460,1947,0,98105,47.6696,-122.267,1710,6200,510000,13,11,2014,0,67,4154,4490,0,1,1
4,2.5,2300,7707,2.0,0,0,3,8,2300,0,2004,0,98038,47.3497,-122.044,2320,6035,380000,12,8,2014,0,10,5407,3715,0,0,0
4,2.5,2810,9800,1.0,0,0,4,8,1710,1100,1973,0,98006,47.5657,-122.149,2800,9800,825000,16,6,2014,0,41,6990,7000,0,1,0
3,3.0,2790,13295,2.0,1,4,4,10,2370,420,1933,1989,98006,47.5466,-122.197,3140,11949,1800000,6,3,2015,56,82,10505,8809,1,1,0
3,1.0,1290,6380,1.5,0,0,3,7,1290,0,1930,0,98115,47.6951,-122.319,1630,6380,790000,7,1,2015,0,85,5090,4750,0,0,1
2,1.5,720,4346,1.0,0,0,4,6,720,0,1942,0,98106,47.5225,-122.351,790,4346,287000,12,12,2014,0,72,3626,3556,0,0,1
3,3.0,2130,5000,1.5,0,0,3,7,1570,560,1913,0,98118,47.5451,-122.284,1638,4500,509000,12,9,2014,0,101,2870,2862,0,1,1
3,2.25,1750,8400,1.0,0,0,3,7,1350,400,1965,0,98188,47.4571,-122.272,2020,9110,270000,8,9,2014,0,49,6650,7090,0,1,1
3,2.0,960,9380,1.0,0,0,3,6,960,0,1949,0,98146,47.4852,-122.343,1460,9240,210000,8,7,2014,0,65,8420,7780,0,0,1
3,1.0,1570,11752,1.5,0,0,5,8,1570,0,1930,0,98133,47.7686,-122.348,2010,8291,415000,24,11,2014,0,84,10182,6281,0,0,1
4,2.5,2920,5500,1.0,0,3,3,10,2030,890,1957,0,98199,47.6406,-122.412,3790,5500,1250000,9,7,2014,0,57,2580,1710,0,1,1
3,1.0,1870,4984,1.0,0,0,3,7,1120,750,1955,0,98116,47.5771,-122.391,1650,5750,499950,1,8,2014,0,59,3114,4100,0,1,1
3,1.5,1540,5040,2.0,0,0,3,8,1540,0,1907,0,98122,47.6138,-122.299,1590,3600,659000,5,9,2014,0,107,3500,2010,0,0,1
4,3.75,2810,10840,2.0,0,2,4,8,2070,740,1994,0,98045,47.4861,-121.804,2370,11248,492000,5,6,2014,0,20,8030,8878,0,1,0
4,2.5,2450,7700,1.0,0,0,3,8,1250,1200,1958,0,98040,47.5731,-122.212,2450,8000,715000,13,8,2014,0,56,5250,5550,0,1,0
1,1.0,730,5005,1.0,0,0,4,5,730,0,1945,0,98117,47.6992,-122.364,1630,5667,306950,9,10,2014,0,69,4275,4037,0,0,1
4,2.0,2480,3680,1.5,0,0,4,7,1470,1010,1916,0,98116,47.5686,-122.392,1500,5750,630000,7,4,2015,0,99,1200,4250,0,1,1
3,1.0,1270,8792,1.0,0,0,5,7,1270,0,1969,0,98056,47.5351,-122.174,1780,8792,367500,9,1,2015,0,46,7522,7012,0,0,0
3,3.25,2230,5460,1.0,0,1,4,8,1430,800,1977,0,98136,47.53,-122.388,2070,5600,699950,25,3,2015,0,38,3230,3530,0,1,1
3,3.0,2880,3750,2.0,0,0,3,9,2220,660,1909,1991,98122,47.6155,-122.29,1910,4000,1000000,16,4,2015,82,106,870,2090,1,1,1
4,2.5,2434,4400,2.0,0,0,3,8,2434,0,2007,0,98001,47.2874,-122.283,2434,4400,285000,16,10,2014,0,7,1966,1966,0,0,0
2,1.5,1120,1312,2.0,0,0,3,7,1000,120,2004,0,98106,47.534,-122.364,1560,1314,215000,14,1,2015,0,11,192,-246,0,1,1
4,2.5,4080,11054,2.0,0,0,3,11,4080,0,2001,0,98059,47.5188,-122.151,3520,11914,1050000,6,3,2015,0,14,6974,8394,0,0,0
4,2.75,3720,9450,1.0,0,4,5,10,1960,1760,1962,0,98006,47.5627,-122.156,2900,8605,1370000,9,5,2014,0,52,5730,5705,0,1,0
3,1.0,1430,7599,1.5,0,0,4,6,1010,420,1930,0,98168,47.4783,-122.265,1290,10320,235000,1,4,2015,0,85,6169,9030,0,1,1
3,2.0,1560,2589,1.0,0,0,3,7,790,770,1923,2001,98103,47.6587,-122.344,1450,3893,604000,16,4,2015,78,92,1029,2443,1,1,1
3,1.75,1700,8400,1.0,0,0,3,8,1460,240,1947,0,98199,47.6534,-122.415,2010,7000,750000,30,5,2014,0,67,6700,4990,0,1,1
4,2.25,2510,9963,1.0,0,0,4,9,2200,310,1967,0,98005,47.5973,-122.177,3110,9963,800000,24,11,2014,0,47,7453,6853,0,1,0
5,2.0,2600,3750,1.5,0,0,4,6,1400,1200,1914,0,98105,47.6691,-122.299,1700,3750,580000,7,1,2015,0,101,1150,2050,0,1,1
1,1.0,790,4590,1.0,0,0,3,6,790,0,1911,0,98118,47.5677,-122.285,1070,4590,350000,4,12,2014,0,103,3800,3520,0,0,1
4,2.0,1710,7490,2.0,0,0,3,7,1320,390,1956,0,98166,47.4544,-122.357,1880,7704,353750,16,12,2014,0,58,5780,5824,0,1,1
5,2.75,2660,8737,1.0,0,4,5,8,1470,1190,1969,0,98006,47.5667,-122.155,3280,8783,1100000,4,6,2014,0,45,6077,5503,0,1,0
4,2.0,1470,10291,1.0,0,0,4,7,1470,0,1963,0,98008,47.6316,-122.121,1460,9601,465000,9,2,2015,0,52,8821,8141,0,0,0
3,2.0,2350,5080,1.5,0,0,3,8,1780,570,1929,0,98118,47.5516,-122.263,1700,5080,568000,7,5,2014,0,85,2730,3380,0,1,1
5,2.0,2440,3080,2.0,0,0,4,8,2440,0,1910,0,98112,47.6242,-122.306,1640,3077,1010000,6,11,2014,0,104,640,1437,0,0,1
3,1.5,1150,11571,1.0,0,0,3,7,1150,0,1961,0,98168,47.4931,-122.298,1630,11571,213500,16,9,2014,0,53,10421,9941,0,0,1
3,2.5,1510,10384,1.0,0,0,2,7,1030,480,1976,0,98077,47.758,-122.071,1490,10000,250000,5,6,2014,0,38,8874,8510,0,1,0
2,1.0,870,4600,1.0,0,0,4,7,870,0,1942,0,98126,47.5274,-122.379,930,4600,357000,3,7,2014,0,72,3730,3670,0,0,1
2,2.0,1280,4095,2.0,0,0,4,8,1280,0,1918,0,98136,47.5501,-122.393,1470,5500,425000,26,9,2014,0,96,2815,4030,0,0,1
3,2.5,2600,7465,2.0,0,0,3,9,2600,0,1988,0,98011,47.7387,-122.217,2660,7683,571000,11,6,2014,0,26,4865,5023,0,0,0
3,2.25,2030,7350,1.0,0,0,4,7,1190,840,1977,0,98052,47.6939,-122.126,1950,7350,588000,19,5,2014,0,37,5320,5400,0,1,0
4,1.5,1930,15531,2.0,0,0,3,7,1930,0,1979,0,98003,47.345,-122.296,1580,7800,275000,23,5,2014,0,35,13601,6220,0,0,0
3,1.75,1970,9135,1.0,0,0,4,7,1370,600,1961,0,98011,47.7603,-122.215,1880,9650,460000,19,3,2015,0,54,7165,7770,0,1,0
4,2.5,4060,9734,1.0,0,4,3,9,2150,1910,1977,0,98028,47.7678,-122.254,2750,10370,603500,4,6,2014,0,37,5674,7620,0,1,0
3,2.5,3316,11447,2.0,0,0,3,9,3316,0,1986,0,98023,47.3036,-122.34,3000,11447,490600,3,7,2014,0,28,8131,8447,0,0,0
2,2.0,1460,9052,1.0,0,2,5,6,1460,0,1900,0,98033,47.6857,-122.208,2554,7834,1010000,24,6,2014,0,114,7592,5280,0,0,0
4,2.0,2100,12620,1.0,0,0,4,7,2100,0,1972,0,98034,47.7239,-122.173,1720,7840,500000,27,8,2014,0,42,10520,6120,0,0,0
4,2.25,1830,6136,2.0,0,0,3,7,1830,0,1990,0,98030,47.367,-122.181,1830,7664,249000,25,6,2014,0,24,4306,5834,0,0,0
3,2.0,1530,8700,1.0,0,0,4,7,1530,0,1970,0,98055,47.4529,-122.207,1960,7600,235000,3,6,2014,0,44,7170,5640,0,0,0
4,2.0,1490,13736,1.0,0,0,4,6,1490,0,1942,0,98125,47.712,-122.281,2040,7200,410000,21,1,2015,0,73,12246,5160,0,0,1
2,1.0,860,6050,1.0,0,0,3,7,860,0,1952,0,98116,47.5697,-122.4,1130,6050,370000,1,7,2014,0,62,5190,4920,0,0,1
5,2.5,2130,7111,1.0,0,0,3,7,1330,800,1968,0,98059,47.5071,-122.16,1840,7592,360000,16,9,2014,0,46,4981,5752,0,1,0
4,2.5,2420,3825,2.0,0,0,3,8,2420,0,2003,0,98042,47.3687,-122.126,1880,4250,298000,21,11,2014,0,11,1405,2370,0,0,0
4,2.25,1900,7200,1.0,0,0,3,8,1370,530,1977,0,98146,47.5033,-122.372,2030,8008,485000,8,7,2014,0,37,5300,5978,0,1,1
3,1.75,1330,9143,1.0,0,0,3,7,1330,0,1960,0,98006,47.5538,-122.176,1950,10384,400000,26,8,2014,0,54,7813,8434,0,0,0
3,2.5,2150,4604,2.0,0,0,3,8,2150,0,2003,0,98075,47.5893,-122.019,2280,4253,580000,5,8,2014,0,11,2454,1973,0,0,0
2,2.5,1370,1140,2.0,0,0,3,8,1080,290,2009,0,98133,47.7055,-122.342,1340,1050,355000,7,8,2014,0,5,-230,-290,0,1,1
3,2.5,2430,12997,2.0,0,0,3,9,2430,0,1992,0,98011,47.744,-122.194,2720,12500,650000,21,7,2014,0,22,10567,9780,0,0,0
4,1.0,1640,8467,1.0,0,2,4,6,1220,420,1943,0,98056,47.4894,-122.188,1060,7396,261490,29,9,2014,0,71,6827,6336,0,1,0
3,1.0,1010,7200,1.0,0,0,3,7,1010,0,1968,0,98034,47.7225,-122.179,1120,7200,347000,16,7,2014,0,46,6190,6080,0,0,0
3,1.0,1500,4100,1.5,0,0,3,7,1370,130,1926,0,98107,47.6689,-122.367,1500,4100,485000,19,5,2014,0,88,2600,2600,0,1,1
3,2.5,1740,1251,2.0,0,0,3,9,1180,560,2012,0,98199,47.644,-122.385,1740,1625,601000,22,10,2014,0,2,-489,-115,0,1,1
3,3.0,1850,12556,2.0,0,0,3,9,1850,0,1976,0,98074,47.6286,-122.053,2390,12474,565000,29,8,2014,0,38,10706,10084,0,0,0
3,2.25,1480,7200,1.0,0,0,3,7,1190,290,1975,0,98023,47.3037,-122.375,1830,7200,291000,7,1,2015,0,40,5720,5370,0,1,0
3,2.5,2280,12498,2.0,0,0,4,9,2280,0,1987,0,98029,47.5688,-122.014,2330,8844,560000,5,11,2014,0,27,10218,6514,0,0,0
4,2.25,3180,9600,2.0,0,0,3,10,3180,0,1984,0,98074,47.6313,-122.045,2840,10739,725000,25,3,2015,0,31,6420,7899,0,0,0
5,3.25,3910,7077,2.0,0,0,3,9,2710,1200,2000,0,98038,47.3766,-122.027,2650,7077,470000,22,7,2014,0,14,3167,4427,0,1,0
2,1.0,770,7434,1.0,0,0,3,6,770,0,1947,0,98155,47.7606,-122.32,1060,7453,264950,9,1,2015,0,68,6664,6393,0,0,1
4,1.5,1780,8000,2.0,0,0,4,6,1080,700,1900,1996,98010,47.3124,-122.003,1750,9147,200000,25,2,2015,96,115,6220,7397,1,1,0
2,2.5,2510,17986,2.0,0,0,3,9,2510,0,1943,2014,98052,47.6832,-122.164,2440,8039,811000,25,8,2014,71,71,15476,5599,1,0,0
3,3.25,1410,1350,3.0,0,0,3,8,1410,0,2005,0,98103,47.698,-122.34,1410,1253,425000,16,9,2014,0,9,-60,-157,0,0,1
3,2.5,1760,7601,2.0,0,0,3,8,1760,0,1992,0,98003,47.2672,-122.313,1920,6851,281000,23,7,2014,0,22,5841,4931,0,0,0
3,2.25,2100,14027,2.0,0,0,3,8,2100,0,1979,0,98042,47.3833,-122.1,2730,5999,270000,16,10,2014,0,35,11927,3269,0,0,0
3,1.0,1490,8239,1.0,0,0,4,6,1490,0,1963,0,98023,47.306,-122.37,1200,8470,205950,11,8,2014,0,51,6749,7270,0,0,0
2,1.0,870,5400,1.0,0,0,3,6,870,0,1950,2007,98126,47.52,-122.374,990,5200,310000,25,6,2014,57,64,4530,4210,1,0,1
3,1.75,1260,1111,2.0,0,0,3,8,1260,0,2003,0,98029,47.5476,-122.005,1410,1630,350000,12,3,2015,0,12,-149,220,0,0,0
4,2.0,2630,16475,2.0,0,0,4,8,2630,0,1953,0,98004,47.639,-122.219,2670,15001,843500,1,6,2014,0,61,13845,12331,0,0,0
4,2.0,1950,3757,1.0,0,0,4,6,1160,790,1908,0,98118,47.5372,-122.269,1720,3757,370000,8,5,2015,0,107,1807,2037,0,1,1
4,2.0,2200,7700,1.0,0,0,3,7,1100,1100,1979,0,98058,47.464,-122.18,1790,7700,279000,20,6,2014,0,35,5500,5910,0,1,0
3,1.0,1230,9600,1.0,0,0,3,7,1230,0,1952,0,98118,47.5553,-122.288,1510,6600,392000,6,1,2015,0,63,8370,5090,0,0,1
2,1.0,1030,5000,1.0,0,0,5,6,1030,0,1917,0,98107,47.6585,-122.363,1550,5000,455000,29,9,2014,0,97,3970,3450,0,0,1
3,3.0,2240,11536,2.0,0,0,3,7,2240,0,1943,2005,98178,47.4886,-122.245,1650,8760,323500,17,9,2014,62,71,9296,7110,1,0,1
3,1.0,1600,4489,1.0,0,2,3,6,800,800,1944,0,98126,47.5686,-122.378,1640,6013,364500,26,9,2014,0,70,2889,4373,0,1,1
4,2.0,2190,14439,1.0,0,0,4,7,1180,1010,1977,0,98001,47.2702,-122.29,2160,14439,280000,9,5,2014,0,37,12249,12279,0,1,0
3,1.75,1899,11325,2.0,0,0,3,7,1899,0,1943,2005,98198,47.3987,-122.3,2000,10454,289900,15,12,2014,62,71,9426,8454,1,0,1
3,1.0,1870,2807,1.5,0,0,4,7,1580,290,1927,0,98107,47.6674,-122.358,1640,4500,585000,13,6,2014,0,87,937,2860,0,1,1
3,2.5,1730,6653,1.0,0,0,4,7,1360,370,1990,0,98042,47.3588,-122.088,1730,7061,269000,16,9,2014,0,24,4923,5331,0,1,0
3,2.25,1860,9210,2.0,0,0,3,7,1860,0,1994,0,98038,47.3864,-122.03,1530,8091,280000,8,8,2014,0,20,7350,6561,0,0,0
3,1.75,1940,9000,1.0,0,0,3,7,1290,650,1965,0,98055,47.4361,-122.189,1900,9120,287000,9,4,2015,0,50,7060,7220,0,1,0
2,1.0,670,5140,1.0,0,0,3,6,670,0,1926,0,98126,47.5387,-122.371,850,5140,183000,12,8,2014,0,88,4470,4290,0,0,1
3,1.0,1820,8142,1.0,0,0,3,7,1040,780,1961,0,98168,47.505,-122.316,1820,8142,309000,19,12,2014,0,53,6322,6322,0,1,1
4,2.5,3810,13579,2.0,0,0,3,10,3810,0,2003,0,98007,47.6006,-122.153,3310,9270,920000,13,10,2014,0,11,9769,5960,0,0,0
5,2.25,2060,4800,2.5,0,0,3,8,2060,0,1907,0,98105,47.66,-122.282,1740,4800,815241,29,9,2014,0,107,2740,3060,0,0,1
3,1.75,1520,7252,1.0,0,0,3,7,1140,380,1975,0,98072,47.7358,-122.175,1910,7820,405000,21,11,2014,0,39,5732,5910,0,1,0
2,1.0,830,4045,1.0,0,0,3,6,830,0,1943,0,98106,47.5293,-122.351,1100,4116,150000,17,7,2014,0,71,3215,3016,0,0,1
4,1.75,1880,9600,1.0,0,0,5,7,1020,860,1946,0,98001,47.2633,-122.281,1560,14400,240000,25,9,2014,0,68,7720,12840,0,1,0
4,2.25,2200,11250,1.5,0,0,5,7,1300,900,1920,0,98033,47.6845,-122.201,2320,10814,698000,2,5,2014,0,94,9050,8494,0,1,0
3,2.0,1800,10950,1.0,0,0,4,8,1800,0,1982,0,98006,47.557,-122.163,2400,11300,440000,9,3,2015,0,33,9150,8900,0,0,0
3,1.0,1200,12500,1.5,0,0,3,6,1200,0,1936,0,98198,47.4162,-122.329,1200,7500,204000,14,4,2015,0,79,11300,6300,0,0,1
3,2.0,2220,6641,1.0,0,2,4,7,1220,1000,1947,0,98199,47.6426,-122.388,1800,5900,875000,16,5,2014,0,67,4421,4100,0,1,1
3,1.5,1380,4500,1.0,0,0,5,7,1380,0,1960,0,98040,47.5866,-122.25,1590,9000,650000,3,7,2014,0,54,3120,7410,0,0,0
3,1.0,1660,8839,1.0,0,0,4,7,1660,0,1947,0,98155,47.7485,-122.3,1230,9236,392500,8,4,2015,0,68,7179,8006,0,0,1
4,1.0,2320,4000,1.5,0,0,3,6,1310,1010,1921,0,98144,47.573,-122.312,1750,4000,400000,17,10,2014,0,93,1680,2250,0,1,1
3,2.25,2800,17300,1.0,0,0,4,8,1420,1380,1971,0,98006,47.5716,-122.128,2140,12650,653000,28,4,2015,0,44,14500,10510,0,1,0
4,1.0,1210,3760,1.5,0,0,3,6,1210,0,1900,0,98103,47.6872,-122.344,1540,3800,452000,20,5,2014,0,114,2550,2260,0,0,1
4,2.5,2331,3826,2.0,0,0,3,8,2331,0,2007,0,98058,47.4444,-122.182,2441,3826,345000,6,5,2014,0,7,1495,1385,0,0,0
4,1.75,1820,6930,1.0,0,2,4,7,1320,500,1952,0,98178,47.5053,-122.242,1820,6825,350000,2,12,2014,0,62,5110,5005,0,1,1
4,2.5,2860,5576,2.0,0,0,3,8,2860,0,2004,0,98028,47.745,-122.224,2290,10667,650000,31,7,2014,0,10,2716,8377,0,0,0
5,3.0,2750,3800,1.5,0,0,5,7,1750,1000,1926,0,98115,47.6845,-122.313,1900,3800,525000,27,5,2014,0,88,1050,1900,0,1,1
5,3.0,2750,3800,1.5,0,0,5,7,1750,1000,1926,0,98115,47.6845,-122.313,1900,3800,840000,26,1,2015,0,89,1050,1900,0,1,1
3,2.5,2280,5000,2.0,0,3,4,9,2280,0,1926,0,98105,47.6574,-122.278,2200,5000,1330000,24,11,2014,0,88,2720,2800,0,0,1
4,2.0,1610,6650,1.0,0,0,3,7,1610,0,1989,0,98023,47.3085,-122.358,1960,6650,259950,20,1,2015,0,26,5040,4690,0,0,0
5,3.5,3760,10207,2.0,0,0,3,10,3150,610,1969,0,98040,47.5605,-122.225,3550,12118,998000,20,2,2015,0,46,6447,8568,0,1,0
3,3.0,2940,4622,2.0,0,0,4,9,2230,710,1988,0,98105,47.6641,-122.293,1580,4000,1070000,10,6,2014,0,26,1682,2420,0,1,1
4,3.0,4460,6833,2.0,0,0,3,10,3140,1320,1955,2007,98112,47.6342,-122.289,3130,7450,1910000,10,7,2014,52,59,2373,4320,1,1,1
3,1.5,1110,1150,2.0,0,0,3,8,940,170,2007,0,98144,47.5929,-122.306,1380,1751,190500,9,3,2015,0,8,40,371,0,1,1
3,1.0,1060,7419,1.0,0,2,4,6,1060,0,1906,0,98177,47.7712,-122.392,2190,5953,370000,4,2,2015,0,109,6359,3763,0,0,1
6,4.5,2810,11214,1.0,0,0,3,8,2010,800,1958,0,98031,47.4045,-122.197,1940,8349,290000,31,7,2014,0,56,8404,6409,0,1,0
3,1.75,1380,4590,1.0,0,0,2,7,930,450,1950,0,98115,47.6841,-122.293,1320,4692,350000,4,11,2014,0,64,3210,3372,0,1,1
3,1.75,1380,4590,1.0,0,0,2,7,930,450,1950,0,98115,47.6841,-122.293,1320,4692,740000,5,3,2015,0,65,3210,3372,0,1,1
3,1.75,2560,8400,1.0,0,0,3,7,1970,590,1959,0,98011,47.7668,-122.197,1970,8400,460000,7,10,2014,0,55,5840,6430,0,1,0
3,1.0,1010,10800,1.0,0,0,4,7,1010,0,1972,0,98045,47.4483,-121.773,1370,9500,290000,26,8,2014,0,42,9790,8130,0,0,0
3,2.5,1600,2231,2.0,0,0,3,7,1600,0,2003,0,98001,47.3314,-122.29,1600,2962,214000,26,9,2014,0,11,631,1362,0,0,0
2,1.0,910,5759,1.0,0,0,3,6,910,0,1951,0,98125,47.7153,-122.284,1520,7518,455000,8,5,2015,0,64,4849,5998,0,0,1
3,2.5,2497,4400,2.0,0,0,3,8,2497,0,2007,0,98001,47.2873,-122.283,2434,4400,275000,25,7,2014,0,7,1903,1966,0,0,0
3,1.5,1800,12196,1.0,0,0,4,7,1800,0,1966,0,98023,47.333,-122.345,1490,11730,305000,9,7,2014,0,48,10396,10240,0,0,0
3,2.5,1320,4320,1.0,0,0,3,6,660,660,1918,0,98106,47.5327,-122.347,1190,4200,366000,21,10,2014,0,96,3000,3010,0,1,1
3,2.5,1670,5090,2.0,0,0,3,7,1670,0,2003,0,98056,47.4799,-122.18,2560,4851,348000,28,3,2015,0,12,3420,2291,0,0,0
4,2.5,3360,11548,2.0,0,0,3,9,3360,0,1988,0,98033,47.6534,-122.182,3400,14091,950000,20,6,2014,0,26,8188,10691,0,0,0
3,3.0,1530,2132,2.0,0,0,3,8,1530,0,1993,0,98038,47.3746,-122.056,1530,3384,199950,20,1,2015,0,22,602,1854,0,0,0
3,2.0,1330,8100,1.0,0,0,4,7,1330,0,1969,0,98034,47.7251,-122.175,1590,8100,386000,5,6,2014,0,45,6770,6510,0,0,0
3,2.25,2160,7964,2.0,0,0,3,8,2160,0,1991,0,98042,47.3622,-122.074,2000,7964,273000,2,1,2015,0,24,5804,5964,0,0,0
4,2.5,1830,6360,2.0,0,0,3,8,1830,0,1994,0,98031,47.4184,-122.18,1830,6596,284000,25,3,2015,0,21,4530,4766,0,0,0
3,1.0,1470,7930,1.0,0,0,3,7,1070,400,1950,0,98177,47.7013,-122.368,1440,8100,399950,26,8,2014,0,64,6460,6660,0,1,1
3,1.75,1150,6423,1.0,0,0,3,5,590,560,1927,0,98115,47.6973,-122.297,1150,8367,285000,15,1,2015,0,88,5273,7217,0,1,1
3,2.5,1790,6452,2.0,0,0,3,7,1790,0,2004,0,98038,47.3841,-122.042,1610,3600,315000,3,4,2015,0,11,4662,1990,0,0,0
3,1.0,1700,7700,1.0,0,0,3,7,1120,580,1960,0,98168,47.5114,-122.318,1700,8800,250000,7,8,2014,0,54,6000,7100,0,1,1
4,2.0,1630,7618,1.5,0,0,3,7,1630,0,1967,0,98198,47.3658,-122.317,1320,8774,290000,16,3,2015,0,48,5988,7454,0,0,1
3,2.0,1650,9641,1.5,0,0,3,7,1650,0,1983,0,98034,47.7145,-122.231,1940,6701,410000,23,5,2014,0,31,7991,4761,0,0,0
4,2.5,2710,8127,2.0,0,0,3,8,2710,0,1994,0,98038,47.379,-122.032,2520,8436,399900,28,7,2014,0,20,5417,5916,0,0,0
4,2.5,3320,11901,2.0,0,0,5,9,2650,670,1977,0,98006,47.554,-122.16,2700,11114,852600,11,6,2014,0,37,8581,8414,0,1,0
2,1.0,720,6321,1.0,0,0,3,6,720,0,1940,0,98118,47.551,-122.289,920,5684,235000,8,8,2014,0,74,5601,4764,0,0,1
3,2.25,1490,8722,2.0,0,0,3,7,1490,0,1997,0,98030,47.3648,-122.185,1510,8061,230000,30,3,2015,0,18,7232,6551,0,0,0
3,2.5,1690,1609,2.0,0,0,3,8,1150,540,2014,0,98029,47.5521,-121.998,1690,1860,404763,29,7,2014,0,0,-81,170,0,1,0
3,2.5,1720,3407,2.0,0,0,3,7,1720,0,1992,0,98031,47.4034,-122.188,1720,3407,245000,23,9,2014,0,22,1687,1687,0,0,0
3,1.5,1140,8500,1.0,0,0,4,7,1140,0,1964,0,98022,47.2093,-122.005,1600,8500,188000,29,1,2015,0,51,7360,6900,0,0,0
4,2.5,2280,7219,2.0,0,0,4,8,2280,0,1987,0,98029,47.5719,-122.021,2240,7471,626100,4,12,2014,0,27,4939,5231,0,0,0
3,1.0,1100,4080,1.0,0,0,4,7,900,200,1929,0,98103,47.6872,-122.351,1170,4080,428750,2,3,2015,0,86,2980,2910,0,1,1
4,2.25,1800,8623,1.0,0,0,4,8,1360,440,1980,0,98033,47.692,-122.184,2370,8623,522000,12,5,2014,0,34,6823,6253,0,1,0
4,2.5,2500,8434,2.0,0,0,4,8,2500,0,1988,0,98052,47.6915,-122.101,1900,8131,684000,11,3,2015,0,27,5934,6231,0,0,0
3,2.25,2950,7232,1.0,0,2,3,8,1520,1430,1983,0,98136,47.5257,-122.382,2130,7140,1070000,20,4,2015,0,32,4282,5010,0,1,1
1,1.0,1940,6300,1.0,0,3,3,8,1940,0,1963,0,98116,47.5782,-122.4,2560,6300,611206,5,5,2015,0,52,4360,3740,0,0,1
2,1.0,1280,5250,1.0,0,0,4,7,1140,140,1942,0,98126,47.5258,-122.377,1050,5250,350000,15,9,2014,0,72,3970,4200,0,1,1
2,1.0,930,5368,1.0,0,0,4,7,930,0,1953,0,98115,47.6952,-122.275,1770,6000,420000,3,9,2014,0,61,4438,4230,0,0,1
5,2.0,1930,9747,1.0,0,0,4,7,1020,910,1962,0,98028,47.7743,-122.235,2040,9370,400000,29,5,2014,0,52,7817,7330,0,1,0
4,2.5,2800,8494,2.0,0,0,3,8,2800,0,2004,0,98038,47.3521,-122.009,3740,8494,426000,20,5,2014,0,10,5694,4754,0,0,0
4,2.25,3190,11597,2.0,0,0,3,10,2300,890,1984,0,98074,47.6323,-122.039,2990,10679,750000,27,6,2014,0,30,8407,7689,0,1,0
3,1.75,1710,10800,1.0,0,0,4,7,1710,0,1958,0,98028,47.7391,-122.241,1890,10800,368000,9,6,2014,0,56,9090,8910,0,0,0
3,1.0,1980,6450,1.0,0,0,4,6,1120,860,1950,0,98106,47.5291,-122.356,1180,5160,342000,27,3,2015,0,65,4470,3980,0,1,1
3,1.75,1910,4800,1.0,0,0,3,7,1080,830,1959,0,98103,47.6844,-122.332,1750,4800,700000,5,6,2014,0,55,2890,3050,0,1,1
6,3.75,3160,5000,2.0,0,0,3,8,3160,0,1989,0,98107,47.6748,-122.384,1740,5000,848750,22,7,2014,0,25,1840,3260,0,0,1
3,2.0,1590,5200,1.0,0,0,3,7,1320,270,1939,0,98103,47.6864,-122.341,1620,5150,720000,3,3,2015,0,76,3610,3530,0,1,1
4,2.25,1890,8549,1.0,0,0,3,8,1890,0,1967,0,98008,47.6328,-122.117,1940,7210,525000,22,9,2014,0,47,6659,5270,0,0,0
3,2.0,1740,18000,1.0,0,0,3,7,1230,510,1989,0,98028,47.7397,-122.242,1740,11250,405000,15,8,2014,0,25,16260,9510,0,1,0
3,2.0,1080,11856,1.0,0,0,5,7,1080,0,1986,0,98033,47.6955,-122.175,1220,9247,392800,28,1,2015,0,29,10776,8027,0,0,0
3,1.5,1730,7800,1.0,0,0,3,7,1330,400,1958,0,98133,47.7365,-122.337,1780,8309,394999,24,2,2015,0,57,6070,6529,0,1,1
3,2.5,2480,6112,2.0,0,0,3,7,2480,0,2004,0,98058,47.4387,-122.114,3220,6727,340000,19,6,2014,0,10,3632,3507,0,0,0
3,2.25,1450,1445,2.0,0,0,3,7,980,470,2005,0,98122,47.6184,-122.301,1510,1370,482500,19,5,2014,0,9,-5,-140,0,1,1
4,2.5,2750,10159,2.0,0,0,3,10,2750,0,1991,0,98006,47.5426,-122.135,3160,10159,812500,9,9,2014,0,23,7409,6999,0,0,0
3,2.5,2820,10208,1.0,0,1,4,8,1410,1410,1954,0,98028,47.7609,-122.26,1540,10684,450000,26,9,2014,0,60,7388,9144,0,1,0
2,3.25,1550,1767,3.0,1,3,3,8,1550,0,2006,0,98075,47.5684,-122.06,2710,3444,1080000,7,5,2015,0,9,217,734,0,0,0
2,2.0,1640,3021,1.0,0,2,3,7,840,800,1959,0,98107,47.666,-122.358,1780,4500,540000,14,10,2014,0,55,1381,2720,0,1,1
4,2.0,1720,5472,1.0,0,0,3,6,860,860,1923,0,98118,47.5299,-122.288,1720,5670,275000,3,10,2014,0,91,3752,3950,0,1,1
5,2.0,2880,12000,2.0,0,0,3,8,2880,0,1921,0,98144,47.5861,-122.295,1720,5000,780000,22,8,2014,0,93,9120,3280,0,0,1
3,1.5,1220,8345,1.5,0,0,3,7,1220,0,1931,0,98178,47.5038,-122.266,1880,10169,225000,24,7,2014,0,83,7125,8289,0,0,1
3,3.0,1560,2250,2.0,0,0,3,9,1560,0,2009,0,98103,47.6929,-122.333,1610,4500,503045,22,7,2014,0,5,690,2890,0,0,1
2,2.0,1090,1357,2.0,0,0,3,7,1090,0,1990,0,98028,47.7526,-122.244,1078,1318,249000,12,9,2014,0,24,267,240,0,0,0
4,1.0,1140,5940,1.0,0,2,3,7,1140,0,1916,0,98103,47.6795,-122.354,1630,4000,569950,10,7,2014,0,98,4800,2370,0,0,1
2,2.25,1040,1377,2.0,0,0,3,8,1040,0,2003,0,98105,47.6692,-122.279,1264,1892,450000,26,1,2015,0,12,337,628,0,0,1
4,2.0,2580,6000,1.0,0,0,5,9,1300,1280,1950,0,98199,47.6514,-122.413,2300,6200,1100000,3,6,2014,0,64,3420,3900,0,1,1
4,2.5,2310,3570,1.5,0,0,3,7,1490,820,1927,2014,98103,47.6889,-122.347,1580,3060,700000,30,5,2014,87,87,1260,1480,1,1,1
3,2.5,1590,4094,2.0,0,0,3,7,1590,0,1991,0,98122,47.61,-122.293,1940,3924,454000,19,8,2014,0,23,2504,1984,0,0,1
3,1.75,1270,9170,1.0,0,0,3,7,1270,0,1969,0,98052,47.6706,-122.151,1700,8500,555000,29,4,2015,0,46,7900,6800,0,0,0
3,1.5,1240,5200,1.0,0,0,5,6,1240,0,1970,0,98042,47.3683,-122.079,1060,5200,214000,6,1,2015,0,45,3960,4140,0,0,0
3,2.5,2210,8622,2.0,0,0,3,8,2210,0,1988,0,98029,47.5715,-122.02,2340,7192,590000,8,8,2014,0,26,6412,4852,0,0,0
3,1.5,1420,5000,1.0,0,0,3,7,920,500,1987,0,98198,47.4192,-122.33,1400,7500,205000,12,5,2015,0,28,3580,6100,0,1,1
3,1.75,1430,9857,1.0,0,2,4,7,1140,290,1980,0,98045,47.4964,-121.771,1310,9880,390000,12,5,2015,0,35,8427,8570,0,1,0
3,2.75,2470,10125,2.0,0,0,3,8,2470,0,1960,2012,98040,47.5651,-122.223,2290,10125,970500,20,6,2014,52,54,7655,7835,1,0,0
3,1.0,1120,10576,1.0,0,0,4,7,1120,0,1969,0,98077,47.7575,-122.072,1300,10000,320000,7,7,2014,0,45,9456,8700,0,0,0
3,2.25,2700,4025,2.0,0,0,4,8,1760,940,1907,0,98122,47.6074,-122.294,1580,4025,552500,23,7,2014,0,107,1325,2445,0,1,1
3,3.0,3490,4500,2.5,0,0,3,9,3170,320,1924,0,98102,47.6394,-122.321,2840,4050,1050000,19,11,2014,0,90,1010,1210,0,1,1
3,1.0,1640,7187,1.0,0,0,3,7,1640,0,1966,0,98058,47.455,-122.182,1340,8346,230000,23,9,2014,0,48,5547,7006,0,0,0
3,1.75,1620,5500,1.0,0,0,3,7,1110,510,1950,0,98112,47.6393,-122.308,2100,6500,680000,29,7,2014,0,64,3880,4400,0,1,1
3,1.75,1670,5400,2.0,0,0,5,8,1670,0,1912,0,98112,47.635,-122.284,2100,5400,985000,2,6,2014,0,102,3730,3300,0,0,1
4,2.5,1870,7471,2.0,0,0,3,8,1870,0,1990,0,98055,47.4314,-122.204,2020,8912,375000,23,6,2014,0,24,5601,6892,0,0,0
2,1.5,1300,4000,1.5,0,0,4,6,1300,0,1900,0,98144,47.5937,-122.301,1480,4000,431000,22,4,2015,0,115,2700,2520,0,0,1
3,2.5,2190,17108,2.0,0,0,3,8,2190,0,1991,0,98019,47.7321,-121.964,2400,14040,463000,9,9,2014,0,23,14918,11640,0,0,0
3,1.75,1320,10500,1.0,0,0,3,7,1320,0,1966,0,98034,47.7267,-122.226,1310,10500,350000,6,10,2014,0,48,9180,9190,0,0,0
3,1.0,1250,7200,1.0,0,0,3,7,1250,0,1964,0,98008,47.6342,-122.12,1430,7400,485000,14,4,2015,0,51,5950,5970,0,0,0
4,1.75,2040,15000,1.0,0,0,4,7,1360,680,1967,0,98092,47.3107,-122.189,2310,15000,355000,29,9,2014,0,47,12960,12690,0,1,0
3,1.75,2140,7280,1.0,0,0,3,7,1070,1070,1910,0,98117,47.6993,-122.377,2280,8400,603500,27,3,2015,0,105,5140,6120,0,1,1
5,1.75,2510,6000,1.5,0,0,5,8,2010,500,1920,0,98144,47.5798,-122.292,2240,5000,860000,19,8,2014,0,94,3490,2760,0,1,1
5,2.5,2200,6250,2.0,0,0,3,7,2200,0,1996,0,98038,47.3675,-122.021,1850,6091,259875,6,3,2015,0,19,4050,4241,0,0,0
4,2.5,2170,8680,1.0,0,0,3,7,1220,950,1959,0,98004,47.6078,-122.192,2010,8680,685000,16,7,2014,0,55,6510,6670,0,1,0
4,2.5,2980,8786,2.0,0,0,3,8,2980,0,2003,0,98038,47.378,-122.03,2980,6718,382500,30,9,2014,0,11,5806,3738,0,0,0
3,1.0,1180,2250,1.5,0,0,3,7,1180,0,1902,0,98117,47.6779,-122.377,1320,5100,490000,1,3,2015,0,113,1070,3780,0,0,1
3,2.0,1540,6000,1.0,0,0,4,6,1540,0,1953,0,98155,47.7372,-122.307,1490,8213,229000,26,1,2015,0,62,4460,6723,0,0,1
3,2.0,1540,6000,1.0,0,0,4,6,1540,0,1953,0,98155,47.7372,-122.307,1490,8213,430000,5,5,2015,0,62,4460,6723,0,0,1
5,2.5,3110,15783,1.0,0,0,3,8,1720,1390,1974,0,98052,47.6301,-122.103,2550,12220,580000,18,8,2014,0,40,12673,9670,0,1,0
3,1.75,1370,6700,1.0,0,0,3,8,1370,0,1940,2012,98117,47.6982,-122.362,1180,6694,510000,13,11,2014,72,74,5330,5514,1,0,1
3,2.25,1760,1800,2.0,0,0,3,7,1330,430,1983,0,98199,47.6579,-122.394,1150,4575,440000,16,9,2014,0,31,40,3425,0,1,1
3,2.5,2810,4984,1.0,0,0,3,9,1750,1060,2006,0,98055,47.4461,-122.209,2810,5711,479950,28,4,2015,0,9,2174,2901,0,1,0
3,2.5,2700,6037,2.0,0,0,3,8,2700,0,2004,0,98065,47.5376,-121.879,2740,6054,565000,10,2,2015,0,11,3337,3314,0,0,0
5,3.0,2680,9624,2.0,0,0,3,7,1870,810,1995,0,98010,47.3279,-122.006,1860,9921,359999,23,2,2015,0,20,6944,8061,0,1,0
3,1.75,1780,4500,1.0,0,0,4,7,920,860,1922,0,98117,47.6827,-122.362,1360,4000,625000,23,1,2015,0,93,2720,2640,0,1,1
3,2.5,2240,7565,2.0,0,0,3,8,2240,0,1999,0,98003,47.3485,-122.301,2190,8254,349950,12,9,2014,0,15,5325,6064,0,0,0
4,2.0,1610,9600,1.0,0,0,5,7,1610,0,1967,0,98056,47.5327,-122.186,1450,9600,415000,17,6,2014,0,47,7990,8150,0,0,0
2,2.0,1440,1170,2.0,0,0,3,9,960,480,2004,0,98116,47.5592,-122.385,1440,1350,435000,5,11,2014,0,10,-270,-90,0,1,1
3,1.75,1550,9060,2.0,0,0,3,7,1550,0,1948,1979,98146,47.5093,-122.345,1080,7620,225000,21,11,2014,31,66,7510,6540,1,0,1
3,1.75,1720,5000,1.0,0,0,3,9,1720,0,1954,2014,98122,47.6157,-122.29,2120,4188,770000,12,5,2014,60,60,3280,2068,1,0,1
3,1.75,1740,10800,1.0,0,0,3,7,1740,0,1959,0,98133,47.7717,-122.351,1810,7735,340000,6,1,2015,0,56,9060,5925,0,0,1
5,2.75,3280,12673,1.0,0,0,4,9,2050,1230,1981,0,98006,47.5504,-122.146,3060,12847,965000,12,3,2015,0,34,9393,9787,0,1,0
1,1.0,1100,4373,1.0,0,0,2,6,820,280,1947,0,98166,47.4653,-122.338,1100,7500,250000,7,5,2014,0,67,3273,6400,0,1,1
3,1.0,1180,11862,1.0,0,0,4,7,1180,0,1948,0,98177,47.7153,-122.363,1540,8100,397990,12,6,2014,0,66,10682,6560,0,0,1
3,1.75,2020,10031,1.0,0,0,5,7,1370,650,1952,0,98155,47.7487,-122.319,1500,8456,535000,18,9,2014,0,62,8011,6956,0,1,1
3,1.5,1150,8450,1.0,0,0,4,6,1150,0,1951,0,98178,47.4927,-122.224,1160,6800,265950,25,6,2014,0,63,7300,5640,0,0,1
3,1.75,2090,7461,1.0,0,0,3,6,1200,890,1986,0,98030,47.3764,-122.184,1420,7462,258000,7,10,2014,0,28,5371,6042,0,1,0
3,2.5,1300,1187,3.0,0,0,3,8,1300,0,2005,0,98107,47.6704,-122.391,1320,1194,505500,2,12,2014,0,9,-113,-126,0,0,1
5,2.5,2240,7770,1.0,0,0,3,7,1340,900,1978,0,98034,47.7198,-122.171,1820,7770,455000,6,5,2014,0,36,5530,5950,0,1,0
5,3.25,3540,5971,1.0,0,2,3,10,2000,1540,2005,0,98033,47.6643,-122.202,2820,6029,1350000,31,10,2014,0,9,2431,3209,0,1,0
4,2.5,2080,7047,2.0,0,0,3,8,2080,0,1996,0,98092,47.2627,-122.215,2580,7227,329800,5,2,2015,0,19,4967,4647,0,0,0
4,2.5,1900,9240,1.0,0,0,3,7,1900,0,1962,0,98007,47.6167,-122.137,2040,8052,450000,5,4,2015,0,53,7340,6012,0,0,0
3,3.5,2760,4500,2.0,0,0,3,9,2120,640,2004,0,98119,47.6529,-122.372,1950,6000,952000,18,12,2014,0,10,1740,4050,0,1,1
4,2.0,1410,4480,1.5,0,0,3,8,1410,0,1927,0,98109,47.6385,-122.344,1240,3400,625000,23,7,2014,0,87,3070,2160,0,0,1
2,1.0,1240,11393,1.0,0,0,4,7,1240,0,1960,0,98030,47.3714,-122.207,1660,11393,226800,12,3,2015,0,55,10153,9733,0,0,0
5,4.25,4420,13497,2.0,0,0,3,11,3510,910,2000,0,98059,47.5262,-122.143,4220,12015,1210000,12,12,2014,0,14,9077,7795,0,1,0
4,2.75,3390,16153,1.0,0,0,4,7,1970,1420,1961,0,98031,47.3954,-122.184,2530,8495,350000,3,10,2014,0,53,12763,5965,0,1,0
3,1.75,1400,8640,1.0,0,0,3,7,1400,0,1962,0,98011,47.7659,-122.204,1630,8640,395000,12,3,2015,0,53,7240,7010,0,0,0
5,3.0,2110,5260,2.0,0,0,3,7,1670,440,2002,0,98118,47.5449,-122.272,2110,5260,285000,19,9,2014,0,12,3150,3150,0,1,1
3,1.0,1270,16800,1.0,0,0,4,7,1270,0,1957,0,98188,47.4599,-122.276,1700,10200,254000,5,5,2015,0,58,15530,8500,0,0,1
2,1.5,2060,10880,1.0,0,0,3,6,1190,870,1924,0,98106,47.515,-122.362,1430,8781,348140,26,8,2014,0,90,8820,7351,0,1,1
4,2.75,2530,7350,1.0,0,0,5,8,1280,1250,1977,0,98023,47.313,-122.374,2280,7350,354950,26,6,2014,0,37,4820,5070,0,1,0
3,2.75,1900,6400,1.0,0,0,5,7,1410,490,1942,0,98105,47.6697,-122.281,1350,6400,706000,12,6,2014,0,72,4500,5050,0,1,1
4,2.5,2910,6479,2.0,0,0,3,7,2910,0,2006,0,98065,47.5402,-121.887,2320,5178,499000,5,5,2014,0,8,3569,2858,0,0,0
5,3.5,2880,10000,2.0,0,3,3,8,1980,900,1991,0,98055,47.4874,-122.223,2120,9535,439000,17,2,2015,0,24,7120,7415,0,1,0
3,1.0,1620,4774,1.5,0,0,3,7,1620,0,1920,0,98103,47.659,-122.339,1880,4560,842000,17,10,2014,0,94,3154,2680,0,0,1
2,1.0,1200,9000,1.0,0,2,5,6,1200,0,1917,0,98198,47.4039,-122.323,1660,9000,255000,9,6,2014,0,97,7800,7340,0,0,1
5,2.25,2130,4360,1.0,0,2,3,8,1240,890,1959,0,98199,47.6586,-122.395,1830,5000,565000,31,12,2014,0,55,2230,3170,0,1,1
5,1.75,1950,8720,1.0,0,0,3,7,1050,900,1962,0,98001,47.3381,-122.289,1660,8030,274000,25,2,2015,0,53,6770,6370,0,1,0
3,2.0,1920,8075,1.0,0,0,4,7,1510,410,1969,0,98023,47.3092,-122.375,1920,7826,260000,9,5,2014,0,45,6155,5906,0,1,0
4,2.0,2510,13695,1.0,0,0,4,7,1280,1230,1961,2001,98033,47.7005,-122.174,1220,12500,581000,7,5,2014,40,53,11185,11280,1,1,0
3,1.5,1990,5978,1.5,1,4,4,7,1990,0,1926,0,98198,47.3449,-122.329,2100,6221,625000,25,7,2014,0,88,3988,4121,0,0,1
3,1.0,1230,9720,1.0,0,0,5,7,1230,0,1969,0,98042,47.3266,-122.138,1230,9720,220000,29,12,2014,0,45,8490,8490,0,0,0
6,4.25,5720,10213,2.0,0,0,3,10,4170,1550,2004,0,98006,47.5464,-122.116,4300,10224,1330000,10,7,2014,0,10,4493,5924,0,1,0
8,2.5,2280,3000,1.5,0,0,3,7,1210,1070,1911,0,98105,47.6675,-122.316,1610,3000,700000,18,3,2015,0,104,720,1390,0,1,1
4,1.0,1550,7260,1.0,0,0,4,6,1550,0,1959,0,98008,47.6229,-122.121,1210,7260,351000,24,9,2014,0,55,5710,6050,0,0,0
3,2.5,1690,1613,2.0,0,0,3,8,1150,540,2014,0,98029,47.5524,-121.998,1690,1619,413565,5,8,2014,0,0,-77,-71,0,1,0
3,3.25,1651,1779,2.0,0,0,3,8,1341,310,2008,0,98133,47.7076,-122.346,1650,2908,363000,12,6,2014,0,6,128,1258,0,1,1
2,1.75,1510,4555,1.0,0,0,3,8,1510,0,2005,0,98053,47.7136,-122.031,1640,4500,473000,10,9,2014,0,9,3045,2860,0,0,0
3,2.0,1490,7431,1.0,0,0,4,7,1490,0,1966,0,98052,47.6697,-122.162,1700,7725,585888,21,4,2015,0,49,5941,6025,0,0,0
4,2.5,2220,4652,2.0,0,0,3,7,2220,0,2001,0,98059,47.4902,-122.154,1840,4500,405000,26,6,2014,0,13,2432,2660,0,0,0
3,2.0,2150,3880,1.0,0,0,3,8,1080,1070,1951,0,98117,47.6814,-122.392,2130,4000,575000,22,12,2014,0,63,1730,1870,0,1,1
3,2.25,1400,7205,1.0,0,0,3,7,1140,260,1985,0,98030,47.349,-122.166,1970,7252,220000,17,7,2014,0,29,5805,5282,0,1,0
4,3.0,2450,10117,1.0,0,0,5,8,1580,870,1967,0,98006,47.5694,-122.132,2530,10125,610000,6,5,2014,0,47,7667,7595,0,1,0
3,1.0,980,6380,1.0,0,0,3,7,760,220,1941,0,98115,47.692,-122.308,1390,6380,499950,12,5,2014,0,73,5400,4990,0,1,1
4,2.5,2800,6874,2.0,0,0,3,9,2170,630,1990,0,98112,47.6215,-122.29,1430,6240,883000,3,3,2015,0,25,4074,4810,0,1,1
2,1.0,1240,8100,1.5,0,2,3,7,1240,0,1925,0,98125,47.7326,-122.288,2790,8100,436000,23,10,2014,0,89,6860,5310,0,0,1
3,2.5,1610,1356,2.0,0,0,3,8,1240,370,2007,0,98106,47.5257,-122.361,1270,1314,320000,13,12,2014,0,7,-254,44,0,1,1
4,2.0,1670,9987,1.0,0,0,3,7,1670,0,1967,0,98001,47.3406,-122.284,1640,7280,204700,15,5,2014,0,47,8317,5640,0,0,0
6,3.0,2320,4502,1.0,0,0,4,7,1200,1120,1987,0,98108,47.5552,-122.3,1160,5628,384000,17,7,2014,0,27,2182,4468,0,1,1
3,2.75,1900,8200,2.0,0,0,4,7,1900,0,1984,0,98031,47.402,-122.183,1620,8200,314000,13,1,2015,0,31,6300,6580,0,0,0
3,2.5,2390,6263,2.0,0,0,3,9,2390,0,2003,0,98028,47.7379,-122.248,2390,11761,535000,30,4,2015,0,12,3873,9371,0,0,0
4,1.5,1470,5850,1.0,0,0,4,7,810,660,1973,0,98052,47.7,-122.129,1290,7300,426000,1,5,2015,0,42,4380,6010,0,1,0
4,2.75,2670,6780,2.0,0,3,5,8,1630,1040,1908,0,98118,47.5131,-122.256,2400,5989,675000,9,12,2014,0,106,4110,3589,0,1,1
4,2.5,2540,6365,2.0,0,0,3,8,1870,670,2000,0,98055,47.4608,-122.215,2290,5942,380000,13,6,2014,0,14,3825,3652,0,1,0
3,2.5,3450,8000,3.0,0,0,4,8,2970,480,1927,1975,98116,47.5605,-122.402,1880,6135,685000,23,7,2014,48,87,4550,4255,1,1,1
4,1.5,1810,6583,1.0,0,0,3,7,1500,310,1968,0,98133,47.7273,-122.351,860,8670,799000,21,4,2015,0,47,4773,7810,0,1,1
5,1.75,1550,6986,1.0,0,0,3,7,1030,520,1978,0,98106,47.5503,-122.356,1550,6986,318500,20,9,2014,0,36,5436,5436,0,1,1
3,1.5,2080,5000,1.0,0,0,3,7,1300,780,1963,0,98118,47.5322,-122.29,1860,5000,420000,24,2,2015,0,52,2920,3140,0,1,1
2,1.0,1100,4000,1.0,0,0,3,7,1100,0,1906,0,98109,47.6388,-122.35,1590,4000,570000,18,12,2014,0,108,2900,2410,0,0,1
4,2.75,3950,12840,2.0,0,0,5,8,3950,0,1960,0,98040,47.5489,-122.219,2350,12507,1050000,13,8,2014,0,54,8890,10157,0,0,0
3,1.0,1250,8450,1.0,0,0,4,7,1250,0,1954,0,98146,47.503,-122.364,1350,9300,333000,17,9,2014,0,60,7200,7950,0,0,1
2,1.75,2620,14138,2.0,1,4,3,8,2120,500,1931,1991,98125,47.7142,-122.277,1830,8279,1360000,24,2,2015,60,84,11518,6449,1,1,1
3,2.5,2290,2798,3.0,0,0,4,9,2290,0,1953,1983,98102,47.641,-122.315,2260,5000,660000,3,6,2014,30,61,508,2740,1,0,1
6,4.5,3500,8504,2.0,0,0,3,7,3500,0,1980,0,98155,47.7351,-122.295,1550,8460,350000,17,9,2014,0,34,5004,6910,0,0,1
6,4.5,3500,8504,2.0,0,0,3,7,3500,0,1980,0,98155,47.7351,-122.295,1550,8460,682500,21,1,2015,0,35,5004,6910,0,0,1
5,2.75,1690,4000,1.0,0,0,5,7,970,720,1943,0,98106,47.5312,-122.354,1240,4000,399990,10,12,2014,0,71,2310,2760,0,1,1
2,1.0,1120,7797,1.0,0,0,3,6,1120,0,1948,0,98055,47.4871,-122.22,2180,7200,216180,21,10,2014,0,66,6677,5020,0,0,0
4,2.25,1740,9613,2.0,0,0,5,8,1740,0,1989,0,98058,47.463,-122.125,1680,9769,300000,15,9,2014,0,25,7873,8089,0,0,0
3,1.0,1010,11880,1.0,0,0,3,7,1010,0,1960,0,98030,47.3762,-122.219,1150,9435,145000,14,10,2014,0,54,10870,8285,0,0,0
3,1.0,1010,11880,1.0,0,0,3,7,1010,0,1960,0,98030,47.3762,-122.219,1150,9435,255000,5,3,2015,0,55,10870,8285,0,0,0
3,1.0,1020,8625,1.0,0,0,3,7,1020,0,1978,0,98045,47.4465,-121.77,1290,9440,245000,29,10,2014,0,36,7605,8150,0,0,0
3,1.75,1850,7056,2.5,0,0,4,8,1850,0,1979,0,98052,47.6602,-122.13,1970,7056,445000,14,10,2014,0,35,5206,5086,0,0,0
3,1.5,1830,8000,1.0,0,0,4,7,1830,0,1957,0,98008,47.6017,-122.122,1310,7500,562000,14,5,2014,0,57,6170,6190,0,0,0
4,1.0,2070,7519,1.0,0,0,3,7,1160,910,1963,0,98008,47.632,-122.119,1730,7519,501000,5,5,2014,0,51,5449,5789,0,1,0
3,1.75,1160,5850,1.0,0,0,4,6,1160,0,1918,0,98146,47.5064,-122.356,1110,8382,190000,13,1,2015,0,97,4690,7272,0,0,1
5,2.5,2340,6000,2.0,0,0,4,10,2340,0,1922,0,98144,47.5764,-122.287,2350,6000,1090000,11,6,2014,0,92,3660,3650,0,0,1
5,3.25,4300,9270,2.0,0,3,3,10,2910,1390,1957,2009,98116,47.5717,-122.409,2780,6610,1400000,9,10,2014,52,57,4970,3830,1,1,1
3,1.5,1590,8256,1.0,0,1,3,7,1090,500,1969,0,98003,47.3488,-122.304,1950,7840,284850,16,12,2014,0,45,6666,5890,0,1,0
4,2.5,2590,7910,2.0,0,0,3,9,2590,0,2003,0,98028,47.7378,-122.248,2110,11761,570000,19,2,2015,0,12,5320,9651,0,0,0
3,1.75,1720,6000,1.0,0,2,3,7,1000,720,1954,0,98178,47.4999,-122.223,1690,6000,304000,3,10,2014,0,60,4280,4310,0,1,1
4,2.5,1790,9787,1.0,0,2,4,8,1240,550,1983,0,98056,47.5344,-122.189,1790,9787,560000,16,12,2014,0,31,7997,7997,0,1,0
3,1.0,1590,8160,1.0,0,1,3,7,1090,500,1954,0,98198,47.4013,-122.321,1540,10500,325000,26,8,2014,0,60,6570,8960,0,1,1
4,2.0,1580,4800,1.5,0,2,3,7,1580,0,1912,0,98136,47.5454,-122.383,1580,4800,557510,6,2,2015,0,103,3220,3220,0,0,1
4,2.25,2580,8820,1.0,0,0,4,9,1620,960,1967,0,98023,47.3122,-122.376,2140,8400,305000,20,4,2015,0,48,6240,6260,0,1,0
3,1.0,1180,7210,1.0,0,0,4,7,1180,0,1963,0,98034,47.7267,-122.241,1700,7210,383001,4,9,2014,0,51,6030,5510,0,0,0
2,1.0,1190,5000,1.0,0,0,3,7,1190,0,1925,0,98116,47.5717,-122.382,1600,5000,487500,8,4,2015,0,90,3810,3400,0,0,1
5,2.5,2450,6994,2.0,0,0,3,8,2450,0,2002,0,98030,47.3572,-122.192,1940,6035,345000,2,7,2014,0,12,4544,4095,0,0,0
6,2.75,2630,16411,1.0,0,0,4,8,1650,980,1974,0,98052,47.6309,-122.093,2250,12255,583000,4,6,2014,0,40,13781,10005,0,1,0
3,2.25,2130,12286,2.0,0,0,3,8,2130,0,1977,0,98052,47.6471,-122.114,2130,10158,534950,12,8,2014,0,37,10156,8028,0,0,0
4,1.0,1060,5750,1.0,0,0,3,6,950,110,1904,0,98199,47.6562,-122.389,1790,5857,403504,12,8,2014,0,110,4690,4067,0,1,1
3,1.75,1480,6120,1.5,0,0,3,7,1480,0,1946,0,98115,47.6858,-122.295,1480,6120,500000,27,4,2015,0,69,4640,4640,0,0,1
4,2.75,2440,5080,2.0,0,0,3,8,1750,690,1960,0,98126,47.5547,-122.379,1920,6375,525000,12,11,2014,0,54,2640,4455,0,1,1
4,2.75,2890,5000,1.5,0,0,3,8,1990,900,1911,2014,98117,47.6768,-122.363,1080,3750,898500,4,8,2014,103,103,2110,2670,1,1,1
4,2.75,2900,6400,2.0,0,0,3,7,2040,860,1911,1970,98136,47.5563,-122.393,1340,6144,450000,1,12,2014,59,103,3500,4804,1,1,1
4,2.25,2650,8149,1.0,0,0,4,8,1610,1040,1975,0,98006,47.5624,-122.176,2290,8019,665000,21,3,2015,0,40,5499,5729,0,1,0
4,2.5,2560,4000,2.0,0,0,5,8,1610,950,1929,0,98117,47.6885,-122.386,1760,4000,825000,2,11,2014,0,85,1440,2240,0,1,1
3,1.0,1150,4800,1.5,0,0,4,6,1150,0,1938,0,98002,47.3101,-122.212,1310,9510,200000,25,6,2014,0,76,3650,8200,0,0,0
3,2.0,1760,6092,1.0,0,0,3,7,1760,0,1998,0,98030,47.3838,-122.184,2590,6255,295000,4,9,2014,0,16,4332,3665,0,0,0
4,2.5,3220,8379,2.0,0,0,3,10,3220,0,2004,0,98034,47.7043,-122.192,2720,7635,748000,15,12,2014,0,10,5159,4915,0,0,0
3,1.0,1250,10744,1.0,0,0,3,6,1250,0,1942,0,98198,47.4226,-122.327,1500,10710,275000,12,2,2015,0,73,9494,9210,0,0,1
3,1.0,1000,8470,1.0,0,0,4,6,1000,0,1963,0,98023,47.3056,-122.37,1020,8470,196000,26,3,2015,0,52,7470,7450,0,0,0
2,1.0,740,11250,1.0,0,0,2,6,740,0,1938,0,98146,47.5036,-122.362,1390,11250,235750,22,5,2014,0,76,10510,9860,0,0,1
3,2.25,2170,8480,1.0,0,0,3,8,2170,0,1965,0,98148,47.4562,-122.33,2080,8452,315000,23,3,2015,0,50,6310,6372,0,0,1
4,2.5,2370,10631,2.0,0,0,3,8,2370,0,1999,0,98003,47.3473,-122.302,2200,8297,338000,25,8,2014,0,15,8261,6097,0,0,0
4,2.5,2300,4249,2.0,0,0,3,8,2300,0,2006,0,98038,47.3516,-122.0,2390,4385,353000,21,1,2015,0,9,1949,1995,0,0,0
3,1.75,1400,6300,1.0,0,0,3,7,1400,0,1998,0,98022,47.2074,-122.001,1400,8490,235000,27,6,2014,0,16,4900,7090,0,0,0
4,2.25,2350,12540,2.0,0,0,3,8,2350,0,1968,0,98177,47.7732,-122.382,2090,7964,505000,18,9,2014,0,46,10190,5874,0,0,1
4,3.0,2660,4600,1.5,0,0,3,8,1820,840,1906,2002,98112,47.6258,-122.305,2350,4600,1230000,6,3,2015,96,109,1940,2250,1,1,1
3,2.0,1100,6360,1.0,0,0,3,7,1100,0,1991,0,98038,47.3878,-122.052,1620,6360,240000,16,10,2014,0,23,5260,4740,0,0,0
4,3.25,3640,3604,2.0,0,2,5,9,1960,1680,1913,0,98122,47.6145,-122.284,1940,4600,1270000,11,9,2014,0,101,-36,2660,0,1,1
2,1.75,1350,2653,2.0,0,0,3,7,1350,0,1986,0,98033,47.6934,-122.184,1370,4115,405000,14,4,2015,0,29,1303,2745,0,0,0
4,2.0,1310,8454,1.0,0,0,4,7,1310,0,1953,0,98155,47.7572,-122.318,1320,8274,304000,24,6,2014,0,61,7144,6954,0,0,1
4,2.25,1800,5555,2.0,0,0,3,7,1800,0,2003,0,98038,47.3498,-122.052,1810,5669,272000,10,10,2014,0,11,3755,3859,0,0,0
2,1.0,1260,3960,1.0,0,0,3,6,690,570,1925,0,98117,47.6899,-122.391,1250,3960,412000,20,6,2014,0,89,2700,2710,0,1,1
4,2.5,2990,7231,2.0,0,0,3,9,2990,0,2001,0,98075,47.5623,-122.032,3160,8339,698000,18,7,2014,0,13,4241,5179,0,0,0
2,1.0,1140,5100,1.0,0,0,3,7,1140,0,1942,0,98136,47.5323,-122.383,1230,5100,400000,9,6,2014,0,72,3960,3870,0,0,1
3,2.5,2100,6825,2.0,0,0,3,8,2100,0,1994,0,98055,47.4314,-122.189,2180,7614,305000,20,11,2014,0,20,4725,5434,0,0,0
4,2.0,2400,12753,1.0,0,0,4,7,2400,0,1962,0,98033,47.6947,-122.177,1830,12060,585000,10,9,2014,0,52,10353,10230,0,0,0
2,1.5,1400,9031,1.0,0,0,3,7,960,440,1982,0,98023,47.2915,-122.368,1450,7658,190000,12,8,2014,0,32,7631,6208,0,1,0
4,2.5,2990,12788,2.0,0,0,3,10,2990,0,1988,0,98075,47.5601,-122.037,3250,12212,760000,20,7,2014,0,26,9798,8962,0,0,0
3,1.0,980,6800,1.0,0,0,3,6,980,0,1946,0,98058,47.4411,-122.186,1140,9975,144000,6,11,2014,0,68,5820,8835,0,0,0
2,1.0,690,5280,1.0,0,0,4,5,690,0,1942,0,98056,47.4953,-122.187,1140,4860,139000,24,6,2014,0,72,4590,3720,0,0,0
4,1.5,1430,6380,1.5,0,0,4,7,1130,300,1945,0,98115,47.6942,-122.319,1570,6380,525000,19,11,2014,0,69,4950,4810,0,1,1
1,1.0,1110,5421,1.0,0,0,3,6,1110,0,1935,0,98177,47.7322,-122.359,1230,8100,293000,16,7,2014,0,79,4311,6870,0,0,1
2,2.5,1250,1580,2.0,0,0,3,7,1030,220,2005,0,98106,47.5243,-122.36,1250,1361,267100,27,4,2015,0,10,330,111,0,1,1
4,3.25,3470,5222,2.0,0,0,3,10,2830,640,2005,0,98033,47.6845,-122.209,3090,6758,1500000,21,4,2015,0,10,1752,3668,0,1,0
3,2.25,1500,15334,2.0,0,0,4,7,1500,0,1992,0,98042,47.3719,-122.091,1530,8102,240000,28,10,2014,0,22,13834,6572,0,0,0
3,2.5,2530,7000,2.5,0,4,3,9,2530,0,1915,1999,98136,47.5465,-122.398,2380,7000,975000,9,4,2015,84,100,4470,4620,1,0,1
5,1.75,2150,7171,1.0,0,0,4,7,1460,690,1970,0,98031,47.3952,-122.176,1710,7300,279950,18,6,2014,0,44,5021,5590,0,1,0
3,1.75,1260,7373,1.0,0,0,4,7,1260,0,1979,0,98034,47.7296,-122.233,1360,7373,405000,27,1,2015,0,36,6113,6013,0,0,0
3,1.0,960,6500,1.0,0,0,4,5,960,0,1954,0,98056,47.497,-122.171,1150,6500,225000,24,11,2014,0,60,5540,5350,0,0,0
3,1.0,1520,7800,1.0,0,0,4,7,1120,400,1967,0,98032,47.3784,-122.29,1740,8000,250000,29,12,2014,0,47,6280,6260,0,1,0
3,2.25,1570,9096,1.0,0,0,4,7,1180,390,1991,0,98022,47.1937,-121.99,1570,8418,272950,31,3,2015,0,24,7526,6848,0,1,0
5,1.0,3240,5324,2.0,0,0,3,9,3240,0,2007,0,98065,47.523,-121.875,3240,6036,625000,22,7,2014,0,7,2084,2796,0,0,0
3,1.75,1280,2147,1.5,0,0,4,7,1280,0,1910,0,98102,47.6362,-122.324,2010,2640,670000,18,7,2014,0,104,867,630,0,0,1
3,2.5,2130,3545,3.0,0,0,5,9,2130,0,1990,0,98109,47.6389,-122.349,1970,3464,1070000,1,4,2015,0,25,1415,1494,0,0,1
3,1.75,1970,8200,1.0,0,0,5,8,1420,550,1963,0,98177,47.7602,-122.363,2140,8000,540000,18,6,2014,0,51,6230,5860,0,1,1
3,2.5,2990,6725,2.0,0,0,3,9,2990,0,2003,0,98059,47.4928,-122.142,2790,6725,525000,5,11,2014,0,11,3735,3935,0,0,0
2,1.0,1160,17700,1.0,0,0,3,7,1160,0,1947,0,98133,47.7244,-122.331,1440,9000,425000,3,3,2015,0,68,16540,7560,0,0,1
3,1.75,1890,7004,1.0,0,0,3,7,1290,600,1965,0,98118,47.5557,-122.28,1440,5378,465500,2,6,2014,0,49,5114,3938,0,1,1
3,2.5,2170,5866,2.0,0,0,3,7,2170,0,2006,0,98065,47.5403,-121.889,2440,5798,443500,17,7,2014,0,8,3696,3358,0,0,0
3,2.25,1250,952,3.0,0,0,3,8,1250,0,2008,0,98133,47.7098,-122.333,1250,1030,205000,20,2,2015,0,7,-298,-220,0,0,1
4,2.5,1940,10200,1.0,0,0,4,8,1140,800,1977,0,98042,47.4157,-122.161,1920,12600,315000,26,6,2014,0,37,8260,10680,0,1,0
3,2.5,2150,8221,2.0,0,0,3,8,2150,0,1992,0,98059,47.5085,-122.15,2490,7951,470000,23,6,2014,0,22,6071,5461,0,0,0
4,2.25,3310,8540,1.0,0,4,4,9,1660,1650,1973,0,98006,47.5603,-122.158,3450,9566,1100000,29,7,2014,0,41,5230,6116,0,1,0
4,2.5,2660,12672,1.0,0,0,4,8,1740,920,1960,0,98003,47.3334,-122.323,2280,12477,310000,18,6,2014,0,54,10012,10197,0,1,0
3,1.0,950,13475,1.0,0,0,3,7,950,0,1950,0,98155,47.7543,-122.306,1240,8910,305000,2,6,2014,0,64,12525,7670,0,0,1
3,1.5,1480,6752,1.0,0,0,4,7,1480,0,1959,0,98056,47.4993,-122.176,1450,8023,307150,10,7,2014,0,55,5272,6573,0,0,0
4,2.5,2840,12866,1.0,0,0,4,9,1780,1060,1977,0,98005,47.6388,-122.167,2840,13209,729032,1,7,2014,0,37,10026,10369,0,1,0
5,2.5,3240,9960,1.0,0,1,3,8,2020,1220,1958,0,98008,47.5858,-122.112,2730,10400,750000,3,3,2015,0,57,6720,7670,0,1,0
4,2.5,1961,3207,2.0,0,0,3,7,1961,0,2006,0,98042,47.3507,-122.16,1961,3401,289000,3,2,2015,0,9,1246,1440,0,0,0
3,1.0,1100,5700,1.0,0,0,3,7,1100,0,1950,0,98115,47.6883,-122.282,1560,6588,480000,15,4,2015,0,65,4600,5028,0,0,1
3,1.75,1500,7367,1.0,0,0,3,8,1500,0,1974,0,98033,47.6722,-122.167,1920,7579,529000,19,2,2015,0,41,5867,5659,0,0,0
3,1.75,1480,4800,2.0,0,0,4,7,1140,340,1944,0,98199,47.6567,-122.397,1810,4800,585000,28,7,2014,0,70,3320,2990,0,1,1
4,2.75,2510,12500,1.0,0,0,5,8,2050,460,1976,0,98052,47.6278,-122.11,2200,12088,704000,25,9,2014,0,38,9990,9888,0,1,0
4,2.0,1490,4054,1.5,0,0,5,7,1490,0,1926,0,98115,47.6744,-122.301,1510,3889,607000,4,3,2015,0,89,2564,2379,0,0,1
3,2.25,2190,8188,2.0,0,0,3,8,1810,380,1978,0,98052,47.6883,-122.113,2190,8374,580000,10,3,2015,0,37,5998,6184,0,1,0
5,2.5,2530,8564,2.0,0,0,4,8,2530,0,1976,0,98006,47.5622,-122.153,2480,8714,875000,5,8,2014,0,38,6034,6234,0,0,0
4,2.5,2440,9350,1.0,0,0,4,8,1560,880,1976,0,98006,47.5614,-122.13,2260,8500,610000,15,10,2014,0,38,6910,6240,0,1,0
4,2.5,2210,5002,1.0,0,0,3,7,1370,840,1977,0,98199,47.6637,-122.401,1970,4920,733000,5,3,2015,0,38,2792,2950,0,1,1
2,1.0,1620,9855,1.0,0,4,3,8,1320,300,1948,0,98136,47.5264,-122.384,1820,7700,700000,7,10,2014,0,66,8235,5880,0,1,1
4,2.75,2410,5225,2.0,0,0,3,8,2410,0,2001,0,98058,47.4244,-122.151,2300,5378,379000,22,12,2014,0,13,2815,3078,0,0,0
2,1.0,920,4400,1.0,0,0,3,7,920,0,1948,0,98103,47.6903,-122.332,1560,4600,412133,19,11,2014,0,66,3480,3040,0,0,1
4,2.25,2330,14190,1.0,0,0,3,8,1740,590,1962,0,98034,47.718,-122.242,2330,14190,480000,2,4,2015,0,53,11860,11860,0,1,0
3,1.75,1940,10245,1.0,0,0,3,7,1940,0,1957,0,98040,47.5833,-122.241,2720,11448,650000,18,12,2014,0,57,8305,8728,0,0,0
2,2.5,1900,5065,2.0,0,0,3,8,1900,0,2005,0,98053,47.7175,-122.034,1350,4664,505000,30,3,2015,0,10,3165,3314,0,0,0
4,2.5,3510,17400,1.0,0,0,4,9,1930,1580,1957,0,98005,47.5963,-122.171,2730,12120,931088,5,5,2015,0,58,13890,9390,0,1,0
4,1.75,1860,7700,1.0,0,0,4,8,1860,0,1964,0,98008,47.626,-122.112,1860,7700,570000,26,9,2014,0,50,5840,5840,0,0,0
3,1.0,1380,4635,1.0,0,0,4,6,1380,0,1919,0,98144,47.57,-122.285,1790,4635,475000,13,8,2014,0,95,3255,2845,0,0,1
6,1.75,2210,8594,1.0,0,0,3,7,1310,900,1959,0,98188,47.4594,-122.273,1850,8594,240000,5,8,2014,0,55,6384,6744,0,1,1
3,1.0,1500,6600,1.0,0,0,2,6,1500,0,1970,0,98168,47.4845,-122.33,1730,6600,243000,16,9,2014,0,44,5100,4870,0,0,1
2,1.75,2080,8112,1.0,1,4,4,8,1040,1040,1939,1984,98125,47.7134,-122.277,2030,8408,1190000,13,10,2014,45,75,6032,6378,1,1,1
3,2.5,2080,4307,2.0,0,0,3,7,2080,0,2004,0,98065,47.53,-121.848,2080,4947,368000,10,9,2014,0,10,2227,2867,0,0,0
5,4.25,3970,4500,2.0,0,0,3,9,2860,1110,2004,0,98027,47.5402,-122.069,3480,4500,811500,20,11,2014,0,10,530,1020,0,1,0
2,1.0,770,8149,1.0,0,0,5,6,770,0,1948,0,98155,47.7406,-122.302,770,8150,275000,4,6,2014,0,66,7379,7380,0,0,1
4,2.5,2500,6005,2.0,0,0,3,9,2500,0,2001,0,98033,47.6922,-122.174,2680,7200,650000,29,9,2014,0,13,3505,4520,0,0,0
3,2.5,1340,10018,1.0,0,0,4,7,1340,0,1976,0,98052,47.6366,-122.094,2520,13068,425000,15,8,2014,0,38,8678,10548,0,0,0
3,2.5,2640,13775,1.0,0,0,3,8,1550,1090,1978,0,98005,47.5875,-122.177,2120,12432,530000,10,12,2014,0,36,11135,10312,0,1,0
4,1.75,2740,8520,1.0,0,2,3,8,1370,1370,1954,0,98118,47.5445,-122.263,2740,9286,657000,22,5,2014,0,60,5780,6546,0,1,1
4,2.75,1580,3770,1.0,0,0,3,7,1080,500,2002,0,98019,47.7368,-121.968,1740,3800,315000,31,12,2014,0,12,2190,2060,0,1,0
3,2.75,1960,13252,1.0,0,0,5,8,1240,720,1975,0,98006,47.5582,-122.139,2040,9866,550000,15,9,2014,0,39,11292,7826,0,1,0
2,2.25,1560,1705,2.0,0,0,3,8,1270,290,2006,0,98126,47.5482,-122.374,1560,1758,347000,15,12,2014,0,8,145,198,0,1,1
5,2.75,2440,8000,1.0,0,0,4,7,1240,1200,1972,0,98034,47.7283,-122.17,1780,8391,525000,6,6,2014,0,42,5560,6611,0,1,0
3,1.5,990,1343,2.0,0,0,3,8,840,150,2007,0,98112,47.6236,-122.306,1350,2521,490000,25,9,2014,0,7,353,1171,0,1,1
3,2.25,2210,7916,2.0,0,0,3,8,2210,0,1978,0,98133,47.7175,-122.339,1450,7955,500000,29,12,2014,0,36,5706,6505,0,0,1
3,2.75,3080,7282,2.0,0,0,3,9,3080,0,2008,0,98059,47.4826,-122.149,3080,7274,585000,28,1,2015,0,7,4202,4194,0,0,0
1,1.0,1020,3200,1.0,0,0,3,7,1020,0,1927,0,98109,47.6361,-122.343,1670,3480,465000,24,10,2014,0,87,2180,1810,0,0,1
4,2.0,1900,8160,1.0,0,0,3,7,1900,0,1975,0,98022,47.2114,-121.986,1280,6532,200000,27,3,2015,0,40,6260,5252,0,0,0
6,4.75,5770,16747,2.0,0,3,3,12,4500,1270,1998,0,98006,47.5512,-122.11,4470,14571,1680000,26,1,2015,0,17,10977,10101,0,1,0
3,4.0,2080,2250,3.0,0,4,3,8,2080,0,1997,0,98103,47.6598,-122.355,2080,2250,715000,3,7,2014,0,17,170,170,0,0,1
3,4.0,2080,2250,3.0,0,4,3,8,2080,0,1997,0,98103,47.6598,-122.355,2080,2250,780000,24,4,2015,0,18,170,170,0,0,1
2,1.0,1480,4080,1.0,0,0,3,7,1050,430,1949,0,98117,47.6842,-122.393,1310,4080,410000,18,8,2014,0,65,2600,2770,0,1,1
2,1.0,1480,4080,1.0,0,0,3,7,1050,430,1949,0,98117,47.6842,-122.393,1310,4080,778100,6,5,2015,0,66,2600,2770,0,1,1
3,1.0,1090,11292,1.0,0,0,4,7,1090,0,1952,0,98133,47.7429,-122.358,1570,8198,406000,30,3,2015,0,63,10202,6628,0,0,1
4,2.5,2800,5900,1.0,0,0,3,8,1660,1140,1963,0,98115,47.6809,-122.286,2580,5900,665000,5,5,2014,0,51,3100,3320,0,1,1
2,1.0,1000,8212,1.0,0,0,4,7,1000,0,1947,0,98133,47.7444,-122.341,1620,8214,305000,25,11,2014,0,67,7212,6594,0,0,1
3,2.5,1640,7668,2.0,0,0,3,7,1640,0,1991,0,98038,47.3505,-122.027,1850,7200,265000,22,8,2014,0,23,6028,5350,0,0,0
4,1.0,1620,4080,1.5,0,0,3,7,1620,0,1923,0,98105,47.6696,-122.324,1760,4080,485000,2,10,2014,0,91,2460,2320,0,0,1
2,1.5,1860,5100,1.0,0,0,3,7,1060,800,1940,0,98136,47.5573,-122.392,1710,5100,510000,21,4,2015,0,75,3240,3390,0,1,1
2,1.0,1080,3899,1.0,0,0,4,8,1080,0,1972,0,98198,47.3792,-122.321,1090,3899,195000,21,5,2014,0,42,2819,2809,0,0,1
3,1.75,1980,5100,1.0,0,0,3,7,1270,710,1965,0,98103,47.6911,-122.347,1400,5100,432500,28,5,2014,0,49,3120,3700,0,1,1
3,1.75,1510,8433,1.0,0,0,4,7,1220,290,1967,0,98008,47.6226,-122.103,1950,8199,490000,10,12,2014,0,47,6923,6249,0,1,0
3,2.5,1690,7165,2.0,0,0,4,7,1690,0,1992,0,98038,47.3498,-122.058,1410,8590,270000,11,7,2014,0,22,5475,7180,0,0,0
2,1.5,1010,2102,2.0,0,0,3,7,1010,0,1984,0,98119,47.6374,-122.375,1480,2632,370000,26,8,2014,0,30,1092,1152,0,0,1
3,2.5,2090,12027,2.0,0,0,3,8,2090,0,1991,0,98031,47.4084,-122.213,2090,12666,327500,15,12,2014,0,23,9937,10576,0,0,0
2,1.0,1060,6120,1.0,0,0,3,7,1060,0,1908,0,98103,47.6739,-122.329,1730,4080,826000,23,3,2015,0,107,5060,2350,0,0,1
3,1.75,1750,7020,2.0,0,0,3,7,1750,0,1934,1978,98010,47.3264,-122.038,1170,9546,510000,1,7,2014,44,80,5270,8376,1,0,0
2,1.0,890,4730,1.0,0,0,3,7,890,0,1941,0,98103,47.6876,-122.341,1330,5904,587750,11,3,2015,0,74,3840,4574,0,0,1
4,2.0,2060,5000,1.0,0,0,3,7,1030,1030,1949,2013,98117,47.6992,-122.379,1280,5000,612500,6,5,2014,64,65,2940,3720,1,1,1
4,1.75,2120,6250,1.0,0,0,5,7,1060,1060,1917,0,98136,47.5506,-122.385,1410,6250,560000,13,3,2015,0,98,4130,4840,0,1,1
3,2.25,2180,4200,1.5,0,0,5,8,1520,660,1939,0,98112,47.6412,-122.302,1850,4200,727000,3,9,2014,0,75,2020,2350,0,1,1
4,3.0,2300,7609,2.0,0,0,4,7,2300,0,1976,0,98002,47.2943,-122.227,940,5937,224000,23,4,2015,0,39,5309,4997,0,0,0
3,2.25,1480,7565,1.0,0,0,3,7,1220,260,1977,0,98034,47.7288,-122.191,1660,7565,439000,23,4,2015,0,38,6085,5905,0,1,0
4,1.5,2740,4912,1.0,0,0,4,8,1370,1370,1937,0,98199,47.6523,-122.412,2160,5006,779000,16,10,2014,0,77,2172,2846,0,1,1
4,3.0,2000,5304,1.5,0,0,4,7,2000,0,1947,0,98115,47.6762,-122.285,1670,5304,775000,27,3,2015,0,68,3304,3634,0,0,1
3,1.75,1380,8362,1.0,0,0,3,7,1380,0,1967,0,98003,47.3121,-122.323,1380,8800,235000,16,9,2014,0,47,6982,7420,0,0,0
4,3.0,3180,12070,2.0,0,0,4,9,3180,0,1976,0,98074,47.6371,-122.058,3110,12600,790000,14,11,2014,0,38,8890,9490,0,0,0
2,1.5,1140,7800,1.0,0,0,4,6,1140,0,1947,0,98004,47.6142,-122.209,2020,7800,903000,1,12,2014,0,67,6660,5780,0,0,0
3,1.0,970,9583,1.0,0,0,4,6,970,0,1967,0,98023,47.3044,-122.366,970,7875,209950,27,6,2014,0,47,8613,6905,0,0,0
3,2.5,1780,7859,2.0,0,0,3,7,1780,0,1988,0,98038,47.3772,-122.045,1670,6618,309000,27,8,2014,0,26,6079,4948,0,0,0
3,1.75,2240,8153,1.0,0,0,3,7,1120,1120,1948,0,98125,47.7303,-122.329,1710,8100,440000,9,6,2014,0,66,5913,6390,0,1,1
2,1.0,920,4000,1.0,0,0,4,7,920,0,1906,0,98105,47.6711,-122.328,1300,4000,514000,15,8,2014,0,108,3080,2700,0,0,1
3,1.75,1830,12500,1.0,0,1,3,7,1200,630,1947,0,98178,47.5087,-122.25,1830,7300,323000,28,7,2014,0,67,10670,5470,0,1,1
2,1.75,1560,7575,1.0,0,0,3,8,1560,0,2002,0,98030,47.3776,-122.228,2050,9000,290000,3,11,2014,0,12,6015,6950,0,0,0
4,4.25,5540,15408,2.0,0,1,3,11,4280,1260,2006,0,98004,47.6071,-122.212,3570,14750,2580000,5,12,2014,0,8,9868,11180,0,1,0
4,1.5,1470,5100,1.5,0,0,3,7,1470,0,1946,0,98117,47.6769,-122.381,1470,5100,551000,23,7,2014,0,68,3630,3630,0,0,1
5,2.5,2900,9525,2.0,0,0,3,9,2900,0,1989,0,98006,47.5442,-122.138,2910,11854,720000,3,11,2014,0,25,6625,8944,0,0,0
3,1.75,1850,7684,1.0,0,0,3,8,1320,530,1979,0,98023,47.2975,-122.37,1940,7630,218000,6,5,2014,0,35,5834,5690,0,1,0
4,2.5,2190,7000,2.0,0,0,3,8,2190,0,1997,0,98042,47.3718,-122.109,2040,7700,334950,23,12,2014,0,17,4810,5660,0,0,0
4,3.25,3200,4477,2.0,0,0,3,9,2390,810,2006,0,98199,47.664,-122.402,1830,4920,825000,17,12,2014,0,8,1277,3090,0,1,1
4,1.75,1670,8000,1.0,0,0,4,8,1670,0,1974,0,98023,47.3193,-122.383,1720,8000,268500,12,8,2014,0,40,6330,6280,0,0,0
3,1.75,1010,9600,1.0,0,0,5,7,1010,0,1969,0,98042,47.3828,-122.09,1320,9600,230000,27,6,2014,0,45,8590,8280,0,0,0
2,1.5,1430,9782,1.0,0,0,3,7,1430,0,1955,0,98188,47.441,-122.282,1430,9828,245500,1,4,2015,0,60,8352,8398,0,0,1
3,2.25,1880,7989,1.0,0,0,3,7,1280,600,1982,0,98125,47.7077,-122.299,1820,7414,440000,29,7,2014,0,32,6109,5594,0,1,1
4,2.75,2180,5799,2.0,0,0,4,8,2180,0,1993,0,98029,47.5702,-121.995,2060,6061,571500,7,10,2014,0,21,3619,4001,0,0,0
3,2.25,1830,4744,2.0,0,0,3,7,1830,0,1997,0,98001,47.2734,-122.248,1670,8001,182500,27,4,2015,0,18,2914,6331,0,0,0
2,1.0,970,5600,1.0,0,0,3,6,970,0,1951,0,98118,47.5297,-122.277,1020,5600,217000,28,10,2014,0,63,4630,4580,0,0,1
2,1.5,1170,5248,1.0,0,0,5,6,1170,0,1941,0,98126,47.5318,-122.374,1170,5120,335000,9,1,2015,0,74,4078,3950,0,0,1
2,1.0,1010,4320,1.0,0,0,5,7,1010,0,1924,0,98115,47.6846,-122.317,1680,4320,501000,24,5,2014,0,90,3310,2640,0,0,1
3,2.5,2140,7641,1.0,0,0,3,8,1290,850,1979,0,98056,47.5053,-122.186,2090,8000,339950,27,10,2014,0,35,5501,5910,0,1,0
3,1.75,2230,10403,1.0,0,0,3,8,1630,600,1968,0,98198,47.4092,-122.295,1730,9450,340000,21,1,2015,0,47,8173,7720,0,1,1
2,1.0,860,8189,1.0,0,0,3,6,860,0,1948,0,98155,47.735,-122.306,1180,8189,298800,25,8,2014,0,66,7329,7009,0,0,1
6,1.75,2540,8400,1.0,0,0,3,8,1340,1200,1977,0,98058,47.4414,-122.129,1900,7695,317500,12,3,2015,0,38,5860,5795,0,1,0
4,2.5,2420,5118,1.5,0,2,5,7,1550,870,1926,0,98126,47.5671,-122.378,1740,5750,598000,2,4,2015,0,89,2698,4010,0,1,1
2,2.25,1640,2240,2.0,0,0,3,8,1640,0,1980,0,98133,47.7154,-122.341,1640,2240,375000,30,4,2015,0,35,600,600,0,0,1
4,2.25,2550,7650,2.0,0,2,4,9,2550,0,1996,0,98106,47.5296,-122.342,2550,7650,465000,16,1,2015,0,19,5100,5100,0,0,1
3,2.5,2507,18400,2.0,0,0,3,8,2507,0,2006,0,98001,47.2867,-122.27,1520,14709,551870,25,2,2015,0,9,15893,13189,0,0,0
3,2.5,1920,7229,2.0,0,0,3,8,1920,0,1993,0,98003,47.2659,-122.31,2310,8009,295000,8,5,2014,0,21,5309,5699,0,0,0
4,1.75,2210,6375,1.0,0,0,3,8,1640,570,1977,0,98003,47.3268,-122.328,2070,7210,263500,24,9,2014,0,37,4165,5140,0,1,0
4,4.0,3530,8400,2.0,0,0,5,8,2630,900,1958,0,98199,47.6402,-122.395,2340,8216,1100000,16,6,2014,0,56,4870,5876,0,1,1
2,1.0,1100,4010,1.5,0,0,5,6,1100,0,1920,0,98106,47.5296,-122.351,980,4501,300000,12,11,2014,0,94,2910,3521,0,0,1
4,1.0,3390,4500,1.5,0,0,3,8,2190,1200,1924,2014,98144,47.5824,-122.293,2030,4872,780000,22,7,2014,90,90,1110,2842,1,1,1
3,1.5,1590,7936,1.0,0,0,3,7,1590,0,1956,0,98106,47.5201,-122.366,1590,7936,325000,27,3,2015,0,59,6346,6346,0,0,1
2,1.0,820,6550,1.0,0,0,3,7,820,0,1949,2012,98126,47.5478,-122.381,1640,6550,370000,7,8,2014,63,65,5730,4910,1,0,1
4,2.5,2370,10000,1.0,0,0,5,8,1660,710,1974,0,98052,47.6383,-122.099,2480,9875,715000,25,7,2014,0,40,7630,7395,0,1,0
4,2.0,1600,12500,1.0,0,0,5,7,1600,0,1938,0,98166,47.4713,-122.355,1260,8306,356000,16,1,2015,0,77,10900,7046,0,0,1
4,1.75,1740,7208,1.5,0,0,3,8,1740,0,1976,0,98058,47.4483,-122.13,1680,7350,329950,24,3,2015,0,39,5468,5670,0,0,0
3,2.25,1470,2500,2.0,0,0,3,8,1080,390,1984,0,98117,47.6762,-122.36,1640,4300,490000,23,6,2014,0,30,1030,2660,0,1,1
3,3.25,1410,1246,3.0,0,0,3,8,1410,0,2005,0,98103,47.6981,-122.34,1410,1253,429000,10,6,2014,0,9,-164,-157,0,0,1
4,2.5,1620,8125,2.0,0,0,4,7,1620,0,1983,0,98074,47.6255,-122.059,1480,8120,510000,31,3,2015,0,32,6505,6640,0,0,0
3,2.5,2360,4080,2.0,0,0,3,7,2360,0,2003,0,98053,47.6825,-122.038,2290,4080,550000,24,9,2014,0,11,1720,1790,0,0,0
3,1.0,1830,6453,1.0,0,0,4,7,1830,0,1956,0,98125,47.7139,-122.288,1670,8012,467500,5,1,2015,0,59,4623,6342,0,0,1
5,2.0,2130,4180,1.5,0,0,5,7,1270,860,1926,0,98116,47.575,-122.388,1710,4180,615000,23,6,2014,0,88,2050,2470,0,1,1
2,1.0,990,15120,1.0,0,0,4,6,990,0,1953,0,98011,47.7669,-122.206,1300,11500,325000,13,10,2014,0,61,14130,10200,0,0,0
2,1.0,1010,4120,2.0,0,0,3,6,1010,0,1907,1953,98055,47.488,-122.2,1200,4120,219950,8,8,2014,46,107,3110,2920,1,0,0
3,1.0,1720,9830,1.0,0,0,4,7,1720,0,1946,0,98040,47.5905,-122.245,3200,8923,950000,13,4,2015,0,69,8110,5723,0,0,0
3,1.0,1630,3200,1.5,0,0,4,8,1630,0,1912,0,98109,47.6351,-122.352,1710,3600,925000,22,9,2014,0,102,1570,1890,0,0,1
4,1.5,1310,8250,1.0,0,0,3,7,1060,250,1953,0,98148,47.425,-122.332,1260,8255,251200,19,5,2014,0,61,6940,6995,0,1,1
3,1.5,1610,5304,1.0,0,0,4,6,1610,0,1968,0,98042,47.3632,-122.087,1060,5304,215000,18,9,2014,0,46,3694,4244,0,0,0
3,2.0,1850,8208,1.0,0,0,4,7,1180,670,1970,0,98023,47.3109,-122.362,1790,8174,245000,5,8,2014,0,44,6358,6384,0,1,0
3,1.75,1270,4815,1.5,0,0,3,6,980,290,1922,0,98108,47.5495,-122.31,1270,6431,259000,6,2,2015,0,93,3545,5161,0,1,1
4,1.5,1420,6720,1.5,0,0,3,7,1420,0,1925,0,98108,47.5518,-122.311,1560,5600,349950,13,11,2014,0,89,5300,4040,0,0,1
2,1.0,1410,4500,1.0,0,0,3,7,1020,390,1939,0,98117,47.6883,-122.384,1300,4500,600000,8,5,2015,0,76,3090,3200,0,1,1
2,1.5,1170,1274,3.0,0,0,3,8,1170,0,2001,0,98107,47.6719,-122.381,1290,1308,405000,2,10,2014,0,13,104,18,0,0,1
3,2.5,1860,10027,2.0,0,0,3,8,1860,0,1993,0,98033,47.6775,-122.165,1530,9204,625000,2,12,2014,0,21,8167,7674,0,0,0
3,3.0,1280,1085,3.0,0,0,3,8,1280,0,2004,0,98103,47.6569,-122.346,1300,1310,533000,29,4,2015,0,11,-195,10,0,0,1
4,2.5,2750,9949,2.0,0,0,3,10,2750,0,1999,0,98007,47.6595,-122.147,2750,9860,1050000,28,7,2014,0,15,7199,7110,0,0,0
3,1.75,1420,3000,1.0,0,0,3,5,710,710,1931,2014,98178,47.4928,-122.274,1960,5000,230000,24,10,2014,83,83,1580,3040,1,1,1
4,1.75,2000,8700,1.0,0,0,5,7,1010,990,1975,0,98042,47.374,-122.141,1490,7350,275000,5,9,2014,0,39,6700,5860,0,1,0
2,1.0,1100,3598,1.0,0,0,4,7,1100,0,1926,0,98144,47.5738,-122.313,1240,3598,403000,10,6,2014,0,88,2498,2358,0,0,1
3,1.5,1240,12400,1.0,0,0,3,7,1240,0,1958,0,98007,47.607,-122.132,1640,9600,415500,22,9,2014,0,56,11160,7960,0,0,0
3,1.75,2170,4000,1.0,0,0,4,7,1110,1060,1925,0,98103,47.6546,-122.337,1890,4000,913000,20,4,2015,0,90,1830,2110,0,1,1
2,1.0,1800,5182,1.0,0,0,3,6,900,900,1942,0,98108,47.5508,-122.3,1570,5876,334998,13,3,2015,0,73,3382,4306,0,1,1
3,1.0,1160,8320,1.0,0,0,4,7,1160,0,1959,0,98032,47.3831,-122.288,1480,7800,201500,9,5,2014,0,55,7160,6320,0,0,0
3,1.0,890,7200,1.0,0,0,3,7,890,0,1951,0,98125,47.71,-122.286,1630,7455,371000,11,6,2014,0,63,6310,5825,0,0,1
4,2.5,2150,7670,1.0,0,0,5,7,1240,910,1976,0,98031,47.3942,-122.189,1610,7350,229950,22,10,2014,0,38,5520,5740,0,1,0
4,2.5,2150,7670,1.0,0,0,5,7,1240,910,1976,0,98031,47.3942,-122.189,1610,7350,344900,22,4,2015,0,39,5520,5740,0,1,0
3,2.5,2060,9715,2.0,0,0,3,8,2060,0,1924,2006,98115,47.6961,-122.316,1240,7072,840000,20,8,2014,82,90,7655,5832,1,0,1
3,1.5,1380,12196,1.0,0,0,4,7,1380,0,1967,0,98003,47.3204,-122.322,1600,10720,285000,16,9,2014,0,47,10816,9120,0,0,0
4,2.25,1800,7200,1.0,0,0,3,7,1230,570,1979,0,98177,47.7717,-122.376,2260,7498,475000,26,3,2015,0,36,5400,5238,0,1,1
2,1.0,1460,7832,1.0,0,0,3,6,1460,0,1924,0,98166,47.4617,-122.346,1460,7632,420000,3,3,2015,0,91,6372,6172,0,0,1
3,2.0,2210,5000,1.5,0,2,3,7,1710,500,1909,0,98103,47.6754,-122.357,1920,5000,685000,30,10,2014,0,105,2790,3080,0,1,1
3,1.0,1140,8775,1.0,0,0,3,6,990,150,1942,0,98146,47.4824,-122.336,1300,8775,197200,20,1,2015,0,73,7635,7475,0,1,1
3,1.0,1240,5000,1.5,0,0,5,7,1240,0,1909,0,98107,47.6755,-122.367,1240,4900,529950,3,7,2014,0,105,3760,3660,0,0,1
3,1.5,1570,1050,2.0,0,0,3,8,1570,0,1915,0,98109,47.6358,-122.356,2070,3600,792000,20,5,2014,0,99,-520,1530,0,0,1
3,2.5,1680,10300,2.0,0,0,4,7,1680,0,1994,0,98010,47.314,-122.001,1680,9849,262000,20,8,2014,0,20,8620,8169,0,0,0
3,1.75,1560,5760,1.0,0,0,5,6,780,780,1927,0,98106,47.5272,-122.359,1320,7680,353900,7,10,2014,0,87,4200,6360,0,1,1
3,2.5,1690,5175,2.0,0,0,3,7,1690,0,2002,0,98038,47.3564,-122.016,1830,5175,305000,27,3,2015,0,13,3485,3345,0,0,0
4,2.0,2310,5004,1.0,0,0,3,7,1430,880,1994,0,98108,47.5471,-122.298,1630,5060,440000,20,4,2015,0,21,2694,3430,0,1,1
4,3.5,2650,3060,2.0,0,0,3,9,2060,590,2001,0,98103,47.6735,-122.332,1470,3060,1010000,17,6,2014,0,13,410,1590,0,1,1
5,3.0,3610,7555,2.0,0,0,3,8,3610,0,2003,0,98038,47.3534,-122.012,3610,7979,549900,19,9,2014,0,11,3945,4369,0,0,0
3,2.25,1760,8287,1.0,0,0,3,7,1160,600,1986,0,98188,47.4501,-122.274,1290,9587,270000,26,8,2014,0,28,6527,8297,0,1,1
3,1.0,940,12521,1.5,0,0,4,7,940,0,1949,0,98133,47.7169,-122.331,1920,9046,430000,30,3,2015,0,66,11581,7126,0,0,1
5,4.25,4830,8050,2.5,0,2,4,11,3710,1120,1914,0,98144,47.5789,-122.286,4470,9194,1930000,30,6,2014,0,100,3220,4724,0,1,1
4,2.75,3350,5416,2.0,0,0,3,9,3350,0,2014,0,98053,47.6849,-122.016,3625,5637,790500,13,8,2014,0,0,2066,2012,0,0,0
3,2.25,1570,7200,2.0,0,0,3,8,1570,0,1991,0,98034,47.7332,-122.232,1620,7318,447450,17,10,2014,0,23,5630,5698,0,0,0
3,2.0,2240,5200,1.0,0,0,3,7,1630,610,1954,0,98112,47.6191,-122.296,1470,3775,375000,9,2,2015,0,61,2960,2305,0,1,1
4,2.0,1950,9940,1.0,0,0,4,7,1950,0,1963,0,98008,47.6332,-122.118,1920,9270,565000,6,2,2015,0,52,7990,7350,0,0,0
2,1.0,1010,3916,1.0,0,2,4,6,810,200,1918,0,98144,47.5728,-122.306,1580,3888,400000,23,4,2015,0,97,2906,2308,0,1,1
3,1.5,1630,10200,1.0,0,0,4,8,1300,330,1976,0,98023,47.3155,-122.364,1960,6700,246000,20,2,2015,0,39,8570,4740,0,1,0
3,1.75,1420,6289,1.0,0,0,3,7,1100,320,1967,0,98155,47.7398,-122.314,1460,7402,329922,29,10,2014,0,47,4869,5942,0,1,1
3,1.0,1210,7425,1.0,0,0,4,6,1210,0,1910,0,98133,47.7125,-122.33,1260,7425,375000,20,4,2015,0,105,6215,6165,0,0,1
3,1.75,1890,9920,1.0,0,0,3,7,1230,660,1944,0,98125,47.7327,-122.306,1380,9086,385000,8,5,2014,0,70,8030,7706,0,1,1
4,2.5,1690,4080,1.5,0,0,4,7,1140,550,1912,0,98117,47.6825,-122.379,1600,4590,591500,3,9,2014,0,102,2390,2990,0,1,1
4,2.0,2560,12155,1.0,0,0,4,7,1350,1210,1960,0,98003,47.3326,-122.323,1790,11906,255000,18,9,2014,0,54,9595,10116,0,1,0
3,1.5,1350,7800,1.0,0,0,3,7,1350,0,1959,0,98059,47.4805,-122.158,1510,8040,275000,16,3,2015,0,56,6450,6530,0,0,0
4,2.75,3120,5000,2.0,0,0,3,9,3120,0,2010,0,98074,47.594,-122.062,3200,5000,800000,29,12,2014,0,4,1880,1800,0,0,0
2,1.0,1140,7435,1.0,0,0,3,7,1140,0,1952,1990,98125,47.73,-122.31,1320,9385,327000,25,4,2015,38,63,6295,8065,1,0,1
4,1.5,2230,11536,1.0,0,1,4,7,1220,1010,1954,0,98166,47.4409,-122.348,2170,12465,355000,30,12,2014,0,60,9306,10295,0,1,1
2,1.0,1050,8220,1.0,0,0,4,6,780,270,1947,0,98155,47.7598,-122.316,1340,7651,310000,3,10,2014,0,67,7170,6311,0,1,1
3,2.0,1200,5700,1.0,0,0,5,7,1200,0,1942,0,98178,47.5031,-122.242,1190,6384,272000,8,8,2014,0,72,4500,5194,0,0,1
3,2.5,1590,8449,2.0,0,0,3,7,1590,0,1989,0,98030,47.3493,-122.177,1750,7172,225000,17,11,2014,0,25,6859,5422,0,0,0
3,1.5,1530,7200,1.0,0,0,3,8,1530,0,1975,0,98155,47.7691,-122.297,2150,7216,375500,10,6,2014,0,39,5670,5066,0,0,1
3,1.75,1570,6500,1.0,0,0,3,7,920,650,1948,0,98116,47.565,-122.398,1570,5750,550000,2,4,2015,0,67,4930,4180,0,1,1
3,1.0,1470,7680,1.0,0,0,3,7,1220,250,1946,0,98106,47.5276,-122.359,1470,6784,248000,18,9,2014,0,68,6210,5314,0,1,1
3,1.0,1470,7680,1.0,0,0,3,7,1220,250,1946,0,98106,47.5276,-122.359,1470,6784,546940,6,5,2015,0,69,6210,5314,0,1,1
4,3.0,3150,6175,2.0,0,0,3,9,3150,0,2001,0,98075,47.5968,-122.017,3150,6986,680000,2,9,2014,0,13,3025,3836,0,0,0
4,2.5,2380,6124,2.0,0,0,3,8,2380,0,1997,0,98030,47.3662,-122.175,2170,6097,350000,18,7,2014,0,17,3744,3927,0,0,0
2,2.5,2000,2500,3.0,0,1,3,8,1810,190,1994,0,98116,47.5788,-122.396,1970,5650,593000,25,3,2015,0,21,500,3680,0,1,1
2,1.0,1140,8147,1.0,0,0,3,7,1140,0,1958,0,98125,47.7278,-122.289,1260,8148,390000,19,3,2015,0,57,7007,6888,0,0,1
2,1.0,1450,9150,1.0,0,0,4,7,1450,0,1965,0,98188,47.4689,-122.277,1440,10636,355000,5,3,2015,0,50,7700,9196,0,0,1
3,2.25,1810,12000,2.0,0,0,3,7,1810,0,1992,0,98003,47.3476,-122.3,1720,9916,257000,24,9,2014,0,22,10190,8196,0,0,0
4,3.0,3600,9687,2.0,0,0,4,9,3600,0,1959,1995,98004,47.6257,-122.208,2620,10400,1700000,26,8,2014,36,55,6087,7780,1,0,0
3,2.0,1260,2550,2.0,0,0,3,7,1260,0,1987,0,98117,47.6821,-122.378,1590,3825,300000,13,1,2015,0,28,1290,2235,0,0,1
3,2.0,1560,1156,3.0,0,0,3,8,1560,0,2014,0,98122,47.605,-122.304,1560,1728,500000,17,12,2014,0,0,-404,168,0,0,1
8,4.0,4020,7500,1.0,0,0,3,8,2010,2010,1968,0,98107,47.6732,-122.363,1560,3737,900000,16,10,2014,0,46,3480,2177,0,1,1
4,3.0,3150,9130,2.0,0,0,3,9,3150,0,2001,0,98075,47.5974,-122.017,2970,6228,695000,15,5,2014,0,13,5980,3258,0,0,0
4,2.5,1680,6655,2.0,0,0,3,7,1680,0,2001,0,98030,47.3867,-122.191,1680,6982,213400,18,12,2014,0,13,4975,5302,0,0,0
2,1.0,1320,8830,1.0,0,0,3,7,1020,300,1939,0,98199,47.6433,-122.404,1620,8531,425000,9,7,2014,0,75,7510,6911,0,1,1
1,1.0,1080,5000,1.5,0,0,3,7,1080,0,1948,0,98199,47.6603,-122.394,1620,4000,411000,9,2,2015,0,67,3920,2380,0,0,1
4,1.0,1220,8500,1.5,0,0,5,6,1220,0,1916,0,98168,47.4792,-122.277,1460,8500,258000,24,4,2015,0,99,7280,7040,0,0,1
3,2.25,1780,3665,2.0,0,0,3,8,1780,0,2004,0,98029,47.5495,-121.997,1770,3669,499000,24,2,2015,0,11,1885,1899,0,0,0
3,1.0,1250,10723,1.0,0,0,4,7,1250,0,1961,0,98059,47.4894,-122.135,1520,10723,310000,11,5,2015,0,54,9473,9203,0,0,0
2,2.5,1780,1311,3.0,0,0,3,8,1350,430,2005,0,98103,47.6962,-122.34,1390,1227,398500,3,11,2014,0,9,-469,-163,0,1,1
4,2.5,1930,8660,1.0,0,0,3,7,1120,810,1981,0,98001,47.3261,-122.26,1830,9591,250600,13,6,2014,0,33,6730,7761,0,1,0
4,2.5,2470,6116,1.0,0,0,3,7,1420,1050,1985,0,98038,47.3792,-122.047,1670,7627,352000,12,8,2014,0,29,3646,5957,0,1,0
2,1.0,1180,2160,1.0,0,1,3,7,940,240,1909,0,98119,47.6313,-122.368,2700,5400,600000,15,7,2014,0,105,980,2700,0,1,1
3,1.0,2270,4182,1.0,0,0,4,7,1170,1100,1946,0,98115,47.688,-122.32,1860,4080,645000,24,3,2015,0,69,1912,2220,0,1,1
4,2.5,1770,5000,2.0,0,0,3,7,1770,0,2004,0,98038,47.3503,-122.005,2080,5100,291500,24,7,2014,0,10,3230,3020,0,0,0
4,1.75,2250,13515,1.0,0,0,4,8,2150,100,1940,0,98030,47.3789,-122.229,2150,12508,350000,8,5,2014,0,74,11265,10358,0,1,0
3,2.5,1540,7280,1.0,0,0,3,7,1080,460,1974,0,98003,47.3102,-122.322,1220,6440,279000,19,9,2014,0,40,5740,5220,0,1,0
2,1.0,820,5400,1.0,0,0,3,6,820,0,1940,0,98117,47.6976,-122.375,1370,5632,320000,4,3,2015,0,75,4580,4262,0,0,1
2,2.0,1580,5203,1.0,0,0,3,8,1580,0,2004,0,98053,47.7174,-122.032,1560,4770,495000,10,3,2015,0,11,3623,3210,0,0,0
5,1.5,2160,5000,1.5,0,2,4,8,2160,0,1926,0,98107,47.6645,-122.36,1450,4265,770000,17,7,2014,0,88,2840,2815,0,0,1
3,2.25,1890,7498,1.0,0,0,3,7,1190,700,1987,0,98125,47.73,-122.297,1660,8100,423500,19,8,2014,0,27,5608,6440,0,1,1
3,3.0,1910,4800,1.5,0,0,3,9,1910,0,1900,1991,98103,47.6572,-122.346,1280,1310,850000,9,10,2014,91,114,2890,30,1,0,1
2,1.0,910,6232,1.0,0,0,3,6,910,0,1943,0,98118,47.5328,-122.272,1070,6232,155000,13,5,2014,0,71,5322,5162,0,0,1
3,2.25,1460,7210,1.0,0,0,3,7,1460,0,1963,0,98008,47.6316,-122.119,1850,7519,505000,13,4,2015,0,52,5750,5669,0,0,0
3,3.5,3310,5558,2.0,0,0,3,9,3310,0,2005,0,98029,47.5553,-122.003,3310,5270,780000,27,2,2015,0,10,2248,1960,0,0,0
2,2.5,2130,5001,1.0,0,0,5,8,1330,800,1972,0,98199,47.6573,-122.399,1750,6000,707000,28,8,2014,0,42,2871,4250,0,1,1
3,2.5,1220,1475,3.0,0,0,3,8,1220,0,2000,0,98117,47.6909,-122.395,1220,1546,497000,1,5,2015,0,15,255,326,0,0,1
4,1.75,1670,8856,1.0,0,2,3,7,1070,600,1955,0,98178,47.5056,-122.251,1660,8088,349170,5,11,2014,0,59,7186,6428,0,1,1
4,1.5,1300,10050,1.5,0,0,3,7,1300,0,1963,0,98059,47.4899,-122.116,1730,10050,287000,2,1,2015,0,52,8750,8320,0,0,0
4,2.5,2430,14400,1.0,0,0,5,8,1670,760,1963,0,98007,47.6202,-122.138,2140,9048,645000,2,6,2014,0,51,11970,6908,0,1,0
5,2.25,2240,9652,2.0,0,0,3,7,2240,0,1990,0,98055,47.4249,-122.211,2180,11644,238000,16,10,2014,0,24,7412,9464,0,0,0
5,2.25,2240,9652,2.0,0,0,3,7,2240,0,1990,0,98055,47.4249,-122.211,2180,11644,328000,13,2,2015,0,25,7412,9464,0,0,0
2,1.5,790,1123,2.0,0,0,3,8,700,90,2003,0,98119,47.651,-122.368,1370,1281,365000,3,11,2014,0,11,333,-89,0,1,1
3,1.0,1380,8147,1.0,0,0,4,7,1380,0,1948,0,98155,47.7407,-122.3,1360,8147,380000,17,3,2015,0,67,6767,6787,0,0,1
4,1.5,1680,10500,2.0,0,0,3,7,1680,0,1962,0,98033,47.6806,-122.166,1830,10264,525000,10,3,2015,0,53,8820,8434,0,0,0
4,2.25,2000,3672,2.0,0,0,5,7,1650,350,1926,0,98117,47.6769,-122.383,2000,5100,402000,25,6,2014,0,88,1672,3100,0,1,1
2,1.0,1680,9250,1.0,0,0,3,7,860,820,1969,0,98072,47.7618,-122.162,1590,9542,308000,24,4,2015,0,46,7570,7952,0,1,0
3,2.5,1960,6997,2.0,0,0,3,7,1960,0,2006,0,98065,47.5415,-121.887,2320,5178,405000,9,10,2014,0,8,5037,2858,0,0,0
4,3.5,3790,6874,2.5,0,0,3,9,3790,0,2010,0,98053,47.6956,-122.022,3370,6535,875000,10,2,2015,0,5,3084,3165,0,0,0
4,2.25,1930,7925,1.0,0,0,3,8,1300,630,1960,0,98155,47.7626,-122.312,1930,7200,367500,11,8,2014,0,54,5995,5270,0,1,1
6,3.5,2580,13572,1.0,0,0,3,8,1290,1290,1987,0,98052,47.6796,-122.113,2020,11656,604000,5,8,2014,0,27,10992,9636,0,1,0
4,2.75,2160,8148,1.0,0,0,3,7,1410,750,1978,0,98125,47.7261,-122.306,2060,8100,435000,17,12,2014,0,36,5988,6040,0,1,1
4,2.5,1970,7098,2.0,0,0,3,7,1970,0,2007,0,98038,47.3576,-122.058,1970,5361,347500,10,10,2014,0,7,5128,3391,0,0,0
4,1.75,1570,16697,1.0,0,2,3,7,1030,540,1981,0,98052,47.671,-122.135,1560,9698,525000,18,3,2015,0,34,15127,8138,0,1,0
2,1.5,1480,15641,1.0,0,0,4,7,1480,0,1940,0,98146,47.5008,-122.366,1520,7525,280000,3,6,2014,0,74,14161,6005,0,0,1
2,1.5,1480,15641,1.0,0,0,4,7,1480,0,1940,0,98146,47.5008,-122.366,1520,7525,490000,5,2,2015,0,75,14161,6005,0,0,1
4,1.75,1430,5490,1.0,0,0,5,6,1430,0,1942,0,98056,47.494,-122.184,1030,5900,265000,23,3,2015,0,73,4060,4870,0,0,0
3,2.5,1400,7629,1.0,0,0,3,7,1120,280,1988,0,98030,47.3788,-122.179,1530,7688,267500,17,4,2015,0,27,6229,6158,0,1,0
4,3.5,5844,10766,2.0,0,1,3,11,5844,0,2007,0,98023,47.3293,-122.364,3413,10766,1280000,17,12,2014,0,7,4922,7353,0,0,0
4,1.75,1840,10720,1.0,0,0,3,7,960,880,1958,0,98008,47.6074,-122.125,1840,9044,404000,6,5,2014,0,56,8880,7204,0,1,0
3,2.25,2530,12042,2.0,0,0,3,8,2530,0,1989,0,98042,47.3742,-122.125,2480,10172,380000,29,4,2015,0,26,9512,7692,0,0,0
4,2.75,2810,10300,1.0,0,0,4,9,1810,1000,1978,0,98006,47.5626,-122.149,2710,9900,812500,8,8,2014,0,36,7490,7190,0,1,0
3,1.0,1020,8610,1.0,0,0,5,7,1020,0,1959,0,98056,47.4974,-122.169,1070,5940,265000,3,7,2014,0,55,7590,4870,0,0,0
5,2.75,2550,7725,1.0,0,0,5,8,1390,1160,1967,0,98056,47.5388,-122.171,2450,7725,480000,9,7,2014,0,47,5175,5275,0,1,0
1,1.0,710,4725,1.0,0,0,3,6,710,0,1939,0,98133,47.7328,-122.34,900,5250,264000,16,9,2014,0,75,4015,4350,0,0,1
4,1.75,2150,9000,1.0,0,0,4,7,1110,1040,1966,0,98052,47.6812,-122.113,2040,9000,550000,9,7,2014,0,48,6850,6960,0,1,0
2,1.5,880,2400,1.5,0,0,3,7,880,0,1929,0,98122,47.6144,-122.295,1220,4440,615000,4,5,2015,0,86,1520,3220,0,0,1
4,2.25,2800,10800,1.0,0,0,3,8,1680,1120,1977,0,98011,47.7448,-122.177,2260,9800,490000,15,7,2014,0,37,8000,7540,0,1,0
4,2.25,2070,7350,2.0,0,0,4,8,2070,0,1977,0,98032,47.3615,-122.274,2080,7210,280927,26,6,2014,0,37,5280,5130,0,0,0
2,1.0,830,6017,1.0,0,0,4,6,830,0,1954,0,98133,47.7466,-122.334,1340,6040,282613,16,5,2014,0,60,5187,4700,0,0,1
4,2.5,2060,7475,1.0,0,0,3,8,1440,620,1985,0,98052,47.7272,-122.105,2280,8396,575550,18,5,2014,0,29,5415,6116,0,1,0
3,2.0,1490,7770,1.0,0,0,4,7,1490,0,1990,0,98042,47.3686,-122.09,1540,7366,259900,20,5,2014,0,24,6280,5826,0,0,0
4,2.25,2120,8267,2.0,0,0,3,8,2120,0,1996,0,98045,47.4885,-121.779,2150,7746,450000,9,12,2014,0,18,6147,5596,0,0,0
4,2.5,2810,6296,2.0,0,0,3,9,2810,0,2013,0,98059,47.5019,-122.151,2850,6140,487500,29,7,2014,0,1,3486,3290,0,0,0
4,2.25,2400,17842,2.0,0,0,4,7,2400,0,1973,0,98002,47.2866,-122.217,1610,12100,275000,28,1,2015,0,42,15442,10490,0,0,0
3,2.5,2460,5027,2.0,0,0,3,8,2460,0,2002,0,98042,47.372,-122.102,2740,5000,305000,11,8,2014,0,12,2567,2260,0,0,0
3,1.0,880,7648,1.0,0,2,4,6,880,0,1940,0,98022,47.1963,-121.997,1020,7566,215000,22,4,2015,0,75,6768,6546,0,0,0
3,2.0,1320,6000,1.5,0,0,4,7,1320,0,1920,0,98144,47.5752,-122.304,1620,4000,410000,8,7,2014,0,94,4680,2380,0,0,1
4,2.5,2160,7826,1.0,0,0,4,7,1390,770,1976,0,98155,47.7754,-122.276,2190,9900,440000,26,6,2014,0,38,5666,7710,0,1,1
4,3.5,4190,15724,2.0,0,2,3,11,4190,0,1994,0,98027,47.5518,-122.096,3300,10113,1160000,29,8,2014,0,20,11534,6813,0,0,0
4,2.0,2280,7200,1.0,0,0,4,7,2280,0,1956,0,98133,47.7132,-122.355,1100,7620,500000,25,11,2014,0,58,4920,6520,0,0,1
5,2.75,2590,6120,2.0,0,0,3,8,2590,0,1909,0,98105,47.6667,-122.327,1390,3060,961000,20,11,2014,0,105,3530,1670,0,0,1
4,2.25,2770,9340,2.0,0,0,4,9,2770,0,1979,0,98027,47.5628,-122.081,3010,9340,825000,24,7,2014,0,35,6570,6330,0,0,0
3,1.75,2145,3840,1.5,0,0,5,8,2145,0,1910,0,98103,47.6875,-122.357,1140,3840,734000,3,11,2014,0,104,1695,2700,0,0,1
4,4.25,4480,5715,2.0,0,0,3,7,3680,800,2003,0,98030,47.373,-122.179,2190,6070,490000,2,10,2014,0,11,1235,3880,0,1,0
4,2.5,1780,6000,2.0,0,0,3,7,1780,0,1991,0,98198,47.3828,-122.302,1630,6000,175000,2,7,2014,0,23,4220,4370,0,0,1
1,1.0,720,4800,1.0,0,0,3,6,720,0,1914,0,98118,47.5303,-122.27,1240,4860,190000,18,6,2014,0,100,4080,3620,0,0,1
4,2.25,2050,12581,2.0,0,0,4,7,2050,0,1978,0,98002,47.3215,-122.204,1620,7400,305000,12,8,2014,0,36,10531,5780,0,0,0
3,1.0,2040,7936,1.0,0,3,5,8,1680,360,1940,0,98177,47.7028,-122.385,2300,10080,1300000,16,3,2015,0,75,5896,7780,0,1,1
2,1.0,920,6600,1.0,0,0,3,6,920,0,1919,2003,98118,47.5452,-122.27,1510,5944,417000,9,6,2014,84,95,5680,4434,1,0,1
2,1.0,680,4190,1.0,0,0,2,5,680,0,1906,0,98103,47.6901,-122.358,1070,4175,275000,13,11,2014,0,108,3510,3105,0,0,1
3,2.5,1940,8196,2.0,0,0,3,8,1940,0,1991,0,98052,47.6786,-122.151,2070,8514,661000,10,12,2014,0,23,6256,6444,0,0,0
4,2.75,2230,9640,1.0,0,0,3,8,1320,910,1998,0,98125,47.7269,-122.325,2100,9600,435000,8,7,2014,0,16,7410,7500,0,1,1
5,2.25,2910,9454,1.0,0,1,3,8,1910,1000,1972,0,98005,47.5871,-122.173,2400,10690,788000,23,10,2014,0,42,6544,8290,0,1,0
5,3.25,5270,17232,2.0,0,1,3,10,4010,1260,1977,2003,98040,47.5536,-122.228,3550,13917,1800000,10,6,2014,26,37,11962,10367,1,1,0
5,3.25,2820,6589,1.5,0,0,3,7,2320,500,1906,2014,98118,47.5357,-122.273,1560,5647,408000,30,6,2014,108,108,3769,4087,1,1,1
2,1.0,1790,3760,1.5,0,0,4,8,1490,300,1912,0,98144,47.5926,-122.293,1458,3760,570000,20,10,2014,0,102,1970,2302,0,1,1
5,3.25,2920,6960,2.0,0,1,3,9,2120,800,1953,2008,98105,47.6712,-122.272,2470,6735,1540000,7,5,2015,55,62,4040,4265,1,1,1
2,1.0,840,5510,1.0,0,0,3,7,840,0,1955,0,98136,47.5247,-122.391,1630,5510,400000,5,5,2014,0,59,4670,3880,0,0,1
3,1.75,1820,8740,1.0,0,0,4,8,1820,0,1987,0,98023,47.3074,-122.385,2210,8320,247000,17,10,2014,0,27,6920,6110,0,0,0
3,1.75,1550,7200,1.0,0,0,3,7,1100,450,1949,0,98125,47.7071,-122.314,1560,7440,453000,4,3,2015,0,66,5650,5880,0,1,1
2,1.0,1270,3008,1.0,0,0,4,6,650,620,1923,0,98118,47.5351,-122.279,1270,1514,235000,8,5,2014,0,91,1738,244,0,1,1
4,1.75,2460,5750,1.5,0,3,5,7,1620,840,1919,0,98126,47.5601,-122.378,1760,4830,675000,21,4,2015,0,96,3290,3070,0,1,1
3,2.0,2110,5150,1.0,0,0,5,6,1080,1030,1919,0,98118,47.5521,-122.271,1170,5107,516200,10,6,2014,0,95,3040,3937,0,1,1
3,1.5,1500,10227,1.0,0,0,4,7,1000,500,1945,0,98022,47.2043,-121.996,1490,7670,257100,16,12,2014,0,69,8727,6180,0,1,0
2,2.0,1440,9985,1.0,0,0,3,8,1440,0,2006,0,98053,47.7217,-122.03,1510,4560,457000,30,3,2015,0,9,8545,3050,0,0,0
3,1.75,1610,3478,1.5,0,0,4,7,1060,550,1929,0,98117,47.6774,-122.372,1610,3478,540000,17,11,2014,0,85,1868,1868,0,1,1
3,1.75,1970,10270,1.0,0,0,4,8,1970,0,1966,0,98032,47.3619,-122.285,1970,8400,268000,3,6,2014,0,48,8300,6430,0,0,0
3,1.0,1150,7314,1.0,0,0,3,7,1150,0,1960,0,98008,47.6246,-122.113,1350,7350,300000,8,7,2014,0,54,6164,6000,0,0,0
5,1.0,1680,9383,1.0,0,0,3,7,1400,280,1929,0,98155,47.7523,-122.311,1680,9458,274000,5,8,2014,0,85,7703,7778,0,1,1
4,3.25,3950,10912,2.0,0,0,3,10,3950,0,2003,0,98004,47.5877,-122.196,3000,10998,1780000,29,4,2015,0,12,6962,7998,0,0,0
3,1.75,2390,7149,1.0,0,0,3,8,1350,1040,1955,0,98125,47.7244,-122.326,1710,7402,396500,23,6,2014,0,59,4759,5692,0,1,1
2,1.5,1820,7800,1.0,0,0,4,7,1240,580,1956,0,98133,47.7513,-122.357,1400,7800,460000,19,11,2014,0,58,5980,6400,0,1,1
3,1.0,1100,8536,1.0,0,0,4,7,1100,0,1957,0,98118,47.5162,-122.261,1570,8040,277000,16,6,2014,0,57,7436,6470,0,0,1
6,4.0,2280,5275,1.0,0,0,3,7,1270,1010,1998,0,98108,47.5556,-122.294,1760,6642,449500,4,11,2014,0,16,2995,4882,0,1,1
4,3.0,2530,4560,1.5,0,0,3,7,1540,990,1925,2014,98112,47.6287,-122.3,1640,4560,785950,3,9,2014,89,89,2030,2920,1,1,1
3,2.5,1940,9775,1.0,0,2,3,8,1440,500,1975,0,98034,47.7142,-122.222,2830,9775,545000,16,6,2014,0,39,7835,6945,0,1,0
3,2.0,1360,9688,1.0,0,0,4,7,1360,0,1983,0,98003,47.2574,-122.31,1390,9685,244000,22,12,2014,0,31,8328,8295,0,0,0
3,2.5,1660,2415,2.0,0,0,3,7,1660,0,1983,0,98042,47.3763,-122.148,1740,2624,165000,22,8,2014,0,31,755,884,0,0,0
2,1.0,800,5000,1.0,0,0,3,7,800,0,1906,0,98107,47.6751,-122.372,1410,5000,435000,9,6,2014,0,108,4200,3590,0,0,1
3,2.5,2670,10082,1.0,0,0,3,10,2670,0,1987,0,98074,47.6359,-122.045,2740,10854,642000,30,5,2014,0,27,7412,8114,0,0,0
3,2.5,1720,4120,2.0,0,0,3,7,1720,0,1999,0,98148,47.4319,-122.328,1720,5544,340000,9,4,2015,0,16,2400,3824,0,0,1
3,1.75,1370,2800,1.0,0,0,5,7,800,570,1982,0,98122,47.6157,-122.291,2270,3773,563250,23,1,2015,0,33,1430,1503,0,1,1
3,1.5,1620,6630,1.0,0,0,3,8,1280,340,1954,0,98117,47.6948,-122.394,1880,5100,620000,12,5,2014,0,60,5010,3220,0,1,1
2,2.0,1290,9041,1.0,0,0,3,7,950,340,1956,0,98108,47.5346,-122.291,1290,5000,275000,10,12,2014,0,58,7751,3710,0,1,1
3,1.0,1830,8209,1.0,0,0,3,7,1830,0,1942,0,98028,47.7439,-122.228,2150,12000,270000,12,5,2014,0,72,6379,9850,0,0,0
4,2.5,2040,5472,2.0,0,0,3,8,2040,0,2003,0,98092,47.3337,-122.189,2420,5782,325000,15,4,2015,0,12,3432,3362,0,0,0
4,2.5,1850,1836,2.0,0,0,3,7,1600,250,2005,0,98029,47.5529,-121.996,1770,2236,476100,3,10,2014,0,9,-14,466,0,1,0
2,1.0,1300,12000,1.0,0,0,4,8,1300,0,1959,0,98004,47.6366,-122.229,2420,15000,700000,20,10,2014,0,55,10700,12580,0,0,0
4,2.0,1620,5200,1.5,0,0,4,7,1620,0,1978,0,98042,47.3629,-122.091,1500,5200,220000,26,9,2014,0,36,3580,3700,0,0,0
3,1.75,1560,10919,1.0,0,0,3,7,1560,0,1975,0,98023,47.2917,-122.366,1730,10919,236000,14,11,2014,0,39,9359,9189,0,0,0
3,2.5,2600,4750,1.0,0,0,4,9,1700,900,1951,0,98117,47.6833,-122.4,2380,4750,790000,2,5,2014,0,63,2150,2370,0,1,1
3,1.0,2010,6000,1.0,0,0,3,7,1210,800,1967,0,98108,47.5515,-122.298,2460,6000,350000,20,8,2014,0,47,3990,3540,0,1,1
2,1.0,780,5300,1.0,0,0,3,6,780,0,1941,0,98146,47.513,-122.354,780,5300,130000,24,3,2015,0,74,4520,4520,0,0,1
4,2.5,1982,6406,2.0,0,0,3,8,1982,0,2004,0,98030,47.3636,-122.192,2340,6501,283200,27,5,2014,0,10,4424,4161,0,0,0
3,1.0,1500,6250,1.0,0,0,3,6,890,610,1945,0,98126,47.5365,-122.368,1210,6250,273000,15,10,2014,0,69,4750,5040,0,1,1
5,2.25,2460,8710,1.0,0,0,4,8,1330,1130,1976,0,98052,47.6651,-122.15,2460,8870,599000,15,12,2014,0,38,6250,6410,0,1,0
4,2.5,2680,11998,1.0,0,3,3,8,1510,1170,1960,0,98003,47.337,-122.321,2680,12746,460000,23,4,2015,0,55,9318,10066,0,1,0
4,1.75,1720,8750,1.0,0,0,3,7,860,860,1971,0,98034,47.726,-122.21,1790,8750,385000,10,6,2014,0,43,7030,6960,0,1,0
3,1.0,1420,7420,1.5,0,0,3,6,1420,0,1944,0,98178,47.4949,-122.239,1290,6600,264250,10,9,2014,0,70,6000,5310,0,0,1
3,2.5,1760,1472,3.0,0,0,3,8,1640,120,2006,0,98119,47.6473,-122.374,1760,5400,608000,29,10,2014,0,8,-288,3640,0,1,1
3,2.0,2360,4800,2.0,0,0,3,9,2360,0,1909,2014,98112,47.6317,-122.312,2260,4800,1760000,3,7,2014,105,105,2440,2540,1,0,1
5,2.0,1890,6050,2.0,0,0,4,7,1890,0,1944,0,98178,47.5018,-122.242,1170,6050,339950,14,11,2014,0,70,4160,4880,0,0,1
6,3.75,3810,6150,2.0,0,0,4,8,3810,0,1977,0,98103,47.694,-122.34,1830,5125,760000,10,4,2015,0,38,2340,3295,0,0,1
2,1.0,1160,5395,1.0,0,0,3,7,860,300,1940,0,98103,47.7007,-122.354,1664,5363,350000,8,4,2015,0,75,4235,3699,0,1,1
6,2.75,3280,16449,1.0,0,0,4,7,1910,1370,1963,0,98007,47.5914,-122.134,2550,9532,730000,27,3,2015,0,52,13169,6982,0,1,0
3,1.0,980,5600,1.0,0,0,2,6,980,0,1949,0,98106,47.5308,-122.361,1840,5302,215000,29,4,2015,0,66,4620,3462,0,0,1
3,2.0,1640,9972,1.0,0,0,4,7,1640,0,1977,0,98075,47.5812,-122.002,1680,10165,420000,15,5,2014,0,37,8332,8485,0,0,0
4,2.25,2060,8470,1.0,0,0,3,8,1440,620,1983,0,98006,47.5605,-122.124,2180,8978,655000,30,5,2014,0,31,6410,6798,0,1,0
3,2.5,1500,10652,2.0,0,0,4,7,1500,0,1981,0,98031,47.4015,-122.176,1610,7417,240000,15,1,2015,0,34,9152,5807,0,0,0
4,2.0,2360,6000,1.0,0,0,5,7,1260,1100,1939,0,98199,47.6534,-122.41,1720,6000,730000,2,6,2014,0,75,3640,4280,0,1,1
4,1.5,1940,12100,1.0,0,0,3,7,1940,0,1962,0,98033,47.6892,-122.164,1380,12100,390000,13,10,2014,0,52,10160,10720,0,0,0
3,1.0,1280,10000,1.0,0,0,4,7,1280,0,1954,0,98006,47.5716,-122.139,1240,10000,473000,28,10,2014,0,60,8720,8760,0,0,0
4,3.5,3630,5670,2.0,0,0,3,10,3630,0,1970,2008,98056,47.5189,-122.206,1620,5400,698000,24,3,2015,38,45,2040,3780,1,0,0
3,2.5,1820,4883,2.0,0,0,3,9,1820,0,2005,0,98028,47.7355,-122.224,2720,5002,511000,14,5,2014,0,9,3063,2282,0,0,0
2,1.5,960,1808,2.0,0,0,3,7,960,0,1993,0,98122,47.6183,-122.298,1290,1668,358000,8,5,2014,0,21,848,378,0,0,1
3,1.75,1630,8400,1.0,0,0,4,7,1060,570,1955,0,98007,47.5983,-122.149,1630,7245,499990,10,4,2015,0,60,6770,5615,0,1,0
4,2.25,1940,10200,1.0,0,0,3,7,1360,580,1960,0,98188,47.4253,-122.283,1940,10200,322000,13,3,2015,0,55,8260,8260,0,1,1
3,1.0,980,9682,1.0,0,0,3,7,980,0,1969,0,98031,47.4136,-122.207,1580,9682,201000,8,10,2014,0,45,8702,8102,0,0,0
4,2.5,3140,16200,1.0,0,1,3,9,2570,570,1988,0,98166,47.4363,-122.342,2530,13200,765000,12,11,2014,0,26,13060,10670,0,1,1
4,2.75,2880,5750,1.5,0,0,5,9,1710,1170,1928,0,98116,47.5874,-122.387,1640,5750,920000,6,6,2014,0,86,2870,4110,0,1,1
4,2.0,1650,7552,1.0,0,0,4,7,860,790,1977,0,98155,47.7765,-122.324,1410,7199,360000,15,4,2015,0,38,5902,5789,0,1,1
3,1.75,1980,9220,2.0,0,0,3,8,1980,0,1987,0,98092,47.2602,-122.219,2080,8305,297300,7,5,2015,0,28,7240,6225,0,0,0
3,1.0,860,9403,1.0,0,0,4,6,860,0,1942,1990,98033,47.6815,-122.173,2136,13009,399000,25,9,2014,48,72,8543,10873,1,0,0
3,1.0,1430,10005,1.5,0,0,4,7,1430,0,1950,0,98133,47.7181,-122.338,1720,8822,400000,20,6,2014,0,64,8575,7102,0,0,1
3,1.75,1260,10164,1.0,0,0,4,6,1260,0,1964,0,98059,47.4752,-122.133,1190,10640,230000,27,8,2014,0,50,8904,9450,0,0,0
3,1.0,960,4560,1.0,0,0,4,7,960,0,1968,0,98106,47.5539,-122.365,970,4800,290000,20,2,2015,0,47,3600,3830,0,0,1
3,2.5,2060,7658,2.0,0,0,3,8,2060,0,2003,0,98023,47.2923,-122.36,2250,7299,323800,30,4,2015,0,12,5598,5049,0,0,0
4,1.5,1430,6380,1.5,0,0,4,9,1430,0,1930,0,98125,47.7014,-122.313,1220,5112,574500,20,10,2014,0,84,4950,3892,0,0,1
3,2.25,1670,1596,2.0,0,0,3,8,1220,450,2002,0,98199,47.6474,-122.396,1670,1596,505000,22,5,2014,0,12,-74,-74,0,1,1
2,1.0,880,10950,1.0,0,0,4,7,880,0,1944,0,98133,47.7332,-122.352,1450,7560,372500,22,4,2015,0,71,10070,6110,0,0,1
2,0.75,520,6862,1.0,0,0,4,4,520,0,1924,1980,98010,47.326,-122.037,1170,8756,330000,14,8,2014,56,90,6342,7586,1,0,0
3,2.5,2140,10136,1.0,0,0,3,8,1320,820,1958,0,98006,47.5602,-122.184,1980,11200,550000,25,1,2015,0,57,7996,9220,0,1,0
4,2.25,1820,8255,1.5,0,0,4,7,1320,500,1930,0,98133,47.723,-122.337,1550,7628,399888,19,6,2014,0,84,6435,6078,0,1,1
2,1.0,1050,2570,1.0,0,0,5,7,850,200,1927,0,98117,47.6764,-122.366,1080,2800,430000,27,6,2014,0,87,1520,1720,0,1,1
3,2.5,2100,6092,2.0,0,0,3,8,2100,0,2013,0,98028,47.7508,-122.239,2250,8592,554990,13,5,2015,0,2,3992,6342,0,0,0
3,2.5,2210,6280,2.0,0,0,3,8,2210,0,2003,0,98038,47.35,-122.043,2250,5972,359950,7,11,2014,0,11,4070,3722,0,0,0
2,1.0,860,2599,1.0,0,0,4,6,860,0,1901,0,98107,47.675,-122.379,1300,3900,405000,23,6,2014,0,113,1739,2600,0,0,1
2,1.0,870,4025,1.0,0,0,3,7,870,0,1981,0,98034,47.7243,-122.161,1370,3488,280000,6,4,2015,0,34,3155,2118,0,0,0
4,2.25,2570,11070,2.0,0,0,4,8,2570,0,1966,0,98058,47.4507,-122.152,2210,9600,479950,8,4,2015,0,49,8500,7390,0,0,0
4,2.25,2360,7733,2.0,0,0,3,8,2360,0,1983,0,98058,47.4403,-122.137,2160,7733,392000,26,2,2015,0,32,5373,5573,0,0,0
3,2.5,2300,9521,2.0,0,0,3,8,2300,0,2003,0,98019,47.7447,-121.976,3020,10042,435000,16,6,2014,0,11,7221,7022,0,0,0
4,2.75,2810,8570,2.0,0,0,3,10,2810,0,1993,0,98004,47.6159,-122.211,2810,9621,1570000,19,8,2014,0,21,5760,6811,0,0,0
4,1.5,2040,10488,1.0,0,0,3,7,1190,850,1961,0,98188,47.4557,-122.269,1960,10488,261000,3,12,2014,0,53,8448,8528,0,1,1
3,2.25,3290,5000,2.0,0,0,3,9,2730,560,1939,0,98105,47.6582,-122.28,2340,4000,1480000,7,5,2015,0,76,1710,1660,0,1,1
7,4.0,2960,2665,2.0,0,0,3,9,1950,1010,1927,2013,98144,47.5835,-122.313,1970,4410,853800,30,4,2015,86,88,-295,2440,1,1,1
3,2.5,2670,10496,2.0,0,0,3,9,2670,0,1989,0,98074,47.6272,-122.026,2490,8636,657500,22,5,2014,0,25,7826,6146,0,0,0
4,2.5,2530,9933,2.0,0,2,3,8,2010,520,1990,0,98092,47.2654,-122.216,2140,9933,331950,4,5,2014,0,24,7403,7793,0,1,0
3,1.75,1720,5899,1.0,0,1,3,8,1220,500,1986,0,98136,47.5399,-122.385,1900,6244,514000,11,6,2014,0,28,4179,4344,0,1,1
3,1.0,1120,5200,1.0,0,0,5,7,1120,0,1976,0,98042,47.3638,-122.088,1690,5200,195700,6,11,2014,0,38,4080,3510,0,0,0
4,2.25,3960,8640,2.0,0,2,3,9,2630,1330,1925,0,98112,47.6317,-122.304,3850,8640,1400000,29,7,2014,0,89,4680,4790,0,1,1
3,2.5,2350,9648,1.0,0,0,4,9,2350,0,1966,0,98008,47.6156,-122.108,2320,10512,643403,23,9,2014,0,48,7298,8192,0,0,0
4,2.5,2380,7066,2.0,0,0,4,7,2380,0,1997,0,98031,47.3982,-122.172,2310,8127,357000,12,5,2014,0,17,4686,5817,0,0,0
3,1.75,1480,8163,1.0,0,0,3,7,1040,440,1953,0,98004,47.638,-122.206,2170,11124,865000,8,4,2015,0,62,6683,8954,0,1,0
3,2.5,2930,9280,2.0,0,0,4,10,2930,0,1988,0,98007,47.6335,-122.151,2730,10090,905000,18,11,2014,0,26,6350,7360,0,0,0
3,1.5,1290,7100,1.0,0,0,3,6,1290,0,1954,0,98198,47.4227,-122.332,1300,7183,265000,22,10,2014,0,60,5810,5883,0,0,1
2,2.5,2730,7246,2.0,0,0,3,9,2730,0,1998,0,98056,47.512,-122.175,3220,7214,535000,24,12,2014,0,16,4516,3994,0,0,0
3,1.0,1290,5440,1.0,0,0,4,6,790,500,1929,0,98117,47.6951,-122.367,1220,5464,450000,11,8,2014,0,85,4150,4244,0,1,1
4,2.5,2170,7533,2.0,0,0,3,8,2170,0,1991,0,98059,47.5057,-122.149,2170,8728,460500,18,2,2015,0,24,5363,6558,0,0,0
4,1.75,1850,8580,1.0,0,0,3,7,1140,710,1960,0,98178,47.4877,-122.24,2210,9240,315000,24,11,2014,0,54,6730,7030,0,1,1
4,2.5,2110,13939,1.0,0,0,3,8,1270,840,1978,0,98008,47.6431,-122.113,2140,8882,607500,13,2,2015,0,37,11829,6742,0,1,0
2,1.0,960,3235,1.0,0,0,4,7,960,0,1916,0,98103,47.661,-122.344,1290,2069,432000,26,1,2015,0,99,2275,779,0,0,1
3,4.0,3910,5350,2.0,0,2,5,10,2610,1300,1933,0,98199,47.6393,-122.408,2890,5350,1700000,9,2,2015,0,82,1440,2460,0,1,1
4,2.5,2590,6139,2.0,0,0,3,8,2590,0,2001,0,98038,47.3883,-122.035,2410,6139,479000,20,8,2014,0,13,3549,3729,0,0,0
5,2.75,3080,6600,2.0,0,0,3,9,3080,0,2002,0,98058,47.4501,-122.122,3080,6600,475000,20,3,2015,0,13,3520,3520,0,0,0
3,1.0,1630,8146,1.0,0,0,3,7,1630,0,1952,0,98125,47.7293,-122.29,1480,8146,415000,19,11,2014,0,62,6516,6666,0,0,1
2,1.0,910,5000,1.0,0,0,4,6,910,0,1914,0,98117,47.683,-122.374,1480,5000,450000,26,8,2014,0,100,4090,3520,0,0,1
5,3.0,3880,8432,2.0,0,0,3,7,3880,0,2004,0,98056,47.4806,-122.176,2620,5623,430000,15,9,2014,0,10,4552,3003,0,0,0
3,1.75,1360,10742,1.0,0,0,5,7,960,400,1971,0,98058,47.4351,-122.173,1830,9000,296000,3,9,2014,0,43,9382,7170,0,1,0
4,2.25,2560,8927,1.0,0,0,3,7,1790,770,1976,0,98001,47.34,-122.271,1920,9669,303000,11,7,2014,0,38,6367,7749,0,1,0
4,2.5,2600,6015,2.0,0,0,3,8,2600,0,2004,0,98075,47.5971,-122.031,2910,5305,641000,21,10,2014,0,10,3415,2395,0,0,0
3,2.25,1220,5739,1.0,0,0,3,7,790,430,1984,0,98115,47.6952,-122.326,1870,5739,280000,10,2,2015,0,31,4519,3869,0,1,1
3,2.0,1560,9635,1.0,0,0,3,7,1260,300,1966,0,98003,47.341,-122.309,1570,8276,260750,5,8,2014,0,48,8075,6706,0,1,0
4,2.5,2080,5191,2.0,0,0,3,8,2080,0,2001,0,98075,47.5978,-122.017,2170,5518,601000,19,11,2014,0,13,3111,3348,0,0,0
3,1.5,1490,6604,1.0,0,0,4,6,1490,0,1918,0,98166,47.4683,-122.351,1330,6604,255000,28,8,2014,0,96,5114,5274,0,0,1
4,2.75,2020,10720,1.0,0,0,4,8,1420,600,1976,0,98052,47.6373,-122.104,2190,10164,555000,5,6,2014,0,38,8700,7974,0,1,0
3,1.5,1530,10827,1.0,0,0,4,8,1530,0,1955,0,98039,47.6354,-122.234,2050,10827,865000,18,11,2014,0,59,9297,8777,0,0,0
2,1.0,1730,9610,1.0,0,0,3,7,1380,350,1962,0,98001,47.2956,-122.285,1310,9812,200000,6,6,2014,0,52,7880,8502,0,1,0
3,1.0,1370,6450,1.0,0,0,3,7,1370,0,1948,0,98125,47.7195,-122.288,1550,6898,357000,17,11,2014,0,66,5080,5348,0,0,1
2,1.5,1050,934,2.0,0,0,3,8,960,90,2007,0,98122,47.6029,-122.309,1470,1885,390000,4,12,2014,0,7,-116,415,0,1,1
5,1.75,2840,10220,1.0,0,0,4,7,2210,630,1954,0,98177,47.764,-122.36,2000,9750,462000,29,7,2014,0,60,7380,7750,0,1,1
2,1.0,1010,5200,1.0,0,0,3,7,1010,0,1955,0,98198,47.4166,-122.323,1580,7500,174500,16,5,2014,0,59,4190,5920,0,0,1
2,1.0,1210,7140,1.5,0,0,3,6,1210,0,1921,0,98133,47.7225,-122.349,1150,7376,305000,10,2,2015,0,94,5930,6226,0,0,1
5,1.75,1720,14040,1.0,0,0,4,8,1150,570,1956,0,98133,47.7365,-122.339,1750,7800,449000,5,2,2015,0,59,12320,6050,0,1,1
3,2.0,2710,5000,2.0,0,0,3,6,2710,0,1951,0,98126,47.5188,-122.373,850,5000,260000,29,8,2014,0,63,2290,4150,0,0,1
4,2.5,3110,6142,2.0,0,0,3,9,3110,0,2004,0,98052,47.701,-122.111,3200,6826,751000,12,5,2014,0,10,3032,3626,0,0,0
2,1.0,1250,9270,1.0,0,0,4,7,1250,0,1948,0,98133,47.7284,-122.339,1130,6800,370037,1,4,2015,0,67,8020,5670,0,0,1
3,1.75,1900,8910,2.0,0,0,4,7,1900,0,1988,0,98092,47.2769,-122.145,1610,8586,229950,25,8,2014,0,26,7010,6976,0,0,0
3,1.75,1740,7682,1.0,0,0,3,8,1330,410,1978,0,98058,47.4451,-122.126,2010,8820,349000,22,4,2015,0,37,5942,6810,0,1,0
4,2.5,2070,3808,2.0,0,0,3,8,2070,0,2003,0,98058,47.4498,-122.12,1900,2992,348000,20,1,2015,0,12,1738,1092,0,0,0
3,3.25,3030,5600,2.0,0,2,3,9,2220,810,1905,2005,98144,47.5978,-122.292,2040,6600,1220000,17,4,2015,100,110,2570,4560,1,1,1
3,1.5,1520,6805,1.0,0,0,4,7,1040,480,1981,0,98023,47.2907,-122.367,1440,7041,265000,23,3,2015,0,34,5285,5601,0,1,0
3,2.75,2780,4815,3.0,0,2,3,10,2780,0,1974,0,98105,47.6569,-122.286,2820,5000,1250000,28,10,2014,0,40,2035,2180,0,0,1
3,1.75,2590,8384,1.0,0,0,4,8,1590,1000,1971,0,98011,47.7739,-122.199,2590,8800,485000,5,8,2014,0,43,5794,6210,0,1,0
4,1.0,1150,5217,1.5,0,0,3,7,1150,0,1951,0,98115,47.6806,-122.287,1220,5217,489000,20,3,2015,0,64,4067,3997,0,0,1
2,1.0,920,5120,1.0,0,0,5,7,920,0,1952,0,98136,47.5569,-122.394,1190,5120,400000,22,1,2015,0,63,4200,3930,0,0,1
3,2.5,2110,3600,2.0,0,0,3,9,2110,0,2005,0,98052,47.665,-122.082,2540,4384,638000,16,6,2014,0,9,1490,1844,0,0,0
3,1.75,1170,8740,1.0,0,0,4,7,1170,0,1968,0,98052,47.6849,-122.117,1870,8448,440000,19,6,2014,0,46,7570,6578,0,0,0
6,2.0,1900,8240,1.0,0,0,2,7,1200,700,1964,0,98125,47.7037,-122.296,1900,8240,305000,25,6,2014,0,50,6340,6340,0,1,1
6,2.0,1900,8240,1.0,0,0,2,7,1200,700,1964,0,98125,47.7037,-122.296,1900,8240,649950,19,3,2015,0,51,6340,6340,0,1,1
4,2.5,3290,6012,2.0,0,0,3,9,3290,0,2005,0,98075,47.5961,-121.98,3210,6005,680000,13,2,2015,0,10,2722,2795,0,0,0
3,2.5,2160,7584,2.0,0,0,3,8,2160,0,1988,0,98029,47.5751,-122.014,2160,7372,555000,4,9,2014,0,26,5424,5212,0,0,0
3,2.5,1980,6608,2.0,0,0,3,8,1980,0,1994,0,98092,47.2642,-122.213,2150,7495,272000,8,8,2014,0,20,4628,5345,0,0,0
4,2.25,2600,9900,1.0,0,0,3,7,1600,1000,1965,0,98178,47.4881,-122.237,1770,11250,270000,26,6,2014,0,49,7300,9480,0,1,1
3,1.0,1280,9775,1.0,0,0,3,6,1280,0,1964,0,98003,47.3262,-122.334,1230,8750,215000,6,1,2015,0,51,8495,7520,0,0,0
3,1.5,1710,17707,1.0,0,0,4,7,1180,530,1947,0,98040,47.5393,-122.216,2590,9508,690000,2,4,2015,0,68,15997,6918,0,1,0
4,1.75,1270,6825,1.0,0,2,3,7,1270,0,1950,0,98178,47.5051,-122.242,1800,6930,256000,5,3,2015,0,65,5555,5130,0,0,1
3,2.25,1890,7314,1.0,0,0,3,7,1100,790,1981,0,98031,47.4121,-122.172,1520,7676,255000,24,3,2015,0,34,5424,6156,0,1,0
7,4.0,3440,8100,2.0,0,0,3,7,3440,0,1970,0,98103,47.6981,-122.349,1420,1560,550000,13,5,2014,0,44,4660,140,0,0,1
3,1.0,1190,5280,1.0,0,0,4,7,1190,0,1957,0,98146,47.5131,-122.383,1280,5280,410000,8,5,2015,0,58,4090,4000,0,0,1
2,1.0,1030,4366,1.0,0,0,3,7,1030,0,1912,0,98136,47.5311,-122.384,1890,4499,410000,6,11,2014,0,102,3336,2609,0,0,1
3,1.75,1240,4000,1.0,0,0,3,7,1240,0,1986,0,98055,47.4728,-122.191,1570,4586,259000,16,7,2014,0,28,2760,3016,0,0,0
4,3.5,4610,12500,2.0,0,2,3,11,4610,0,2003,0,98033,47.6508,-122.203,2340,11538,1650000,12,8,2014,0,11,7890,9198,0,0,0
5,1.0,1590,5000,1.5,0,0,3,7,1190,400,1929,0,98116,47.5752,-122.381,1590,5000,518000,13,11,2014,0,85,3410,3410,0,1,1
3,2.5,1760,3097,2.0,0,0,3,8,1760,0,1992,0,98029,47.5764,-121.996,1760,3285,485000,5,3,2015,0,23,1337,1525,0,0,0
4,2.5,2340,5420,2.0,0,0,3,8,2340,0,2003,0,98038,47.3773,-122.029,2420,6252,354000,23,4,2015,0,12,3080,3832,0,0,0
3,1.75,1150,10466,1.0,0,0,5,7,1150,0,1959,0,98006,47.5531,-122.177,1350,10384,464500,24,6,2014,0,55,9316,9034,0,0,0
3,2.5,1750,4200,2.0,0,0,3,7,1750,0,2005,0,98038,47.3605,-122.04,1890,4048,300000,25,8,2014,0,9,2450,2158,0,0,0
3,2.75,3890,7216,2.0,0,1,3,8,3260,630,1967,2010,98118,47.5445,-122.266,2490,9920,1080000,1,7,2014,43,47,3326,7430,1,1,1
4,2.5,1770,6666,2.0,0,0,3,7,1770,0,1989,0,98023,47.2877,-122.349,1780,6666,309950,21,7,2014,0,25,4896,4886,0,0,0
3,1.0,1160,3700,1.5,0,0,3,7,1160,0,1909,0,98106,47.5651,-122.359,1340,3750,315000,17,9,2014,0,105,2540,2410,0,0,1
3,1.0,1440,5580,1.5,0,0,3,7,1440,0,1908,0,98115,47.6898,-122.326,2010,5580,499950,24,7,2014,0,106,4140,3570,0,0,1
4,2.0,2600,4800,1.0,0,2,3,8,1400,1200,1953,0,98119,47.637,-122.371,2050,3505,780000,7,7,2014,0,61,2200,1455,0,1,1
3,3.25,2640,16090,1.0,0,2,4,8,1960,680,1976,0,98040,47.5374,-122.213,3690,15000,885000,21,11,2014,0,38,13450,11310,0,1,0
2,1.0,1010,3885,1.5,0,0,4,7,1010,0,1906,1990,98112,47.6224,-122.304,1770,4200,500000,7,5,2014,84,108,2875,2430,1,0,1
3,2.0,1840,6755,1.0,0,2,3,8,1840,0,1989,0,98003,47.3512,-122.305,1790,6459,329000,19,12,2014,0,25,4915,4669,0,0,0
4,1.75,1720,7455,1.0,0,0,4,7,1020,700,1963,0,98058,47.4669,-122.182,1720,7700,246000,28,10,2014,0,51,5735,5980,0,1,0
3,1.5,1280,9600,1.0,0,0,4,7,1280,0,1960,0,98033,47.6922,-122.163,1510,10005,405000,23,12,2014,0,54,8320,8495,0,0,0
4,1.75,1700,7800,1.0,0,0,5,7,1120,580,1981,0,98059,47.4801,-122.158,1560,7800,349000,29,5,2014,0,33,6100,6240,0,1,0
4,2.5,1980,12062,2.0,0,0,3,8,1980,0,1992,0,98031,47.4038,-122.167,2300,7902,374950,23,3,2015,0,23,10082,5602,0,0,0
3,2.0,1160,7217,1.0,0,0,3,7,1160,0,1969,0,98034,47.7279,-122.227,1870,9104,306000,29,7,2014,0,45,6057,7234,0,0,0
4,1.75,1980,7840,1.0,0,0,4,7,990,990,1961,0,98008,47.6226,-122.115,1520,8400,416000,5,8,2014,0,53,5860,6880,0,1,0
3,2.5,1960,12476,2.0,0,0,4,8,1960,0,1989,0,98056,47.5315,-122.172,2450,12177,560000,23,6,2014,0,25,10516,9727,0,0,0
3,1.75,1980,11274,1.0,0,0,4,7,1480,500,1968,0,98058,47.4474,-122.167,1520,8010,299950,11,12,2014,0,46,9294,6490,0,1,0
3,2.5,1450,8977,1.0,0,0,3,8,1450,0,1990,0,98092,47.2576,-122.214,2410,8850,265500,6,4,2015,0,25,7527,6440,0,0,0
3,1.5,1200,12000,1.0,0,0,3,7,1200,0,1986,0,98001,47.268,-122.245,1200,9405,219000,12,8,2014,0,28,10800,8205,0,0,0
3,1.75,1830,17349,1.0,0,0,3,8,1230,600,1977,0,98072,47.7427,-122.109,1840,11694,365000,5,5,2015,0,38,15519,9854,0,1,0
3,1.75,1510,8301,1.0,0,0,3,7,1510,0,1967,0,98034,47.7243,-122.222,1460,7910,366000,2,6,2014,0,47,6791,6450,0,0,0
3,2.25,1310,1264,3.0,0,0,3,8,1310,0,2014,0,98117,47.6987,-122.366,1330,2183,514950,1,5,2015,0,1,-46,853,0,0,1
4,2.75,3790,10669,2.0,0,0,3,10,3790,0,1999,0,98075,47.5976,-121.983,3750,11634,875000,4,6,2014,0,15,6879,7884,0,0,0
3,2.25,2240,8800,1.0,0,0,5,8,2240,0,1957,0,98005,47.5937,-122.172,2240,8800,831000,20,1,2015,0,58,6560,6560,0,0,0
4,3.25,2740,7266,2.0,0,0,3,9,2060,680,2003,0,98027,47.5346,-122.066,3030,6546,689900,15,5,2014,0,11,4526,3516,0,1,0
3,2.5,1660,10763,2.0,0,0,3,7,1660,0,1994,0,98038,47.3812,-122.029,2010,7983,315000,24,7,2014,0,20,9103,5973,0,0,0
3,1.0,1480,7284,1.0,0,0,3,7,970,510,1963,0,98133,47.7757,-122.353,2020,7920,336500,24,6,2014,0,51,5804,5900,0,1,1
3,2.75,2640,4050,1.5,0,0,5,8,1750,890,1926,0,98112,47.6332,-122.281,1920,3600,1100000,27,5,2014,0,88,1410,1680,0,1,1
6,2.0,1900,8057,1.0,0,0,4,7,1170,730,1959,0,98133,47.762,-122.335,2090,8626,375000,4,8,2014,0,55,6157,6536,0,1,1
4,3.5,3440,6000,2.0,0,0,4,8,3440,0,2002,0,98198,47.4077,-122.331,1660,7800,455000,8,7,2014,0,12,2560,6140,0,0,1
3,1.75,1640,10695,1.0,0,2,3,8,1640,0,1975,0,98034,47.7145,-122.222,2790,9775,505000,25,6,2014,0,39,9055,6985,0,0,0
3,1.0,1450,3350,1.5,0,0,4,7,1450,0,1919,0,98126,47.5607,-122.378,1340,4255,450000,30,7,2014,0,95,1900,2915,0,0,1
3,2.5,2300,7398,2.0,0,0,3,8,2300,0,2001,0,98065,47.5369,-121.876,2580,6983,567500,8,6,2014,0,13,5098,4403,0,0,0
3,1.5,1460,8505,1.0,0,0,4,7,1460,0,1955,0,98055,47.4402,-122.195,1580,8505,265000,6,10,2014,0,59,7045,6925,0,0,0
3,2.0,1570,14992,1.0,0,0,3,8,1570,0,2001,0,98014,47.6965,-121.922,1640,15000,340000,30,12,2014,0,13,13422,13360,0,0,0
3,2.0,1540,8885,1.5,0,0,5,6,1540,0,1939,0,98019,47.7403,-121.984,1730,5000,375000,30,4,2015,0,76,7345,3270,0,0,0
6,3.0,3300,4218,2.0,0,0,3,8,2200,1100,1970,0,98103,47.6557,-122.344,1420,4218,920000,26,12,2014,0,44,918,2798,0,1,1
4,2.25,2130,11843,2.0,0,0,4,9,2130,0,1972,0,98040,47.5358,-122.225,2380,11643,850000,12,6,2014,0,42,9713,9263,0,0,0
3,1.0,1010,9750,1.0,0,0,5,7,1010,0,1969,0,98042,47.3244,-122.144,1230,9750,202000,10,12,2014,0,45,8740,8520,0,0,0
4,3.0,2420,12000,1.0,0,0,3,9,2420,0,1984,0,98077,47.7267,-122.063,3100,13020,725000,29,9,2014,0,30,9580,9920,0,0,0
2,1.5,1960,6000,1.0,0,0,3,8,1210,750,1951,0,98103,47.6849,-122.333,2060,6000,680200,6,2,2015,0,64,4040,3940,0,1,1
3,1.0,1170,9000,1.0,0,0,4,6,1170,0,1918,0,98022,47.2109,-121.987,1280,8160,216500,14,4,2015,0,97,7830,6880,0,0,0
3,1.5,1890,7650,1.0,0,0,5,7,1890,0,1966,0,98003,47.3454,-122.314,1510,7560,325000,12,12,2014,0,48,5760,6050,0,0,0
3,2.5,2250,4134,2.0,0,0,3,9,2250,0,2004,0,98052,47.6651,-122.084,2390,4134,675000,12,8,2014,0,10,1884,1744,0,0,0
2,0.75,750,16321,1.0,0,1,3,4,750,0,1936,0,98034,47.6985,-122.229,3020,10625,435000,12,5,2015,0,79,15571,7605,0,0,0
3,1.75,1610,14000,1.0,0,0,4,7,1050,560,1977,0,98010,47.3429,-122.036,1550,10080,263500,22,1,2015,0,38,12390,8530,0,1,0
3,2.5,2520,3750,2.0,0,1,4,9,2520,0,1995,0,98116,47.5671,-122.404,2250,6200,875000,22,4,2015,0,20,1230,3950,0,0,1
4,1.0,1340,8400,1.0,0,0,5,7,1340,0,1966,0,98023,47.3313,-122.343,1120,8400,246600,11,4,2015,0,49,7060,7280,0,0,0
3,2.25,1460,941,3.0,0,0,3,8,1460,0,2006,0,98133,47.7145,-122.356,1490,1399,337000,1,7,2014,0,8,-519,-91,0,0,1
3,1.75,1380,7500,1.0,0,0,3,7,1380,0,1988,0,98038,47.3628,-122.045,1530,7500,240000,11,11,2014,0,26,6120,5970,0,0,0
3,1.75,1510,11120,1.0,0,0,4,8,1510,0,1984,0,98005,47.5931,-122.158,2660,10800,490000,10,9,2014,0,30,9610,8140,0,0,0
3,1.0,910,8008,1.0,0,0,3,7,910,0,1971,0,98034,47.726,-122.22,1480,7404,305000,7,3,2015,0,44,7098,5924,0,0,0
3,2.5,1970,3655,2.0,0,0,3,7,1970,0,2003,0,98019,47.7453,-121.984,1970,2952,350000,3,4,2015,0,12,1685,982,0,0,0
3,1.75,1540,6632,1.0,0,0,3,7,1070,470,1959,0,98178,47.4973,-122.252,2510,6618,284200,24,2,2015,0,56,5092,4108,0,1,1
4,2.5,1980,9757,2.0,0,0,5,7,1980,0,1995,0,98038,47.3675,-122.019,1610,6147,357000,28,1,2015,0,20,7777,4537,0,0,0
3,2.25,2300,15952,1.0,0,0,4,8,1150,1150,1963,0,98039,47.6322,-122.232,2200,14284,1000000,8,10,2014,0,51,13652,12084,0,1,0
4,2.25,1880,3000,2.0,0,0,3,8,1760,120,1909,1977,98103,47.6864,-122.349,1880,3000,616500,25,11,2014,68,105,1120,1120,1,1,1
4,2.75,2640,3750,2.0,0,0,5,7,1840,800,1911,0,98117,47.6783,-122.363,1690,5000,750000,25,11,2014,0,103,1110,3310,0,1,1
6,4.5,3900,9100,2.0,0,0,3,8,2870,1030,1979,0,98052,47.6612,-122.137,2080,9216,650000,7,10,2014,0,35,5200,7136,0,1,0
4,2.25,2670,10050,1.0,0,0,4,8,1420,1250,1962,0,98032,47.3792,-122.28,2190,10050,275000,15,7,2014,0,52,7380,7860,0,1,0
4,1.75,1840,4280,1.0,0,0,4,7,920,920,1918,0,98105,47.6681,-122.32,1660,4280,540000,3,10,2014,0,96,2440,2620,0,1,1
3,1.0,1120,10665,1.0,0,0,4,6,1120,0,1961,0,98001,47.2886,-122.274,1240,10639,225000,14,8,2014,0,53,9545,9399,0,0,0
4,2.5,2970,9072,2.0,0,0,3,10,2970,0,1991,0,98006,47.562,-122.114,2740,8729,845000,9,4,2015,0,24,6102,5989,0,0,0
3,2.25,1410,7740,1.0,0,0,5,6,1410,0,1923,0,98126,47.523,-122.371,1220,7740,490000,12,3,2015,0,92,6330,6520,0,0,1
4,2.5,3060,8167,2.0,0,0,3,9,3060,0,2005,0,98029,47.5521,-121.989,2930,4800,753000,9,12,2014,0,9,5107,1870,0,0,0
3,1.75,2490,7210,1.0,0,0,3,7,1290,1200,1972,0,98034,47.726,-122.198,1610,7210,475000,9,2,2015,0,43,4720,5600,0,1,0
1,0.75,840,7203,1.5,0,0,3,6,840,0,1949,0,98168,47.4756,-122.301,1560,8603,124000,3,10,2014,0,65,6363,7043,0,0,1
1,0.75,840,7203,1.5,0,0,3,6,840,0,1949,0,98168,47.4756,-122.301,1560,8603,224000,24,4,2015,0,66,6363,7043,0,0,1
2,1.0,1130,3800,1.0,0,0,4,7,1130,0,1916,0,98117,47.6862,-122.378,1470,3800,485000,14,8,2014,0,98,2670,2330,0,0,1
4,1.75,1850,6000,1.0,0,0,4,6,1270,580,1944,0,98178,47.4923,-122.247,1270,6600,230000,24,6,2014,0,70,4150,5330,0,1,1
4,2.75,2330,14175,1.0,0,0,3,7,1800,530,1980,0,98031,47.4193,-122.194,1480,10125,372000,5,11,2014,0,34,11845,8645,0,1,0
4,2.5,1880,9426,2.0,0,0,4,7,1880,0,1990,0,98042,47.3584,-122.089,1760,7040,306000,7,5,2015,0,25,7546,5280,0,0,0
4,3.5,2980,3000,2.0,0,0,3,9,2340,640,2008,0,98115,47.6768,-122.326,1810,4545,905000,27,8,2014,0,6,20,2735,0,1,1
4,1.0,1440,6678,1.0,0,0,3,7,1040,400,1950,0,98116,47.571,-122.392,1320,6678,440000,26,3,2015,0,65,5238,5358,0,1,1
3,1.75,1630,10001,1.0,0,0,4,7,1100,530,1977,0,98042,47.3605,-122.12,1630,10001,280000,28,4,2015,0,38,8371,8371,0,1,0
3,2.5,1930,4500,2.0,0,0,3,8,1930,0,1990,0,98029,47.5791,-122.001,1770,4500,425000,24,6,2014,0,24,2570,2730,0,0,0
2,0.75,1130,11429,1.0,0,0,3,7,1130,0,1956,0,98188,47.4526,-122.284,1550,10700,204950,26,8,2014,0,58,10299,9150,0,0,1
2,1.75,1650,7500,1.0,0,0,4,7,1000,650,1959,0,98033,47.6871,-122.207,2530,9000,670000,14,7,2014,0,55,5850,6470,0,1,0
2,1.0,820,2723,1.0,0,0,3,7,820,0,1921,0,98103,47.6623,-122.339,1370,3850,475000,7,5,2014,0,93,1903,2480,0,0,1
5,2.5,2900,6650,1.0,0,0,3,7,1450,1450,1964,0,98168,47.4935,-122.332,1600,8246,352000,20,3,2015,0,51,3750,6646,0,1,1
4,1.75,2330,8800,1.0,0,2,4,7,1260,1070,1961,0,98008,47.6148,-122.113,2270,8800,575000,9,4,2015,0,54,6470,6530,0,1,0
3,2.0,1660,5070,2.0,0,3,3,8,1660,0,1950,1990,98108,47.5552,-122.296,2440,6664,491000,13,10,2014,40,64,3410,4224,1,0,1
4,2.5,3020,7465,2.0,0,0,3,9,3020,0,2004,0,98075,47.5982,-121.98,3100,5587,750000,9,7,2014,0,10,4445,2487,0,0,0
4,1.0,1150,6000,1.5,0,0,3,6,1150,0,1907,0,98118,47.562,-122.283,840,3030,225000,13,8,2014,0,107,4850,2190,0,0,1
4,2.5,2130,7300,1.0,0,0,4,7,1230,900,1963,0,98005,47.605,-122.167,2130,7560,732600,22,6,2014,0,51,5170,5430,0,1,0
4,2.25,2460,8001,2.0,0,0,4,8,2460,0,1984,0,98006,47.548,-122.154,2460,9126,818000,16,3,2015,0,31,5541,6666,0,0,0
3,2.25,2360,14950,1.0,0,0,4,9,2360,0,1978,0,98042,47.3856,-122.158,2720,14388,431000,20,8,2014,0,36,12590,11668,0,0,0
2,2.25,1320,1034,3.0,0,0,3,7,1320,0,1996,0,98133,47.7039,-122.344,1330,1206,304000,2,10,2014,0,18,-286,-124,0,0,1
5,2.0,1910,4667,1.0,0,0,3,7,1010,900,1908,0,98112,47.6236,-122.306,1230,2545,650000,21,10,2014,0,106,2757,1315,0,1,1
2,2.0,1610,6160,2.0,0,0,4,8,1610,0,1977,0,98052,47.6644,-122.13,1750,6305,450000,10,4,2015,0,38,4550,4555,0,0,0
4,1.0,1610,8401,1.0,0,0,3,7,1610,0,1958,0,98056,47.5104,-122.165,1610,8401,269000,22,8,2014,0,56,6791,6791,0,0,0
3,1.0,1160,10732,1.0,0,0,3,7,1160,0,1953,0,98004,47.6391,-122.205,2390,13656,875000,31,12,2014,0,61,9572,11266,0,0,0
4,2.25,2870,8393,1.0,0,0,4,8,1480,1390,1977,0,98040,47.5787,-122.245,2930,9850,890000,29,4,2015,0,38,5523,6920,0,1,0
4,2.5,2280,9725,2.0,0,0,3,8,2280,0,1986,0,98072,47.7568,-122.141,2140,8780,565000,9,10,2014,0,28,7445,6640,0,0,0
2,2.0,1370,1339,2.0,0,0,4,8,1150,220,2006,0,98122,47.6021,-122.295,1370,1339,448175,13,3,2015,0,9,-31,-31,0,1,1
5,3.0,2970,6500,2.0,0,0,3,9,2970,0,2000,0,98075,47.5973,-122.018,2970,6588,680000,11,9,2014,0,14,3530,3618,0,0,0
3,3.5,1570,1486,2.5,0,0,3,8,1330,240,2000,0,98199,47.652,-122.384,1610,1486,494000,22,4,2015,0,15,-84,-124,0,1,1
4,3.0,2880,5500,2.0,0,0,4,9,1920,960,1926,0,98102,47.6448,-122.317,2110,5500,1100000,27,1,2015,0,89,2620,3390,0,1,1
5,2.5,1900,9460,1.0,0,0,3,7,1190,710,1969,0,98034,47.7096,-122.202,1940,8360,450000,16,1,2015,0,46,7560,6420,0,1,0
3,1.75,2020,11050,1.0,0,0,4,8,1320,700,1969,0,98059,47.4706,-122.119,1940,11050,330000,30,10,2014,0,45,9030,9110,0,1,0
4,2.5,3110,11397,2.0,0,3,4,10,3110,0,1984,0,98006,47.5623,-122.106,3110,11586,960000,20,8,2014,0,30,8287,8476,0,0,0
4,2.5,2390,7056,2.0,0,0,3,9,2390,0,1990,0,98001,47.3385,-122.264,2590,7801,360000,24,12,2014,0,24,4666,5211,0,0,0
3,2.5,2150,11672,2.0,0,0,3,8,2150,0,2004,0,98038,47.3515,-122.006,2150,5450,378000,10,8,2014,0,10,9522,3300,0,0,0
3,1.75,1340,6250,1.0,0,0,4,7,1090,250,1941,0,98136,47.5427,-122.386,1550,1755,499950,12,9,2014,0,73,4910,205,0,1,1
3,2.5,1990,12866,2.0,0,0,4,7,1990,0,1986,0,98072,47.7477,-122.17,2310,8803,450000,24,7,2014,0,28,10876,6493,0,0,0
2,2.0,1600,5969,1.0,0,0,4,7,800,800,1950,0,98116,47.5691,-122.394,1520,5969,523500,25,8,2014,0,64,4369,4449,0,1,1
3,2.5,2080,4828,2.0,0,0,3,8,2080,0,2002,0,98042,47.3737,-122.132,2190,4620,290000,2,6,2014,0,12,2748,2430,0,0,0
3,3.25,1340,5434,2.0,0,0,3,7,1340,0,1986,0,98038,47.3779,-122.045,1670,6203,176000,6,2,2015,0,29,4094,4533,0,0,0
3,2.0,2590,3750,1.5,0,0,5,7,1790,800,1904,0,98109,47.635,-122.353,2440,4000,885000,18,9,2014,0,110,1160,1560,0,1,1
2,1.75,1240,3000,1.5,0,0,3,7,1240,0,1906,0,98105,47.6689,-122.326,1800,4080,483000,24,6,2014,0,108,1760,2280,0,0,1
3,1.0,1310,7125,1.0,0,0,4,7,1310,0,1978,0,98042,47.3739,-122.148,1650,7290,240000,8,5,2015,0,37,5815,5640,0,0,0
4,2.25,2530,5200,1.0,0,1,4,8,1530,1000,1957,0,98117,47.6985,-122.382,2240,5200,720000,25,9,2014,0,57,2670,2960,0,1,1
4,2.5,1780,5822,2.0,0,0,3,7,1780,0,2001,0,98058,47.4455,-122.169,1990,4092,311000,5,11,2014,0,13,4042,2102,0,0,0
3,2.0,1600,7995,1.0,0,0,3,7,1600,0,1950,1984,98118,47.5177,-122.257,2440,6900,332500,2,1,2015,34,65,6395,4460,1,0,1
3,1.75,1570,15330,1.0,0,0,3,7,1080,490,1956,0,98166,47.4608,-122.34,1250,13330,164950,26,6,2014,0,58,13760,12080,0,1,1
3,1.75,1570,15330,1.0,0,0,3,7,1080,490,1956,0,98166,47.4608,-122.34,1250,13330,371000,23,3,2015,0,59,13760,12080,0,1,1
3,1.75,1650,16200,1.0,0,0,3,7,1650,0,1976,0,98031,47.3926,-122.168,1650,8680,264500,23,1,2015,0,39,14550,7030,0,0,0
4,2.25,2920,6513,2.0,0,0,4,9,2260,660,1937,0,98112,47.638,-122.29,4510,9248,1740000,5,7,2014,0,77,3593,4738,0,1,1
2,1.0,870,4280,1.0,0,2,4,6,870,0,1921,0,98105,47.6697,-122.29,1750,4280,503000,30,3,2015,0,94,3410,2530,0,0,1
4,2.5,2830,5010,2.0,0,0,3,9,2170,660,2000,0,98115,47.6952,-122.327,1880,5739,738000,29,10,2014,0,14,2180,3859,0,1,1
2,1.0,980,3350,1.0,0,0,4,7,980,0,1925,0,98103,47.6858,-122.352,1260,4000,393000,23,9,2014,0,89,2370,2740,0,0,1
4,2.5,2360,9647,1.0,0,2,3,8,1530,830,1964,0,98003,47.3367,-122.332,2580,9680,260000,25,3,2015,0,51,7287,7100,0,1,0
2,1.0,1000,4640,1.0,0,2,3,7,1000,0,1915,0,98116,47.5659,-122.389,1940,5800,505000,9,4,2015,0,100,3640,3860,0,0,1
3,1.5,1660,8000,1.0,0,0,4,7,1120,540,1976,0,98030,47.353,-122.172,1900,7500,241000,5,1,2015,0,39,6340,5600,0,1,0
3,1.75,1520,9605,1.0,0,0,3,7,1520,0,1975,0,98052,47.667,-122.142,2040,9900,530000,16,3,2015,0,40,8085,7860,0,0,0
1,1.0,1180,4000,1.5,0,2,4,8,840,340,1910,0,98118,47.5561,-122.266,1420,4000,713000,12,8,2014,0,104,2820,2580,0,1,1
3,1.75,1770,10125,2.0,0,0,3,7,1770,0,1944,1978,98133,47.7289,-122.353,1680,9825,487000,22,7,2014,34,70,8355,8145,1,0,1
2,1.0,980,5393,1.0,0,0,3,6,980,0,1969,0,98042,47.3674,-122.081,980,5200,128000,13,11,2014,0,45,4413,4220,0,0,0
3,1.0,1840,10178,1.0,0,0,3,7,1040,800,1960,0,98198,47.3979,-122.317,2040,10660,210500,13,11,2014,0,54,8338,8620,0,1,1
3,2.5,1810,7210,1.0,0,0,5,7,1210,600,1968,0,98059,47.5067,-122.163,1770,7210,420000,15,1,2015,0,47,5400,5440,0,1,0
3,2.5,1780,4320,2.0,0,0,4,8,1780,0,1930,1986,98115,47.6809,-122.293,1690,4952,679000,30,10,2014,56,84,2540,3262,1,0,1
4,2.75,2840,4227,3.0,0,0,3,9,2840,0,2014,0,98052,47.7097,-122.107,2880,4227,784950,18,12,2014,0,0,1387,1347,0,0,0
4,2.5,2650,6366,2.0,0,0,3,9,2650,0,1998,0,98092,47.3325,-122.171,2650,6200,352000,19,11,2014,0,16,3716,3550,0,0,0
3,1.5,1270,1318,2.0,0,0,3,7,1080,190,2004,0,98199,47.6526,-122.384,1360,1488,386000,11,6,2014,0,10,48,128,0,1,1
3,1.75,1260,17000,1.0,0,0,3,7,1260,0,1994,0,98146,47.5114,-122.361,1540,7213,335000,30,4,2015,0,21,15740,5673,0,0,1
5,2.25,2680,13292,1.0,0,0,3,8,1340,1340,1976,0,98028,47.7422,-122.257,2220,13181,599950,3,11,2014,0,38,10612,10961,0,1,0
4,3.25,3830,6765,2.0,0,0,3,9,3830,0,2014,0,98053,47.685,-122.016,3830,6507,963990,24,7,2014,0,0,2935,2677,0,0,0
3,2.0,1610,3600,2.0,0,2,5,8,1610,0,1925,0,98144,47.5969,-122.293,2540,6600,735000,25,9,2014,0,89,1990,4060,0,0,1
3,4.25,3840,9751,2.0,0,0,3,10,3840,0,1998,0,98074,47.6347,-122.064,3230,7189,858450,17,3,2015,0,17,5911,3959,0,0,0
5,2.75,2670,4000,2.0,0,0,4,7,1800,870,1914,0,98105,47.6711,-122.315,2460,4000,665000,7,5,2015,0,101,1330,1540,0,1,1
3,2.5,2000,7414,2.0,0,0,4,7,2000,0,1993,0,98038,47.3508,-122.057,2000,7414,290000,31,7,2014,0,21,5414,5414,0,0,0
2,1.0,860,4320,1.0,0,0,3,7,860,0,1925,0,98108,47.5263,-122.325,980,6000,250000,13,4,2015,0,90,3460,5020,0,0,1
3,1.75,1420,7205,1.0,0,0,3,7,1420,0,1986,0,98030,47.3555,-122.175,1690,7405,192500,8,10,2014,0,28,5785,5715,0,0,0
4,2.0,2060,13400,1.0,0,2,4,8,2060,0,1957,0,98166,47.4404,-122.34,1950,10370,350000,25,8,2014,0,57,11340,8420,0,0,1
4,2.5,2790,9910,2.0,0,0,3,8,2790,0,2003,0,98059,47.4891,-122.141,2590,9910,518000,19,3,2015,0,12,7120,7320,0,0,0
4,1.0,1410,3376,1.5,0,0,5,7,1410,0,1911,0,98107,47.6606,-122.365,1040,3600,563000,1,7,2014,0,103,1966,2560,0,0,1
4,3.0,2420,9566,2.0,0,0,3,7,2420,0,2003,0,98188,47.4693,-122.266,2420,9135,375000,7,10,2014,0,11,7146,6715,0,0,1
3,2.5,1460,1319,3.0,0,0,3,8,1460,0,2002,0,98103,47.698,-122.349,1430,1530,400000,27,2,2015,0,13,-141,100,0,0,1
2,1.0,1000,5120,1.0,0,0,3,6,1000,0,1902,0,98122,47.6088,-122.307,1940,4300,317500,23,9,2014,0,112,4120,2360,0,0,1
3,2.5,1740,13750,2.0,0,0,4,9,1740,0,1975,0,98008,47.6264,-122.092,2540,14300,645000,13,5,2014,0,39,12010,11760,0,0,0
2,1.0,1280,4840,1.0,0,0,3,7,1200,80,1908,0,98115,47.6762,-122.299,1860,5500,649000,9,3,2015,0,107,3560,3640,0,1,1
4,2.5,2520,3980,2.0,0,0,3,8,2520,0,2004,0,98027,47.5399,-122.07,2580,3980,605000,17,4,2015,0,11,1460,1400,0,0,0
3,3.5,1500,1471,3.0,0,0,3,7,1500,0,1999,0,98177,47.7034,-122.362,1500,1445,337900,21,8,2014,0,15,-29,-55,0,0,1
3,2.75,2490,3600,2.0,0,0,3,8,2290,200,1906,0,98122,47.6098,-122.292,1880,3600,535000,5,2,2015,0,109,1110,1720,0,1,1
4,1.0,1530,5684,1.0,0,0,3,7,1130,400,1957,0,98108,47.5507,-122.298,1540,6095,325000,22,9,2014,0,57,4154,4555,0,1,1
4,2.25,1740,10875,1.0,0,0,3,8,1740,0,1967,0,98059,47.5132,-122.157,1680,10701,429950,15,12,2014,0,47,9135,9021,0,0,0
2,1.0,1280,6000,1.0,0,0,3,7,1280,0,1965,0,98112,47.6339,-122.282,2460,4800,650000,31,7,2014,0,49,4720,2340,0,0,1
4,2.25,2320,13114,2.0,0,0,5,8,2320,0,1967,0,98040,47.5762,-122.239,2740,15000,1200000,1,5,2015,0,48,10794,12260,0,0,0
2,1.0,1140,10404,1.0,0,0,3,5,1140,0,1935,0,98155,47.7497,-122.286,2200,11550,275000,10,9,2014,0,79,9264,9350,0,0,1
3,1.75,2340,4206,1.0,0,0,5,7,1170,1170,1917,0,98144,47.5759,-122.288,1360,4725,640000,5,6,2014,0,97,1866,3365,0,1,1
3,1.5,1240,9125,1.0,0,0,4,7,1240,0,1967,0,98058,47.4469,-122.155,1670,9125,275000,23,9,2014,0,47,7885,7455,0,0,0
4,2.5,2740,10533,2.0,0,0,3,9,2740,0,1997,0,98074,47.6095,-122.006,2760,8603,672800,24,7,2014,0,17,7793,5843,0,0,0
4,2.25,1940,9144,1.0,0,0,4,7,1430,510,1956,0,98007,47.5942,-122.135,1460,9437,495000,27,5,2014,0,58,7204,7977,0,1,0
4,2.0,2850,7861,1.0,0,4,4,10,1450,1400,1970,0,98117,47.6995,-122.397,2810,8087,1280000,20,5,2014,0,44,5011,5277,0,1,1
3,1.0,1160,9375,1.0,0,0,3,7,1160,0,1967,0,98077,47.7419,-122.073,1160,9650,380000,29,4,2015,0,48,8215,8490,0,0,0
3,2.0,2130,8225,1.0,0,0,4,8,2130,0,1987,0,98058,47.4396,-122.162,2580,8225,397500,20,8,2014,0,27,6095,5645,0,0,0
5,2.5,2420,8560,1.0,0,2,3,7,1620,800,1978,0,98118,47.532,-122.285,2210,7040,352000,7,5,2014,0,36,6140,4830,0,1,1
6,2.5,2820,8600,1.0,0,0,5,8,1430,1390,1967,0,98006,47.565,-122.144,2070,8900,893880,13,4,2015,0,48,5780,6830,0,1,0
3,2.25,1770,8165,2.0,0,0,3,7,1770,0,1977,0,98034,47.7166,-122.236,1650,8165,420000,7,5,2014,0,37,6395,6515,0,0,0
3,2.0,1260,2500,1.0,0,0,4,7,750,510,1987,0,98107,47.6748,-122.371,1710,5000,503000,21,3,2015,0,28,1240,3290,0,1,1
2,1.75,2330,10143,1.0,0,2,4,7,1220,1110,1953,0,98146,47.4899,-122.359,2560,9750,689000,9,9,2014,0,61,7813,7190,0,1,1
4,2.75,2490,3840,1.5,0,0,4,7,1610,880,1922,0,98103,47.6551,-122.344,1420,4000,749500,2,9,2014,0,92,1350,2580,0,1,1
4,2.5,2800,12831,2.0,0,0,3,8,2800,0,2001,0,98019,47.7392,-121.966,2810,10235,563500,9,6,2014,0,13,10031,7425,0,0,0
4,3.0,2440,9664,2.0,0,0,3,8,1890,550,1981,0,98028,47.7649,-122.253,2380,9609,480000,30,6,2014,0,33,7224,7229,0,1,0
4,3.0,2540,8800,1.0,0,1,3,9,1620,920,1977,0,98023,47.3204,-122.387,2540,8800,374950,22,4,2015,0,38,6260,6260,0,1,0
3,2.5,1600,6250,2.0,0,0,3,7,1600,0,1995,0,98038,47.3675,-122.02,1760,6110,308950,10,4,2015,0,20,4650,4350,0,0,0
4,2.75,2680,16934,1.0,0,0,4,7,1340,1340,1958,0,98106,47.542,-122.364,1240,7000,445000,17,9,2014,0,56,14254,5760,0,1,1
3,1.5,1220,9000,1.0,0,0,4,7,1220,0,1968,0,98042,47.3642,-122.109,1220,9472,237200,21,4,2015,0,47,7780,8252,0,0,0
3,1.75,1550,7270,1.5,0,0,5,7,1550,0,1953,0,98125,47.72,-122.317,1050,7210,453500,2,9,2014,0,61,5720,6160,0,0,1
3,2.0,2080,4549,1.0,0,0,5,7,1040,1040,1954,0,98115,47.6886,-122.309,1620,4549,616500,7,5,2015,0,61,2469,2929,0,1,1
1,1.0,630,5150,1.0,0,0,4,5,630,0,1954,0,98117,47.6923,-122.369,1390,5150,396000,7,4,2015,0,61,4520,3760,0,0,1
3,1.0,1070,8179,1.0,0,0,3,6,1070,0,1949,0,98146,47.5015,-122.349,1050,8177,210000,8,7,2014,0,65,7109,7127,0,0,1
2,1.75,1900,5175,1.0,0,0,3,7,1200,700,1919,0,98116,47.5689,-122.386,1370,5175,539000,1,10,2014,0,95,3275,3805,0,1,1
3,2.0,1490,4800,2.0,0,0,5,6,1490,0,1948,0,98117,47.6933,-122.361,1500,4800,437500,7,7,2014,0,66,3310,3300,0,0,1
3,1.5,1500,15000,1.0,0,0,3,7,1500,0,1952,0,98031,47.3926,-122.208,1790,13905,215000,16,7,2014,0,62,13500,12115,0,0,0
4,2.5,2410,4780,2.0,0,0,3,7,2410,0,2000,0,98065,47.5326,-121.879,2410,4025,440000,18,6,2014,0,14,2370,1615,0,0,0
3,1.0,1120,9075,1.0,0,0,3,7,1120,0,1977,0,98077,47.7551,-122.072,1120,9705,335000,6,1,2015,0,38,7955,8585,0,0,0
4,2.25,3220,7700,2.0,0,0,4,8,3220,0,1976,0,98023,47.3188,-122.38,2570,7700,359999,25,9,2014,0,38,4480,5130,0,0,0
3,2.25,1610,10454,1.0,0,0,3,7,1610,0,1977,0,98148,47.4517,-122.331,1720,9583,280000,12,9,2014,0,37,8844,7863,0,0,1
4,2.75,2250,3433,1.5,0,0,3,8,1500,750,1927,2013,98112,47.6382,-122.307,1970,3484,1050000,8,7,2014,86,87,1183,1514,1,1,1
1,2.0,1240,4800,2.0,0,0,3,6,1240,0,1910,0,98055,47.4778,-122.211,1030,4800,290000,19,11,2014,0,104,3560,3770,0,0,0
2,2.25,1660,2748,2.0,0,0,3,7,1660,0,1995,0,98055,47.4333,-122.212,1620,3167,235000,17,12,2014,0,19,1088,1547,0,0,0
3,1.75,2080,3000,1.0,0,0,4,7,1040,1040,1925,0,98103,47.6853,-122.35,1000,3193,495000,1,10,2014,0,89,920,2193,0,1,1
3,2.25,1880,7488,2.0,0,0,3,8,1880,0,1980,0,98032,47.3631,-122.277,2180,7344,290000,24,2,2015,0,35,5608,5164,0,0,0
4,1.5,1050,9516,1.0,0,0,4,7,1050,0,1969,0,98031,47.4151,-122.181,1390,9600,230000,28,10,2014,0,45,8466,8210,0,0,0
3,1.75,1480,8475,1.0,0,0,4,7,1480,0,1968,0,98023,47.3126,-122.361,1800,8800,234000,20,2,2015,0,47,6995,7000,0,0,0
4,2.5,2420,4500,2.0,0,0,3,7,2420,0,2001,0,98053,47.6874,-122.037,2280,4500,597400,3,10,2014,0,13,2080,2220,0,0,0
4,2.5,2660,10452,2.0,0,0,3,9,2660,0,1993,0,98052,47.6972,-122.104,2890,9025,755000,19,5,2014,0,21,7792,6135,0,0,0
3,2.5,2430,5715,2.0,0,0,3,7,2430,0,1999,0,98030,47.3718,-122.168,3040,5702,342000,3,4,2015,0,16,3285,2662,0,0,0
2,1.0,770,3325,1.0,0,0,3,7,770,0,1918,0,98122,47.6102,-122.299,960,4800,497000,28,7,2014,0,96,2555,3840,0,0,1
4,2.75,2920,4500,2.0,0,0,3,9,2920,0,1999,0,98006,47.5646,-122.124,2920,4505,730000,15,10,2014,0,15,1580,1585,0,0,0
3,1.0,1370,5250,1.0,0,0,3,7,1070,300,1939,0,98109,47.6421,-122.348,2410,4200,655000,1,10,2014,0,75,3880,1790,0,1,1
3,2.5,1870,3118,2.0,0,0,3,8,1870,0,1993,0,98038,47.3739,-122.056,1580,3601,205000,20,11,2014,0,21,1248,2021,0,0,0
4,2.0,1800,4800,1.5,0,0,3,7,1800,0,1918,0,98112,47.6388,-122.302,1950,4800,632750,7,4,2015,0,97,3000,2850,0,0,1
5,3.0,2100,7715,1.0,0,0,3,7,1250,850,2013,0,98168,47.4866,-122.319,2100,7959,330000,12,5,2014,0,1,5615,5859,0,1,1
5,2.25,2530,8250,2.0,0,0,4,7,2530,0,1961,0,98007,47.6117,-122.134,2020,8250,527500,7,10,2014,0,53,5720,6230,0,0,0
4,2.5,3290,6465,2.0,0,0,3,9,3290,0,2002,0,98075,47.5981,-121.976,3100,5929,716500,8,5,2014,0,12,3175,2829,0,0,0
4,2.5,1890,5395,2.0,0,0,3,7,1890,0,2006,0,98065,47.5415,-121.883,2060,5395,388500,17,12,2014,0,8,3505,3335,0,0,0
3,1.75,1680,7770,1.0,0,0,4,7,1680,0,1967,0,98005,47.6028,-122.167,1880,7770,530000,4,9,2014,0,47,6090,5890,0,0,0
3,2.5,2170,4517,2.0,0,0,3,8,2170,0,2002,0,98059,47.4819,-122.14,2610,4770,419000,8,1,2015,0,13,2347,2160,0,0,0
3,1.75,1200,7360,1.0,0,0,4,7,1200,0,1978,0,98052,47.6979,-122.13,1200,7500,385000,9,3,2015,0,37,6160,6300,0,0,0
4,2.5,2990,5669,2.0,0,0,3,8,2990,0,2003,0,98074,47.6119,-122.011,3110,5058,655000,28,5,2014,0,11,2679,1948,0,0,0
4,2.75,3770,10900,2.0,0,2,5,9,3070,700,1924,0,98144,47.5849,-122.29,3000,5000,1700000,1,7,2014,0,90,7130,2000,0,1,1
3,1.5,1700,9579,1.0,0,0,4,7,1100,600,1962,0,98023,47.3209,-122.338,1700,9628,262000,9,2,2015,0,53,7879,7928,0,1,0
4,1.0,1550,4750,1.5,0,0,3,7,1550,0,1919,0,98117,47.6824,-122.389,1320,4750,533000,7,8,2014,0,95,3200,3430,0,0,1
3,1.75,1680,8100,1.0,0,2,3,8,1680,0,1950,0,98177,47.7212,-122.364,1880,7750,640000,2,4,2015,0,65,6420,5870,0,0,1
4,2.5,1910,10300,1.0,0,0,3,8,1910,0,1921,1968,98177,47.7581,-122.359,1910,7750,458400,8,7,2014,47,93,8390,5840,1,0,1
5,3.25,3160,10587,1.0,0,0,5,7,2190,970,1960,0,98034,47.7238,-122.165,2200,7761,620000,18,3,2015,0,55,7427,5561,0,1,0
3,1.5,2020,11358,1.0,0,0,4,6,1190,830,1956,0,98033,47.6641,-122.185,2370,9520,465000,12,5,2014,0,58,9338,7150,0,1,0
4,3.75,3210,7054,2.0,0,0,4,8,3210,0,1985,0,98052,47.7268,-122.103,2350,8020,690000,4,8,2014,0,29,3844,5670,0,0,0
4,2.5,1910,10221,2.0,0,0,3,8,1910,0,1994,0,98038,47.381,-122.035,2210,8705,369950,20,8,2014,0,20,8311,6495,0,0,0
2,1.0,840,6480,1.0,0,0,4,5,840,0,1954,0,98001,47.264,-122.258,1100,7300,124500,26,3,2015,0,61,5640,6200,0,0,0
4,2.25,2620,10920,1.0,0,0,3,9,2620,0,1965,0,98005,47.6117,-122.164,2370,11907,950000,6,8,2014,0,49,8300,9537,0,0,0
4,1.5,1220,10580,1.0,0,0,3,7,1220,0,1965,0,98008,47.6205,-122.116,1350,7800,418000,16,6,2014,0,49,9360,6450,0,0,0
3,1.0,1060,8000,1.0,0,0,4,6,1060,0,1927,0,98002,47.305,-122.218,1060,4697,160000,10,12,2014,0,87,6940,3637,0,0,0
4,2.5,2200,10800,1.0,0,0,3,8,1500,700,1964,0,98155,47.7711,-122.288,2280,10800,457000,15,4,2015,0,51,8600,8520,0,1,1
2,1.75,2120,7680,1.0,0,0,5,6,1130,990,1948,0,98126,47.5304,-122.374,1220,7680,530000,29,1,2015,0,67,5560,6460,0,1,1
3,1.0,1250,7300,1.0,0,0,4,7,1250,0,1956,0,98008,47.6032,-122.125,1540,7400,385000,22,5,2014,0,58,6050,5860,0,0,0
3,1.75,1440,7800,1.0,0,0,4,7,1440,0,1958,0,98008,47.5996,-122.12,1440,7800,491000,18,3,2015,0,57,6360,6360,0,0,0
4,2.25,1890,8034,1.0,0,0,4,8,1890,0,1967,0,98008,47.6338,-122.117,1920,7210,521000,20,8,2014,0,47,6144,5290,0,0,0
3,1.0,1140,8528,1.0,0,0,5,7,1140,0,1967,0,98022,47.2098,-122.004,1140,8112,255000,10,4,2015,0,48,7388,6972,0,0,0
5,3.0,2840,7199,1.0,0,0,3,7,1710,1130,2003,0,98178,47.5065,-122.275,2210,10800,292050,27,5,2014,0,11,4359,8590,0,1,1
6,3.0,1880,7200,1.0,0,0,4,7,1880,0,1966,0,98056,47.5029,-122.188,1540,13022,326000,20,5,2014,0,48,5320,11482,0,0,0
2,1.0,750,5120,1.0,0,0,4,6,750,0,1941,0,98126,47.5312,-122.375,930,7200,300000,24,6,2014,0,73,4370,6270,0,0,1
3,1.75,1630,7480,1.0,0,0,3,7,1330,300,1979,0,98058,47.4514,-122.159,1940,7480,291600,30,4,2015,0,36,5850,5540,0,1,0
5,1.5,1720,12551,1.0,0,0,3,7,1720,0,1967,0,98027,47.5241,-122.053,1560,12960,435000,19,2,2015,0,48,10831,11400,0,0,0
3,2.5,1600,1311,3.0,0,0,3,8,1600,0,2005,0,98117,47.6903,-122.394,1390,1321,465000,18,12,2014,0,9,-289,-69,0,0,1
3,2.25,1230,7420,1.5,0,0,5,7,1230,0,1913,0,98002,47.3184,-122.22,1260,7556,200000,20,6,2014,0,101,6190,6296,0,0,0
3,1.5,1610,6132,1.0,0,2,4,7,1090,520,1959,0,98056,47.5017,-122.174,1650,6132,238000,17,7,2014,0,55,4522,4482,0,1,0
4,2.5,1320,7000,1.0,0,0,4,7,1320,0,1956,0,98008,47.6007,-122.127,1550,8610,455000,3,11,2014,0,58,5680,7060,0,0,0
6,3.0,2180,7220,2.0,0,0,3,7,2180,0,1980,0,98003,47.3046,-122.305,2260,7344,230000,30,10,2014,0,34,5040,5084,0,0,0
4,2.25,2190,4104,2.0,0,0,5,8,1410,780,1928,0,98112,47.6419,-122.306,1990,3860,808000,11,9,2014,0,86,1914,1870,0,1,1
3,1.0,1490,5700,1.5,0,0,3,7,1490,0,1916,0,98103,47.6549,-122.331,2290,5700,578500,17,12,2014,0,98,4210,3410,0,0,1
3,2.0,1463,868,3.0,0,0,3,7,1463,0,2003,0,98115,47.6843,-122.317,1484,4320,390000,5,6,2014,0,11,-595,2836,0,0,1
3,2.5,1800,3933,2.0,0,0,3,8,1800,0,1989,0,98029,47.5746,-122.009,1800,4659,517500,5,5,2015,0,26,2133,2859,0,0,0
4,2.75,2880,4000,1.5,0,0,3,9,2100,780,1912,2000,98144,47.5843,-122.293,2110,4000,755000,26,6,2014,88,102,1120,1890,1,1,1
3,1.75,1250,4120,1.0,0,0,4,7,980,270,1925,0,98117,47.685,-122.36,1250,4120,579500,30,10,2014,0,89,2870,2870,0,1,1
3,2.75,1670,1350,3.0,0,0,3,9,1350,320,2014,0,98116,47.5764,-122.408,1520,4800,649950,29,9,2014,0,0,-320,3280,0,1,1
4,1.75,2000,6120,1.0,0,0,3,7,1100,900,1965,0,98178,47.5035,-122.258,1880,6120,228000,8,5,2014,0,49,4120,4240,0,1,1
4,1.75,2280,3680,1.5,0,0,5,7,1470,810,1926,0,98115,47.6754,-122.3,1850,3680,665000,2,12,2014,0,88,1400,1830,0,1,1
4,2.5,2110,6069,2.0,0,0,3,9,2110,0,1999,0,98052,47.6374,-122.111,2180,9000,689000,25,3,2015,0,16,3959,6820,0,0,0
4,2.5,2520,11240,1.0,0,0,3,8,1440,1080,1977,0,98052,47.6748,-122.144,2360,10345,560000,22,10,2014,0,37,8720,7985,0,1,0
3,1.0,1590,6420,1.0,0,0,3,7,1590,0,1944,0,98136,47.5355,-122.392,1780,5900,529000,29,5,2014,0,70,4830,4120,0,0,1
5,2.5,2100,14858,1.0,0,0,5,8,2100,0,1970,0,98059,47.4721,-122.123,1980,11730,375000,8,1,2015,0,45,12758,9750,0,0,0
4,2.75,2090,9240,1.0,0,0,4,6,2090,0,1949,0,98146,47.4854,-122.343,1460,9240,325000,23,9,2014,0,65,7150,7780,0,0,1
4,2.5,3390,10519,2.0,0,2,3,10,3390,0,1990,0,98003,47.332,-122.334,2830,10519,583000,15,1,2015,0,25,7129,7689,0,0,0
2,1.0,790,9784,1.0,0,0,3,6,790,0,1932,0,98155,47.7634,-122.284,2350,10102,330000,29,4,2015,0,83,8994,7752,0,0,1
3,2.5,1970,8727,2.0,0,0,3,7,1970,0,1995,0,98092,47.3263,-122.189,1670,9168,262000,17,4,2015,0,20,6757,7498,0,0,0
4,2.5,2870,6776,2.0,0,0,3,8,2870,0,2004,0,98065,47.539,-121.878,2770,6658,555000,13,3,2015,0,11,3906,3888,0,0,0
2,1.0,1110,6000,1.0,0,0,3,7,1010,100,1951,0,98118,47.5632,-122.282,1410,3500,585000,2,3,2015,0,64,4890,2090,0,1,1
3,2.75,1940,3088,2.0,0,3,3,8,1770,170,2008,0,98065,47.5185,-121.878,1410,2335,425590,27,2,2015,0,7,1148,925,0,1,0
2,1.0,720,4840,1.0,0,0,4,6,720,0,1947,0,98126,47.5534,-122.375,1510,4840,235000,3,6,2014,0,67,4120,3330,0,0,1
2,1.0,710,4000,1.0,0,0,3,6,710,0,1909,0,98118,47.5535,-122.269,960,4000,362362,24,7,2014,0,105,3290,3040,0,0,1
3,2.0,1370,7500,1.0,0,0,3,7,1370,0,1997,0,98038,47.3634,-122.046,1420,7500,252000,4,2,2015,0,18,6130,6080,0,0,0
4,2.5,2690,9551,2.0,0,0,3,9,2690,0,1992,0,98058,47.4343,-122.156,2890,9121,439000,24,12,2014,0,22,6861,6231,0,0,0
4,2.25,3360,10810,2.0,0,0,4,9,3360,0,1988,0,98092,47.3316,-122.203,2590,10810,465000,12,8,2014,0,26,7450,8220,0,0,0
4,2.0,1500,7854,1.5,0,0,3,7,1500,0,1983,0,98023,47.3127,-122.354,1500,7334,249900,3,10,2014,0,31,6354,5834,0,0,0
2,2.5,2600,5000,1.0,0,0,5,8,1300,1300,1926,0,98126,47.5806,-122.379,2260,5000,665000,18,7,2014,0,88,2400,2740,0,1,1
3,1.75,1160,8774,1.0,0,0,3,7,1160,0,1972,0,98034,47.7159,-122.165,1990,7908,370000,14,10,2014,0,42,7614,5918,0,0,0
2,1.0,1430,3000,1.5,0,0,3,7,1300,130,1929,0,98112,47.6415,-122.303,1750,4000,620000,12,6,2014,0,85,1570,2250,0,1,1
3,1.0,1870,7671,1.0,0,0,4,8,1720,150,1937,0,98177,47.7162,-122.36,1460,7679,375000,24,7,2014,0,77,5801,6219,0,1,1
4,2.0,2560,9390,1.0,0,0,5,8,1280,1280,1957,0,98133,47.7169,-122.329,1830,8169,552625,27,8,2014,0,57,6830,6339,0,1,1
3,1.0,1160,10500,1.0,0,0,4,7,1160,0,1966,0,98034,47.7267,-122.227,1520,10500,315500,30,9,2014,0,48,9340,8980,0,0,0
2,1.75,1680,8187,1.0,0,0,4,8,1680,0,1983,0,98027,47.5603,-122.081,2390,7801,620000,19,9,2014,0,31,6507,5411,0,0,0
4,2.5,2010,9075,1.0,0,0,4,8,1310,700,1959,0,98006,47.553,-122.182,1850,9220,510000,25,11,2014,0,55,7065,7370,0,1,0
3,2.5,2670,12806,2.0,0,0,3,9,2670,0,2010,0,98038,47.3686,-122.059,3010,7231,430000,24,2,2015,0,5,10136,4221,0,0,0
3,2.0,1080,7236,1.0,0,0,5,7,1080,0,1947,0,98125,47.7143,-122.32,1120,8008,390000,3,6,2014,0,67,6156,6888,0,0,1
3,1.0,1430,3840,1.0,0,0,3,7,950,480,1945,0,98117,47.6847,-122.381,1430,3840,466500,5,6,2014,0,69,2410,2410,0,1,1
2,2.25,1290,2436,2.0,0,0,3,7,1290,0,1984,0,98052,47.6803,-122.156,1360,3088,315000,28,10,2014,0,30,1146,1728,0,0,0
4,1.5,1240,9600,1.0,0,0,3,7,1240,0,1971,0,98023,47.3206,-122.397,1240,9592,220000,5,5,2014,0,43,8360,8352,0,0,0
3,1.75,1840,17286,1.0,0,0,4,7,1440,400,1978,0,98030,47.371,-122.173,1840,14541,325000,6,3,2015,0,37,15446,12701,0,1,0
3,1.0,1120,8443,1.0,0,0,3,7,1120,0,1953,0,98133,47.7715,-122.336,1450,8433,365000,28,4,2015,0,62,7323,6983,0,0,1
3,3.5,2100,12384,2.0,0,0,3,9,2100,0,1980,0,98188,47.4687,-122.263,2400,7776,356000,14,5,2014,0,34,10284,5376,0,0,1
4,1.75,2030,12518,1.0,0,0,3,8,1610,420,1950,0,98125,47.7278,-122.297,1650,7872,380000,23,9,2014,0,64,10488,6222,0,1,1
4,2.25,2030,8764,2.0,0,0,4,8,2030,0,1983,0,98052,47.7214,-122.11,1950,8750,579000,13,7,2014,0,31,6734,6800,0,0,0
2,1.0,890,5000,1.0,0,0,3,7,890,0,1943,0,98105,47.6666,-122.279,1680,5000,682000,1,5,2015,0,72,4110,3320,0,0,1
3,1.75,1750,12325,1.0,0,0,4,7,1470,280,1968,0,98052,47.6832,-122.118,1820,9750,499000,16,6,2014,0,46,10575,7930,0,1,0
3,1.0,1300,5880,1.0,0,0,3,7,1300,0,1968,0,98052,47.6937,-122.113,1300,7700,333760,23,4,2015,0,47,4580,6400,0,0,0
3,1.75,1750,10870,1.0,0,0,5,7,1750,0,1968,0,98056,47.4989,-122.188,1230,10868,380000,22,7,2014,0,46,9120,9638,0,0,0
3,3.0,1440,1350,3.5,0,2,3,8,1440,0,2005,0,98103,47.6525,-122.345,1440,1350,435000,1,8,2014,0,9,-90,-90,0,0,1
3,2.75,1700,3264,1.0,0,0,3,7,1060,640,1919,0,98115,47.6767,-122.311,1880,4080,520000,20,1,2015,0,96,1564,2200,0,1,1
3,2.25,1470,16728,1.0,0,0,4,7,1350,120,1959,0,98168,47.4968,-122.302,1540,9000,270000,8,8,2014,0,55,15258,7460,0,1,1
5,2.75,2520,4643,1.5,0,0,4,8,2120,400,1916,0,98112,47.6348,-122.301,2100,4564,1100000,13,3,2015,0,99,2123,2464,0,1,1
3,1.75,2140,13286,1.0,0,0,4,8,1220,920,1964,0,98006,47.5722,-122.128,2250,13286,577500,8,10,2014,0,50,11146,11036,0,1,0
3,1.75,1550,5000,1.0,0,0,3,7,1250,300,1911,2011,98107,47.6722,-122.372,1110,5000,650000,28,7,2014,100,103,3450,3890,1,1,1
4,2.5,3180,10319,2.0,0,0,4,11,3180,0,1986,0,98040,47.5372,-122.232,3130,12120,1230000,5,12,2014,0,28,7139,8990,0,0,0
2,2.0,1440,3720,1.5,0,0,3,7,1440,0,1983,0,98115,47.6902,-122.325,1490,4308,475000,21,7,2014,0,31,2280,2818,0,0,1
3,1.0,1150,10132,1.0,0,0,4,7,1150,0,1970,0,98023,47.3172,-122.372,1180,8713,200000,30,3,2015,0,45,8982,7533,0,0,0
4,2.5,2320,11717,2.0,0,0,3,8,2320,0,1997,0,98045,47.484,-121.78,2320,9714,397000,20,6,2014,0,17,9397,7394,0,0,0
3,2.0,1230,8450,1.0,0,0,3,7,1230,0,1989,0,98155,47.7548,-122.305,2110,8536,383610,19,2,2015,0,26,7220,6426,0,0,1
4,2.5,2060,5742,2.0,0,0,3,7,2060,0,1999,0,98030,47.3612,-122.185,1610,7298,275000,28,7,2014,0,15,3682,5688,0,0,0
3,2.0,2783,11177,2.0,0,0,3,8,2783,0,1910,1999,98126,47.538,-122.38,1730,8018,840000,9,7,2014,89,104,8394,6288,1,0,1
4,2.5,2140,7350,2.0,0,0,3,8,2140,0,1985,0,98058,47.4483,-122.124,2120,8395,365000,18,9,2014,0,29,5210,6275,0,0,0
3,2.75,1420,955,2.0,0,0,3,8,1160,260,2004,0,98029,47.5477,-122.003,1420,955,362000,4,9,2014,0,10,-465,-465,0,1,0
3,1.75,2090,6258,1.0,0,0,3,7,1390,700,1956,0,98108,47.5503,-122.301,1790,5793,350000,1,11,2014,0,58,4168,4003,0,1,1
2,1.75,1320,13052,1.5,0,0,3,7,1320,0,1980,0,98014,47.712,-121.352,1320,13052,200000,11,11,2014,0,34,11732,11732,0,0,0
4,2.5,2300,8100,1.0,0,0,4,8,1360,940,1979,0,98023,47.2979,-122.371,1910,7630,299000,6,5,2015,0,36,5800,5720,0,1,0
3,2.25,2960,8330,1.0,0,3,4,10,2260,700,1953,0,98177,47.7035,-122.385,2960,8840,1330000,25,2,2015,0,62,5370,5880,0,1,1
2,1.75,1740,7290,1.0,0,0,3,8,1280,460,1950,0,98199,47.6461,-122.397,1820,6174,550000,17,12,2014,0,64,5550,4354,0,1,1
2,1.0,1300,6617,1.0,0,0,3,7,1300,0,1986,0,98125,47.7238,-122.302,1820,7800,324500,8,5,2015,0,29,5317,5980,0,0,1
3,1.0,1170,7350,1.0,0,0,4,7,1170,0,1960,0,98008,47.625,-122.117,1170,7350,312500,5,1,2015,0,55,6180,6180,0,0,0
2,1.0,1250,5413,1.0,0,0,4,7,1250,0,1923,0,98115,47.6945,-122.315,1250,5413,511000,20,10,2014,0,91,4163,4163,0,0,1
2,1.5,1230,1561,2.0,0,0,3,7,1230,0,1983,0,98042,47.3768,-122.149,1660,2243,139500,24,3,2015,0,32,331,583,0,0,0
4,2.5,2180,7203,2.0,0,0,4,8,2180,0,1989,0,98059,47.5119,-122.151,2350,7334,464000,11,6,2014,0,25,5023,4984,0,0,0
3,1.75,1740,8800,1.0,0,0,3,7,1140,600,1978,0,98023,47.2968,-122.372,1690,7920,255000,29,4,2015,0,37,7060,6230,0,1,0
4,2.5,3830,4644,2.0,0,0,3,8,2900,930,2004,0,98065,47.5384,-121.88,3400,6163,679975,17,4,2015,0,11,814,2763,0,1,0
3,2.0,2250,14274,1.0,0,0,4,8,1500,750,1964,0,98040,47.5762,-122.217,2820,13813,624800,9,7,2014,0,50,12024,10993,0,1,0
3,2.5,2090,6000,1.5,0,0,4,9,2090,0,1928,0,98105,47.6567,-122.281,2730,6000,1370000,30,5,2014,0,86,3910,3270,0,0,1
3,1.5,2400,10275,1.0,0,0,4,8,1540,860,1964,0,98052,47.6888,-122.126,2380,10125,510000,12,12,2014,0,50,7875,7745,0,1,0
4,2.25,2260,7200,2.0,0,0,4,7,2260,0,1984,0,98031,47.4121,-122.183,1720,7200,289659,26,6,2014,0,30,4940,5480,0,0,0
4,2.5,2910,6250,2.0,0,0,3,8,2910,0,1999,0,98065,47.538,-121.87,2550,6250,585000,24,4,2015,0,16,3340,3700,0,0,0
5,3.0,3640,6930,2.0,0,0,3,8,3640,0,2004,0,98038,47.3521,-122.012,3740,7182,555000,26,6,2014,0,10,3290,3442,0,0,0
3,2.0,1600,7350,1.0,0,0,4,7,1600,0,1979,0,98052,47.6977,-122.126,1600,7200,460000,9,9,2014,0,35,5750,5600,0,0,0
3,2.5,2110,7434,2.0,0,0,4,7,2110,0,1978,0,98031,47.3935,-122.169,2100,7749,319000,21,11,2014,0,36,5324,5649,0,0,0
3,2.5,1720,1916,2.0,0,0,3,7,1720,0,2005,0,98059,47.4895,-122.166,1760,1916,280000,19,5,2014,0,9,196,156,0,0,0
3,1.0,1100,7470,1.0,0,0,4,5,1100,0,1917,0,98065,47.5242,-121.831,1280,7055,250000,18,11,2014,0,97,6370,5775,0,0,0
4,2.5,2620,8312,2.0,0,0,3,9,2620,0,1990,0,98074,47.6272,-122.033,2260,8515,749950,16,1,2015,0,25,5692,6255,0,0,0
3,2.5,1890,4808,2.0,0,0,3,8,1890,0,2000,0,98065,47.5348,-121.866,2460,5348,465000,2,4,2015,0,15,2918,2888,0,0,0
3,1.75,1850,2797,1.0,0,0,3,8,1150,700,1977,0,98103,47.6871,-122.336,1450,4599,580000,13,4,2015,0,38,947,3149,0,1,1
4,2.5,2506,7206,2.0,0,0,3,8,2506,0,2007,0,98023,47.3236,-122.337,2441,7220,350000,10,11,2014,0,7,4700,4779,0,0,0
4,1.0,1700,7689,1.0,0,0,3,7,1080,620,1977,0,98052,47.6955,-122.116,1700,7333,456000,5,9,2014,0,37,5989,5633,0,1,0
3,2.0,1550,18958,1.5,0,0,3,7,1550,0,1983,0,98198,47.3699,-122.319,1840,12826,290000,18,2,2015,0,32,17408,10986,0,0,1
4,2.75,2200,16288,1.0,0,0,3,7,1290,910,1980,0,98059,47.4793,-122.122,2650,6620,475000,11,7,2014,0,34,14088,3970,0,1,0
3,2.5,1890,3629,2.0,0,0,3,7,1890,0,2005,0,98038,47.3613,-122.041,1980,4000,285000,8,9,2014,0,9,1739,2020,0,0,0
3,1.0,1140,6400,1.0,0,0,3,7,1140,0,1962,0,98168,47.4902,-122.331,1340,6650,309000,27,2,2015,0,53,5260,5310,0,0,1
3,2.25,1940,6500,1.0,0,0,3,8,1440,500,1979,0,98042,47.3565,-122.149,1880,8991,219000,26,2,2015,0,36,4560,7111,0,1,0
3,2.5,2130,7199,2.0,0,0,3,8,2130,0,1990,0,98074,47.6331,-122.027,1890,7546,546500,9,10,2014,0,24,5069,5656,0,0,0
2,1.0,1470,5566,1.0,0,0,4,7,770,700,1919,0,98118,47.5348,-122.269,1410,5808,338000,13,2,2015,0,96,4096,4398,0,1,1
2,1.0,1070,8130,1.0,0,0,3,7,1070,0,1942,0,98117,47.697,-122.37,1360,7653,505000,11,3,2015,0,73,7060,6293,0,0,1
4,1.75,1680,15084,1.0,0,0,4,7,840,840,1979,0,98014,47.6895,-121.912,1800,15092,340000,2,10,2014,0,35,13404,13292,0,1,0
3,2.25,2730,10675,2.0,0,0,3,9,2730,0,1990,0,98074,47.6289,-122.042,2770,10570,678000,22,8,2014,0,24,7945,7800,0,0,0
3,1.75,1890,10292,1.0,0,0,4,8,1890,0,1969,0,98040,47.535,-122.234,2630,10625,800000,8,12,2014,0,45,8402,7995,0,0,0
1,1.0,1080,3230,1.0,0,0,3,6,1080,0,1963,0,98002,47.3075,-122.217,1210,5760,112000,25,7,2014,0,51,2150,4550,0,0,0
3,1.75,1440,16819,1.5,0,0,4,6,1440,0,1925,0,98023,47.3318,-122.373,1560,12376,252000,10,3,2015,0,90,15379,10816,0,0,0
4,2.75,2540,7210,1.0,0,0,4,7,1600,940,1979,0,98058,47.4601,-122.165,1820,7766,335000,4,6,2014,0,35,4670,5946,0,1,0
3,2.0,2300,13418,1.0,0,0,3,8,1430,870,1955,0,98004,47.6075,-122.2,2140,9380,610000,3,7,2014,0,59,11118,7240,0,1,0
3,2.0,1690,6790,1.0,0,0,3,7,1360,330,1979,0,98023,47.2981,-122.38,1740,6790,245000,28,10,2014,0,35,5100,5050,0,1,0
3,1.75,1800,16026,1.0,0,0,3,8,1390,410,1972,0,98008,47.5815,-122.121,2210,13959,493500,5,2,2015,0,43,14226,11749,0,1,0
4,2.25,1770,8505,2.0,0,0,3,8,1770,0,1986,0,98052,47.6904,-122.102,1880,8939,596500,7,1,2015,0,29,6735,7059,0,0,0
3,2.0,1190,4072,1.5,0,0,5,6,1190,0,1907,0,98118,47.5276,-122.274,1680,5850,245000,1,7,2014,0,107,2882,4170,0,0,1
3,1.75,1320,7200,1.0,0,0,4,7,1320,0,1977,0,98028,47.7341,-122.237,1750,7260,333500,27,10,2014,0,37,5880,5510,0,0,0
3,1.0,1290,8974,1.0,0,0,5,7,1290,0,1976,0,98072,47.74,-122.173,1540,7500,373000,10,11,2014,0,38,7684,5960,0,0,0
4,2.5,3000,5639,2.0,0,0,3,8,3000,0,2008,0,98052,47.7066,-122.115,3000,4587,759900,24,7,2014,0,6,2639,1587,0,0,0
3,2.25,1358,1204,3.0,0,0,3,7,1358,0,2007,0,98133,47.7054,-122.346,1358,1196,317000,26,8,2014,0,7,-154,-162,0,0,1
3,1.5,1220,4080,1.5,0,0,5,7,1220,0,1914,0,98144,47.5746,-122.289,1320,4080,670000,12,5,2015,0,101,2860,2760,0,0,1
3,1.5,1060,6954,1.0,0,0,4,6,1060,0,1983,0,98106,47.5497,-122.355,1560,6372,310000,30,4,2015,0,32,5894,4812,0,0,1
4,2.5,3020,13122,2.0,0,0,3,9,2540,480,1997,0,98052,47.6989,-122.111,3020,10873,750000,15,10,2014,0,17,10102,7853,0,1,0
3,2.0,1640,3440,2.0,0,0,3,7,1640,0,1987,0,98052,47.6829,-122.097,1070,3549,408000,21,7,2014,0,27,1800,2479,0,0,0
5,3.75,3870,8225,2.0,0,0,3,10,3870,0,1998,0,98074,47.6078,-122.01,3600,9361,900000,17,6,2014,0,16,4355,5761,0,0,0
4,2.5,1740,6000,1.0,0,0,4,7,1740,0,1952,0,98178,47.5026,-122.236,1190,6000,339000,17,3,2015,0,63,4260,4810,0,0,1
3,2.0,1140,6000,1.0,0,0,3,7,1140,0,1909,0,98109,47.637,-122.355,1260,4000,660000,13,4,2015,0,106,4860,2740,0,0,1
4,3.0,3290,10783,2.0,0,0,3,9,3290,0,1990,0,98031,47.3904,-122.178,2810,10783,449950,22,4,2015,0,25,7493,7973,0,0,0
3,1.0,1210,6000,1.0,0,0,3,7,1210,0,1930,0,98178,47.4984,-122.224,1210,6000,235000,25,8,2014,0,84,4790,4790,0,0,1
5,2.25,3320,13138,1.0,0,2,4,9,1900,1420,1964,0,98028,47.759,-122.269,2820,13138,769000,13,1,2015,0,51,9818,10318,0,1,0
2,2.0,1350,3900,1.0,0,0,3,8,1350,0,2003,0,98053,47.7094,-122.03,1440,3900,428000,7,5,2014,0,11,2550,2460,0,0,0
3,2.25,1990,7340,2.0,0,0,3,8,1990,0,1984,0,98072,47.7579,-122.141,2180,11223,445000,16,5,2014,0,30,5350,9043,0,0,0
4,2.5,2060,6958,1.0,0,0,3,7,1220,840,1974,0,98034,47.7251,-122.168,1760,7350,462000,21,3,2015,0,41,4898,5590,0,1,0
3,1.0,1460,6198,1.5,0,0,4,7,1460,0,1916,0,98107,47.6626,-122.361,2280,5160,775000,6,5,2015,0,99,4738,2880,0,0,1
4,1.75,2250,10108,1.0,0,0,4,8,2250,0,1967,0,98008,47.5922,-122.118,2050,9750,605000,1,12,2014,0,47,7858,7700,0,0,0
4,2.5,3140,8060,2.0,0,0,3,9,3140,0,1991,0,98023,47.3091,-122.343,3000,8060,389950,22,5,2014,0,23,4920,5060,0,0,0
4,3.5,3560,6098,2.0,0,0,3,10,3560,0,2006,0,98075,47.5828,-121.972,3660,6846,790000,11,7,2014,0,8,2538,3186,0,0,0
2,1.0,1410,5000,1.0,0,2,4,7,940,470,1918,0,98126,47.5531,-122.379,1450,5000,442000,30,1,2015,0,97,3590,3550,0,1,1
4,2.25,2770,13500,2.0,0,0,3,8,2770,0,1974,0,98040,47.543,-122.231,2300,13500,890000,13,6,2014,0,40,10730,11200,0,0,0
3,1.0,1864,6978,1.0,0,0,4,7,1864,0,1958,0,98002,47.285,-122.206,990,8000,235000,19,3,2015,0,57,5114,7010,0,0,0
4,1.75,1930,6720,1.0,0,2,3,8,1130,800,1959,0,98115,47.6935,-122.312,1850,6380,495000,17,12,2014,0,55,4790,4530,0,1,1
3,2.0,2020,5500,1.5,0,3,3,10,1790,230,1937,0,98199,47.6388,-122.409,2580,5500,1400000,18,6,2014,0,77,3480,2920,0,1,1
3,2.0,1300,8400,1.0,0,0,4,7,1300,0,1967,0,98198,47.368,-122.315,1300,7500,251000,26,8,2014,0,47,7100,6200,0,0,1
5,3.5,2770,9305,2.0,0,0,3,9,2770,0,1985,0,98006,47.5628,-122.114,2520,9773,804000,23,9,2014,0,29,6535,7253,0,0,0
3,2.5,1690,1689,2.0,0,0,3,8,1150,540,2014,0,98029,47.5528,-121.999,1540,1689,419990,21,8,2014,0,0,-1,149,0,1,0
3,2.5,2710,5733,2.0,0,0,3,7,2710,0,2003,0,98092,47.3357,-122.171,2720,5733,275000,9,2,2015,0,12,3023,3013,0,0,0
3,2.25,1190,13630,1.0,0,0,3,7,1190,0,1984,0,98045,47.4813,-121.735,1630,14405,445000,25,9,2014,0,30,12440,12775,0,0,0
4,1.0,1360,13372,1.0,0,0,3,7,1360,0,1955,0,98028,47.7622,-122.263,1540,10283,330000,27,5,2014,0,59,12012,8743,0,0,0
3,1.0,1500,5605,1.0,0,0,5,6,750,750,1942,0,98106,47.5456,-122.359,1050,9100,270000,18,8,2014,0,72,4105,8050,0,1,1
4,2.0,1610,4770,1.0,0,0,4,7,1230,380,1941,0,98126,47.5333,-122.381,1180,6120,495000,3,4,2015,0,74,3160,4940,0,1,1
4,1.75,1420,10300,2.0,0,0,3,7,1420,0,1950,2001,98002,47.3121,-122.215,1420,10300,225000,6,3,2015,51,65,8880,8880,1,0,0
3,1.5,1750,5400,1.0,0,0,4,7,1050,700,1952,0,98115,47.6799,-122.279,1750,5400,716528,4,5,2015,0,63,3650,3650,0,1,1
3,2.5,1510,6095,2.0,0,0,4,7,1510,0,1991,0,98038,47.3498,-122.037,1520,6000,260000,14,10,2014,0,23,4585,4480,0,0,0
4,2.5,2330,9928,2.0,0,0,3,8,2330,0,1998,0,98045,47.4836,-121.783,2430,8175,471000,9,6,2014,0,16,7598,5745,0,0,0
5,3.5,2690,4800,2.0,0,2,3,8,1930,760,1919,1984,98118,47.5592,-122.269,2080,4900,690000,26,2,2015,65,96,2110,2820,1,1,1
5,1.5,1700,7200,1.5,0,0,3,7,1700,0,1937,0,98011,47.7614,-122.203,1460,7194,548000,28,4,2015,0,78,5500,5734,0,0,0
3,1.0,1020,5410,1.0,0,0,4,7,880,140,1928,0,98115,47.6924,-122.31,1580,5376,505000,26,7,2014,0,86,4390,3796,0,1,1
3,1.0,1160,11799,1.0,0,0,3,7,1160,0,1966,0,98034,47.7263,-122.229,1220,10500,325000,17,12,2014,0,48,10639,9280,0,0,0
3,2.25,2010,10760,2.0,0,0,3,8,2010,0,1985,0,98052,47.7276,-122.103,2240,9357,605000,17,6,2014,0,29,8750,7117,0,0,0
2,1.75,1370,4495,1.0,0,0,4,8,1370,0,1975,0,98198,47.3794,-122.317,1370,4686,276200,5,5,2015,0,40,3125,3316,0,0,1
3,1.0,1370,4040,1.5,0,0,3,7,1370,0,1906,0,98103,47.6867,-122.354,1220,3030,530000,24,7,2014,0,108,2670,1810,0,0,1
3,3.0,1990,9600,1.0,0,0,3,7,1440,550,1988,0,98003,47.3499,-122.296,1670,9600,245000,2,9,2014,0,26,7610,7930,0,1,0
2,1.0,780,6727,1.0,0,0,3,6,780,0,1939,0,98168,47.4733,-122.281,1860,10124,221900,15,10,2014,0,75,5947,8264,0,0,1
4,2.0,2240,4508,1.0,0,2,4,8,1340,900,1926,0,98178,47.5096,-122.25,1930,5250,466000,29,4,2015,0,89,2268,3320,0,1,1
3,2.0,2210,6387,1.0,0,0,3,8,2210,0,2003,0,98003,47.265,-122.302,2570,6497,383150,13,2,2015,0,12,4177,3927,0,0,0
4,1.0,1390,4240,1.0,0,0,3,7,1050,340,1924,0,98103,47.6596,-122.338,1810,4240,657100,5,5,2014,0,90,2850,2430,0,1,1
4,2.5,1960,11600,1.0,0,0,5,6,980,980,1931,0,98002,47.2898,-122.222,1160,7685,215000,20,6,2014,0,83,9640,6525,0,1,0
2,1.0,850,2850,1.0,0,0,4,7,850,0,1927,0,98115,47.6875,-122.309,1450,4015,489000,24,11,2014,0,87,2000,2565,0,0,1
4,2.5,2980,12764,2.0,0,0,3,10,2980,0,1994,0,98075,47.5857,-122.027,3080,9810,649000,5,11,2014,0,20,9784,6730,0,0,0
4,1.75,1980,10800,1.0,0,0,4,8,1320,660,1953,0,98005,47.5899,-122.173,2310,10800,700000,12,5,2015,0,62,8820,8490,0,1,0
2,1.0,790,8424,1.0,0,0,4,6,790,0,1953,0,98133,47.7511,-122.352,1470,8424,268500,20,5,2014,0,61,7634,6954,0,0,1
3,2.5,1800,5001,2.0,0,0,3,7,1800,0,1996,0,98034,47.7126,-122.231,2106,5618,515000,10,6,2014,0,18,3201,3512,0,0,0
4,2.0,2260,10800,1.0,0,0,3,9,2260,0,1978,0,98007,47.6124,-122.153,2650,9900,685000,23,2,2015,0,37,8540,7250,0,0,0
2,1.5,800,2142,2.0,0,0,3,7,800,0,2006,0,98144,47.5917,-122.297,1320,2742,305000,16,10,2014,0,8,1342,1422,0,0,1
4,2.0,2490,4600,1.5,0,2,3,8,2090,400,1926,0,98105,47.6557,-122.278,2910,5000,950000,12,1,2015,0,89,2110,2090,0,1,1
4,2.5,1610,4568,2.0,0,0,3,7,1610,0,2006,0,98001,47.3351,-122.289,1834,4604,292500,26,3,2015,0,9,2958,2770,0,0,0
4,1.75,1850,7730,1.0,0,0,5,7,1100,750,1956,0,98133,47.7481,-122.355,2260,8581,270000,14,8,2014,0,58,5880,6321,0,1,1
4,1.75,1850,7730,1.0,0,0,5,7,1100,750,1956,0,98133,47.7481,-122.355,2260,8581,450000,4,12,2014,0,58,5880,6321,0,1,1
4,1.0,1920,6480,1.5,0,0,3,7,1920,0,1920,0,98117,47.6897,-122.374,1600,6470,535000,27,10,2014,0,94,4560,4870,0,0,1
3,2.5,1740,3082,2.0,0,0,3,8,1740,0,2000,0,98029,47.5489,-122.006,1910,3075,550000,6,3,2015,0,15,1342,1165,0,0,0
3,2.25,1430,2003,2.0,0,0,3,8,980,450,1996,0,98144,47.5908,-122.292,2210,4000,457500,24,6,2014,0,18,573,1790,0,1,1
3,1.5,1420,8580,1.0,0,0,3,6,1420,0,1962,0,98023,47.3076,-122.362,1200,8580,136500,6,5,2014,0,52,7160,7380,0,0,0
3,1.5,1420,8580,1.0,0,0,3,6,1420,0,1962,0,98023,47.3076,-122.362,1200,8580,224097,8,10,2014,0,52,7160,7380,0,0,0
3,2.5,1560,10608,2.0,0,0,3,7,1560,0,1994,0,98042,47.3572,-122.161,1360,10608,254000,22,9,2014,0,20,9048,9248,0,0,0
4,2.25,2030,13500,1.0,0,0,3,7,1230,800,1963,0,98059,47.4596,-122.066,1830,13800,335000,11,6,2014,0,51,11470,11970,0,1,0
5,2.5,3280,6553,2.0,0,0,3,9,3280,0,2012,0,98045,47.475,-121.737,3360,7242,594950,2,4,2015,0,3,3273,3882,0,0,0
3,1.0,1180,9832,1.0,0,0,3,7,1180,0,1970,0,98042,47.3845,-122.085,1220,9894,169950,16,9,2014,0,44,8652,8674,0,0,0
3,2.5,1940,10800,1.0,0,0,3,8,1340,600,1979,0,98077,47.7471,-122.075,2080,9600,432500,6,10,2014,0,35,8860,7520,0,1,0
2,1.75,1300,4000,2.0,0,0,3,7,1300,0,1948,0,98105,47.6687,-122.288,1350,4013,440000,20,5,2014,0,66,2700,2663,0,0,1
3,2.25,1650,3788,2.0,0,0,3,7,1650,0,1985,0,98031,47.3908,-122.167,1510,3994,233703,18,9,2014,0,29,2138,2484,0,0,0
3,1.5,1140,3292,2.0,0,0,3,7,1140,0,1988,0,98029,47.5701,-122.017,1150,3592,310000,14,11,2014,0,26,2152,2442,0,0,0
3,2.5,2540,6762,2.0,0,0,3,10,2540,0,1998,0,98007,47.6239,-122.144,2870,6631,735000,2,4,2015,0,17,4222,3761,0,0,0
4,2.75,3440,8150,2.0,0,0,3,10,3440,0,2014,0,98056,47.5168,-122.189,2560,8315,730000,17,12,2014,0,0,4710,5755,0,0,0
3,1.75,1800,9000,1.0,0,0,3,7,1200,600,1961,0,98178,47.4932,-122.278,980,6000,257000,24,10,2014,0,53,7200,5020,0,1,1
2,2.25,1260,1240,3.0,0,0,3,8,1260,0,2004,0,98103,47.6531,-122.352,1330,1300,485000,19,5,2014,0,10,-20,-30,0,0,1
4,2.25,2370,6000,1.0,0,2,3,8,1440,930,1959,0,98177,47.7023,-122.388,3280,8843,899000,19,6,2014,0,55,3630,5563,0,1,1
3,1.0,1520,8055,1.5,0,0,3,7,1520,0,1952,0,98125,47.7222,-122.305,1560,8160,279000,18,11,2014,0,62,6535,6600,0,0,1
4,2.0,1750,7245,1.0,0,0,4,7,1050,700,1974,0,98092,47.3164,-122.196,1640,7245,225000,11,12,2014,0,40,5495,5605,0,1,0
3,1.5,2680,4775,2.0,0,2,5,8,1880,800,1913,0,98109,47.6333,-122.347,2280,5947,1360000,25,6,2014,0,101,2095,3667,0,1,1
3,2.5,1590,4242,2.0,0,0,3,7,1590,0,2000,0,98065,47.5309,-121.876,1590,3702,355000,11,8,2014,0,14,2652,2112,0,0,0
4,1.75,1560,8700,1.0,0,0,4,7,1560,0,1967,0,98034,47.7274,-122.181,2080,8000,382500,2,5,2014,0,47,7140,5920,0,0,0
3,2.5,2000,9669,2.0,0,0,4,8,2000,0,1992,0,98022,47.1964,-122.009,1930,9202,324360,7,11,2014,0,22,7669,7272,0,0,0
3,1.75,2380,10450,1.5,0,0,3,8,2380,0,1966,0,98023,47.3143,-122.37,2320,8500,315000,24,3,2015,0,49,8070,6180,0,0,0
2,1.0,2230,11472,2.0,0,0,3,7,2230,0,1951,0,98133,47.7372,-122.35,1870,8649,426000,16,7,2014,0,63,9242,6779,0,0,1
5,2.5,2820,6305,2.0,0,0,3,8,2820,0,2003,0,98003,47.2616,-122.296,2610,6306,395000,6,4,2015,0,12,3485,3696,0,0,0
3,1.0,1570,9650,1.5,0,0,5,5,1570,0,1922,0,98010,47.3531,-121.982,1330,9650,212644,21,11,2014,0,92,8080,8320,0,0,0
3,3.0,1845,5100,2.0,0,2,5,8,1845,0,1947,0,98056,47.5204,-122.208,2100,7650,510000,9,10,2014,0,67,3255,5550,0,0,0
2,1.0,830,9000,1.0,0,0,3,6,830,0,1939,0,98032,47.3813,-122.243,1160,7680,85000,15,9,2014,0,75,8170,6520,0,0,0
2,1.0,830,9000,1.0,0,0,3,6,830,0,1939,0,98032,47.3813,-122.243,1160,7680,235000,30,12,2014,0,75,8170,6520,0,0,0
4,2.5,2030,5754,2.0,0,0,3,8,2030,0,2001,0,98042,47.3542,-122.137,2030,5784,295000,8,4,2015,0,14,3724,3754,0,0,0
3,2.5,1430,2200,1.5,0,0,4,7,1430,0,1910,0,98103,47.6601,-122.331,1740,4275,720001,10,8,2014,0,104,770,2535,0,0,1
3,1.0,1510,6083,1.0,0,0,4,6,860,650,1940,0,98115,47.6966,-122.324,1510,5712,313950,6,5,2014,0,74,4573,4202,0,1,1
3,1.0,1510,6083,1.0,0,0,4,6,860,650,1940,0,98115,47.6966,-122.324,1510,5712,415000,8,10,2014,0,74,4573,4202,0,1,1
3,1.75,1610,12247,1.0,0,0,3,8,1610,0,1981,0,98058,47.4476,-122.124,2010,9271,305000,19,5,2014,0,33,10637,7261,0,0,0
3,1.5,1600,4128,1.5,0,0,3,8,1250,350,1906,0,98122,47.6122,-122.297,1540,3976,625000,1,10,2014,0,108,2528,2436,0,1,1
3,1.0,1420,11040,1.0,0,0,4,7,1420,0,1961,0,98007,47.5969,-122.14,1530,8208,490000,14,4,2015,0,54,9620,6678,0,0,0
3,2.0,1660,8641,2.0,0,0,4,8,1660,0,1987,0,98042,47.3663,-122.088,1490,8641,269950,22,7,2014,0,27,6981,7151,0,0,0
4,3.0,3310,4500,2.5,0,0,5,9,2910,400,1900,0,98103,47.6594,-122.345,1440,3750,829000,13,8,2014,0,114,1190,2310,0,1,1
3,1.0,1040,9750,1.0,0,0,3,7,1040,0,1959,0,98188,47.4553,-122.274,1510,11100,217500,12,3,2015,0,56,8710,9590,0,0,1
4,1.75,1850,7350,1.0,0,0,3,7,1050,800,1965,0,98001,47.3413,-122.277,1450,7250,270000,16,7,2014,0,49,5500,5800,0,1,0
3,3.0,4610,8400,2.0,0,2,3,8,2790,1820,1947,1999,98144,47.5854,-122.292,2160,5000,1250000,26,9,2014,52,67,3790,2840,1,1,1
4,2.5,2480,5100,2.0,0,0,3,8,2480,0,2007,0,98019,47.7383,-121.969,2270,5115,480000,27,1,2015,0,8,2620,2845,0,0,0
3,1.75,2130,6500,1.0,0,2,3,8,1170,960,1954,0,98199,47.6424,-122.386,2020,5000,575000,6,5,2014,0,60,4370,2980,0,1,1
4,2.75,2350,5589,2.0,0,0,3,7,2350,0,2001,0,98059,47.5098,-122.155,2014,6365,426950,3,11,2014,0,13,3239,4351,0,0,0
3,1.0,920,7314,1.0,0,0,3,6,920,0,1960,0,98002,47.2892,-122.22,1010,7420,125000,5,9,2014,0,54,6394,6410,0,0,0
3,1.0,920,7314,1.0,0,0,3,6,920,0,1960,0,98002,47.2892,-122.22,1010,7420,208000,16,3,2015,0,55,6394,6410,0,0,0
4,2.0,1780,10622,1.0,0,0,4,7,900,880,1976,0,98058,47.4573,-122.158,1550,8900,325000,24,9,2014,0,38,8842,7350,0,1,0
7,4.0,2690,10880,1.0,0,0,4,8,2690,0,1960,0,98033,47.6787,-122.168,1840,10836,597157,22,9,2014,0,54,8190,8996,0,0,0
4,2.5,3010,3120,2.5,0,2,3,8,3010,0,2006,0,98029,47.5539,-121.996,2140,3840,728725,7,1,2015,0,9,110,1700,0,0,0
5,2.0,3180,10800,1.0,0,0,3,8,1910,1270,1968,0,98052,47.6354,-122.103,2440,9750,708000,18,8,2014,0,46,7620,7310,0,1,0
4,3.0,4120,14021,2.0,0,0,3,11,4120,0,2005,0,98075,47.5985,-122.026,4390,14684,1300000,23,7,2014,0,9,9901,10294,0,0,0
3,1.0,1280,11625,1.0,0,0,4,7,1280,0,1977,0,98053,47.6827,-122.059,1320,10875,405000,24,4,2015,0,38,10345,9555,0,0,0
4,2.75,1690,6090,1.5,0,0,3,7,1400,290,1945,0,98115,47.6814,-122.269,1820,6090,550000,28,10,2014,0,69,4400,4270,0,1,1
4,2.5,2320,5375,2.0,0,0,3,7,2320,0,2006,0,98065,47.5415,-121.883,2060,5395,451000,9,4,2015,0,9,3055,3335,0,0,0
5,3.75,3090,7415,2.0,0,0,3,8,3090,0,2014,0,98166,47.435,-122.329,2790,7425,540500,19,6,2014,0,0,4325,4635,0,0,1
4,1.0,1640,10455,1.0,0,0,3,7,950,690,1963,0,98023,47.2974,-122.366,1360,9750,218000,25,11,2014,0,51,8815,8390,0,1,0
4,2.25,2170,7007,1.0,0,0,3,8,1540,630,1974,0,98033,47.672,-122.169,2040,7700,562000,20,10,2014,0,40,4837,5660,0,1,0
2,1.0,1090,9994,1.0,0,0,3,7,1090,0,1954,0,98168,47.4761,-122.287,1090,11700,196700,12,11,2014,0,60,8904,10610,0,0,1
3,1.75,1930,10183,1.0,0,0,4,8,1480,450,1975,0,98006,47.5624,-122.135,2320,10000,583000,22,8,2014,0,39,8253,7680,0,1,0
5,2.5,2100,17825,1.0,0,0,4,7,1400,700,1974,0,98092,47.3094,-122.191,2200,14602,309900,4,12,2014,0,40,15725,12402,0,1,0
4,3.0,3110,18843,2.0,0,0,3,9,3110,0,1995,0,98058,47.4619,-122.154,3080,14735,485000,16,10,2014,0,19,15733,11655,0,0,0
3,1.0,930,3348,1.0,0,0,4,6,930,0,1926,0,98118,47.5532,-122.277,1210,3348,465000,24,4,2015,0,89,2418,2138,0,0,1
4,2.25,2050,8372,2.0,0,0,4,8,2050,0,1984,0,98052,47.7234,-122.107,2010,8037,595000,12,8,2014,0,30,6322,6027,0,0,0
3,1.0,1160,7560,1.0,0,0,4,6,1160,0,1958,0,98058,47.45,-122.179,1160,7560,254000,18,7,2014,0,56,6400,6400,0,0,0
3,2.75,1820,9490,2.0,0,0,3,7,1820,0,1994,0,98011,47.7481,-122.178,1950,8851,488500,30,10,2014,0,20,7670,6901,0,0,0
4,2.5,2110,8990,2.0,0,0,3,8,2110,0,1977,0,98058,47.4457,-122.127,2040,8800,260000,27,10,2014,0,37,6880,6760,0,0,0
2,1.0,870,8487,1.0,0,0,4,6,870,0,1944,0,98178,47.4955,-122.239,1350,6850,166000,2,1,2015,0,71,7617,5500,0,0,1
2,1.5,1080,6760,1.0,0,2,3,6,1080,0,1923,0,98117,47.7008,-122.386,2080,5800,440000,7,11,2014,0,91,5680,3720,0,0,1
3,2.0,1260,7560,2.0,0,0,5,6,1260,0,1943,0,98133,47.7225,-122.351,1260,7595,375000,2,2,2015,0,72,6300,6335,0,0,1
2,1.0,900,4800,1.0,0,0,4,6,780,120,1944,0,98199,47.6575,-122.4,1270,5520,529500,25,2,2015,0,71,3900,4250,0,1,1
2,1.0,750,6439,1.0,0,0,4,6,750,0,1934,0,98103,47.6995,-122.354,1470,6374,338000,14,10,2014,0,80,5689,4904,0,0,1
3,2.25,1800,15903,1.0,0,0,3,8,1340,460,1986,0,98038,47.3813,-122.043,2000,15233,335620,16,3,2015,0,29,14103,13233,0,1,0
2,1.0,1390,7740,1.0,0,0,4,6,1390,0,1925,0,98126,47.5232,-122.371,1290,7740,354000,3,10,2014,0,89,6350,6450,0,0,1
4,3.5,2160,3600,2.0,0,0,3,8,1660,500,1998,0,98122,47.6103,-122.297,1230,3840,601000,14,8,2014,0,16,1440,2610,0,1,1
3,2.25,1840,9040,1.0,0,0,3,8,1370,470,1979,0,98023,47.3144,-122.339,1870,8992,285000,24,4,2015,0,36,7200,7122,0,1,0
2,2.0,1690,4200,2.0,0,0,3,7,1690,0,1906,0,98112,47.621,-122.303,1540,4200,462500,30,9,2014,0,108,2510,2660,0,0,1
4,2.5,2650,10459,2.0,0,0,4,8,2650,0,1989,0,98003,47.2739,-122.293,2340,8777,350000,11,7,2014,0,25,7809,6437,0,0,0
4,1.0,1120,3844,1.0,0,0,3,7,1120,0,1972,0,98133,47.7038,-122.352,1480,3844,329000,24,12,2014,0,42,2724,2364,0,0,1
4,2.5,2500,11983,1.0,0,0,3,7,1320,1180,1984,2008,98058,47.4292,-122.148,1460,9005,312500,11,4,2015,24,31,9483,7545,1,1,0
4,2.5,2220,5338,2.0,0,0,3,7,2220,0,2001,0,98059,47.4887,-122.15,2220,5338,370000,13,6,2014,0,13,3118,3118,0,0,0
3,1.75,1260,12750,1.0,0,0,3,7,1260,0,1979,0,98034,47.7289,-122.233,1460,7865,399900,11,3,2015,0,36,11490,6405,0,0,0
3,1.0,1480,6550,1.5,0,0,4,6,1480,0,1925,0,98126,47.5498,-122.381,1200,6550,398000,20,11,2014,0,89,5070,5350,0,0,1
2,1.5,930,7400,1.0,0,2,4,7,830,100,1909,0,98116,47.5691,-122.408,1920,4152,550500,4,3,2015,0,106,6470,2232,0,1,1
3,2.75,2780,7200,1.5,0,0,4,8,1870,910,1913,0,98118,47.5632,-122.27,1700,7200,709000,24,2,2015,0,102,4420,5500,0,1,1
5,2.75,2770,7620,1.0,0,0,3,7,1700,1070,1965,0,98106,47.5188,-122.348,1720,7620,402000,12,12,2014,0,49,4850,5900,0,1,1
3,2.25,2140,6720,1.0,0,0,3,8,1440,700,1961,0,98117,47.6949,-122.396,2060,6720,524000,20,11,2014,0,53,4580,4660,0,1,1
4,1.0,1760,8906,1.0,0,0,3,7,1230,530,1966,0,98055,47.4288,-122.198,1180,10407,185000,23,9,2014,0,48,7146,9227,0,1,0
4,1.0,1760,8906,1.0,0,0,3,7,1230,530,1966,0,98055,47.4288,-122.198,1180,10407,365000,20,2,2015,0,49,7146,9227,0,1,0
4,2.5,3110,11422,2.0,0,0,3,9,3110,0,1989,0,98115,47.6833,-122.271,2850,7254,925000,9,9,2014,0,25,8312,4404,0,0,1
3,1.75,2260,11781,1.0,0,0,4,8,1520,740,1968,0,98008,47.5982,-122.128,2530,10176,714000,2,4,2015,0,47,9521,7646,0,1,0
3,2.0,1460,9759,1.0,0,0,5,7,1460,0,1972,0,98052,47.6644,-122.144,1620,8421,495000,16,10,2014,0,42,8299,6801,0,0,0
3,2.25,2050,6648,1.0,0,0,3,7,1230,820,1990,0,98133,47.7258,-122.332,1760,7200,535000,20,4,2015,0,25,4598,5440,0,1,1
4,2.5,2340,10800,1.0,0,0,3,8,2340,0,1953,2007,98040,47.5715,-122.225,2650,13500,880000,24,10,2014,54,61,8460,10850,1,0,0
3,1.5,1230,8056,1.0,0,0,4,6,1230,0,1949,0,98168,47.4878,-122.314,850,6714,150000,16,6,2014,0,65,6826,5864,0,0,1
3,2.25,1880,6565,1.0,0,0,4,8,1420,460,1972,0,98008,47.6396,-122.113,2060,7280,554500,27,3,2015,0,43,4685,5220,0,1,0
3,1.75,1280,3880,1.5,0,0,5,7,1280,0,1916,0,98117,47.6871,-122.391,980,3880,520000,8,4,2015,0,99,2600,2900,0,0,1
4,2.75,3660,5637,2.0,0,0,3,9,3660,0,2014,0,98053,47.6845,-122.017,3625,5639,839990,22,8,2014,0,0,1977,2014,0,0,0
3,2.5,1650,5683,2.0,0,0,3,7,1650,0,2003,0,98053,47.683,-122.035,1650,4193,500000,22,8,2014,0,11,4033,2543,0,0,0
3,2.5,1580,2170,2.0,0,0,3,7,1580,0,2003,0,98118,47.5418,-122.289,1610,1917,247800,2,8,2014,0,11,590,307,0,0,1
4,2.5,2490,5812,2.0,0,0,3,8,2490,0,2000,0,98042,47.3875,-122.155,2690,6012,344200,11,7,2014,0,14,3322,3322,0,0,0
4,2.5,2000,6107,2.0,0,0,3,8,2000,0,2003,0,98011,47.7557,-122.221,2040,6520,459950,23,6,2014,0,11,4107,4480,0,0,0
4,1.75,1550,9899,1.0,0,0,4,7,1550,0,1967,0,98030,47.3583,-122.183,1500,11272,229900,15,9,2014,0,47,8349,9772,0,0,0
4,2.25,2820,9602,1.0,0,1,3,8,1950,870,1974,0,98008,47.5881,-122.113,2890,9602,750000,19,2,2015,0,41,6782,6712,0,1,0
4,2.5,2600,9355,1.0,0,0,3,9,1840,760,1983,0,98028,47.7446,-122.249,2250,7691,509000,24,10,2014,0,31,6755,5441,0,1,0
5,2.5,2500,7200,1.0,0,0,4,7,1490,1010,1977,0,98052,47.6964,-122.12,1960,8325,661500,27,6,2014,0,37,4700,6365,0,1,0
2,1.0,1270,1399,3.0,0,0,3,7,1270,0,2000,0,98136,47.5552,-122.381,1140,1442,370000,25,11,2014,0,14,129,302,0,0,1
4,2.75,2900,17400,1.0,0,0,4,8,2410,490,1978,0,98052,47.6431,-122.108,2620,12240,785000,17,7,2014,0,36,14500,9620,0,1,0
2,1.0,840,6720,1.0,0,0,3,7,840,0,1952,0,98116,47.5707,-122.396,1250,6720,355000,18,8,2014,0,62,5880,5470,0,0,1
4,2.0,1940,6350,1.0,0,0,4,7,970,970,1951,0,98103,47.6948,-122.357,960,6350,446000,31,7,2014,0,63,4410,5390,0,1,1
3,2.5,1940,8347,2.0,0,0,3,8,1940,0,1990,0,98042,47.3654,-122.164,1940,7131,324000,28,10,2014,0,24,6407,5191,0,0,0
3,1.0,1390,9112,1.0,0,0,4,7,1390,0,1951,0,98004,47.6071,-122.197,2290,9112,745000,17,10,2014,0,63,7722,6822,0,0,0
4,2.5,3940,4407,2.0,0,0,4,8,2620,1320,1921,0,98112,47.6374,-122.299,1790,4407,1200000,10,11,2014,0,93,467,2617,0,1,1
2,2.5,1760,3710,1.0,0,0,3,8,1130,630,1988,0,98072,47.7335,-122.16,1760,4200,385000,15,12,2014,0,26,1950,2440,0,1,0
3,2.25,2560,8040,1.0,0,0,3,8,1510,1050,1958,0,98125,47.7124,-122.303,1980,8040,565000,11,12,2014,0,56,5480,6060,0,1,1
4,2.5,2300,7314,1.0,0,0,4,8,1420,880,1979,0,98133,47.7671,-122.33,2010,7314,465000,19,11,2014,0,35,5014,5304,0,1,1
3,3.25,1770,1977,3.0,0,0,3,8,1770,0,2001,0,98125,47.7186,-122.314,1860,2210,401000,27,8,2014,0,13,207,350,0,0,1
3,1.75,2310,11200,1.0,0,0,4,8,1630,680,1978,0,98030,47.3637,-122.21,2350,13300,385000,19,6,2014,0,36,8890,10950,0,1,0
3,2.5,2310,4930,2.0,0,0,4,8,2310,0,1989,0,98055,47.4512,-122.208,2230,5324,395000,17,10,2014,0,25,2620,3094,0,0,0
5,1.5,2000,8100,1.5,0,0,3,6,2000,0,1946,0,98168,47.4945,-122.304,960,9239,245000,14,4,2015,0,69,6100,8279,0,0,1
3,2.0,1540,3600,1.0,0,0,3,7,890,650,1994,0,98122,47.6103,-122.296,1540,3600,500000,25,3,2015,0,21,2060,2060,0,1,1
5,1.75,2590,6720,1.0,0,0,4,7,1750,840,1979,0,98055,47.435,-122.192,1820,7521,334000,3,11,2014,0,35,4130,5701,0,1,0
3,1.0,980,10960,1.0,0,0,4,7,980,0,1953,0,98005,47.5908,-122.173,2100,10960,550000,1,5,2015,0,62,9980,8860,0,0,0
3,1.0,1730,7950,1.0,0,0,4,7,1180,550,1961,0,98198,47.3644,-122.312,1830,8890,216000,24,11,2014,0,53,6220,7060,0,1,1
3,2.5,3070,5871,3.0,0,0,4,8,2510,560,1928,0,98178,47.5007,-122.223,2220,4000,340500,30,10,2014,0,86,2801,1780,0,1,1
4,2.25,2100,12738,2.0,0,0,4,8,2100,0,1975,0,98059,47.4698,-122.118,2000,12090,375000,13,8,2014,0,39,10638,10090,0,0,0
3,2.75,2080,16740,1.0,0,3,3,8,1580,500,1966,0,98198,47.3632,-122.324,2175,7568,600000,9,1,2015,0,49,14660,5393,0,1,1
4,1.75,1890,8000,1.0,0,0,4,7,1250,640,1960,0,98133,47.7576,-122.333,1870,8270,375000,15,5,2014,0,54,6110,6400,0,1,1
4,1.75,2000,4000,1.5,0,0,5,7,1450,550,1926,0,98126,47.5659,-122.375,1430,4000,536500,9,5,2014,0,88,2000,2570,0,1,1
2,1.5,1110,3600,1.0,0,0,5,7,1110,0,1904,0,98119,47.6382,-122.359,1670,5400,750000,4,3,2015,0,111,2490,3730,0,0,1
3,1.0,1650,10075,1.0,0,0,3,7,1170,480,1955,0,98177,47.7695,-122.359,1690,8125,355000,11,2,2015,0,60,8425,6435,0,1,1
3,2.0,1410,6413,1.0,0,0,4,7,910,500,1947,0,98115,47.6826,-122.298,1330,6050,590000,1,7,2014,0,67,5003,4720,0,1,1
2,1.0,2140,6000,1.0,0,0,4,7,1070,1070,1946,0,98199,47.651,-122.399,1560,6000,680000,7,5,2015,0,69,3860,4440,0,1,1
3,2.5,1860,11122,2.0,0,0,3,8,1860,0,1994,0,98059,47.5062,-122.151,2420,8542,429000,6,10,2014,0,20,9262,6122,0,0,0
2,1.0,1170,4080,1.0,0,0,4,7,1170,0,1909,0,98117,47.6784,-122.386,1560,4586,581000,2,5,2015,0,106,2910,3026,0,0,1
3,1.5,980,7770,1.0,0,0,4,7,980,0,1968,0,98033,47.6923,-122.201,1470,7350,463800,31,3,2015,0,47,6790,5880,0,0,0
5,1.75,1650,3000,1.5,0,0,3,8,1650,0,1902,0,98144,47.5955,-122.306,1740,4000,443000,7,7,2014,0,112,1350,2260,0,0,1
3,2.5,1480,7210,1.0,0,0,3,7,1180,300,1986,0,98023,47.3124,-122.351,1690,7396,276200,25,9,2014,0,28,5730,5706,0,1,0
5,3.5,4060,8309,2.0,0,0,3,9,2960,1100,2001,0,98028,47.757,-122.228,1730,11711,630000,23,4,2015,0,14,4249,9981,0,1,0
3,1.75,1370,3300,2.0,0,0,5,7,1370,0,1927,0,98105,47.6714,-122.32,1560,3927,570000,22,12,2014,0,87,1930,2367,0,0,1
4,2.25,2480,6000,2.0,0,2,3,10,2380,100,1929,0,98199,47.6392,-122.406,3030,5600,979700,13,10,2014,0,85,3520,2570,0,1,1
4,2.5,2030,4080,1.5,0,0,4,8,1730,300,1921,0,98115,47.6753,-122.311,1980,4080,730000,11,12,2014,0,93,2050,2100,0,1,1
5,2.25,2200,9600,1.0,0,0,4,7,1100,1100,1963,0,98023,47.3263,-122.364,1780,9680,268450,4,12,2014,0,51,7400,7900,0,1,0
3,1.75,1770,7508,1.0,0,0,3,7,1270,500,1962,0,98133,47.7354,-122.343,1690,8880,490000,4,3,2015,0,53,5738,7190,0,1,1
3,2.5,2550,6240,1.0,0,3,5,8,1750,800,1957,0,98117,47.6992,-122.387,2180,5200,808000,27,8,2014,0,57,3690,3020,0,1,1
3,1.0,1250,9786,1.0,0,0,4,7,1250,0,1969,0,98072,47.7622,-122.163,1660,9621,350000,30,4,2015,0,46,8536,7961,0,0,0
4,1.75,2390,5880,1.0,0,2,3,8,1390,1000,1957,0,98117,47.6956,-122.399,2210,6260,695000,28,10,2014,0,57,3490,4050,0,1,1
1,1.0,1120,11800,1.5,0,0,3,7,1120,0,1950,0,98168,47.5123,-122.331,2330,9290,309950,13,8,2014,0,64,10680,6960,0,0,1
3,1.0,1270,8508,1.0,0,0,4,6,650,620,1942,0,98168,47.4961,-122.322,1200,9415,134000,30,10,2014,0,72,7238,8215,0,1,1
4,2.5,2390,9638,2.0,0,0,3,10,2390,0,1988,0,98029,47.5598,-122.018,2630,9258,645500,18,11,2014,0,26,7248,6628,0,0,0
3,2.0,1760,5488,1.5,0,0,3,7,1540,220,1927,0,98119,47.6479,-122.367,1760,5943,750000,9,3,2015,0,88,3728,4183,0,1,1
3,2.5,2560,3600,2.0,0,0,3,9,2110,450,1967,2003,98112,47.632,-122.279,2690,4800,1400000,10,10,2014,36,47,1040,2110,1,1,1
4,1.75,1820,7700,1.0,0,0,4,7,1100,720,1955,0,98177,47.7545,-122.357,1700,8500,344900,25,9,2014,0,59,5880,6800,0,1,1
2,3.25,1840,1500,3.0,0,0,3,8,1840,0,2001,0,98103,47.6595,-122.354,1910,2500,601450,8,10,2014,0,13,-340,590,0,0,1
4,2.0,1810,4400,2.0,0,0,3,8,1700,110,1909,0,98122,47.6132,-122.292,1470,4400,575000,7,1,2015,0,106,2590,2930,0,1,1
3,1.75,2470,9620,1.0,0,1,4,7,1570,900,1962,0,98198,47.3996,-122.32,2600,9620,405000,21,5,2014,0,52,7150,7020,0,1,1
4,2.75,2520,14021,2.0,0,0,3,9,2520,0,1999,0,98019,47.7344,-121.957,2330,14007,518000,24,6,2014,0,15,11501,11677,0,0,0
2,1.0,1600,7936,1.0,0,0,3,7,1600,0,1947,0,98155,47.7411,-122.322,1580,7440,265000,17,7,2014,0,67,6336,5860,0,0,1
3,1.0,1280,4875,1.0,0,0,5,6,1280,0,1969,0,98042,47.3686,-122.081,1060,4875,180000,25,9,2014,0,45,3595,3815,0,0,0
3,2.5,1590,9736,2.0,0,0,3,7,1590,0,1985,0,98001,47.33,-122.278,1580,7500,285000,18,3,2015,0,30,8146,5920,0,0,0
3,2.75,2000,7200,1.0,0,0,3,7,1000,1000,1954,2014,98166,47.4531,-122.352,1440,7200,433000,16,3,2015,60,61,5200,5760,1,1,1
3,1.75,1780,11440,1.0,0,0,3,8,1350,430,1977,0,98059,47.474,-122.139,2180,11440,399000,23,2,2015,0,38,9660,9260,0,1,0
3,2.5,1700,7210,2.0,0,0,5,7,1700,0,1966,0,98052,47.6688,-122.161,1700,7566,565000,2,8,2014,0,48,5510,5866,0,0,0
3,1.5,1970,10080,1.0,0,0,3,7,1970,0,1966,0,98168,47.4703,-122.276,2240,10080,406500,24,2,2015,0,49,8110,7840,0,0,1
4,1.75,1940,11500,1.0,0,0,4,7,1090,850,1955,0,98006,47.5774,-122.147,1700,8360,420000,7,8,2014,0,59,9560,6660,0,1,0
4,3.5,3290,5559,1.5,0,0,3,8,2290,1000,1906,2004,98103,47.6788,-122.346,1790,6000,965000,20,2,2015,98,109,2269,4210,1,1,1
4,3.5,3500,9523,2.0,0,0,3,10,2460,1040,1996,0,98033,47.6848,-122.208,3160,5997,1380000,24,10,2014,0,18,6023,2837,0,1,0
5,2.25,3260,7969,2.0,0,0,4,8,3260,0,1982,0,98023,47.314,-122.344,2070,7962,353950,7,10,2014,0,32,4709,5892,0,0,0
5,3.25,4230,10260,2.0,0,0,3,10,3860,370,1996,0,98027,47.5503,-122.081,2980,10997,847700,10,7,2014,0,18,6030,8017,0,1,0
5,1.0,1590,6700,1.5,0,0,3,6,1090,500,1942,0,98146,47.5075,-122.35,1370,8040,185000,2,7,2014,0,72,5110,6670,0,1,1
2,1.5,1010,6000,1.0,0,0,4,7,1010,0,1923,0,98178,47.498,-122.222,1290,6000,269000,19,11,2014,0,91,4990,4710,0,0,1
3,1.75,1820,8400,1.0,0,0,3,7,1340,480,1976,0,98072,47.734,-122.17,1900,8112,422800,24,12,2014,0,38,6580,6212,0,1,0
2,1.0,870,7500,1.0,0,0,3,7,870,0,1947,0,98136,47.5465,-122.384,1240,5709,379950,15,12,2014,0,67,6630,4469,0,0,1
3,2.0,1620,7800,1.0,0,0,3,7,1200,420,1969,0,98034,47.7288,-122.171,1540,7565,525000,26,12,2014,0,45,6180,6025,0,1,0
4,1.0,1630,8400,1.0,0,0,3,6,1630,0,1962,0,98023,47.3052,-122.362,1190,8989,209950,22,7,2014,0,52,6770,7799,0,0,0
3,2.0,1230,1613,2.0,0,0,3,8,1010,220,2003,0,98107,47.6661,-122.37,1610,1873,439950,4,12,2014,0,11,383,263,0,1,1
4,2.5,2160,4500,2.0,0,0,3,7,2160,0,2002,0,98056,47.4819,-122.182,2160,4496,359000,23,4,2015,0,13,2340,2336,0,0,0
3,1.0,1020,5870,1.0,0,0,3,6,1020,0,1941,0,98155,47.741,-122.314,1160,6901,242500,10,9,2014,0,73,4850,5741,0,0,1
3,1.75,1590,9417,1.0,0,0,4,7,1590,0,1954,0,98177,47.7617,-122.36,1600,9272,330000,26,9,2014,0,60,7827,7672,0,0,1
5,1.0,3020,4800,2.0,0,0,3,7,3020,0,1901,0,98122,47.6025,-122.313,1350,1307,630000,18,12,2014,0,113,1780,-43,0,0,1
3,1.75,2280,7800,1.0,0,3,4,8,1360,920,1941,0,98117,47.6985,-122.387,2280,5200,750000,15,8,2014,0,73,5520,2920,0,1,1
4,2.5,2790,6540,2.0,0,0,3,9,2790,0,1999,0,98074,47.6087,-122.016,2790,6270,695000,13,10,2014,0,15,3750,3480,0,0,0
2,0.5,580,6900,1.0,0,0,3,5,580,0,1941,0,98118,47.5135,-122.262,1570,5040,109000,14,1,2015,0,74,6320,3470,0,0,1
3,1.5,2030,10075,1.0,0,0,5,7,1080,950,1961,0,98055,47.4713,-122.197,2210,10075,389000,25,2,2015,0,54,8045,7865,0,1,0
2,1.0,850,2700,1.0,0,0,5,6,850,0,1924,0,98105,47.6684,-122.316,1630,3000,447000,23,10,2014,0,90,1850,1370,0,0,1
3,2.0,2480,13310,1.0,0,0,2,7,2480,0,1955,0,98052,47.6759,-122.114,2400,11340,1200000,30,12,2014,0,59,10830,8940,0,0,0
3,1.75,1010,12000,1.0,0,0,4,7,1010,0,1977,0,98011,47.77,-122.207,1080,10619,315000,10,12,2014,0,37,10990,9539,0,0,0
3,2.5,2420,8244,2.0,0,0,3,10,2420,0,1988,0,98029,47.5595,-122.019,2500,9320,640000,14,4,2015,0,27,5824,6820,0,0,0
3,2.25,2180,9246,2.0,0,0,3,9,2180,0,1984,0,98074,47.6215,-122.031,2300,9298,570000,19,11,2014,0,30,7066,6998,0,0,0
5,2.75,2040,7488,1.0,0,0,4,7,1200,840,1969,0,98034,47.7289,-122.172,1530,7488,449500,3,6,2014,0,45,5448,5958,0,1,0
4,2.75,2640,5000,2.0,0,0,3,9,1840,800,1943,2004,98105,47.6619,-122.275,2010,5000,1080000,17,3,2015,61,72,2360,2990,1,1,1
2,1.0,1060,7868,1.0,0,0,3,7,1060,0,1952,0,98155,47.7414,-122.295,1530,10728,294950,11,3,2015,0,63,6808,9198,0,0,1
3,1.0,1640,13939,1.0,0,0,3,7,1040,600,1960,0,98198,47.3947,-122.313,2080,13000,170500,23,9,2014,0,54,12299,10920,0,1,1
4,1.0,1190,7620,1.5,0,0,3,6,1190,0,1926,0,98106,47.5281,-122.348,1060,7320,312000,8,12,2014,0,88,6430,6260,0,0,1
3,2.5,2180,15484,1.0,0,0,3,8,2180,0,1992,0,98003,47.2688,-122.309,2090,10775,350000,27,10,2014,0,22,13304,8685,0,0,0
4,2.5,2120,8448,2.0,0,0,4,9,2120,0,1989,0,98029,47.5654,-122.01,2140,8122,690000,28,7,2014,0,25,6328,5982,0,0,0
4,2.5,2210,9427,2.0,0,0,3,7,2210,0,1999,0,98148,47.4323,-122.327,1770,8770,375000,10,6,2014,0,15,7217,7000,0,0,1
4,2.25,2500,8500,1.0,0,0,4,8,1600,900,1978,0,98006,47.5615,-122.131,2290,8927,646000,4,6,2014,0,36,6000,6637,0,1,0
3,2.5,1560,4800,2.0,0,0,4,7,1560,0,1974,0,98001,47.2653,-122.285,1510,12240,239950,27,3,2015,0,41,3240,10730,0,0,0
5,2.5,2510,7525,1.5,0,0,4,7,1710,800,1929,0,98106,47.5422,-122.359,1270,6741,400000,29,7,2014,0,85,5015,5471,0,1,1
3,2.0,1310,8069,1.0,0,0,3,7,1310,0,1990,0,98042,47.3694,-122.083,1310,8392,240000,4,9,2014,0,24,6759,7082,0,0,0
4,4.0,4260,11765,2.0,0,0,3,11,3280,980,1939,2010,98112,47.638,-122.288,4260,10408,3400000,8,5,2015,71,76,7505,6148,1,1,1
3,2.0,2500,4080,1.5,0,0,5,7,1680,820,1922,0,98103,47.6813,-122.346,1550,3060,695000,1,7,2014,0,92,1580,1510,0,1,1
2,1.0,670,6720,1.0,0,0,5,6,670,0,1942,0,98126,47.5151,-122.372,710,6720,304950,24,9,2014,0,72,6050,6010,0,0,1
3,1.75,1840,2310,1.0,0,2,4,8,1140,700,1914,0,98109,47.6462,-122.351,1670,4000,650000,5,8,2014,0,100,470,2330,0,1,1
3,1.75,1480,2211,2.0,0,0,3,7,1480,0,1995,0,98103,47.6966,-122.35,1480,2197,402500,15,7,2014,0,19,731,717,0,0,1
3,2.5,2420,7307,2.0,0,0,3,7,2420,0,1998,0,98065,47.5361,-121.871,2420,5577,482000,25,6,2014,0,16,4887,3157,0,0,0
3,2.0,1820,4480,1.0,0,0,5,7,1120,700,1923,0,98105,47.6717,-122.295,1920,4480,655000,31,10,2014,0,91,2660,2560,0,1,1
5,2.75,1940,5000,2.0,0,0,5,7,1940,0,1951,0,98107,47.6704,-122.362,1940,4230,577000,26,9,2014,0,63,3060,2290,0,0,1
3,2.5,1630,5996,2.0,0,0,3,7,1630,0,1986,0,98055,47.4738,-122.19,1660,4504,350000,20,10,2014,0,28,4366,2844,0,0,0
4,2.25,2520,8000,1.0,0,2,3,8,1680,840,1970,0,98023,47.3202,-122.383,2300,8000,415000,8,9,2014,0,44,5480,5700,0,1,0
3,2.5,2490,8582,2.0,0,0,3,9,2490,0,2000,0,98074,47.625,-122.042,2870,7598,654300,9,4,2015,0,15,6092,4728,0,0,0
4,2.0,2380,10800,2.0,0,2,3,8,2380,0,1925,0,98118,47.5682,-122.275,2112,6600,855000,2,9,2014,0,89,8420,4488,0,0,1
3,2.5,2490,4000,2.0,0,0,5,8,1670,820,1918,0,98109,47.6403,-122.35,2310,4000,1150000,26,6,2014,0,96,1510,1690,0,1,1
2,2.5,1240,1546,2.0,0,0,3,7,1240,0,2007,0,98108,47.5634,-122.298,1520,2468,330000,30,5,2014,0,7,306,948,0,0,1
4,2.25,1900,10950,1.0,0,0,4,7,1400,500,1959,0,98032,47.3582,-122.284,1700,11850,290000,23,9,2014,0,55,9050,10150,0,1,0
3,1.75,1810,12600,1.0,0,0,3,7,1400,410,1977,0,98034,47.7143,-122.233,1934,12600,450000,14,8,2014,0,37,10790,10666,0,1,0
3,1.0,1620,9450,1.5,0,0,3,7,1620,0,1928,0,98168,47.5136,-122.313,2070,11970,265000,23,6,2014,0,86,7830,9900,0,0,1
4,2.5,2640,7883,2.0,0,0,3,8,2640,0,1990,0,98092,47.3124,-122.188,2150,7683,359000,6,5,2015,0,25,5243,5533,0,0,0
4,3.75,2870,4500,2.0,0,3,3,10,2510,360,2012,0,98119,47.6291,-122.363,2870,6354,2000000,2,3,2015,0,3,1630,3484,0,1,1
2,1.0,800,2280,1.0,0,0,5,6,800,0,1946,0,98107,47.6588,-122.362,1310,4200,402500,1,7,2014,0,68,1480,2890,0,0,1
3,1.75,1360,5445,1.0,0,0,4,7,1360,0,1957,0,98008,47.6071,-122.123,1570,7840,450000,25,8,2014,0,57,4085,6270,0,0,0
5,2.25,1950,8086,1.0,0,0,3,7,1130,820,1980,0,98003,47.3179,-122.331,1670,8550,262500,6,3,2015,0,35,6136,6880,0,1,0
4,2.25,1970,7200,2.0,0,0,3,8,1970,0,1979,0,98092,47.3132,-122.182,1790,7500,285000,25,2,2015,0,36,5230,5710,0,0,0
3,2.5,2020,4861,2.0,0,0,3,7,2020,0,2005,0,98058,47.4659,-122.144,2170,4600,290000,4,3,2015,0,10,2841,2430,0,0,0
2,2.5,2280,6230,1.0,0,0,3,8,2280,0,2005,0,98053,47.7065,-122.013,1640,5931,752500,7,8,2014,0,9,3950,4291,0,0,0
4,2.75,3540,13515,2.0,0,0,3,10,3540,0,1998,0,98075,47.5945,-121.982,3540,11538,820000,8,12,2014,0,16,9975,7998,0,0,0
3,2.5,1560,2740,2.0,0,0,3,8,1560,0,1999,0,98059,47.4909,-122.154,1310,2698,292000,11,8,2014,0,15,1180,1388,0,0,0
2,1.0,750,6089,1.0,0,2,3,6,750,0,1937,0,98055,47.475,-122.199,1430,6451,213000,3,10,2014,0,77,5339,5021,0,0,0
4,3.0,2240,7035,2.0,0,0,3,7,2240,0,1942,1993,98146,47.5124,-122.374,1060,6300,400000,17,11,2014,51,72,4795,5240,1,0,1
1,0.75,590,5650,1.0,0,0,3,6,590,0,1944,0,98118,47.5181,-122.267,980,5650,202000,14,7,2014,0,70,5060,4670,0,0,1
3,2.0,1580,14398,1.0,0,0,3,7,1080,500,1981,0,98005,47.6328,-122.174,1650,14407,617450,4,5,2015,0,34,12818,12757,0,1,0
3,1.0,1040,8000,1.0,0,0,4,7,1040,0,1956,0,98166,47.4711,-122.35,1170,9450,250000,14,1,2015,0,59,6960,8280,0,0,1
5,1.75,1880,10000,1.0,0,0,3,7,960,920,1963,0,98034,47.7182,-122.201,1580,10000,405000,29,5,2014,0,51,8120,8420,0,1,0
2,1.0,1070,8750,1.0,0,0,3,7,1070,0,1951,0,98055,47.4734,-122.198,1300,9670,325000,31,3,2015,0,64,7680,8370,0,0,0
3,3.0,1860,7440,1.0,0,0,5,7,1040,820,1954,0,98178,47.5035,-122.255,1490,8160,301350,22,5,2014,0,60,5580,6670,0,1,1
2,1.75,1550,7800,1.0,0,0,3,7,1050,500,1940,0,98136,47.5436,-122.39,1370,5000,425000,3,3,2015,0,75,6250,3630,0,1,1
3,1.0,1860,6360,1.0,0,0,3,8,1470,390,1954,0,98136,47.5327,-122.392,1770,6175,460000,5,9,2014,0,60,4500,4405,0,1,1
3,2.5,3090,10940,2.0,0,2,3,10,3090,0,1992,0,98006,47.5492,-122.119,3410,12157,938000,19,4,2015,0,23,7850,8747,0,0,0
3,1.75,1720,8867,1.0,0,0,3,8,1320,400,1985,0,98058,47.44,-122.136,2200,9170,348000,29,7,2014,0,29,7147,6970,0,1,0
2,1.0,1260,4080,1.5,0,0,5,7,1260,0,1926,0,98115,47.687,-122.32,1720,4080,435000,6,6,2014,0,88,2820,2360,0,0,1
3,1.5,1120,11430,1.0,0,0,4,7,1120,0,1963,0,98031,47.4105,-122.194,1790,8760,227950,13,11,2014,0,51,10310,6970,0,0,0
2,1.0,1250,5880,1.0,0,0,3,6,900,350,1948,0,98117,47.6908,-122.391,1520,5020,425000,30,3,2015,0,67,4630,3500,0,1,1
3,2.0,1810,4064,1.5,0,0,3,7,1810,0,1925,0,98103,47.6859,-122.339,1518,2945,550000,2,6,2014,0,89,2254,1427,0,0,1
3,2.5,1890,7053,2.0,0,0,4,8,1890,0,1992,0,98031,47.3967,-122.183,2000,7226,347500,21,7,2014,0,22,5163,5226,0,0,0
4,1.75,2020,6000,1.0,0,0,3,7,1620,400,1959,0,98144,47.577,-122.302,1870,4000,397000,30,9,2014,0,55,3980,2130,0,1,1
4,1.75,1790,11875,1.0,0,0,4,7,1490,300,1969,0,98027,47.522,-122.047,1870,11760,410000,2,6,2014,0,45,10085,9890,0,1,0
3,3.5,3190,6776,2.0,0,0,3,10,3190,0,1998,0,98074,47.6348,-122.064,3230,7189,780000,11,7,2014,0,16,3586,3959,0,0,0
4,3.25,3030,5164,1.5,0,0,5,9,2700,330,1925,0,98112,47.6394,-122.299,1890,4415,1350000,9,9,2014,0,89,2134,2525,0,1,1
3,2.25,1630,3070,2.0,0,0,3,7,1630,0,2004,0,98053,47.6785,-122.03,1690,3200,476000,28,10,2014,0,10,1440,1510,0,0,0
3,2.0,1560,7000,1.0,0,0,4,7,1560,0,1968,0,98001,47.3355,-122.284,1560,7200,226500,30,12,2014,0,46,5440,5640,0,0,0
3,2.0,1340,2550,2.0,0,0,3,7,1340,0,1984,0,98117,47.6793,-122.38,1370,5100,495000,31,7,2014,0,30,1210,3730,0,0,1
5,3.25,2590,11500,1.0,0,2,4,9,2590,0,1968,0,98040,47.545,-122.229,2780,11989,1500000,19,3,2015,0,47,8910,9209,0,0,0
3,1.0,1020,5950,1.0,0,0,3,6,880,140,1950,0,98106,47.5436,-122.357,1800,5950,385000,22,4,2015,0,65,4930,4150,0,1,1
3,2.5,2370,5344,2.0,0,0,3,9,2370,0,2003,0,98065,47.54,-121.863,2990,5418,535950,9,3,2015,0,12,2974,2428,0,0,0
2,1.0,1120,4000,1.0,0,0,3,7,1120,0,1926,0,98105,47.6567,-122.327,1620,4000,465000,26,3,2015,0,89,2880,2380,0,0,1
3,1.75,1440,11787,1.0,0,0,3,8,1440,0,1983,0,98074,47.6276,-122.033,2190,11787,495000,26,6,2014,0,31,10347,9597,0,0,0
4,2.0,2170,5404,1.5,0,0,5,6,1470,700,1920,0,98002,47.3046,-122.22,1030,5477,250000,10,2,2015,0,95,3234,4447,0,1,0
4,2.25,3490,6906,2.0,0,0,4,10,2280,1210,1928,0,98199,47.6424,-122.407,2540,6223,1230000,6,5,2014,0,86,3416,3683,0,1,1
4,2.25,1970,8941,2.0,0,0,3,7,1970,0,1973,0,98034,47.7223,-122.172,1880,7793,400000,17,2,2015,0,42,6971,5913,0,0,0
4,2.5,2780,13521,2.0,0,0,3,10,2780,0,1987,0,98074,47.6374,-122.042,2980,11454,715000,21,8,2014,0,27,10741,8474,0,0,0
3,2.0,2250,7757,1.0,0,0,3,8,2250,0,1992,0,98003,47.2684,-122.308,1970,6866,342000,23,2,2015,0,23,5507,4896,0,0,0
4,1.75,1340,8400,1.0,0,0,5,7,1340,0,1967,0,98056,47.5382,-122.173,1980,8400,420000,30,4,2015,0,48,7060,6420,0,0,0
3,1.0,1400,7360,1.0,0,0,4,7,1400,0,1968,0,98092,47.3123,-122.186,1600,8030,148226,8,7,2014,0,46,5960,6430,0,0,0
3,1.0,1320,8220,1.0,0,0,3,7,1320,0,1959,0,98198,47.3697,-122.309,1320,7920,150000,3,6,2014,0,55,6900,6600,0,0,1
2,1.0,820,10270,1.0,0,0,3,7,820,0,1954,0,98168,47.5119,-122.329,1670,10086,150000,22,5,2014,0,60,9450,8416,0,0,1
2,1.0,1080,9435,1.0,0,0,3,6,1080,0,1958,0,98058,47.459,-122.181,1200,9210,230000,18,6,2014,0,56,8355,8010,0,0,0
2,1.0,840,5400,1.0,0,0,4,7,840,0,1948,0,98118,47.5489,-122.271,1340,5400,389100,2,9,2014,0,66,4560,4060,0,0,1
4,2.25,2070,8720,1.0,0,0,5,8,1360,710,1974,0,98033,47.6678,-122.182,2180,8510,645000,16,12,2014,0,40,6650,6330,0,1,0
3,1.0,1520,6500,1.0,0,0,3,7,990,530,1958,0,98198,47.4164,-122.332,1500,7500,310000,2,3,2015,0,57,4980,6000,0,1,1
2,1.75,1210,1189,2.0,0,0,3,8,1210,0,2014,0,98029,47.5526,-121.998,1540,1672,351358,4,10,2014,0,0,-21,132,0,0,0
5,2.75,3810,9360,2.0,0,0,3,10,3810,0,2014,0,98004,47.6039,-122.194,2110,9870,1700000,10,3,2015,0,1,5550,7760,0,0,0
3,2.0,1540,3600,2.0,0,0,3,8,1540,0,1900,1988,98112,47.6343,-122.283,2970,3600,850000,20,10,2014,88,114,2060,630,1,0,1
4,2.5,2310,14023,2.0,0,0,3,9,2310,0,1991,0,98019,47.7351,-121.964,2410,14007,470000,14,5,2014,0,23,11713,11597,0,0,0
3,2.25,1870,1900,3.0,0,0,3,8,1870,0,2008,0,98103,47.6537,-122.34,1690,1694,770000,18,11,2014,0,6,30,4,0,0,1
3,1.75,1840,11440,1.0,0,0,4,8,1340,500,1977,0,98059,47.474,-122.14,1940,11440,366000,24,6,2014,0,37,9600,9500,0,1,0
3,2.5,2060,7184,2.0,0,0,3,8,2060,0,1987,0,98029,47.567,-122.012,2230,7788,545000,10,7,2014,0,27,5124,5558,0,0,0
3,1.0,1010,8800,1.0,0,0,4,7,1010,0,1968,0,98002,47.2761,-122.208,1550,7700,205000,9,9,2014,0,46,7790,6150,0,0,0
2,1.0,1020,8155,1.0,0,0,4,7,1020,0,1948,0,98177,47.7257,-122.361,1430,8157,405000,8,5,2014,0,66,7135,6727,0,0,1
4,2.5,2220,7210,1.0,0,0,3,7,1270,950,1973,0,98011,47.7428,-122.183,2220,7313,467000,10,4,2015,0,42,4990,5093,0,1,0
2,1.0,1050,4125,1.0,0,0,4,7,1050,0,1909,0,98144,47.5736,-122.307,1650,4125,392500,26,9,2014,0,105,3075,2475,0,0,1
4,2.75,3030,18400,1.5,0,3,3,9,2360,670,1973,0,98034,47.7019,-122.243,3030,12486,901000,27,10,2014,0,41,15370,9456,0,1,0
3,1.75,1800,7199,1.0,0,0,3,7,1300,500,1972,0,98125,47.7264,-122.307,1800,8100,500000,3,12,2014,0,42,5399,6300,0,1,1
3,2.5,1860,3690,2.0,0,0,3,7,1860,0,2000,0,98028,47.776,-122.239,1870,4394,384950,30,5,2014,0,14,1830,2524,0,0,0
2,1.0,860,6120,1.0,0,0,3,7,860,0,1948,0,98155,47.7503,-122.328,1100,6860,245000,17,7,2014,0,66,5260,5760,0,0,1
4,2.25,3080,10487,2.0,0,0,4,9,3080,0,1968,0,98040,47.5344,-122.224,2480,10607,1170000,9,2,2015,0,47,7407,8127,0,0,0
3,1.5,1280,3640,2.0,0,0,3,6,1280,0,1983,0,98002,47.334,-122.214,1150,4105,184500,21,4,2015,0,32,2360,2955,0,0,0
2,2.0,1540,5000,1.5,0,0,3,8,1540,0,1986,0,98023,47.319,-122.394,1590,5000,269000,14,4,2015,0,29,3460,3410,0,0,0
3,2.5,1530,3296,2.0,0,0,3,8,1530,0,1998,0,98007,47.6181,-122.138,1530,4099,570000,21,7,2014,0,16,1766,2569,0,0,0
4,1.75,2350,11914,1.0,0,0,4,8,2350,0,1961,0,98040,47.5392,-122.228,2240,10706,850000,12,5,2014,0,53,9564,8466,0,0,0
3,1.0,920,5200,1.0,0,0,4,6,920,0,1969,0,98042,47.3647,-122.082,920,4875,209000,2,2,2015,0,46,4280,3955,0,0,0
4,1.75,1840,5100,1.0,0,0,4,5,1840,0,1933,0,98056,47.5209,-122.205,2160,5400,327000,6,8,2014,0,81,3260,3240,0,0,0
3,1.5,1650,9957,1.0,0,0,4,7,1100,550,1961,0,98125,47.7303,-122.298,1650,7957,369500,13,6,2014,0,53,8307,6307,0,1,1
3,1.75,1760,8025,1.0,0,0,4,7,1230,530,1976,0,98034,47.7287,-122.192,1590,7543,440000,26,2,2015,0,39,6265,5953,0,1,0
4,2.25,3290,12329,1.5,0,0,4,10,3290,0,1968,0,98040,47.5639,-122.216,3170,12329,947500,12,5,2014,0,46,9039,9159,0,0,0
2,1.0,1270,4500,1.5,0,0,4,7,1270,0,1919,0,98122,47.6059,-122.295,2140,4550,510000,17,3,2015,0,96,3230,2410,0,0,1
3,2.0,1600,10318,1.0,0,0,3,7,930,670,1941,0,98133,47.7466,-122.347,1590,7040,385000,28,4,2015,0,74,8718,5450,0,1,1
5,3.0,2670,9920,1.0,0,0,3,8,1400,1270,1990,0,98001,47.3211,-122.277,1890,10341,370000,20,8,2014,0,24,7250,8451,0,1,0
4,1.5,1960,4500,1.5,0,2,3,7,1960,0,1922,0,98117,47.6797,-122.359,1960,4500,660000,1,12,2014,0,92,2540,2540,0,0,1
3,1.75,2000,11880,2.0,0,0,3,8,2000,0,1979,0,98075,47.5882,-122.052,1820,15120,440000,19,8,2014,0,35,9880,13300,0,0,0
2,1.0,1430,12092,1.0,0,0,4,7,1430,0,1938,0,98125,47.7023,-122.276,2320,10800,460000,1,12,2014,0,76,10662,8480,0,0,1
3,3.0,2330,7304,1.0,0,0,3,9,1300,1030,1971,0,98005,47.5982,-122.172,2330,9518,516000,2,12,2014,0,43,4974,7188,0,1,0
4,2.5,2060,5607,2.0,0,0,3,7,2060,0,2002,0,98058,47.4365,-122.144,2060,5367,343888,15,8,2014,0,12,3547,3307,0,0,0
4,1.75,2240,9886,1.5,0,0,4,7,2240,0,1965,0,98008,47.6294,-122.116,1540,8040,500000,9,6,2014,0,49,7646,6500,0,0,0
5,1.75,2330,6450,1.0,0,1,3,8,1330,1000,1958,0,98146,47.4959,-122.367,2330,8258,465000,8,5,2015,0,57,4120,5928,0,1,1
5,2.25,2180,7813,2.0,0,0,3,7,2180,0,1986,0,98038,47.3651,-122.051,1880,8649,302000,12,5,2014,0,28,5633,6769,0,0,0
2,1.0,1280,7861,1.0,0,0,4,6,1280,0,1913,0,98002,47.3007,-122.228,1020,6480,195000,7,11,2014,0,101,6581,5460,0,0,0
3,2.5,2140,8925,2.0,0,0,3,8,2140,0,1991,0,98074,47.6314,-122.027,2310,8956,640000,9,6,2014,0,23,6785,6646,0,0,0
6,2.5,2890,8122,1.0,0,0,3,8,1630,1260,1977,0,98008,47.5886,-122.113,2730,9915,502000,23,6,2014,0,37,5232,7185,0,1,0
3,2.5,1480,3851,2.0,0,0,3,8,1480,0,1998,0,98072,47.7732,-122.163,1650,4716,360000,17,4,2015,0,17,2371,3066,0,0,0
4,2.5,1680,3000,2.0,0,0,3,7,1680,0,2003,0,98178,47.494,-122.279,1420,5500,290500,25,3,2015,0,12,1320,4080,0,0,1
4,3.0,2163,5883,2.0,0,0,3,7,2163,0,2006,0,98001,47.2734,-122.251,1700,10143,248000,9,5,2014,0,8,3720,8443,0,0,0
4,2.5,2280,7568,2.0,0,0,4,7,2280,0,2001,0,98056,47.5115,-122.194,2280,5312,433000,16,5,2014,0,13,5288,3032,0,0,0
2,1.0,820,4200,1.0,0,0,3,7,820,0,1980,0,98112,47.6249,-122.298,1290,4000,480000,13,4,2015,0,35,3380,2710,0,0,1
3,1.0,1330,5000,1.0,0,0,3,7,1120,210,1957,0,98125,47.7211,-122.308,1920,7790,410000,21,4,2015,0,58,3670,5870,0,1,1
4,2.75,2310,5000,2.0,0,0,3,7,2310,0,2006,0,98038,47.3614,-122.035,1980,5000,309950,5,5,2014,0,8,2690,3020,0,0,0
3,2.0,1290,7372,1.0,0,0,5,7,1290,0,1990,0,98042,47.3658,-122.085,1290,7366,253000,1,12,2014,0,24,6082,6076,0,0,0
3,1.0,1410,8925,1.0,0,0,3,7,1410,0,1958,0,98052,47.6782,-122.162,1330,8925,440000,24,4,2015,0,57,7515,7595,0,0,0
5,1.75,1240,8936,1.0,0,0,3,7,1240,0,1954,0,98006,47.5738,-122.136,1600,9341,333000,18,11,2014,0,60,7696,7741,0,0,0
3,2.25,2020,9000,2.0,0,0,3,7,2020,0,1979,0,98045,47.4487,-121.775,1460,9680,345000,24,12,2014,0,35,6980,8220,0,0,0
4,2.5,2500,5831,2.0,0,0,3,8,2500,0,2007,0,98038,47.3454,-122.039,2500,5188,350000,26,9,2014,0,7,3331,2688,0,0,0
2,1.0,790,14200,1.0,0,0,3,7,790,0,1951,0,98188,47.459,-122.285,1430,10000,198000,7,8,2014,0,63,13410,8570,0,0,1
3,1.75,2040,11294,1.0,0,0,4,7,1340,700,1952,0,98004,47.5923,-122.197,2120,9587,730000,25,7,2014,0,62,9254,7467,0,1,0
3,1.5,1430,9600,1.0,0,0,4,7,1430,0,1966,0,98059,47.4737,-122.15,1590,10240,266200,28,5,2014,0,48,8170,8650,0,0,0
4,2.5,2250,10160,2.0,0,0,5,8,2250,0,1967,0,98040,47.5645,-122.219,2660,10125,1060000,16,3,2015,0,48,7910,7465,0,0,0
3,1.75,1300,12731,1.0,0,0,3,8,1300,0,1981,0,98074,47.6236,-122.04,1700,13556,430000,23,6,2014,0,33,11431,11856,0,0,0
4,2.25,2560,9731,2.0,0,0,4,7,2560,0,1973,0,98034,47.7261,-122.246,1860,9731,650000,10,6,2014,0,41,7171,7871,0,0,0
3,2.5,2190,5071,2.0,0,0,3,8,2190,0,2004,0,98038,47.3506,-122.04,2300,5654,379900,17,3,2015,0,11,2881,3354,0,0,0
2,1.5,940,1222,2.0,0,0,3,7,860,80,2004,0,98125,47.7178,-122.318,1302,1840,325000,27,4,2015,0,11,282,538,0,1,1
4,2.25,1740,8449,1.0,0,0,4,7,1170,570,1958,0,98008,47.6079,-122.123,1980,11175,455000,6,6,2014,0,56,6709,9195,0,1,0
4,3.75,2220,3797,1.5,0,0,4,6,1330,890,1917,0,98108,47.5574,-122.315,1490,4340,392000,15,9,2014,0,97,1577,2850,0,1,1
3,1.75,1310,7811,1.0,0,0,3,7,1310,0,1976,0,98034,47.7319,-122.167,1530,7800,373000,4,9,2014,0,38,6501,6270,0,0,0
5,3.0,2710,8227,1.0,0,2,3,8,1910,800,1953,0,98199,47.6505,-122.39,2060,5400,951250,16,10,2014,0,61,5517,3340,0,1,1
3,2.0,1300,14350,1.0,0,0,3,7,1300,0,1955,2013,98006,47.5736,-122.152,1520,10670,502000,24,6,2014,58,59,13050,9150,1,0,0
2,1.0,1080,3500,1.0,0,3,3,7,1080,0,1924,0,98103,47.6667,-122.356,1790,4000,525000,23,6,2014,0,90,2420,2210,0,0,1
4,2.5,2110,11680,1.0,0,0,4,7,1420,690,1977,0,98052,47.6964,-122.118,1890,9600,580000,25,2,2015,0,38,9570,7710,0,1,0
3,2.25,1590,9425,1.0,0,0,3,7,1170,420,1985,0,98058,47.4291,-122.16,1590,9394,278000,22,12,2014,0,29,7835,7804,0,1,0
2,1.0,910,4800,1.0,0,0,4,7,910,0,1923,0,98126,47.5536,-122.377,1450,5000,422500,16,12,2014,0,91,3890,3550,0,0,1
4,2.0,1590,5400,1.0,0,2,3,7,990,600,1900,0,98119,47.637,-122.367,2190,4800,783200,9,9,2014,0,114,3810,2610,0,1,1
4,2.5,3290,6628,2.0,0,0,3,9,3290,0,2003,0,98075,47.5994,-121.975,3240,5831,715000,20,6,2014,0,11,3338,2591,0,0,0
3,2.5,2010,2212,2.0,0,0,3,8,1390,620,2014,0,98029,47.5523,-121.998,1690,1619,472217,4,8,2014,0,0,202,-71,0,1,0
3,2.5,2060,4030,2.0,0,0,3,7,2060,0,1999,0,98032,47.3909,-122.238,2060,4029,244615,28,5,2014,0,15,1970,1969,0,0,0
3,1.75,1560,14288,1.0,0,0,3,6,780,780,1944,0,98125,47.7183,-122.306,1320,8928,385000,12,12,2014,0,70,12728,7608,0,1,1
3,1.0,1120,6600,1.0,0,0,3,7,1120,0,1943,0,98105,47.6712,-122.267,1300,6600,549995,25,7,2014,0,71,5480,5300,0,0,1
4,3.75,3550,15151,2.0,0,0,3,11,3550,0,2004,0,98075,47.5888,-121.971,4340,15151,959900,16,8,2014,0,10,11601,10811,0,0,0
6,4.5,3300,7200,2.0,0,0,3,8,3300,0,1980,0,98052,47.6798,-122.104,2470,7561,510000,23,7,2014,0,34,3900,5091,0,0,0
3,1.75,2000,12669,1.0,0,3,4,7,1200,800,1965,0,98070,47.3579,-122.446,1580,12055,367000,13,8,2014,0,49,10669,10475,0,1,0
5,3.0,2680,8410,2.0,0,0,3,8,1810,870,1990,0,98058,47.4401,-122.126,1860,8410,375000,8,10,2014,0,24,5730,6550,0,1,0
2,2.25,1290,1334,3.0,0,0,3,8,1290,0,2007,0,98107,47.6719,-122.382,1350,1334,500000,12,5,2014,0,7,44,-16,0,0,1
2,2.25,1290,1334,3.0,0,0,3,8,1290,0,2007,0,98107,47.6719,-122.382,1350,1334,489000,13,1,2015,0,8,44,-16,0,0,1
3,2.0,1150,700,2.0,0,0,3,7,800,350,2000,0,98136,47.5552,-122.381,1060,1910,340000,27,4,2015,0,15,-450,850,0,1,1
3,1.75,1880,5978,1.0,0,0,5,7,940,940,1957,0,98144,47.5793,-122.294,1930,4770,562000,1,5,2015,0,58,4098,2840,0,1,1
3,2.5,2400,7478,2.0,0,0,3,9,2400,0,2002,0,98019,47.7362,-121.974,2980,8182,489950,12,9,2014,0,12,5078,5202,0,0,0
3,2.25,1920,9600,1.0,0,0,4,8,1560,360,1968,0,98052,47.6341,-122.103,2040,9600,652000,3,10,2014,0,46,7680,7560,0,1,0
4,3.25,4350,7090,2.0,0,0,3,8,2870,1480,1999,0,98042,47.3747,-122.156,2490,7266,472000,24,10,2014,0,15,2740,4776,0,1,0
4,2.5,1910,9244,1.0,0,0,4,6,1910,0,1963,0,98059,47.4918,-122.141,2590,9286,333000,12,6,2014,0,51,7334,6696,0,0,0
3,1.5,2000,7350,1.0,0,0,3,8,2000,0,1953,0,98177,47.7061,-122.368,1890,6960,560000,30,5,2014,0,61,5350,5070,0,0,1
5,2.25,3480,9200,2.0,0,0,3,8,3480,0,1979,0,98006,47.5585,-122.153,3130,9200,860000,10,7,2014,0,35,5720,6070,0,0,0
4,3.0,2820,11500,2.0,0,0,3,10,2820,0,1991,0,98075,47.5826,-122.028,2770,9694,692500,5,12,2014,0,23,8680,6924,0,0,0
4,1.75,2710,11400,1.0,0,0,4,9,1430,1280,1976,0,98006,47.561,-122.153,2640,11000,925000,12,8,2014,0,38,8690,8360,0,1,0
3,2.25,2080,2856,1.5,0,0,3,7,1550,530,2003,0,98042,47.4198,-122.158,2080,2275,267500,21,10,2014,0,11,776,195,0,1,0
4,2.5,2200,6018,2.0,0,0,3,8,2200,0,2010,0,98019,47.7338,-121.966,2480,5899,396800,14,7,2014,0,4,3818,3419,0,0,0
4,1.5,1180,8058,1.0,0,0,5,7,1180,0,1969,0,98092,47.2966,-122.19,1800,9348,220000,9,4,2015,0,46,6878,7548,0,0,0
3,2.0,1460,10311,1.0,0,0,4,7,1460,0,1975,0,98052,47.6771,-122.156,1690,9679,455500,27,5,2014,0,39,8851,7989,0,0,0
3,1.75,2110,11250,1.0,0,0,4,8,2110,0,1961,0,98040,47.5402,-122.216,2560,10992,743000,12,6,2014,0,53,9140,8432,0,0,0
4,1.5,1790,17925,1.0,0,0,4,6,1790,0,1951,0,98155,47.7501,-122.302,1660,15165,338000,5,12,2014,0,63,16135,13505,0,0,1
3,1.75,1340,13115,1.0,0,0,3,7,1340,0,1978,0,98045,47.5021,-121.77,1370,10800,332000,3,10,2014,0,36,11775,9430,0,0,0
3,1.0,2460,4000,1.5,0,0,4,7,1370,1090,1918,0,98112,47.6268,-122.297,1680,4000,563225,23,1,2015,0,97,1540,2320,0,1,1
2,1.0,1240,5000,1.0,0,0,3,7,1000,240,1920,0,98103,47.6634,-122.351,1480,3500,645000,13,10,2014,0,94,3760,2020,0,1,1
3,2.5,2750,16000,2.0,0,0,4,9,2560,190,1981,0,98033,47.693,-122.187,2370,11279,739000,30,12,2014,0,33,13250,8909,0,1,0
3,2.5,2530,13446,2.0,0,0,3,9,2530,0,1993,0,98019,47.7345,-121.961,2450,13446,435000,1,7,2014,0,21,10916,10996,0,0,0
3,2.25,3200,3800,2.0,0,0,5,9,2650,550,1914,0,98102,47.638,-122.317,2400,3900,995000,29,7,2014,0,100,600,1500,0,1,1
4,2.75,2020,7357,1.0,0,0,3,7,1350,670,1986,0,98034,47.7145,-122.225,1690,7804,520000,20,3,2015,0,29,5337,6114,0,1,0
3,1.75,2350,7641,1.0,0,0,3,7,1510,840,1978,0,98034,47.7307,-122.219,2190,7500,440000,7,10,2014,0,36,5291,5310,0,1,0
3,1.5,1690,6010,1.0,0,0,3,7,1230,460,1946,0,98115,47.6955,-122.291,1690,5418,440000,17,9,2014,0,68,4320,3728,0,1,1
3,1.0,1280,3900,1.0,0,0,4,7,1280,0,1921,0,98103,47.6545,-122.336,2020,4560,738000,24,3,2015,0,94,2620,2540,0,0,1
3,1.5,1170,9848,1.0,0,0,3,7,1170,0,1963,0,98028,47.7612,-122.234,2220,5542,250000,3,4,2015,0,52,8678,3322,0,0,0
4,2.25,2700,8580,2.0,0,0,3,8,2700,0,1992,0,98022,47.2087,-122.009,2420,8580,338150,2,9,2014,0,22,5880,6160,0,0,0
3,2.25,1800,7371,1.0,0,0,3,7,1280,520,1979,0,98072,47.7584,-122.145,1960,7675,425000,2,9,2014,0,35,5571,5715,0,1,0
3,1.0,1120,9656,1.0,0,0,5,7,1120,0,1955,0,98006,47.567,-122.139,1720,9908,435000,13,10,2014,0,59,8536,8188,0,0,0
5,1.5,1900,10226,1.0,0,0,3,7,1130,770,1961,0,98034,47.7226,-122.227,1690,10227,415000,27,5,2014,0,53,8326,8537,0,1,0
2,2.5,1350,944,2.0,0,0,3,9,870,480,2004,0,98116,47.5591,-122.385,1440,1350,439000,6,10,2014,0,10,-406,-90,0,1,1
5,1.0,1410,6400,1.0,0,0,5,7,960,450,1955,0,98198,47.4207,-122.334,1400,6500,295832,27,5,2014,0,59,4990,5100,0,1,1
3,1.75,1560,9514,1.0,0,0,4,7,1560,0,1967,0,98031,47.4088,-122.21,1550,9600,285000,31,10,2014,0,47,7954,8050,0,0,0
3,1.5,1090,5003,1.0,0,0,3,7,1090,0,1962,0,98125,47.703,-122.321,1540,5279,350000,30,4,2015,0,53,3913,3739,0,0,1
2,2.75,1465,972,2.0,0,0,3,7,1050,415,2006,0,98112,47.621,-122.298,1480,1430,489000,21,10,2014,0,8,-493,-50,0,1,1
3,2.25,1790,6930,1.0,0,0,3,7,1390,400,1974,0,98003,47.3536,-122.317,1810,7420,304500,24,11,2014,0,40,5140,5610,0,1,0
3,1.5,1300,7313,1.0,0,0,4,7,1300,0,1968,0,98055,47.4568,-122.21,1770,8075,288000,17,3,2015,0,47,6013,6305,0,0,0
3,1.75,1920,9512,1.0,0,0,3,8,1440,480,1980,0,98011,47.7606,-122.167,1820,9512,417000,11,2,2015,0,35,7592,7692,0,1,0
3,3.0,1420,991,2.0,0,0,3,8,1040,380,2005,0,98102,47.6408,-122.327,1500,1301,615000,1,4,2015,0,10,-429,-199,0,1,1
5,3.5,3760,4857,2.0,0,3,3,9,2820,940,2004,0,98072,47.7398,-122.167,3000,5693,730000,18,9,2014,0,10,1097,2693,0,1,0
2,1.0,930,3447,1.0,0,0,4,8,930,0,1978,0,98198,47.3822,-122.318,1160,3447,178500,21,8,2014,0,36,2517,2287,0,0,1
4,2.0,1580,9600,1.0,0,0,5,7,1050,530,1965,0,98198,47.4091,-122.313,1710,9600,300000,15,8,2014,0,49,8020,7890,0,1,1
4,2.5,2170,8518,1.0,0,3,3,7,1350,820,1955,0,98178,47.5073,-122.234,1880,7680,415000,23,6,2014,0,59,6348,5800,0,1,1
3,1.75,2040,15695,1.0,0,0,4,8,2040,0,1959,0,98166,47.4155,-122.339,2280,14400,452500,22,8,2014,0,55,13655,12120,0,0,1
4,2.75,3430,15877,1.0,0,4,3,11,3430,0,2005,0,98065,47.5364,-121.856,4080,14577,1010000,14,8,2014,0,9,12447,10497,0,0,0
4,2.5,2160,7000,2.0,0,0,4,9,2160,0,1989,0,98029,47.5659,-122.013,2300,7440,653000,1,12,2014,0,25,4840,5140,0,0,0
4,2.25,2060,5649,1.0,0,0,5,8,1360,700,1941,0,98199,47.6496,-122.407,2060,5626,715000,14,5,2014,0,73,3589,3566,0,1,1
3,1.75,1410,4080,1.5,0,0,4,7,1410,0,1927,0,98105,47.6695,-122.32,1820,4080,541000,28,8,2014,0,87,2670,2260,0,0,1
4,1.5,1850,7547,1.5,0,0,4,7,1850,0,1960,0,98198,47.3714,-122.309,1730,7577,245000,9,12,2014,0,54,5697,5847,0,0,1
2,1.0,1370,10038,1.5,0,0,4,7,1370,0,1922,0,98133,47.719,-122.339,1610,8822,547000,17,2,2015,0,93,8668,7212,0,0,1
5,2.75,3330,12408,1.0,0,0,3,10,1740,1590,1976,0,98074,47.6318,-122.058,2780,12000,750000,2,4,2015,0,39,9078,9220,0,1,0
5,2.5,1970,12375,1.0,0,0,3,8,1570,400,1959,0,98133,47.7412,-122.354,1970,8941,575000,26,1,2015,0,56,10405,6971,0,1,1
3,1.75,1310,8670,1.0,0,0,4,6,1310,0,1984,0,98092,47.3156,-122.186,2622,7191,216000,13,8,2014,0,30,7360,4569,0,0,0
3,1.75,1640,4579,1.0,0,0,4,6,1640,0,1916,0,98133,47.7061,-122.352,1580,5040,443000,22,9,2014,0,98,2939,3460,0,0,1
4,2.25,1600,6202,2.0,0,0,4,7,1600,0,1986,0,98038,47.3784,-122.046,1530,6298,257700,3,11,2014,0,28,4602,4768,0,0,0
3,1.0,1230,9440,1.0,0,0,3,7,1230,0,1978,0,98045,47.4657,-121.747,1230,10296,278000,14,4,2015,0,37,8210,9066,0,0,0
3,2.5,2240,3691,2.0,0,0,3,7,2240,0,2003,0,98092,47.3364,-122.169,2619,3691,300000,5,11,2014,0,11,1451,1072,0,0,0
3,2.5,2190,7904,2.0,0,0,3,8,2190,0,1995,0,98092,47.2617,-122.21,2190,7669,269100,13,2,2015,0,20,5714,5479,0,0,0
3,1.0,990,10752,1.5,0,0,4,7,990,0,1929,0,98133,47.7648,-122.35,1820,7600,402500,18,8,2014,0,85,9762,5780,0,0,1
2,1.5,1010,7719,2.0,0,0,3,7,1010,0,1981,0,98056,47.5128,-122.189,1210,7719,306888,10,6,2014,0,33,6709,6509,0,0,0
4,2.5,2920,14210,2.0,0,0,4,10,2920,0,1978,0,98007,47.6196,-122.15,2840,13702,795000,26,12,2014,0,36,11290,10862,0,0,0
4,2.5,2310,5573,2.0,0,0,4,9,2310,0,2003,0,98056,47.5197,-122.2,2310,6189,525000,4,8,2014,0,11,3263,3879,0,0,0
2,1.0,1220,6000,1.0,0,0,3,6,880,340,1938,0,98118,47.5647,-122.27,1220,6840,452000,29,8,2014,0,76,4780,5620,0,1,1
3,2.25,1550,5401,2.0,0,0,3,7,1550,0,2000,0,98019,47.737,-121.967,1740,4485,350000,13,4,2015,0,15,3851,2745,0,0,0
4,2.5,2070,6180,2.0,0,0,3,8,2070,0,2007,0,98056,47.4915,-122.183,1250,6018,410000,9,4,2015,0,8,4110,4768,0,0,0
3,1.75,2060,3600,1.5,0,0,3,7,1180,880,1905,1985,98119,47.6389,-122.371,1730,2475,595000,13,11,2014,80,109,1540,745,1,1,1
3,2.5,1690,4851,2.0,0,0,3,7,1690,0,2004,0,98053,47.6795,-122.034,2330,4851,499000,7,4,2015,0,11,3161,2521,0,0,0
4,2.5,2550,7555,2.0,0,0,3,8,2550,0,2001,0,98001,47.2614,-122.29,2550,6800,340000,22,10,2014,0,13,5005,4250,0,0,0
5,3.25,3370,7947,2.0,0,0,3,10,3370,0,2001,0,98033,47.6906,-122.202,2040,7900,1070000,25,6,2014,0,13,4577,5860,0,0,0
4,2.5,2382,5899,2.0,0,0,3,8,2382,0,2011,0,98003,47.2793,-122.295,2382,5897,345000,19,8,2014,0,3,3517,3515,0,0,0
3,2.25,1620,7566,2.0,0,0,3,7,1620,0,1990,0,98038,47.3566,-122.039,1470,7566,280500,18,2,2015,0,25,5946,6096,0,0,0
3,1.0,1140,6120,1.5,0,0,3,7,1140,0,1926,0,98115,47.6822,-122.309,1800,4080,704000,25,2,2015,0,89,4980,2280,0,0,1
3,1.5,1900,7584,1.0,0,0,5,7,1900,0,1962,0,98056,47.5091,-122.19,1410,7584,335000,7,8,2014,0,52,5684,6174,0,0,0
4,3.0,3370,7920,1.0,0,3,3,10,1860,1510,1988,0,98117,47.6773,-122.403,2730,7380,1330000,23,5,2014,0,26,4550,4650,0,1,1
3,2.75,2300,8000,1.0,0,0,3,7,1430,870,1965,0,98003,47.3293,-122.306,2070,10200,420000,11,8,2014,0,49,5700,8130,0,1,0
4,2.0,2040,5050,1.0,0,0,5,7,1160,880,1937,0,98115,47.6885,-122.324,2040,5050,705000,20,2,2015,0,78,3010,3010,0,1,1
4,1.75,1840,10528,1.0,0,0,3,7,1210,630,1990,0,98023,47.2987,-122.385,1620,9331,274900,4,11,2014,0,24,8688,7711,0,1,0
4,2.5,2860,3345,2.0,0,0,3,8,2190,670,2004,0,98072,47.7735,-122.158,2860,3596,499950,2,5,2014,0,10,485,736,0,1,0
3,1.5,1400,7550,1.0,0,0,4,7,1400,0,1953,0,98133,47.7566,-122.337,1730,7562,415250,18,3,2015,0,62,6150,5832,0,0,1
3,1.0,990,7520,1.0,0,0,4,7,990,0,1958,0,98002,47.285,-122.207,990,7440,222000,17,3,2015,0,57,6530,6450,0,0,0
3,2.5,1640,5707,2.0,0,0,3,7,1640,0,1995,0,98031,47.4016,-122.209,1850,5827,300000,30,4,2015,0,20,4067,3977,0,0,0
3,1.75,2820,8879,1.0,0,0,5,7,1540,1280,1920,1957,98146,47.5094,-122.376,1640,7850,456700,18,11,2014,37,94,6059,6210,1,1,1
3,2.75,1970,5200,1.5,0,3,3,8,1970,0,1915,2002,98136,47.5374,-122.388,2140,5200,925500,19,3,2015,87,100,3230,3060,1,0,1
5,2.5,2840,15598,1.0,0,0,4,8,1470,1370,1975,0,98059,47.4693,-122.117,2570,14930,375000,23,7,2014,0,39,12758,12360,0,1,0
3,2.5,2370,15375,2.0,0,2,3,9,2370,0,1993,0,98042,47.3803,-122.147,2450,9800,420000,14,10,2014,0,21,13005,7350,0,0,0
3,2.5,2610,7301,2.0,0,0,3,8,2610,0,2004,0,98072,47.7614,-122.139,2460,7181,575000,17,10,2014,0,10,4691,4721,0,0,0
3,2.0,1340,1951,1.0,0,0,3,6,670,670,1915,0,98144,47.5763,-122.309,1520,2248,335000,28,4,2015,0,100,611,728,0,1,1
4,2.0,1300,7200,1.0,0,0,3,7,1300,0,1958,0,98122,47.6169,-122.294,1540,6600,428000,18,2,2015,0,57,5900,5060,0,0,1
3,3.0,2630,4896,2.0,0,0,3,9,2630,0,2006,0,98052,47.6932,-122.133,2880,4972,738000,27,6,2014,0,8,2266,2092,0,0,0
5,1.75,1960,3748,1.0,0,0,3,7,980,980,1965,0,98133,47.7027,-122.349,1410,3844,415000,19,8,2014,0,49,1788,2434,0,1,1
3,1.0,1090,6125,1.0,0,0,4,6,790,300,1945,0,98126,47.5343,-122.37,1050,6125,392000,25,8,2014,0,69,5035,5075,0,1,1
2,1.0,1550,4600,1.0,0,0,4,7,1050,500,1941,0,98117,47.686,-122.384,1550,4600,555000,6,11,2014,0,73,3050,3050,0,1,1
3,2.5,1770,2677,2.0,0,0,3,7,1770,0,2005,0,98055,47.4339,-122.194,1550,1798,260000,6,3,2015,0,10,907,248,0,0,0
3,1.0,1390,10500,1.5,0,0,3,6,1390,0,1940,0,98024,47.567,-121.893,1350,9800,392500,9,3,2015,0,75,9110,8450,0,0,0
3,2.5,2979,17313,2.0,0,2,3,11,2979,0,1993,0,98006,47.5503,-122.118,3890,14797,912000,1,8,2014,0,21,14334,10907,0,0,0
2,1.0,830,7609,1.0,0,0,3,6,830,0,1943,0,98146,47.5057,-122.348,1170,7609,135000,18,11,2014,0,71,6779,6439,0,0,1
3,1.5,1360,7488,1.0,0,0,4,7,1050,310,1975,0,98001,47.3314,-122.275,1580,7508,238000,29,12,2014,0,39,6128,5928,0,1,0
4,2.0,1650,5974,1.0,0,0,5,7,860,790,1972,0,98178,47.5008,-122.257,1940,6001,251000,1,10,2014,0,42,4324,4061,0,1,1
2,1.75,1510,5319,2.0,0,0,4,8,1510,0,1978,0,98052,47.6647,-122.13,1740,6160,406500,14,7,2014,0,36,3809,4420,0,0,0
4,2.25,3010,10925,2.0,0,0,4,9,3010,0,1988,0,98092,47.3326,-122.201,2690,10925,433495,12,3,2015,0,27,7915,8235,0,0,0
3,2.25,1510,6071,1.0,0,0,4,7,1150,360,1985,0,98042,47.3619,-122.077,1510,7271,265000,24,12,2014,0,29,4561,5761,0,1,0
3,1.75,1950,7260,1.0,0,0,3,8,1520,430,1957,0,98133,47.7187,-122.33,1950,7548,360000,6,2,2015,0,58,5310,5598,0,1,1
4,1.0,1800,12485,1.0,0,0,5,7,950,850,1955,0,98006,47.5729,-122.147,1290,9840,425000,17,7,2014,0,59,10685,8550,0,1,0
2,2.75,2810,11205,1.0,0,0,3,7,1510,1300,1968,0,98178,47.4869,-122.243,2520,13000,450000,27,3,2015,0,47,8395,10480,0,1,1
3,1.75,1760,8266,1.0,0,0,5,7,1760,0,1954,0,98133,47.7708,-122.339,1400,8519,449900,16,3,2015,0,61,6506,7119,0,0,1
4,2.5,2040,5875,2.0,0,0,3,8,2040,0,2004,0,98056,47.5051,-122.17,2230,5459,345000,17,10,2014,0,10,3835,3229,0,0,0
3,1.75,1530,7650,1.0,0,0,4,8,1530,0,1977,0,98058,47.4435,-122.128,1850,6804,317000,5,8,2014,0,37,6120,4954,0,0,0
3,1.5,1810,3880,1.5,0,0,4,8,1310,500,1929,0,98117,47.6835,-122.392,1400,3880,585000,7,5,2015,0,86,2070,2480,0,1,1
3,1.75,1180,14292,1.0,0,0,3,7,1180,0,1981,0,98045,47.4818,-121.733,1480,14400,455000,18,6,2014,0,33,13112,12920,0,0,0
4,2.25,2250,3463,2.0,0,0,4,8,2250,0,1968,0,98052,47.6324,-122.106,1850,2811,497000,20,8,2014,0,46,1213,961,0,0,0
3,1.75,1070,6315,1.0,0,0,3,7,1070,0,1992,0,98023,47.2803,-122.356,1520,5707,226750,22,4,2015,0,23,5245,4187,0,0,0
4,2.0,1820,7102,1.0,0,0,3,7,1220,600,1950,0,98155,47.7447,-122.324,1650,8184,385000,19,8,2014,0,64,5282,6534,0,1,1
3,0.75,1080,5025,1.0,0,0,3,5,1080,0,1948,0,98146,47.4936,-122.335,1370,6000,205000,11,12,2014,0,66,3945,4630,0,0,1
4,2.5,2760,13093,2.0,0,0,4,9,2760,0,1989,0,98075,47.5845,-122.06,2810,13545,745000,29,9,2014,0,25,10333,10735,0,0,0
4,2.5,2550,4770,2.0,0,0,3,8,2550,0,2005,0,98038,47.3526,-122.0,2380,4590,371000,20,6,2014,0,9,2220,2210,0,0,0
4,2.5,2080,8504,2.0,0,0,3,8,2080,0,1991,0,98029,47.5703,-121.998,2000,6773,545000,29,8,2014,0,23,6424,4773,0,0,0
3,1.0,1280,5460,1.5,0,0,4,7,1280,0,1931,0,98133,47.7321,-122.334,1390,5500,443000,8,5,2015,0,84,4180,4110,0,0,1
2,1.0,950,6350,1.0,0,0,3,7,950,0,1951,0,98106,47.528,-122.352,1080,7620,287000,18,3,2015,0,64,5400,6540,0,0,1
3,1.0,1050,7577,1.0,0,0,3,7,1050,0,1983,0,98023,47.2891,-122.357,1430,7245,194000,24,6,2014,0,31,6527,5815,0,0,0
3,1.0,1800,7650,1.0,0,0,5,7,1800,0,1957,0,98056,47.4922,-122.178,1230,7650,265000,29,6,2014,0,57,5850,6420,0,0,0
4,2.75,3840,10004,1.0,0,2,4,9,2110,1730,1963,0,98040,47.5606,-122.225,3500,12118,1140000,8,4,2015,0,52,6164,8618,0,1,0
4,3.25,3674,12793,2.0,0,1,3,9,3674,0,1987,0,98166,47.4357,-122.343,3220,13100,699950,8,5,2015,0,28,9119,9880,0,0,1
4,1.0,1710,7000,1.5,0,0,3,7,1710,0,1950,0,98125,47.7037,-122.293,2030,7938,433000,15,10,2014,0,64,5290,5908,0,0,1
2,1.75,910,2693,1.0,0,0,3,6,910,0,2003,0,98038,47.3493,-122.025,1360,2693,200000,16,10,2014,0,11,1783,1333,0,0,0
4,2.75,2340,11034,1.0,0,0,3,8,1720,620,1967,0,98155,47.7686,-122.278,2370,11941,440000,2,6,2014,0,47,8694,9571,0,1,1
3,1.5,1510,8360,1.0,0,0,3,7,1120,390,1960,0,98007,47.6119,-122.133,1700,8360,400000,13,11,2014,0,54,6850,6660,0,1,0
4,2.5,2630,15000,2.0,0,0,5,8,2630,0,1962,0,98027,47.5262,-122.028,1770,8700,589000,14,10,2014,0,52,12370,6930,0,0,0
3,1.0,940,3000,1.5,0,0,3,7,940,0,1903,0,98122,47.6033,-122.3,1210,3500,520000,2,1,2015,0,112,2060,2290,0,0,1
2,2.25,1370,1248,2.0,0,0,3,7,1200,170,2000,0,98102,47.6399,-122.32,1800,3360,555000,23,4,2015,0,15,-122,1560,0,1,1
3,2.5,2480,5082,2.0,0,0,3,7,2480,0,2004,0,98065,47.5297,-121.846,2480,5874,470000,9,3,2015,0,11,2602,3394,0,0,0
2,1.5,1068,1158,2.0,0,0,3,7,1068,0,1990,0,98028,47.753,-122.244,1078,1278,207000,29,12,2014,0,24,90,200,0,0,0
4,2.75,2390,9650,1.0,0,2,3,8,1620,770,1976,0,98003,47.3438,-122.322,2390,10000,379750,13,11,2014,0,38,7260,7610,0,1,0
4,1.75,2170,4600,1.0,0,0,3,7,1270,900,1950,0,98117,47.6894,-122.384,1750,4000,709000,7,5,2015,0,65,2430,2250,0,1,1
3,2.5,1520,9864,1.0,0,0,3,7,1160,360,1993,0,98092,47.3186,-122.171,1580,7425,240000,23,9,2014,0,21,8344,5845,0,1,0
4,1.5,2210,10497,1.0,0,0,4,8,1650,560,1953,0,98166,47.4321,-122.347,1840,12697,445500,4,2,2015,0,62,8287,10857,0,1,1
5,2.5,3200,7863,1.0,0,3,5,8,1600,1600,1959,0,98199,47.6398,-122.39,2640,7680,1310000,9,9,2014,0,55,4663,5040,0,1,1
3,1.5,1160,10125,1.0,0,0,4,7,1160,0,1959,0,98059,47.4919,-122.151,1440,10018,210000,24,3,2015,0,56,8965,8578,0,0,0
4,2.5,2670,5895,2.0,0,0,3,8,2670,0,1999,0,98074,47.6066,-122.016,2820,6531,603000,11,8,2014,0,15,3225,3711,0,0,0
3,2.5,2520,10012,2.0,0,0,3,10,2520,0,1987,0,98074,47.6295,-122.051,2680,10071,720000,7,4,2015,0,28,7492,7391,0,0,0
2,1.0,760,5500,1.5,0,0,3,5,760,0,1947,0,98168,47.5045,-122.329,1040,5515,92000,16,6,2014,0,67,4740,4475,0,0,1
3,1.75,1310,5000,2.0,0,0,4,7,1310,0,1901,0,98107,47.6722,-122.379,1270,4750,600000,26,1,2015,0,114,3690,3480,0,0,1
4,2.5,2750,13950,1.0,0,3,4,8,1380,1370,1948,0,98146,47.4938,-122.364,2460,13950,725000,8,4,2015,0,67,11200,11490,0,1,1
5,2.25,1790,10300,1.0,0,0,3,7,1270,520,1961,0,98155,47.7718,-122.292,1790,10300,409950,10,12,2014,0,53,8510,8510,0,1,1
3,2.5,1790,7167,2.0,0,0,3,8,1790,0,1989,0,98074,47.6176,-122.045,1680,7418,515000,6,5,2014,0,25,5377,5738,0,0,0
4,2.5,2400,11640,1.0,0,0,5,8,1800,600,1968,0,98058,47.4485,-122.139,2440,10823,495000,12,5,2015,0,47,9240,8383,0,1,0
4,2.25,2420,10200,2.0,0,0,4,9,2420,0,1973,0,98040,47.5336,-122.225,2390,10200,998000,24,6,2014,0,41,7780,7810,0,0,0
3,1.75,1710,8767,1.0,0,0,4,8,1710,0,1986,0,98033,47.6945,-122.188,2050,9200,630000,9,7,2014,0,28,7057,7150,0,0,0
3,1.75,2000,7480,1.0,0,0,3,8,1320,680,1972,0,98177,47.7734,-122.359,2000,8610,410000,1,8,2014,0,42,5480,6610,0,1,1
3,2.25,1580,11580,1.0,0,0,4,8,1580,0,1979,0,98006,47.5503,-122.155,2630,10009,602000,19,8,2014,0,35,10000,7379,0,0,0
4,2.75,2310,10232,1.0,0,0,5,8,1310,1000,1980,0,98006,47.5515,-122.153,2820,9886,750000,12,11,2014,0,34,7922,7066,0,1,0
4,3.0,3580,9316,2.5,0,0,3,10,2370,1210,1991,0,98007,47.595,-122.133,2580,9242,711600,8,7,2014,0,23,5736,6662,0,1,0
4,4.0,4320,8709,2.0,0,0,3,11,3190,1130,2006,0,98027,47.5369,-122.07,4010,8321,1050000,25,8,2014,0,8,4389,4311,0,1,0
4,2.5,3220,18618,2.0,0,1,3,10,3220,0,1991,0,98056,47.5326,-122.181,2650,11896,710000,4,2,2015,0,24,15398,9246,0,0,0
3,2.0,1660,13085,1.0,0,0,3,7,1010,650,1985,0,98001,47.3298,-122.277,1660,7778,250000,4,12,2014,0,29,11425,6118,0,1,0
4,1.75,2420,8400,1.0,0,0,5,7,1620,800,1964,0,98056,47.5017,-122.165,1660,8400,350000,15,10,2014,0,50,5980,6740,0,1,0
2,1.0,830,7200,1.0,0,0,2,6,830,0,1920,0,98118,47.5604,-122.275,1150,6600,200000,16,1,2015,0,95,6370,5450,0,0,1
4,2.25,1710,7000,1.0,0,0,4,7,1040,670,1972,0,98034,47.719,-122.217,1780,6500,450000,30,10,2014,0,42,5290,4720,0,1,0
5,2.5,2600,4641,2.0,0,0,3,7,2600,0,2005,0,98058,47.4325,-122.146,2330,4589,316000,1,8,2014,0,9,2041,2259,0,0,0
1,1.0,670,4920,1.0,0,0,3,5,670,0,1920,0,98126,47.5342,-122.373,1050,4920,310000,16,10,2014,0,94,4250,3870,0,0,1
3,1.5,1500,11975,1.0,0,0,4,7,1500,0,1970,0,98045,47.4658,-121.758,1510,13875,392000,23,2,2015,0,45,10475,12365,0,0,0
3,3.25,1460,1254,3.0,0,0,3,8,1460,0,2000,0,98103,47.6535,-122.353,1400,1255,521000,6,10,2014,0,14,-206,-145,0,0,1
2,2.0,1540,7110,1.0,0,0,3,7,960,580,1949,0,98117,47.6932,-122.395,1860,7065,495000,22,8,2014,0,65,5570,5205,0,1,1
3,1.75,1250,8084,1.0,0,0,4,7,1250,0,1967,0,98001,47.3364,-122.276,1340,7680,209000,21,11,2014,0,47,6834,6340,0,0,0
4,2.0,2230,9900,1.5,0,0,5,9,2230,0,1959,0,98005,47.5979,-122.173,2510,11041,809950,6,6,2014,0,55,7670,8531,0,0,0
4,2.5,2400,7292,1.0,0,0,3,8,1530,870,1980,0,98133,47.7749,-122.339,1710,7909,415000,12,3,2015,0,35,4892,6199,0,1,1
2,2.0,1830,3600,1.0,0,0,4,7,1230,600,1926,0,98109,47.6359,-122.351,2020,3600,825000,11,9,2014,0,88,1770,1580,0,1,1
3,2.25,1480,1384,3.0,0,0,3,8,1480,0,2008,0,98103,47.691,-122.342,1310,1329,436000,23,2,2015,0,7,-96,19,0,0,1
4,2.5,2620,8331,2.0,0,0,3,9,2620,0,1991,0,98058,47.4357,-122.159,2760,8174,460000,8,7,2014,0,23,5711,5414,0,0,0
3,1.0,1300,5782,1.0,0,0,4,6,1300,0,1959,0,98065,47.524,-121.821,1020,7200,281000,14,7,2014,0,55,4482,6180,0,0,0
4,1.5,3120,7680,1.0,0,3,3,8,1660,1460,1956,0,98199,47.646,-122.39,2900,7680,976000,25,8,2014,0,58,4560,4780,0,1,1
4,2.5,2400,10364,2.0,0,0,3,8,2400,0,1995,0,98045,47.4832,-121.799,2390,9918,485000,20,4,2015,0,20,7964,7528,0,0,0
3,2.5,1430,9240,2.0,0,0,3,7,1430,0,1984,0,98074,47.6258,-122.058,1480,8125,429000,25,7,2014,0,30,7810,6645,0,0,0
3,2.5,2480,7428,2.0,0,0,3,9,2480,0,1990,0,98006,47.5489,-122.185,2600,8322,729000,4,3,2015,0,25,4948,5722,0,0,0
3,2.5,2280,4757,2.0,0,0,3,8,2280,0,2003,0,98075,47.5901,-122.018,2280,4534,625000,9,4,2015,0,12,2477,2254,0,0,0
3,1.75,1390,9328,1.0,0,0,4,7,1390,0,1987,0,98092,47.2766,-122.146,1550,8374,218500,16,1,2015,0,28,7938,6824,0,0,0
3,1.0,1030,8395,1.0,0,0,4,7,1030,0,1960,0,98023,47.3322,-122.337,1370,9380,175000,6,2,2015,0,55,7365,8010,0,0,0
3,1.0,1120,8200,1.0,0,0,4,7,1120,0,1938,0,98125,47.7254,-122.29,1820,7205,442500,5,2,2015,0,77,7080,5385,0,0,1
3,2.0,1300,3000,2.0,0,0,3,7,1300,0,1986,0,98115,47.6728,-122.325,1670,4500,480000,21,3,2015,0,29,1700,2830,0,0,1
3,2.25,2410,9668,1.0,0,1,4,8,1540,870,1965,0,98117,47.6996,-122.391,2510,5250,715500,8,10,2014,0,49,7258,2740,0,1,1
3,1.75,1470,7350,1.0,0,0,3,8,1470,0,1963,0,98052,47.6687,-122.154,1470,7350,432500,20,11,2014,0,51,5880,5880,0,0,0
5,2.75,2910,13332,2.0,0,0,4,8,2910,0,1940,1991,98146,47.4977,-122.359,1760,8900,605000,14,11,2014,51,74,10422,7140,1,0,1
4,4.0,5000,12941,3.0,0,2,3,12,5000,0,2002,0,98006,47.55,-122.103,4560,12941,1690000,13,1,2015,0,13,7941,8381,0,0,0
3,2.25,1690,12662,1.0,0,0,5,7,1090,600,1982,0,98178,47.4972,-122.264,1950,9642,318000,10,2,2015,0,33,10972,7692,0,1,1
2,1.0,1000,7228,1.0,0,0,4,7,1000,0,1947,0,98133,47.7294,-122.352,1100,7228,311300,16,10,2014,0,67,6228,6128,0,0,1
5,2.75,2400,7904,1.0,0,0,3,7,1450,950,1992,0,98188,47.4683,-122.263,2400,7475,325000,15,4,2015,0,23,5504,5075,0,1,1
5,3.5,3330,3705,2.0,0,0,3,9,2610,720,2008,0,98006,47.5567,-122.124,2810,3971,795000,17,11,2014,0,6,375,1161,0,1,0
4,2.25,2060,10358,1.0,0,0,4,8,1320,740,1962,0,98006,47.5478,-122.174,2060,9676,558000,19,6,2014,0,52,8298,7616,0,1,0
4,2.5,2350,7245,2.0,0,0,3,8,2350,0,1993,0,98074,47.6318,-122.023,2350,9419,598850,18,11,2014,0,21,4895,7069,0,0,0
3,2.5,2180,9722,2.0,0,0,3,8,2180,0,1994,0,98056,47.527,-122.173,2440,9722,515700,23,10,2014,0,20,7542,7282,0,0,0
3,2.5,1870,5013,2.0,0,0,3,8,1870,0,2003,0,98011,47.7552,-122.221,2040,5555,458000,20,6,2014,0,11,3143,3515,0,0,0
3,2.25,3530,13000,2.5,0,0,4,10,3530,0,1985,0,98042,47.3823,-122.159,2960,13000,583500,24,2,2015,0,30,9470,10040,0,0,0
4,2.5,2460,4166,2.0,0,0,3,9,2460,0,2003,0,98034,47.7072,-122.232,2460,4964,653750,23,7,2014,0,11,1706,2504,0,0,0
3,2.5,1650,4725,2.0,0,0,3,8,1650,0,2011,0,98038,47.3548,-122.055,2000,4725,299000,11,7,2014,0,3,3075,2725,0,0,0
3,2.75,3176,13391,2.0,0,3,4,9,2726,450,1985,0,98198,47.3429,-122.33,3470,12779,819000,8,7,2014,0,29,10215,9309,0,1,1
4,2.25,2420,9000,1.0,0,4,5,9,2000,420,1967,0,98146,47.4884,-122.363,2400,9035,945000,18,7,2014,0,47,6580,6635,0,1,1
4,2.5,2260,9696,1.0,0,0,3,9,2260,0,1983,0,98074,47.643,-122.066,2400,12111,608700,6,11,2014,0,31,7436,9711,0,0,0
4,2.0,2380,6122,1.0,0,2,4,8,1310,1070,1949,0,98199,47.6506,-122.405,1810,5202,812000,9,5,2015,0,66,3742,3392,0,1,1
5,2.5,3400,8970,1.0,0,0,4,8,1700,1700,1959,0,98133,47.7358,-122.335,1890,8475,464000,13,5,2014,0,55,5570,6585,0,1,1
4,2.5,2672,4297,2.0,0,0,3,8,2020,652,2005,0,98115,47.6955,-122.289,1720,6120,700000,3,12,2014,0,9,1625,4400,0,1,1
3,1.0,1180,4219,1.0,0,0,3,7,1060,120,1939,0,98117,47.6867,-122.378,1630,4219,435000,16,10,2014,0,75,3039,2589,0,1,1
3,1.5,1810,14400,1.0,0,0,4,7,1810,0,1954,0,98001,47.2887,-122.269,1710,12000,229500,7,10,2014,0,60,12590,10290,0,0,0
3,2.25,1450,13439,1.0,0,0,4,7,1180,270,1963,0,98003,47.2811,-122.299,1520,12348,265000,3,11,2014,0,51,11989,10828,0,1,0
3,2.5,2650,9380,1.0,0,0,5,8,1680,970,1975,0,98155,47.7756,-122.273,2310,9600,590000,9,7,2014,0,39,6730,7290,0,1,1
2,0.75,850,7710,1.0,0,2,5,6,550,300,1909,0,98108,47.5588,-122.301,2500,6022,360000,21,5,2014,0,105,6860,3522,0,1,1
4,2.0,1820,7200,1.0,0,0,3,7,1300,520,1976,0,98136,47.5161,-122.388,1770,8149,548500,6,4,2015,0,39,5380,6379,0,1,1
3,1.75,1960,4788,1.0,0,0,4,7,1090,870,1920,0,98115,47.6746,-122.312,1960,3960,599000,7,5,2014,0,94,2828,2000,0,1,1
3,1.75,1320,6600,1.0,0,0,3,7,1320,0,1988,0,98168,47.4838,-122.33,1070,6594,292000,8,12,2014,0,26,5280,5524,0,0,1
3,1.5,2210,6500,1.0,0,0,4,7,1030,1180,1912,0,98136,47.5434,-122.388,1750,6370,500000,8,12,2014,0,102,4290,4620,0,1,1
3,2.5,1910,11550,1.5,0,0,3,8,1910,0,2003,0,98074,47.6213,-122.064,2230,11550,580000,13,11,2014,0,11,9640,9320,0,0,0
4,2.5,2840,6268,2.0,0,0,3,9,2840,0,1998,0,98028,47.7386,-122.235,2790,6526,580000,9,5,2014,0,16,3428,3736,0,0,0
3,1.0,1320,5000,1.0,0,0,4,7,1090,230,1920,0,98107,47.6674,-122.365,1700,5000,594000,18,11,2014,0,94,3680,3300,0,1,1
3,2.5,2440,7600,1.0,0,0,3,7,1420,1020,1981,0,98052,47.6966,-122.127,2060,7700,500000,9,4,2015,0,34,5160,5640,0,1,0
4,2.5,2420,8056,1.0,0,0,3,8,1680,740,1988,0,98029,47.5748,-122.013,2160,6807,550000,6,10,2014,0,26,5636,4647,0,1,0
3,1.75,1180,6260,1.0,0,0,4,8,1180,0,1993,0,98038,47.3531,-122.048,1580,7272,275000,29,4,2015,0,22,5080,5692,0,0,0
3,2.25,1820,7420,2.0,0,0,4,8,1820,0,1983,0,98058,47.4368,-122.162,1900,7526,390000,30,4,2015,0,32,5600,5626,0,0,0
3,3.0,3760,8500,2.5,0,3,4,10,3060,700,1910,0,98116,47.5815,-122.398,2610,5500,1250000,26,6,2014,0,104,4740,2890,0,1,1
3,2.25,1560,15340,2.0,0,0,3,7,1560,0,1997,0,98168,47.4989,-122.322,1560,8260,250000,26,8,2014,0,17,13780,6700,0,0,1
2,2.5,1790,5400,2.0,0,0,4,8,1790,0,1979,0,98052,47.6606,-122.128,1700,5760,405000,29,9,2014,0,35,3610,4060,0,0,0
3,1.0,1430,7000,1.0,0,0,3,6,1430,0,1968,0,98023,47.3018,-122.369,1050,7700,213950,13,8,2014,0,46,5570,6650,0,0,0
3,1.5,1390,11340,1.0,0,0,4,7,1390,0,1963,0,98031,47.3984,-122.186,1740,11340,232000,22,12,2014,0,51,9950,9600,0,0,0
3,1.0,990,10800,1.0,0,0,4,6,990,0,1959,0,98002,47.293,-122.215,1060,10364,207000,11,4,2015,0,56,9810,9304,0,0,0
3,2.5,2520,5000,3.0,0,0,3,9,2520,0,1990,0,98106,47.5664,-122.359,1130,5000,540000,3,9,2014,0,24,2480,3870,0,0,1
4,1.5,2060,4000,1.5,0,2,3,7,1580,480,1920,1990,98103,47.6857,-122.353,1160,4000,750000,7,5,2015,70,95,1940,2840,1,1,1
4,2.5,2150,7303,2.0,0,0,3,8,2150,0,2005,0,98056,47.5109,-122.183,1940,9569,392500,4,6,2014,0,9,5153,7629,0,0,0
5,2.5,2500,12220,1.0,0,0,3,8,1690,810,1962,0,98003,47.3335,-122.325,2130,12000,305000,4,2,2015,0,53,9720,9870,0,1,0
3,2.5,2390,9157,2.0,0,0,3,9,2390,0,1984,0,98052,47.6617,-122.15,2360,8250,735000,23,5,2014,0,30,6767,5890,0,0,0
4,2.5,2400,6137,2.0,0,0,3,8,2400,0,1990,0,98074,47.6187,-122.04,2120,7468,575000,7,7,2014,0,24,3737,5348,0,0,0
2,1.0,660,5000,1.0,0,0,3,6,660,0,1915,0,98106,47.5664,-122.364,1000,5000,175000,18,6,2014,0,99,4340,4000,0,0,1
4,2.5,1580,6633,2.0,0,0,4,7,1580,0,1984,0,98042,47.3768,-122.118,1590,6633,291000,3,12,2014,0,30,5053,5043,0,0,0
4,2.5,3250,8970,2.0,0,0,3,10,3250,0,1994,0,98075,47.5862,-122.037,3240,8449,791500,4,8,2014,0,20,5720,5209,0,0,0
3,2.0,1880,9659,1.0,0,0,3,8,1180,700,1951,0,98155,47.7497,-122.284,1780,9659,475000,10,7,2014,0,63,7779,7879,0,1,1
2,1.0,1190,11400,1.0,0,0,3,7,1190,0,1951,0,98178,47.5012,-122.265,1410,11400,238950,13,11,2014,0,63,10210,9990,0,0,1
3,3.5,1280,1257,2.0,0,0,3,8,1040,240,2000,0,98107,47.6721,-122.374,1280,1249,470000,20,10,2014,0,14,-23,-31,0,1,1
4,1.75,2380,15324,1.0,0,0,3,8,1610,770,1978,0,98074,47.6262,-122.049,2540,12608,420000,27,4,2015,0,37,12944,10068,0,1,0
3,2.5,2040,7605,2.0,0,0,3,8,2040,0,1996,0,98045,47.4876,-121.779,2150,7545,440000,20,4,2015,0,19,5565,5395,0,0,0
4,1.75,1440,4300,1.5,0,0,4,8,1290,150,1929,0,98117,47.6846,-122.372,1640,5000,656000,20,8,2014,0,85,2860,3360,0,1,1
3,2.5,2120,4310,2.0,0,0,3,7,2120,0,2001,0,98053,47.687,-122.037,2280,4380,559950,14,7,2014,0,13,2190,2100,0,0,0
2,2.0,990,5416,1.0,0,0,3,6,990,0,1935,0,98122,47.604,-122.311,1650,3360,600000,13,11,2014,0,79,4426,1710,0,0,1
3,1.0,1710,12000,1.0,0,0,4,7,1710,0,1972,0,98001,47.2616,-122.281,1310,9600,255000,4,8,2014,0,42,10290,8290,0,0,0
4,1.5,1840,7076,1.5,0,0,3,7,1840,0,1957,0,98106,47.5185,-122.345,1510,7320,210750,1,4,2015,0,58,5236,5810,0,0,1
4,1.0,1150,2560,1.5,0,0,3,7,1150,0,1909,0,98109,47.6368,-122.355,1890,3000,485000,18,7,2014,0,105,1410,1110,0,0,1
3,2.5,2250,8076,2.0,0,0,3,8,2250,0,1995,0,98038,47.3667,-122.041,2180,7244,390000,20,10,2014,0,19,5826,5064,0,0,0
3,2.5,2460,12600,1.0,0,0,4,8,1810,650,1970,0,98059,47.473,-122.118,1820,11180,405000,23,3,2015,0,45,10140,9360,0,1,0
4,1.0,1540,4500,1.5,0,0,2,7,1540,0,1905,0,98116,47.587,-122.384,1920,6000,462500,10,9,2014,0,109,2960,4080,0,0,1
4,2.25,2210,14073,1.0,0,0,3,8,1630,580,1978,0,98059,47.4774,-122.142,2340,11340,435000,10,2,2015,0,37,11863,9000,0,1,0
3,2.5,1440,5434,2.0,0,0,3,7,1440,0,2003,0,98053,47.6818,-122.034,1560,3770,440000,19,11,2014,0,11,3994,2210,0,0,0
3,1.75,1790,7650,1.0,0,3,3,9,1790,0,1978,0,98023,47.3213,-122.385,2540,7600,299950,25,6,2014,0,36,5860,5060,0,0,0
2,1.5,1120,1024,2.0,0,0,3,8,1120,0,1970,1998,98122,47.6175,-122.298,1120,1549,440000,4,5,2015,28,45,-96,429,1,0,1
3,2.5,1260,11877,1.0,0,0,3,7,1260,0,1975,0,98045,47.4442,-121.762,1430,9790,312620,13,11,2014,0,39,10617,8360,0,0,0
3,1.5,1180,12324,1.0,0,0,3,7,800,380,1981,0,98074,47.6337,-122.032,1280,11371,372500,5,6,2014,0,33,11144,10091,0,1,0
3,2.5,1730,8076,2.0,0,0,3,8,1730,0,1994,0,98003,47.2619,-122.308,1780,6930,297262,9,2,2015,0,21,6346,5150,0,0,0
4,3.0,2250,7245,1.0,0,0,4,7,1250,1000,1963,0,98005,47.6045,-122.169,1960,7245,735000,10,2,2015,0,52,4995,5285,0,1,0
3,1.5,1550,5034,2.0,0,0,4,7,1550,0,1922,0,98177,47.7072,-122.36,1820,7200,430000,26,8,2014,0,92,3484,5380,0,0,1
2,1.75,1070,9750,1.5,0,0,3,7,1070,0,1995,0,98014,47.7131,-121.319,970,9750,241000,22,10,2014,0,19,8680,8780,0,0,0
3,1.0,1460,9750,1.0,0,0,4,7,1460,0,1969,0,98042,47.3242,-122.144,1270,9750,201000,12,5,2014,0,45,8290,8480,0,0,0
2,1.0,1060,4000,1.0,0,0,4,7,1060,0,1910,0,98115,47.6731,-122.315,1770,4000,570000,20,4,2015,0,105,2940,2230,0,0,1
4,1.75,1840,9600,1.0,0,0,3,7,1220,620,1967,0,98052,47.6579,-122.125,1770,9720,538000,8,5,2014,0,47,7760,7950,0,1,0
3,2.5,2440,4244,2.0,0,0,3,8,2440,0,2011,0,98052,47.7057,-122.112,2690,4556,729000,12,5,2015,0,4,1804,1866,0,0,0
4,1.75,1700,14756,1.0,0,0,3,7,850,850,1955,0,98006,47.5762,-122.143,1680,10250,331500,8,1,2015,0,60,13056,8570,0,1,0
2,1.0,680,8064,1.0,0,0,3,6,680,0,1941,0,98188,47.469,-122.298,1340,10800,110700,19,5,2014,0,73,7384,9460,0,0,1
3,2.0,1700,8448,1.0,0,0,3,7,1700,0,1996,0,98022,47.2077,-122.011,1350,8587,245000,2,10,2014,0,18,6748,7237,0,0,0
3,1.75,2000,7111,1.0,0,0,4,7,1360,640,1956,0,98177,47.7676,-122.373,1830,9000,427000,21,7,2014,0,58,5111,7170,0,1,1
4,1.75,2340,5940,1.0,0,0,3,8,1290,1050,1953,0,98115,47.6789,-122.281,1930,5940,650500,6,8,2014,0,61,3600,4010,0,1,1
2,1.0,1120,7440,1.0,0,0,4,7,1120,0,1939,0,98155,47.7405,-122.323,1170,7440,335900,14,8,2014,0,75,6320,6270,0,0,1
2,2.0,1510,5133,1.5,0,0,3,7,1510,0,1939,0,98199,47.6415,-122.401,1470,6000,535000,3,9,2014,0,75,3623,4530,0,0,1
5,2.0,2120,2400,1.0,0,0,4,6,1080,1040,1906,0,98144,47.5979,-122.297,1690,4400,360000,22,1,2015,0,109,280,2710,0,1,1
3,2.25,1500,8100,1.0,0,0,3,7,1210,290,1968,0,98055,47.4632,-122.19,1600,7896,294900,4,2,2015,0,47,6600,6296,0,1,0
2,1.0,1030,5934,1.0,0,0,4,7,1030,0,1928,0,98115,47.6828,-122.287,1420,5588,460000,11,3,2015,0,87,4904,4168,0,0,1
2,1.0,1150,4400,1.0,0,0,4,7,1150,0,1905,0,98112,47.6226,-122.292,1240,4400,463000,9,5,2014,0,109,3250,3160,0,0,1
4,2.0,1750,8116,1.0,0,0,4,5,1750,0,1943,0,98056,47.5097,-122.181,1440,7865,199500,9,9,2014,0,71,6366,6425,0,0,0
4,2.0,1750,8116,1.0,0,0,4,5,1750,0,1943,0,98056,47.5097,-122.181,1440,7865,247000,24,11,2014,0,71,6366,6425,0,0,0
4,2.5,2170,14024,2.0,0,0,3,8,2170,0,1992,0,98019,47.7346,-121.97,2240,14029,442500,9,6,2014,0,22,11854,11789,0,0,0
3,2.5,1690,3827,2.0,0,0,3,7,1690,0,2005,0,98053,47.6768,-122.029,1690,3129,449000,3,9,2014,0,9,2137,1439,0,0,0
4,1.0,1600,4500,1.5,0,0,4,7,1600,0,1926,0,98115,47.6804,-122.316,1720,4500,725000,6,3,2015,0,89,2900,2780,0,0,1
3,1.0,1060,7900,1.0,0,0,3,7,1060,0,1961,2001,98058,47.4604,-122.18,1310,7900,215000,5,2,2015,40,54,6840,6590,1,0,0
2,1.75,1990,6549,1.0,0,0,3,7,1170,820,1948,0,98115,47.7,-122.296,1640,7202,582500,18,12,2014,0,66,4559,5562,0,1,1
4,2.25,2210,9371,2.0,0,0,4,8,2210,0,1968,0,98032,47.3634,-122.279,2300,11584,305000,24,6,2014,0,46,7161,9284,0,0,0
4,2.75,3090,7650,2.0,0,2,3,8,2340,750,1959,1989,98042,47.3622,-122.157,2760,10370,734000,23,9,2014,30,55,4560,7610,1,1,0
3,2.0,1050,10072,1.0,0,0,3,7,1050,0,1986,0,98019,47.7341,-121.976,1130,10087,300000,5,5,2014,0,28,9022,8957,0,0,0
4,2.5,2095,4400,1.5,0,0,5,8,1295,800,1910,0,98116,47.5838,-122.39,1980,4400,711000,11,9,2014,0,104,2305,2420,0,1,1
3,1.75,1520,12282,1.0,0,0,3,8,1220,300,1978,0,98155,47.7516,-122.299,1860,13500,360000,16,7,2014,0,36,10762,11640,0,1,1
5,2.5,2750,12350,2.0,0,0,3,8,2750,0,1987,0,98031,47.419,-122.206,1650,9810,357000,10,12,2014,0,27,9600,8160,0,0,0
3,1.75,1200,9266,1.0,0,0,4,7,1200,0,1960,0,98002,47.314,-122.208,1200,9266,235000,30,9,2014,0,54,8066,8066,0,0,0
3,1.75,1830,9720,1.0,0,1,3,7,1150,680,1928,1976,98040,47.5511,-122.23,3380,10854,550000,8,8,2014,48,86,7890,7474,1,1,0
3,1.0,1160,7202,1.0,0,0,4,7,1160,0,1957,0,98133,47.7675,-122.334,1620,8598,324000,5,12,2014,0,57,6042,6978,0,0,1
3,2.0,1750,9239,1.0,0,0,3,8,1410,340,1989,0,98133,47.7583,-122.339,1720,7874,420000,28,4,2015,0,26,7489,6154,0,1,1
4,2.5,2400,7693,2.0,0,0,3,8,2400,0,2003,0,98059,47.4881,-122.142,2400,8038,450000,19,6,2014,0,11,5293,5638,0,0,0
5,3.5,4140,6770,2.0,0,0,3,9,3030,1110,2004,0,98027,47.5381,-122.069,3960,5431,825000,20,4,2015,0,11,2630,1471,0,1,0
4,2.25,2115,6234,2.0,0,0,3,7,2115,0,1998,0,98002,47.285,-122.201,2440,6366,272000,22,7,2014,0,16,4119,3926,0,0,0
3,2.0,2580,15653,1.5,0,0,3,9,2580,0,1990,0,98166,47.4561,-122.361,1920,9840,481000,22,10,2014,0,24,13073,7920,0,0,1
3,1.0,1220,3400,1.0,0,0,3,7,1060,160,1927,0,98117,47.6775,-122.363,1350,3750,500000,5,8,2014,0,87,2180,2400,0,1,1
2,1.5,1630,3780,1.0,0,0,4,7,890,740,1940,0,98107,47.6711,-122.403,1770,6400,448000,12,6,2014,0,74,2150,4630,0,1,1
2,2.0,1350,4220,1.0,0,0,3,8,1350,0,2004,0,98053,47.718,-122.034,1350,4409,480000,19,3,2015,0,11,2870,3059,0,0,0
3,2.5,1690,2890,2.0,0,0,3,7,1690,0,2004,0,98053,47.6802,-122.031,1690,2730,475000,8,9,2014,0,10,1200,1040,0,0,0
2,2.25,1700,2383,2.0,0,0,3,8,1700,0,2005,0,98029,47.547,-121.997,1700,2700,472500,21,10,2014,0,9,683,1000,0,0,0
4,2.25,1890,7616,1.0,0,0,4,8,1260,630,1979,0,98003,47.3275,-122.329,1890,7420,291000,23,9,2014,0,35,5726,5530,0,1,0
2,1.0,850,5250,1.0,0,0,4,7,850,0,1950,0,98133,47.731,-122.342,1440,5250,294000,22,7,2014,0,64,4400,3810,0,0,1
4,2.5,2480,12688,1.0,0,0,4,9,1820,660,1967,0,98004,47.6344,-122.205,2910,11979,1010000,30,7,2014,0,47,10208,9069,0,1,0
3,2.5,1690,3129,2.0,0,0,3,7,1690,0,2002,0,98053,47.6875,-122.043,1690,3129,442500,17,10,2014,0,12,1439,1439,0,0,0
2,1.0,810,8424,1.0,0,0,4,6,810,0,1959,0,98023,47.3286,-122.346,820,8424,170000,27,6,2014,0,55,7614,7604,0,0,0
3,2.25,2580,6000,2.0,0,0,3,8,1780,800,1925,0,98144,47.5778,-122.289,2300,5995,665000,18,2,2015,0,90,3420,3695,0,1,1
2,1.75,2140,5000,1.0,0,0,3,7,1000,1140,1930,1991,98112,47.6284,-122.291,2250,4000,675000,14,7,2014,61,84,2860,1750,1,1,1
2,1.75,1360,10000,1.0,0,0,3,6,1360,0,1957,1989,98019,47.7421,-121.982,1430,10000,279900,4,2,2015,32,58,8640,8570,1,0,0
4,1.5,1800,3245,1.5,0,0,4,8,1800,0,1929,0,98103,47.6605,-122.331,1800,4275,875000,30,6,2014,0,85,1445,2475,0,0,1
3,2.5,1920,3867,2.0,0,0,3,8,1920,0,2005,0,98029,47.5538,-121.994,2190,3841,571000,4,8,2014,0,9,1947,1651,0,0,0
3,1.0,860,5060,1.5,0,0,3,7,860,0,1927,0,98133,47.7062,-122.341,880,5060,320000,17,6,2014,0,87,4200,4180,0,0,1
3,1.75,1160,5082,1.0,0,0,3,6,580,580,1942,0,98178,47.503,-122.262,1730,6000,137900,1,4,2015,0,73,3922,4270,0,1,1
3,1.0,1280,3870,1.0,0,0,3,7,640,640,1945,0,98122,47.6163,-122.294,1280,4800,360000,4,3,2015,0,70,2590,3520,0,1,1
4,1.5,1800,9576,1.0,0,0,4,7,1800,0,1977,0,98045,47.4664,-121.747,1370,9576,271000,5,2,2015,0,38,7776,8206,0,0,0
4,2.5,2400,4596,2.0,0,0,3,8,2400,0,2004,0,98001,47.3358,-122.265,2230,4763,280000,26,9,2014,0,10,2196,2533,0,0,0
2,1.0,940,6350,1.0,0,0,4,5,940,0,1942,0,98103,47.698,-122.357,1490,6350,283000,28,4,2015,0,73,5410,4860,0,0,1
3,1.0,1110,7208,1.0,0,0,3,7,1110,0,1980,0,98052,47.6979,-122.124,1440,7210,411500,13,2,2015,0,35,6098,5770,0,0,0
3,2.25,2420,7548,1.0,0,0,4,8,1370,1050,1967,0,98023,47.3112,-122.376,2150,8000,282000,17,9,2014,0,47,5128,5850,0,1,0
3,2.5,1850,1499,2.5,0,0,3,9,1790,60,2005,0,98199,47.6475,-122.396,1770,1539,535000,9,12,2014,0,9,-351,-231,0,1,1
4,2.5,2020,4350,2.0,0,0,5,9,1730,290,1943,0,98199,47.6503,-122.41,1620,5800,554729,3,7,2014,0,71,2330,4180,0,1,1
4,2.5,2020,4350,2.0,0,0,5,9,1730,290,1943,0,98199,47.6503,-122.41,1620,5800,868000,24,2,2015,0,72,2330,4180,0,1,1
4,1.75,1920,6000,1.0,0,0,4,7,960,960,1954,0,98125,47.7137,-122.315,1850,7200,455000,17,11,2014,0,60,4080,5350,0,1,1
2,1.75,1280,8500,1.0,0,0,3,7,1280,0,1953,2010,98033,47.6553,-122.19,1950,10356,595000,29,10,2014,57,61,7220,8406,1,0,0
4,2.5,3130,5240,2.0,0,0,3,8,3130,0,2004,0,98038,47.3446,-122.042,2470,5240,400000,20,3,2015,0,11,2110,2770,0,0,0
4,2.5,3920,12415,2.0,0,0,3,10,3920,0,1997,0,98075,47.5658,-122.032,3639,12805,770000,25,6,2014,0,17,8495,9166,0,0,0
4,2.75,3100,3773,2.0,0,0,3,8,2000,1100,1919,1996,98122,47.6158,-122.291,2130,3777,742500,9,5,2014,77,95,673,1647,1,1,1
3,2.0,1670,13775,1.0,0,0,3,8,1670,0,1968,0,98045,47.4873,-121.783,2130,14500,375000,12,8,2014,0,46,12105,12370,0,0,0
3,1.75,2190,8500,1.0,0,0,4,9,2190,0,1957,0,98112,47.64,-122.285,2850,8868,1570000,17,12,2014,0,57,6310,6018,0,0,1
4,1.5,1200,11163,1.5,0,0,4,6,1200,0,1970,0,98092,47.3024,-122.106,1200,11163,178000,18,3,2015,0,45,9963,9963,0,0,0
3,1.75,1470,10390,1.0,0,0,3,7,1470,0,1989,0,98031,47.4192,-122.201,1770,7507,262500,9,10,2014,0,25,8920,5737,0,0,0
3,1.75,1650,5000,1.5,0,0,4,8,1650,0,1900,0,98107,47.6743,-122.371,1630,5000,730000,15,4,2015,0,115,3350,3370,0,0,1
5,1.75,1840,10453,1.0,0,2,3,8,1360,480,1948,0,98166,47.4508,-122.368,2250,11250,395000,3,7,2014,0,66,8613,9000,0,1,1
3,1.0,1210,6650,1.0,0,0,3,6,1210,0,1959,0,98008,47.6214,-122.12,990,7590,355000,24,10,2014,0,55,5440,6600,0,0,0
3,2.5,1870,8541,2.0,0,0,3,8,1870,0,1989,0,98023,47.2925,-122.346,2150,7789,299990,8,9,2014,0,25,6671,5639,0,0,0
4,2.25,2660,11200,2.0,0,0,4,8,2660,0,1972,0,98059,47.4722,-122.131,2090,11120,425000,18,11,2014,0,42,8540,9030,0,0,0
2,1.0,1150,7552,1.0,0,0,3,7,1150,0,1951,0,98125,47.7215,-122.323,1150,7346,349000,7,1,2015,0,64,6402,6196,0,0,1
4,1.75,1740,4816,1.0,0,0,5,7,870,870,1942,0,98116,47.5758,-122.382,1210,5074,554950,11,11,2014,0,72,3076,3864,0,1,1
6,3.0,2580,8064,1.5,0,0,3,7,1880,700,1913,0,98118,47.5549,-122.287,1510,6084,326000,16,11,2014,0,101,5484,4574,0,1,1
4,1.75,1720,6975,1.0,0,0,3,8,1420,300,1975,0,98052,47.6506,-122.121,2210,7875,580000,26,6,2014,0,39,5255,5665,0,1,0
3,2.75,2610,11290,1.0,0,0,3,7,1630,980,1985,0,98033,47.6632,-122.201,2570,9125,757000,25,11,2014,0,29,8680,6555,0,1,0
3,1.75,1400,7920,1.0,0,0,3,7,1400,0,1965,0,98034,47.7312,-122.202,1310,7876,335000,23,7,2014,0,49,6520,6566,0,0,0
4,2.75,2830,7334,2.0,0,0,3,8,2830,0,2005,0,98059,47.4868,-122.141,2830,7378,540000,17,4,2015,0,10,4504,4548,0,0,0
5,2.25,2630,8625,2.0,0,0,3,8,2630,0,1966,0,98032,47.3619,-122.287,1880,8670,320000,10,10,2014,0,48,5995,6790,0,0,0
3,2.5,1580,7918,2.0,0,0,3,7,1580,0,1994,0,98055,47.4431,-122.19,1650,7916,280000,21,4,2015,0,21,6338,6266,0,0,0
3,2.0,1540,10931,1.0,0,3,3,7,1540,0,1989,0,98045,47.495,-121.776,1570,10485,324000,23,7,2014,0,25,9391,8915,0,0,0
3,1.0,2120,7735,1.0,0,0,4,7,1060,1060,1967,0,98059,47.4869,-122.123,1010,8570,300000,20,5,2014,0,47,5615,7560,0,1,0
3,1.75,1830,10000,2.0,0,0,4,7,1830,0,1913,1964,98019,47.741,-121.979,1480,10000,360000,28,8,2014,51,101,8170,8520,1,0,0
3,2.5,2260,10153,2.0,0,0,3,10,2260,0,1987,0,98074,47.641,-122.068,2740,10153,600000,23,6,2014,0,27,7893,7413,0,0,0
3,3.25,1830,1804,3.0,0,0,3,8,1830,0,2014,0,98117,47.6945,-122.377,1830,1804,599950,9,7,2014,0,0,-26,-26,0,0,1
4,1.0,1190,7920,1.0,0,0,3,6,890,300,1951,0,98126,47.5305,-122.371,1140,7920,190000,25,3,2015,0,64,6730,6780,0,1,1
4,1.75,2310,9002,1.0,0,0,3,7,1780,530,1970,0,98034,47.731,-122.166,2090,8814,350000,30,3,2015,0,45,6692,6724,0,1,0
3,1.0,1230,4600,1.5,0,0,3,7,1230,0,1929,0,98116,47.5616,-122.392,1230,4600,522000,10,4,2015,0,86,3370,3370,0,0,1
3,2.5,2940,10809,2.0,0,0,3,10,2940,0,1992,0,98006,47.5418,-122.136,3090,10348,850000,18,3,2015,0,23,7869,7258,0,0,0
3,1.0,1010,8800,1.0,0,0,4,7,1010,0,1954,0,98118,47.5483,-122.278,1400,4095,308000,30,6,2014,0,60,7790,2695,0,0,1
6,2.25,2550,5000,2.0,0,0,4,7,2550,0,1907,0,98117,47.6785,-122.396,1480,5000,1020000,2,12,2014,0,107,2450,3520,0,0,1
3,1.0,1480,5100,1.5,0,0,3,7,1480,0,1938,1959,98103,47.6915,-122.348,1300,5100,397500,28,10,2014,21,76,3620,3800,1,0,1
3,1.75,1460,7967,1.0,0,0,3,7,1040,420,1977,0,98023,47.3199,-122.374,1460,6835,186000,27,1,2015,0,38,6507,5375,0,1,0
5,3.0,3110,12429,1.0,0,0,3,8,1790,1320,1977,0,98011,47.7463,-122.213,3050,11902,436500,20,6,2014,0,37,9319,8852,0,1,0
3,2.0,2140,4923,1.0,0,0,4,8,1070,1070,1928,0,98103,47.6902,-122.339,1470,4923,710000,3,6,2014,0,86,2783,3453,0,1,1
5,3.25,3450,6360,2.0,0,0,5,9,1860,1590,1905,0,98122,47.6133,-122.287,2310,5000,1380000,14,1,2015,0,110,2910,2690,0,1,1
3,2.25,1960,10682,1.0,0,0,3,7,1960,0,1957,0,98008,47.6319,-122.124,1540,10682,450000,28,4,2015,0,58,8722,9142,0,0,0
4,2.75,1890,5240,1.0,0,0,3,7,980,910,1981,0,98106,47.5528,-122.356,1600,5240,375000,21,1,2015,0,34,3350,3640,0,1,1
2,1.0,2080,14659,1.0,0,0,3,7,1040,1040,1960,0,98178,47.4858,-122.231,1920,15208,315000,13,11,2014,0,54,12579,13288,0,1,1
3,1.0,1700,4165,1.5,0,0,3,7,1700,0,1918,0,98118,47.5569,-122.277,1400,4165,467500,13,2,2015,0,97,2465,2765,0,0,1
3,1.0,1140,7316,1.0,0,0,3,6,1140,0,1959,0,98106,47.527,-122.362,1140,7440,330000,27,2,2015,0,56,6176,6300,0,0,1
4,3.25,2590,3889,3.0,0,0,3,9,2590,0,2013,0,98007,47.6259,-122.142,2590,4062,760000,24,3,2015,0,2,1299,1472,0,0,0
3,1.75,1480,800,2.0,0,0,3,8,1000,480,2014,0,98136,47.5493,-122.387,1480,1143,469000,30,12,2014,0,0,-680,-337,0,1,1
3,3.0,1500,1473,2.0,0,0,3,8,1120,380,2000,0,98122,47.6063,-122.305,1720,1976,408000,13,8,2014,0,14,-27,256,0,1,1
3,2.75,2660,10350,1.0,0,4,4,8,1330,1330,1971,0,98008,47.5868,-122.116,2820,10043,851000,3,10,2014,0,43,7690,7223,0,1,0
2,2.0,1350,3926,1.0,0,0,3,8,1350,0,2007,0,98053,47.7192,-122.024,1440,3926,410000,25,7,2014,0,7,2576,2486,0,0,0
2,1.0,860,10500,1.0,0,0,3,6,860,0,1943,0,98024,47.5662,-121.886,950,10500,235000,13,3,2015,0,72,9640,9550,0,0,0
2,1.0,1000,4500,1.0,0,0,3,6,1000,0,1916,0,98055,47.4896,-122.204,980,4837,207100,28,8,2014,0,98,3500,3857,0,0,0
4,2.5,2480,16360,1.0,0,0,5,7,1510,970,1959,0,98028,47.7638,-122.265,1770,15205,560000,26,6,2014,0,55,13880,13435,0,1,0
3,2.75,3860,12786,2.0,0,0,4,10,3860,0,1984,0,98006,47.549,-122.141,2820,14636,903000,31,10,2014,0,30,8926,11816,0,0,0
3,1.75,2140,4800,2.0,0,0,3,8,1690,450,1905,0,98112,47.6311,-122.312,2440,4800,998500,7,1,2015,0,110,2660,2360,0,1,1
4,1.75,1820,13600,1.5,0,0,3,7,1120,700,1959,0,98032,47.3743,-122.295,1810,11970,268500,30,7,2014,0,55,11780,10160,0,1,0
4,2.5,2660,11200,2.0,0,0,3,9,2660,0,1999,0,98004,47.5894,-122.197,3290,11275,1130000,1,8,2014,0,15,8540,7985,0,0,0
3,2.0,1470,12096,1.0,0,0,4,6,1470,0,1942,0,98030,47.3734,-122.193,1470,10966,250000,18,11,2014,0,72,10626,9496,0,0,0
3,2.25,2980,7700,1.0,0,0,3,9,2530,450,1964,0,98112,47.6336,-122.29,3020,8234,1230000,12,1,2015,0,51,4720,5214,0,1,1
4,2.0,1870,7700,1.0,0,0,3,8,1870,0,1966,0,98055,47.4619,-122.196,2270,8580,325000,17,3,2015,0,49,5830,6310,0,0,0
5,3.0,2430,8000,1.0,0,0,4,7,1370,1060,1957,0,98008,47.603,-122.12,1770,8000,506000,15,6,2014,0,57,5570,6230,0,1,0
4,2.5,2790,6538,2.0,0,0,3,9,2790,0,2003,0,98027,47.5349,-122.066,2990,6538,751000,25,3,2015,0,12,3748,3548,0,0,0
4,2.25,2340,5300,1.0,0,0,5,8,1700,640,1963,0,98008,47.6202,-122.112,1890,8250,665000,23,4,2015,0,52,2960,6360,0,1,0
4,2.5,2520,8515,2.0,0,0,3,7,2520,0,1999,0,98019,47.7233,-121.959,2130,6930,450000,27,5,2014,0,15,5995,4800,0,0,0
3,1.0,1200,5252,1.0,0,0,3,7,1200,0,1962,0,98007,47.6075,-122.134,1800,7920,427000,17,11,2014,0,52,4052,6120,0,0,0
3,1.75,1330,12618,1.0,0,3,3,7,1330,0,1983,0,98188,47.4403,-122.271,1870,8429,265000,16,4,2015,0,32,11288,6559,0,0,1
3,1.5,1310,2996,2.0,0,0,3,7,1310,0,1998,0,98144,47.5879,-122.299,1310,2997,398000,5,11,2014,0,16,1686,1687,0,0,1
6,3.5,3020,4500,2.0,0,0,3,7,3020,0,1941,1992,98178,47.498,-122.225,900,6000,354000,4,11,2014,51,73,1480,5100,1,0,1
4,2.5,2260,6086,2.0,0,0,3,8,2260,0,1999,0,98030,47.3642,-122.174,2260,6218,339950,13,4,2015,0,16,3826,3958,0,0,0
2,1.0,790,4000,1.0,0,0,3,6,790,0,1948,0,98115,47.6844,-122.289,990,5000,399000,12,11,2014,0,66,3210,4010,0,0,1
2,2.0,970,5000,1.0,0,0,3,7,970,0,1983,0,98034,47.7223,-122.16,1540,5000,325000,10,10,2014,0,31,4030,3460,0,0,0
3,2.0,2250,8000,1.0,0,2,4,9,2250,0,1955,0,98177,47.7077,-122.378,2880,10960,998800,19,8,2014,0,59,5750,8080,0,0,1
4,2.5,1530,2248,1.5,0,0,3,7,1530,0,1914,0,98144,47.5766,-122.309,1340,3700,350000,19,9,2014,0,100,718,2360,0,0,1
4,1.75,1780,11436,1.0,0,0,5,9,1780,0,1967,0,98004,47.6273,-122.194,2100,12052,1000000,5,8,2014,0,47,9656,9952,0,0,0
3,2.5,2120,5277,2.0,0,0,3,7,2120,0,2005,0,98053,47.6811,-122.034,2370,5257,561000,18,3,2015,0,10,3157,2887,0,0,0
2,1.0,1500,6685,1.0,0,0,3,7,1190,310,1926,0,98133,47.7186,-122.354,1420,6561,245000,7,7,2014,0,88,5185,5141,0,1,1
2,1.0,1500,6685,1.0,0,0,3,7,1190,310,1926,0,98133,47.7186,-122.354,1420,6561,570000,13,2,2015,0,89,5185,5141,0,1,1
4,3.0,2390,4000,1.5,0,0,5,8,1460,930,1931,0,98103,47.6857,-122.331,1670,4000,845000,30,10,2014,0,83,1610,2330,0,1,1
4,2.5,2390,9600,2.0,0,0,3,7,2390,0,1996,0,98010,47.3289,-122.001,1900,9603,314500,29,9,2014,0,18,7210,7703,0,0,0
3,1.75,2920,9370,1.0,0,0,4,8,1620,1300,1981,0,98006,47.5491,-122.151,2890,9609,650000,18,6,2014,0,33,6450,6719,0,1,0
2,1.0,850,5000,1.0,0,0,3,5,850,0,1907,0,98055,47.4874,-122.207,910,4815,298000,6,5,2015,0,108,4150,3905,0,0,0
2,1.0,930,3200,1.0,0,0,3,7,930,0,1904,0,98122,47.609,-122.314,1690,3840,500000,9,4,2015,0,111,2270,2150,0,0,1
4,2.5,3340,12248,2.0,0,1,3,9,2470,870,1998,0,98126,47.5858,-122.379,2110,5679,870000,10,6,2014,0,16,8908,3569,0,1,1
2,1.0,710,6732,1.0,0,0,5,6,710,0,1942,0,98126,47.5151,-122.372,710,6720,299000,6,4,2015,0,73,6022,6010,0,0,1
3,2.25,2240,6450,1.0,0,0,3,7,1440,800,1979,0,98125,47.7034,-122.315,1390,6450,527000,12,8,2014,0,35,4210,5060,0,1,1
3,1.0,1060,7638,1.0,0,0,5,7,1060,0,1966,0,98007,47.5941,-122.142,1470,8097,420000,6,11,2014,0,48,6578,6627,0,0,0
3,2.5,2360,8764,2.0,0,0,3,8,2360,0,1991,0,98022,47.2114,-122.009,2360,8746,290000,12,2,2015,0,24,6404,6386,0,0,0
3,1.75,1730,9334,1.0,0,0,3,8,1220,510,1977,0,98052,47.6478,-122.113,2020,10000,499990,15,8,2014,0,37,7604,7980,0,1,0
3,1.75,1170,4000,1.0,0,0,3,6,720,450,1943,2013,98106,47.5306,-122.354,1130,4000,315000,27,10,2014,70,71,2830,2870,1,1,1
3,1.75,1290,7205,1.5,0,0,3,7,1290,0,1971,0,98034,47.7329,-122.237,1340,7214,365000,18,11,2014,0,43,5915,5874,0,0,0
4,2.75,2010,7000,2.0,0,0,5,8,2010,0,1901,0,98199,47.6607,-122.396,1420,4400,774000,6,11,2014,0,113,4990,2980,0,0,1
3,1.5,1490,12186,1.0,0,0,4,7,1490,0,1950,0,98155,47.7739,-122.322,1180,14285,368888,6,4,2015,0,65,10696,13105,0,0,1
4,2.5,1930,7862,2.0,0,0,3,7,1930,0,1994,0,98038,47.3644,-122.04,1640,9145,339500,2,10,2014,0,20,5932,7505,0,0,0
4,1.75,2240,7500,1.0,0,0,4,7,1120,1120,1956,0,98133,47.7466,-122.34,1440,7500,344950,23,9,2014,0,58,5260,6060,0,1,1
3,2.0,2320,17688,1.0,0,0,3,8,2320,0,1952,1994,98166,47.4519,-122.363,1610,14482,450000,12,11,2014,42,62,15368,12872,1,0,1
4,2.75,2990,6626,2.0,0,0,3,9,2990,0,2014,0,98052,47.7107,-122.11,2910,5533,814950,18,11,2014,0,0,3636,2623,0,0,0
4,2.5,2200,5730,2.0,0,0,3,8,2200,0,2003,0,98042,47.3482,-122.153,2200,5772,299900,5,9,2014,0,11,3530,3572,0,0,0
3,2.0,1500,7828,1.0,0,0,4,7,1500,0,1967,0,98058,47.4484,-122.158,1500,7700,315000,27,2,2015,0,48,6328,6200,0,0,0
3,1.75,3860,9000,1.0,0,2,3,9,1930,1930,1970,0,98155,47.7431,-122.29,2960,9000,880000,16,12,2014,0,44,5140,6040,0,1,1
3,1.5,1430,5200,1.0,0,0,4,7,1030,400,1977,0,98042,47.3644,-122.094,1190,5200,195000,29,12,2014,0,37,3770,4010,0,1,0
5,2.75,3750,8279,2.0,0,0,3,9,3750,0,2001,0,98074,47.6039,-122.06,3450,8279,910000,8,12,2014,0,13,4529,4829,0,0,0
5,2.5,3100,10189,2.0,0,0,3,8,3100,0,2002,0,98019,47.738,-121.965,2840,10189,540000,27,8,2014,0,12,7089,7349,0,0,0
3,2.5,1870,5874,2.0,0,0,3,7,1870,0,2005,0,98042,47.3992,-122.163,2090,4060,306000,16,5,2014,0,9,4004,1970,0,0,0
4,2.25,2040,7600,1.0,0,0,4,8,1580,460,1978,0,98023,47.3169,-122.365,2130,7200,272000,16,10,2014,0,36,5560,5070,0,1,0
5,3.5,3700,8504,2.0,0,0,3,8,2750,950,1950,2014,98105,47.669,-122.275,2370,6246,1300000,9,12,2014,64,64,4804,3876,1,1,1
3,1.75,3150,9258,1.0,0,1,3,8,2370,780,1970,0,98027,47.5571,-122.08,2740,10274,450000,17,10,2014,0,44,6108,7534,0,1,0
3,2.5,1990,12793,2.0,0,0,3,8,1990,0,1993,0,98028,47.7347,-122.226,2290,9035,450000,7,7,2014,0,21,10803,6745,0,0,0
4,1.0,1740,11075,1.5,0,0,3,7,1740,0,1965,0,98133,47.7458,-122.334,1580,7684,310000,10,6,2014,0,49,9335,6104,0,0,1
2,2.25,2080,11285,1.0,0,0,4,8,1180,900,1954,0,98042,47.3628,-122.147,2590,13048,530000,12,5,2015,0,61,9205,10458,0,1,0
4,2.5,2060,10125,2.0,0,0,4,7,1560,500,1979,0,98028,47.764,-122.262,1760,9876,435000,12,1,2015,0,36,8065,8116,0,1,0
3,1.5,1760,4000,2.0,0,0,3,8,1760,0,1922,0,98102,47.6401,-122.32,1760,4000,690000,2,7,2014,0,92,2240,2240,0,0,1
4,2.5,1620,4000,2.0,0,0,3,7,1620,0,2008,0,98038,47.3661,-122.02,1580,3780,305000,1,4,2015,0,7,2380,2200,0,0,0
3,1.75,1210,7000,1.0,0,0,3,7,1210,0,1975,0,98058,47.4572,-122.169,1670,7000,300000,5,11,2014,0,39,5790,5330,0,0,0
4,3.0,2040,5050,1.0,0,0,3,8,1490,550,1993,0,98092,47.3266,-122.175,2020,6118,289950,22,1,2015,0,22,3010,4098,0,1,0
3,2.5,2270,9600,2.0,0,0,3,9,2270,0,1990,0,98011,47.7388,-122.206,2580,9617,575000,5,11,2014,0,24,7330,7037,0,0,0
3,1.5,1060,9600,1.0,0,0,4,7,1060,0,1962,0,98023,47.3229,-122.348,1440,9600,219000,15,7,2014,0,52,8540,8160,0,0,0
4,3.0,1940,8170,1.0,0,0,4,7,1940,0,1948,0,98155,47.7381,-122.302,1310,8169,265000,2,7,2014,0,66,6230,6859,0,0,1
5,3.25,3070,5000,2.0,0,0,3,9,2050,1020,2006,0,98103,47.6742,-122.356,2070,5000,1110000,14,7,2014,0,8,1930,2930,0,1,1
3,1.0,930,7590,1.0,0,0,3,6,820,110,1943,0,98166,47.4802,-122.335,1220,7590,200000,9,3,2015,0,72,6660,6370,0,1,1
4,2.75,2180,8480,1.0,0,3,4,7,1210,970,1959,0,98146,47.4961,-122.366,2240,8497,545000,24,4,2015,0,56,6300,6257,0,1,1
3,2.5,2130,8404,2.0,0,0,3,8,2130,0,1991,0,98058,47.4623,-122.13,2130,8404,378000,19,3,2015,0,24,6274,6274,0,0,0
2,1.75,800,4800,1.0,0,0,4,6,800,0,1922,0,98136,47.5559,-122.396,1090,5000,388000,26,3,2015,0,93,4000,3910,0,0,1
4,2.25,2200,8384,1.0,0,0,3,7,1250,950,1959,0,98155,47.753,-122.317,1750,8384,425000,26,11,2014,0,55,6184,6634,0,1,1
2,1.5,1130,746,2.0,0,0,3,8,1030,100,2009,0,98107,47.6684,-122.363,1520,1519,536000,7,7,2014,0,5,-384,-1,0,1,1
3,2.5,1680,1620,2.0,0,0,3,9,1120,560,2014,0,98119,47.6425,-122.374,1610,1618,629950,24,3,2015,0,1,-60,8,0,1,1
4,1.75,1470,5350,1.0,0,0,3,7,980,490,1955,0,98125,47.7048,-122.315,1970,6138,465000,11,6,2014,0,59,3880,4168,0,1,1
4,2.5,2300,11165,2.0,0,0,4,8,2300,0,1979,0,98008,47.5794,-122.118,2170,11165,592000,28,1,2015,0,36,8865,8995,0,0,0
3,2.5,1330,816,3.0,0,0,3,8,1330,0,2004,0,98117,47.6836,-122.387,1330,1113,375000,16,7,2014,0,10,-514,-217,0,0,1
5,2.5,2640,7096,2.0,0,0,3,7,2640,0,2003,0,98053,47.6827,-122.038,2640,4850,632500,16,6,2014,0,11,4456,2210,0,0,0
4,1.75,2430,9747,1.0,0,0,3,8,1780,650,1974,0,98155,47.7687,-122.276,2340,10296,459950,8,8,2014,0,40,7317,7956,0,1,1
3,1.0,1440,11330,1.0,0,0,3,7,1440,0,1965,0,98168,47.4742,-122.265,1580,10100,255000,15,1,2015,0,50,9890,8520,0,0,1
3,2.0,1320,7200,1.0,0,0,5,7,1320,0,1975,0,98031,47.3947,-122.174,1540,7200,251750,10,6,2014,0,39,5880,5660,0,0,0
3,2.5,2810,6300,2.0,0,0,3,8,2810,0,2001,0,98074,47.6077,-122.02,2860,6630,725000,1,5,2015,0,14,3490,3770,0,0,0
3,3.25,1370,1194,3.0,0,0,3,8,1370,0,2005,0,98107,47.6704,-122.391,1320,1217,460000,16,10,2014,0,9,-176,-103,0,0,1
3,2.5,2000,6341,1.0,0,0,5,8,1040,960,1981,0,98116,47.5639,-122.401,2030,6341,625000,28,8,2014,0,33,4341,4311,0,1,1
3,1.75,1980,6760,1.0,0,0,4,8,1980,0,1973,0,98008,47.6398,-122.113,2120,7280,530000,8,5,2014,0,41,4780,5160,0,0,0
3,2.5,2050,8172,2.0,0,0,3,8,2050,0,2002,0,98168,47.4808,-122.28,2140,5664,394950,27,4,2015,0,13,6122,3524,0,0,1
4,1.75,2320,9240,1.0,0,0,3,7,1160,1160,1959,2014,98178,47.4909,-122.257,2130,7320,324950,14,8,2014,55,55,6920,5190,1,1,1
3,2.25,1960,1985,2.0,0,0,3,7,1750,210,2003,0,98118,47.5417,-122.289,1760,1985,330000,6,5,2015,0,12,25,225,0,1,1
4,1.75,1910,8171,1.0,0,0,3,7,1910,0,1986,0,98030,47.35,-122.168,1910,7542,220000,17,2,2015,0,29,6261,5632,0,0,0
3,3.25,2030,11070,2.0,0,0,4,8,2030,0,1980,0,98052,47.6478,-122.117,2450,11070,685000,7,7,2014,0,34,9040,8620,0,0,0
3,2.25,2210,7680,1.0,0,2,3,8,1730,480,1972,0,98177,47.7729,-122.389,2390,7680,500000,24,2,2015,0,43,5470,5290,0,1,1
4,2.75,2610,9426,1.0,0,0,3,7,1360,1250,1965,0,98188,47.4435,-122.279,1600,9426,368000,4,9,2014,0,49,6816,7826,0,1,1
3,2.25,2520,7975,2.0,0,0,4,9,1550,970,1990,0,98033,47.6704,-122.183,2520,9900,825000,3,11,2014,0,24,5455,7380,0,1,0
6,1.75,1840,2774,1.0,0,0,3,7,1060,780,1900,0,98122,47.6041,-122.31,1680,4292,660000,16,6,2014,0,114,934,2612,0,1,1
3,1.75,1570,7416,1.0,0,0,4,7,1570,0,1971,0,98031,47.4117,-122.174,1900,7416,253000,29,9,2014,0,43,5846,5516,0,0,0
3,1.75,1930,5400,2.0,0,2,3,9,1930,0,1978,0,98177,47.77,-122.391,2100,6840,605000,14,2,2015,0,37,3470,4740,0,0,1
3,1.0,1160,10384,1.0,0,0,4,6,1160,0,1969,0,98038,47.3634,-122.027,1200,9880,215000,15,5,2014,0,45,9224,8680,0,0,0
4,2.5,2820,15000,2.0,0,0,4,9,2820,0,1985,0,98052,47.7255,-122.101,2440,15000,650000,25,9,2014,0,29,12180,12560,0,0,0
4,2.0,3060,8000,2.0,0,0,4,8,2040,1020,1922,0,98144,47.5795,-122.29,2730,5800,877500,19,2,2015,0,93,4940,3070,0,1,1
3,1.0,1320,8450,1.0,0,0,3,6,880,440,1961,0,98023,47.3278,-122.337,1320,8450,232500,19,6,2014,0,53,7130,7130,0,1,0
2,2.0,1200,3624,2.0,0,0,3,6,1200,0,2003,0,98038,47.349,-122.025,1360,2693,234000,2,12,2014,0,11,2424,1333,0,0,0
3,1.0,1040,9600,1.0,0,0,3,7,1040,0,1978,0,98053,47.6738,-122.063,1370,10889,399950,29,12,2014,0,36,8560,9519,0,0,0
3,2.5,1990,8991,1.0,0,0,3,7,1570,420,1969,0,98042,47.3939,-122.164,1920,8991,256750,21,5,2014,0,45,7001,7071,0,1,0
3,2.5,1690,9626,2.0,0,0,3,8,1690,0,1984,0,98027,47.5647,-122.092,1860,8958,535000,2,6,2014,0,30,7936,7098,0,0,0
3,2.0,1810,2738,2.0,0,0,4,9,1810,0,1979,0,98008,47.6112,-122.115,1760,2754,515000,7,11,2014,0,35,928,994,0,0,0
4,1.75,2520,8442,1.0,0,0,4,7,1640,880,1953,0,98004,47.6317,-122.205,2110,8442,770000,12,2,2015,0,62,5922,6332,0,1,0
3,2.5,1570,5113,1.0,0,0,3,7,1090,480,1996,0,98001,47.3327,-122.29,1570,5150,256000,2,1,2015,0,19,3543,3580,0,1,0
3,1.0,1680,8910,1.0,0,0,4,7,1680,0,1940,0,98117,47.7011,-122.375,1620,7182,489900,21,8,2014,0,74,7230,5562,0,0,1
3,1.5,1250,7200,1.0,0,0,4,7,1250,0,1978,0,98032,47.3678,-122.282,1250,7560,165000,20,8,2014,0,36,5950,6310,0,0,0
3,1.5,1280,7742,1.0,0,0,4,7,1280,0,1962,0,98031,47.3947,-122.197,1450,8316,220000,18,3,2015,0,53,6462,6866,0,0,0
3,2.5,1580,5725,2.0,0,0,3,7,1580,0,2004,0,98072,47.7611,-122.161,1510,5725,375000,30,10,2014,0,10,4145,4215,0,0,0
3,1.75,1650,7145,2.0,0,0,5,8,1300,350,1977,0,98155,47.7733,-122.324,1760,7206,422250,22,1,2015,0,38,5495,5446,0,1,1
3,1.75,1660,9600,1.0,0,0,3,8,1380,280,1981,0,98011,47.7601,-122.167,2030,9500,420000,3,6,2014,0,33,7940,7470,0,1,0
4,2.5,2410,7140,2.0,0,0,3,8,2410,0,1993,0,98074,47.6329,-122.021,2350,7140,608000,23,9,2014,0,21,4730,4790,0,0,0
3,2.25,1720,4000,1.5,0,0,4,7,1450,270,1921,0,98105,47.6683,-122.286,1410,4000,620000,16,5,2014,0,93,2280,2590,0,1,1
3,2.5,3120,12406,2.0,0,2,3,9,1940,1180,1983,0,98006,47.5507,-122.141,3240,13141,850000,17,2,2015,0,32,9286,9901,0,1,0
4,2.5,2680,9928,1.0,0,0,4,8,1340,1340,1974,0,98027,47.5219,-122.052,2180,10478,463000,16,1,2015,0,41,7248,8298,0,1,0
5,1.75,2640,13290,1.0,1,4,4,8,1400,1240,1954,0,98178,47.5022,-122.223,2400,11942,750000,27,1,2015,0,61,10650,9542,0,1,1
3,3.25,3730,13264,2.0,0,0,3,9,3730,0,1989,0,98077,47.7246,-122.059,3730,14933,1070000,25,3,2015,0,26,9534,11203,0,0,0
3,2.0,1700,6498,1.0,0,0,3,7,1700,0,1986,0,98038,47.3781,-122.044,1700,6654,290000,9,9,2014,0,28,4798,4954,0,0,0
4,1.75,2280,5959,1.0,0,0,3,7,1250,1030,1947,0,98116,47.5655,-122.395,1640,5911,525000,10,7,2014,0,67,3679,4271,0,1,1
3,2.25,1220,2980,2.0,0,0,3,7,1220,0,1986,0,98034,47.7151,-122.203,1220,2140,319000,17,2,2015,0,29,1760,920,0,0,0
6,4.5,3500,8504,2.0,0,0,3,7,3500,0,1980,0,98155,47.7349,-122.295,1550,8460,592500,2,2,2015,0,35,5004,6910,0,0,1
3,2.5,2010,14298,2.0,0,0,3,7,2010,0,1977,0,98070,47.5069,-122.472,2010,14298,350000,13,5,2014,0,37,12288,12288,0,0,0
3,1.75,2130,9775,1.0,0,0,4,8,1430,700,1973,0,98027,47.5326,-122.049,2130,11250,454900,26,2,2015,0,42,7645,9120,0,1,0
4,2.25,1800,9018,2.0,0,0,3,7,1800,0,1992,0,98022,47.2126,-121.984,1670,9380,272000,15,4,2015,0,23,7218,7710,0,0,0
3,1.0,1070,10125,1.0,0,0,3,7,1070,0,1961,0,98033,47.7012,-122.167,1540,10200,357500,16,7,2014,0,53,9055,8660,0,0,0
3,1.75,1020,5000,1.0,0,0,5,6,1020,0,1954,0,98118,47.5332,-122.29,1360,5000,285000,28,8,2014,0,60,3980,3640,0,0,1
4,2.0,1600,6861,1.0,0,0,3,7,1600,0,1994,0,98003,47.2701,-122.313,1870,7455,280000,26,3,2015,0,21,5261,5585,0,0,0
4,1.5,1380,7800,1.0,0,0,3,7,1080,300,1928,0,98125,47.7093,-122.306,1770,7503,477000,3,9,2014,0,86,6420,5733,0,1,1
4,2.5,2100,3125,2.0,0,2,3,7,1400,700,1907,1993,98107,47.6634,-122.358,2060,5040,595000,19,11,2014,86,107,1025,2980,1,1,1
3,2.25,2110,2850,3.0,0,0,3,8,2110,0,2001,0,98103,47.6915,-122.339,1340,5001,525000,17,7,2014,0,13,740,3661,0,0,1
3,2.0,1320,5665,1.0,0,0,3,7,1320,0,1986,0,98023,47.3096,-122.357,1336,7080,225000,27,8,2014,0,28,4345,5744,0,0,0
4,2.5,2420,10603,1.0,0,0,5,7,1210,1210,1958,0,98028,47.7397,-122.259,1750,10800,485000,23,7,2014,0,56,8183,9050,0,1,0
3,1.0,1390,4814,1.5,0,0,3,6,1390,0,1908,0,98115,47.6881,-122.32,1730,3990,341000,3,7,2014,0,106,3424,2260,0,0,1
3,3.25,2320,6744,2.0,0,0,3,9,1930,390,2014,0,98125,47.7132,-122.293,1700,6744,674000,16,1,2015,0,1,4424,5044,0,1,1
3,2.5,2170,8169,2.0,0,0,3,8,2170,0,2003,0,98059,47.4833,-122.139,2240,6733,442250,27,1,2015,0,12,5999,4493,0,0,0
3,2.0,1450,8928,1.0,0,0,3,7,1450,0,1998,0,98042,47.3637,-122.075,2050,8523,276000,13,11,2014,0,16,7478,6473,0,0,0
3,2.5,1370,4400,1.0,0,0,3,8,1370,0,1988,0,98034,47.7139,-122.203,1630,4400,394000,22,8,2014,0,26,3030,2770,0,0,0
3,2.5,1810,3192,1.0,0,0,3,7,1070,740,2001,0,98019,47.7364,-121.969,1740,3720,355000,19,11,2014,0,13,1382,1980,0,1,0
3,2.5,1420,14850,1.0,0,0,4,7,1020,400,1963,0,98032,47.3661,-122.29,2060,8800,260000,9,5,2014,0,51,13430,6740,0,1,0
3,2.75,2090,9620,1.0,0,0,3,8,1340,750,1987,0,98023,47.2741,-122.337,2150,9660,300000,1,7,2014,0,27,7530,7510,0,1,0
3,2.75,2090,9620,1.0,0,0,3,8,1340,750,1987,0,98023,47.2741,-122.337,2150,9660,310000,24,3,2015,0,28,7530,7510,0,1,0
3,1.0,1330,6900,1.0,0,0,3,7,1330,0,1976,0,98023,47.3033,-122.381,1530,7000,209000,2,12,2014,0,38,5570,5470,0,0,0
3,2.0,1330,7419,1.0,0,0,3,7,1330,0,1985,0,98034,47.7322,-122.236,1330,7297,344950,11,12,2014,0,29,6089,5967,0,0,0
5,2.0,1910,7200,1.0,0,0,4,6,1110,800,1951,0,98178,47.4975,-122.261,1150,5948,230000,11,6,2014,0,63,5290,4798,0,1,1
3,1.75,2310,7680,1.0,0,0,4,8,1410,900,1978,0,98032,47.3743,-122.285,2080,7680,336950,24,4,2015,0,37,5370,5600,0,1,0
3,2.75,2500,7378,1.0,0,0,5,7,1390,1110,1948,0,98177,47.7032,-122.37,2040,7140,700000,11,6,2014,0,66,4878,5100,0,1,1
3,2.0,1310,7332,1.0,0,0,3,7,1310,0,1987,0,98038,47.3597,-122.051,1530,7362,230000,4,9,2014,0,27,6022,5832,0,0,0
3,2.25,2400,16301,1.0,0,0,3,8,1400,1000,1962,0,98115,47.6901,-122.282,1720,9828,595000,10,12,2014,0,52,13901,8108,0,1,1
3,1.0,1400,4914,1.5,0,0,3,7,1400,0,1929,0,98117,47.681,-122.364,1400,3744,470000,21,11,2014,0,85,3514,2344,0,0,1
4,1.75,1700,7800,1.0,0,0,4,8,1700,0,1975,0,98052,47.651,-122.119,2430,8342,600000,12,12,2014,0,39,6100,5912,0,0,0
4,3.75,3160,9525,2.5,0,0,3,10,3160,0,1997,0,98040,47.5623,-122.221,2400,9525,1380000,27,5,2014,0,17,6365,7125,0,0,0
3,1.75,1340,13241,1.0,0,2,3,7,1340,0,1985,0,98034,47.7268,-122.213,2090,9704,427800,14,11,2014,0,29,11901,7614,0,0,0
4,2.0,1470,8395,1.0,0,0,4,7,1470,0,1965,0,98008,47.631,-122.117,1760,7976,445000,6,6,2014,0,49,6925,6216,0,0,0
3,1.75,1790,7679,1.0,0,0,4,7,1790,0,1953,0,98133,47.7442,-122.338,1560,7680,382000,16,7,2014,0,61,5889,6120,0,0,1
3,1.0,1580,8206,1.0,0,0,3,7,1100,480,1962,0,98198,47.3676,-122.312,1600,8196,255000,24,12,2014,0,52,6626,6596,0,1,1
3,1.0,1090,10000,1.0,0,0,3,6,1090,0,1961,0,98014,47.6503,-121.911,1040,7500,240000,21,7,2014,0,53,8910,6460,0,0,0
5,3.25,3240,6551,1.5,0,4,4,9,2500,740,1939,0,98115,47.6792,-122.273,2740,9300,1230000,20,6,2014,0,75,3311,6560,0,1,1
4,1.75,2520,7200,1.0,0,2,5,7,1260,1260,1955,0,98056,47.4835,-122.192,2360,7300,435000,13,2,2015,0,60,4680,4940,0,1,0
3,1.75,2230,13529,1.0,0,0,3,9,2230,0,1949,0,98004,47.6204,-122.217,2230,11900,1450000,27,3,2015,0,66,11299,9670,0,0,0
4,3.0,2430,5502,2.0,0,0,3,8,2430,0,2002,0,98038,47.356,-122.014,2000,5702,425000,6,5,2015,0,13,3072,3702,0,0,0
2,1.0,1020,4200,1.0,0,0,5,6,1020,0,1923,0,98136,47.5319,-122.391,1660,4200,393000,16,12,2014,0,91,3180,2540,0,0,1
4,1.0,1810,7500,1.0,0,0,2,7,1410,400,1959,0,98168,47.4935,-122.333,1250,6255,264950,20,6,2014,0,55,5690,5005,0,1,1
4,2.5,3460,9699,2.0,0,0,3,10,3460,0,1987,0,98074,47.637,-122.04,3140,10631,746500,12,4,2015,0,28,6239,7491,0,0,0
3,1.0,2020,8100,1.0,0,0,3,7,1170,850,1956,0,98125,47.7136,-122.288,1480,7620,450000,24,11,2014,0,58,6080,6140,0,1,1
3,2.0,1410,7466,1.0,0,0,3,7,1410,0,1983,0,98058,47.427,-122.147,1410,7610,229950,17,6,2014,0,31,6056,6200,0,0,0
2,1.0,750,4000,1.0,0,0,2,6,750,0,1933,0,98108,47.54,-122.32,1160,4000,425000,13,1,2015,0,82,3250,2840,0,0,1
3,2.25,2290,9047,2.0,0,0,4,8,2290,0,1984,0,98006,47.5545,-122.163,2120,9275,753000,31,10,2014,0,30,6757,7155,0,0,0
2,1.0,720,5750,1.0,0,0,2,6,720,0,1943,0,98136,47.5535,-122.393,980,6125,310000,6,10,2014,0,71,5030,5145,0,0,1
2,1.0,1200,6014,1.0,0,0,4,6,600,600,1949,0,98118,47.5357,-122.28,1270,4652,395000,19,12,2014,0,65,4814,3382,0,1,1
4,3.0,2120,7650,2.0,0,0,3,8,2120,0,1964,0,98007,47.6214,-122.14,2260,7885,295000,28,8,2014,0,50,5530,5625,0,0,0
3,1.75,1580,8820,1.0,0,0,4,7,1580,0,1967,0,98003,47.317,-122.325,1280,8500,225000,23,6,2014,0,47,7240,7220,0,0,0
3,2.25,1830,8831,1.0,0,0,3,7,1460,370,1979,0,98034,47.7286,-122.215,2330,8064,431000,2,2,2015,0,36,7001,5734,0,1,0
3,2.5,2000,8057,1.0,0,0,3,8,1360,640,1998,0,98042,47.3724,-122.107,2530,8964,358500,26,3,2015,0,17,6057,6434,0,1,0
2,1.0,980,3600,1.0,0,0,3,6,980,0,1907,0,98119,47.6366,-122.365,1690,3600,595000,28,4,2015,0,108,2620,1910,0,0,1
4,1.0,1740,8100,1.0,0,0,4,7,1020,720,1962,0,98058,47.467,-122.185,1600,8949,260000,3,12,2014,0,52,6360,7349,0,1,0
3,2.0,1450,7300,1.5,0,0,5,7,1450,0,1955,0,98133,47.7517,-122.342,1660,9069,375000,17,9,2014,0,59,5850,7409,0,0,1
3,2.5,1560,4200,2.0,0,0,3,7,1560,0,2003,0,98038,47.3838,-122.026,1560,4200,295000,25,5,2014,0,11,2640,2640,0,0,0
4,2.5,2050,8909,1.0,0,2,4,8,1690,360,1986,0,98198,47.398,-122.31,2190,8912,403900,31,7,2014,0,28,6859,6722,0,1,1
3,1.75,1760,12823,1.0,0,0,4,7,1460,300,1956,0,98002,47.2868,-122.21,1450,10800,269950,22,7,2014,0,58,11063,9350,0,1,0
3,3.5,1740,1975,2.0,0,3,3,8,1310,430,1998,0,98122,47.6085,-122.311,1740,1975,640000,18,2,2015,0,17,235,235,0,1,1
3,1.0,910,8789,1.0,0,0,3,7,910,0,1966,0,98148,47.4345,-122.326,1160,8789,221000,27,6,2014,0,48,7879,7629,0,0,1
3,1.75,1700,7532,1.0,0,0,3,7,1700,0,1987,0,98030,47.355,-122.176,1690,7405,255000,17,6,2014,0,27,5832,5715,0,0,0
4,2.5,2620,4469,2.0,0,0,3,7,2620,0,2008,0,98042,47.3663,-122.115,2250,4500,300000,23,6,2014,0,6,1849,2250,0,0,0
3,2.25,1500,7410,1.0,0,0,4,7,1500,0,1973,0,98058,47.4597,-122.162,1750,7990,270000,20,3,2015,0,42,5910,6240,0,0,0
4,1.75,1630,5750,1.0,0,0,3,7,1160,470,1947,0,98116,47.5674,-122.384,1640,5750,575000,3,3,2015,0,68,4120,4110,0,1,1
3,1.5,1370,9800,1.0,0,0,5,7,1370,0,1968,0,98001,47.3068,-122.27,1370,9800,246900,11,2,2015,0,47,8430,8430,0,0,0
2,2.5,1390,1132,2.0,0,0,3,8,1130,260,2006,0,98102,47.6228,-122.319,1400,1237,635000,6,4,2015,0,9,-258,-163,0,1,1
3,1.0,1190,7500,1.0,0,0,5,7,1190,0,1968,0,98042,47.3248,-122.142,1200,9750,215000,10,9,2014,0,46,6310,8550,0,0,0
4,3.0,2370,8154,1.0,0,0,3,7,1380,990,1977,0,98125,47.7258,-122.306,2100,8148,522500,20,2,2015,0,38,5784,6048,0,1,1
2,1.5,1360,1934,2.0,0,0,4,7,1360,0,1978,0,98092,47.2857,-122.189,1360,1898,150000,22,7,2014,0,36,574,538,0,0,0
4,4.25,4850,12445,2.0,1,4,5,10,3850,1000,1989,0,98034,47.7011,-122.244,3350,12210,3000000,18,6,2014,0,25,7595,8860,0,1,0
4,2.5,3700,7051,2.0,0,0,3,11,3700,0,2006,0,98029,47.5427,-121.995,3580,6175,950000,21,11,2014,0,8,3351,2595,0,0,0
6,2.75,3500,5150,2.0,0,0,5,8,2430,1070,1909,0,98117,47.6842,-122.363,1430,3860,865000,3,12,2014,0,105,1650,2430,0,1,1
3,1.75,1670,9600,1.0,0,0,5,8,1670,0,1961,0,98040,47.5754,-122.233,1900,9600,785000,4,6,2014,0,53,7930,7700,0,0,0
3,2.25,1640,8400,1.0,0,0,3,8,1180,460,1968,0,98032,47.3733,-122.289,1600,8120,245700,25,6,2014,0,46,6760,6520,0,1,0
3,2.25,3400,12825,1.0,0,1,3,9,3400,0,1961,0,98118,47.5435,-122.26,2510,11574,951000,15,4,2015,0,54,9425,9064,0,0,1
3,1.75,2060,3500,1.0,0,0,5,7,1030,1030,1951,0,98118,47.5635,-122.282,1110,6000,499950,2,4,2015,0,64,1440,4890,0,1,1
3,2.0,2330,3600,1.5,0,0,4,7,1580,750,1900,0,98122,47.6025,-122.303,1750,3600,549000,17,9,2014,0,114,1270,1850,0,1,1
5,3.75,3700,7920,3.0,0,4,3,9,2900,800,1983,0,98115,47.6865,-122.266,2860,6360,1400000,11,12,2014,0,31,4220,3500,0,1,1
3,2.0,1990,3000,1.5,0,2,5,8,1430,560,1927,0,98144,47.5891,-122.293,1780,5000,619000,20,8,2014,0,87,1010,3220,0,1,1
5,3.0,2020,5917,1.0,0,0,3,7,1220,800,1993,0,98108,47.5482,-122.294,2130,5529,311000,9,10,2014,0,21,3897,3399,0,1,1
5,2.25,2980,7781,1.0,0,0,3,9,1580,1400,1960,0,98125,47.7048,-122.279,2310,7781,600000,1,7,2014,0,54,4801,5471,0,1,1
4,3.5,3990,5267,2.0,0,0,3,10,3990,0,2008,0,98006,47.5641,-122.124,3230,6481,1080000,26,6,2014,0,6,1277,3251,0,0,0
2,1.0,790,6600,1.0,0,0,3,6,790,0,1949,0,98122,47.6149,-122.293,1520,4400,436000,19,6,2014,0,65,5810,2880,0,0,1
2,1.0,1060,8000,1.0,0,0,3,6,1060,0,1941,0,98168,47.5088,-122.333,1390,8000,205000,15,7,2014,0,73,6940,6610,0,0,1
2,2.5,1900,2983,2.0,0,0,3,8,1900,0,2006,0,98053,47.7029,-122.015,1510,3876,530000,3,9,2014,0,8,1083,2366,0,0,0
5,2.5,3361,6983,2.0,0,0,3,10,3361,0,2006,0,98092,47.3427,-122.169,3112,6920,511000,11,8,2014,0,8,3622,3808,0,0,0
5,2.5,2740,5460,2.0,0,0,3,8,2740,0,2005,0,98031,47.4042,-122.204,2900,5971,370000,10,3,2015,0,10,2720,3071,0,0,0
4,1.75,2040,6000,1.0,0,0,5,7,1020,1020,1943,0,98136,47.5507,-122.383,1440,6000,500000,16,12,2014,0,71,3960,4560,0,1,1
1,1.0,720,5196,1.0,0,0,3,7,720,0,1911,0,98103,47.6928,-122.337,1580,5762,270000,8,9,2014,0,103,4476,4182,0,0,1
3,1.75,2000,8400,1.5,0,0,4,8,2000,0,1959,0,98133,47.7535,-122.334,2000,8400,415000,5,8,2014,0,55,6400,6400,0,0,1
5,4.5,4400,15580,2.0,0,0,3,11,3390,1010,2003,0,98004,47.6232,-122.207,2150,14249,1800000,5,6,2014,0,11,11180,12099,0,1,0
3,1.75,1300,8976,1.0,0,0,3,7,1300,0,1967,0,98003,47.3357,-122.305,1430,9750,236000,17,12,2014,0,47,7676,8320,0,0,0
2,2.5,1420,2229,2.0,0,0,3,7,1420,0,2004,0,98059,47.4871,-122.165,1500,2230,278000,8,12,2014,0,10,809,730,0,0,0
3,2.25,1540,5338,1.0,0,0,5,7,770,770,1954,0,98115,47.6942,-122.304,1680,6525,312000,3,6,2014,0,60,3798,4845,0,1,1
3,2.25,1540,5338,1.0,0,0,5,7,770,770,1954,0,98115,47.6942,-122.304,1680,6525,539000,4,3,2015,0,61,3798,4845,0,1,1
3,3.0,2360,2750,2.0,0,1,3,7,1780,580,1983,0,98125,47.7142,-122.281,1970,5800,498000,10,9,2014,0,31,390,3830,0,1,1
3,1.75,1690,13500,1.0,0,0,4,7,1690,0,1978,0,98040,47.5897,-122.233,1950,10500,780000,25,2,2015,0,37,11810,8550,0,0,0
3,2.0,2300,5000,1.0,0,0,4,8,1150,1150,1938,0,98199,47.6521,-122.413,2300,5000,650000,23,9,2014,0,76,2700,2700,0,1,1
4,1.75,1650,7088,1.0,0,0,3,8,1650,0,1973,0,98027,47.5688,-122.087,1850,7523,559500,9,4,2015,0,42,5438,5673,0,0,0
2,1.0,990,6448,1.0,0,0,3,7,990,0,1948,0,98178,47.5031,-122.245,1130,7200,219950,24,7,2014,0,66,5458,6070,0,0,1
4,2.25,2130,8410,2.0,0,0,4,8,2130,0,1977,0,98006,47.5589,-122.128,2170,8400,671500,25,7,2014,0,37,6280,6230,0,0,0
3,2.25,1960,8875,1.0,0,0,3,7,1290,670,1965,0,98003,47.3344,-122.301,1890,8700,182000,28,7,2014,0,49,6915,6810,0,1,0
2,1.0,770,2500,1.0,0,0,3,6,770,0,1913,1960,98072,47.7534,-122.172,1500,8286,203700,22,8,2014,47,101,1730,6786,1,0,0
4,1.75,2010,3600,1.5,0,0,3,7,2010,0,1902,0,98119,47.6337,-122.371,2010,3600,740000,5,5,2014,0,112,1590,1590,0,0,1
2,1.0,800,17965,1.0,0,0,4,5,800,0,1942,0,98058,47.4693,-122.161,1500,8925,230000,11,3,2015,0,73,17165,7425,0,0,0
3,1.0,910,11117,1.0,0,0,3,7,910,0,1955,0,98003,47.3432,-122.309,1490,8416,128000,9,10,2014,0,59,10207,6926,0,0,0
3,1.0,1200,6628,1.0,0,0,4,7,1200,0,1952,0,98155,47.7367,-122.319,1330,6768,345000,22,8,2014,0,62,5428,5438,0,0,1
4,2.5,3570,6246,2.0,0,0,3,7,3570,0,2005,0,98075,47.5927,-122.006,2260,5231,663000,27,4,2015,0,10,2676,2971,0,0,0
3,2.5,1820,8085,2.0,0,0,3,7,1820,0,1983,0,98055,47.4575,-122.204,1860,8625,329950,20,6,2014,0,31,6265,6765,0,0,0
3,2.25,2930,7005,3.0,0,2,3,9,2670,260,1999,0,98117,47.6763,-122.404,2450,6460,1050000,11,8,2014,0,15,4075,4010,0,1,1
3,1.75,1480,4050,1.0,0,0,3,7,870,610,1926,0,98115,47.681,-122.304,1350,4500,402300,12,11,2014,0,88,2570,3150,0,1,1
4,2.5,3305,16164,1.5,0,0,5,7,2245,1060,1922,1956,98133,47.7563,-122.338,1620,8883,492000,7,5,2014,34,92,12859,7263,1,1,1
4,2.5,2230,5000,1.0,0,0,3,7,1650,580,2006,0,98059,47.4799,-122.129,2090,4637,448000,7,5,2015,0,9,2770,2547,0,1,0
3,1.0,1560,7800,1.0,0,0,3,7,1560,0,1955,0,98188,47.4549,-122.287,1468,9375,273000,25,2,2015,0,60,6240,7907,0,0,1
3,1.0,1030,7200,1.0,0,0,3,6,880,150,1948,0,98126,47.5255,-122.376,1030,7200,335000,3,10,2014,0,66,6170,6170,0,1,1
3,3.75,2380,3600,1.5,0,0,3,7,1690,690,1927,0,98112,47.6374,-122.307,1990,3520,695000,5,9,2014,0,87,1220,1530,0,1,1
3,1.0,1010,7903,1.0,0,0,3,6,1010,0,1948,0,98155,47.766,-122.32,1010,7903,279000,3,5,2015,0,67,6893,6893,0,0,1
2,1.75,2060,2700,1.0,0,0,3,7,1030,1030,1929,0,98115,47.6856,-122.312,1390,2700,485000,5,12,2014,0,85,640,1310,0,1,1
4,2.5,2370,10580,2.0,0,0,3,8,2370,0,1966,0,98055,47.464,-122.192,1590,8584,383000,12,8,2014,0,48,8210,6994,0,0,0
2,1.5,1078,1263,2.0,0,0,3,7,1078,0,1990,0,98028,47.7532,-122.244,1078,1263,240000,19,11,2014,0,24,185,185,0,0,0
2,1.0,890,7250,1.0,0,0,3,7,890,0,1943,0,98125,47.7118,-122.314,900,7000,285000,24,2,2015,0,72,6360,6100,0,0,1
3,1.75,1420,8250,1.0,0,0,4,7,1420,0,1960,0,98007,47.6112,-122.133,2020,8250,460000,5,9,2014,0,54,6830,6230,0,0,0
3,1.5,1280,2114,1.5,0,0,3,8,1280,0,1904,0,98122,47.6174,-122.308,1540,1456,687500,14,10,2014,0,110,834,-84,0,0,1
4,2.25,2430,10050,2.0,0,0,4,8,2430,0,1979,0,98006,47.5563,-122.163,2390,10250,825000,15,10,2014,0,35,7620,7860,0,0,0
2,2.5,1860,6359,2.0,0,0,3,7,1860,0,2003,0,98038,47.3847,-122.029,1860,6359,314950,29,7,2014,0,11,4499,4499,0,0,0
3,2.0,1800,12669,1.0,0,0,3,7,1800,0,1956,1990,98033,47.6935,-122.173,1970,9775,470000,4,6,2014,34,58,10869,7805,1,0,0
3,1.5,1960,8815,1.0,0,0,4,7,1020,940,1958,0,98006,47.5765,-122.159,1760,9534,500000,18,8,2014,0,56,6855,7774,0,1,0
3,1.5,1550,7260,1.5,0,0,2,6,1550,0,1925,0,98166,47.4693,-122.349,1190,7620,313000,17,11,2014,0,89,5710,6430,0,0,1
2,1.0,840,3840,1.0,0,0,4,7,840,0,1926,0,98117,47.684,-122.378,1310,3840,445000,10,7,2014,0,88,3000,2530,0,0,1
4,1.75,2080,8750,1.0,0,0,4,8,1330,750,1967,0,98032,47.3749,-122.291,1790,8750,300000,28,8,2014,0,47,6670,6960,0,1,0
4,2.5,2210,5077,1.5,0,0,4,8,1480,730,1912,0,98126,47.5719,-122.377,1740,5000,619500,14,10,2014,0,102,2867,3260,0,1,1
3,1.5,1210,5240,1.0,0,0,4,7,610,600,1983,0,98106,47.5524,-122.356,1560,5240,305000,13,6,2014,0,31,4030,3680,0,1,1
3,2.5,1350,941,3.0,0,0,3,9,1350,0,2007,0,98119,47.6265,-122.364,1640,1369,874000,1,4,2015,0,8,-409,-271,0,0,1
3,2.0,1860,5146,2.0,0,0,3,8,1860,0,1991,0,98029,47.5706,-121.999,1950,5146,477500,13,3,2015,0,24,3286,3196,0,0,0
3,2.0,1940,4500,1.0,0,3,3,7,1090,850,1926,0,98107,47.6659,-122.359,1700,4500,700000,10,11,2014,0,88,2560,2800,0,1,1
4,3.5,3400,5222,2.0,0,0,3,9,3400,0,2005,0,98038,47.3559,-122.0,3190,5326,515000,6,3,2015,0,10,1822,2136,0,0,0
4,2.5,2240,9385,2.0,0,0,3,8,2240,0,1991,0,98133,47.7125,-122.332,2010,9000,590000,16,10,2014,0,23,7145,6990,0,0,1
3,1.75,1170,8239,1.0,0,0,3,7,1170,0,1981,0,98042,47.3679,-122.088,1180,7866,205000,1,7,2014,0,33,7069,6686,0,0,0
3,3.25,3130,9302,2.0,0,0,3,8,2190,940,1987,0,98023,47.3078,-122.338,2350,7949,310000,22,10,2014,0,27,6172,5599,0,1,0
2,2.25,1510,7280,2.0,0,0,3,7,1510,0,1987,0,98074,47.6264,-122.058,1510,8120,442500,21,8,2014,0,27,5770,6610,0,0,0
4,1.75,1760,6204,1.0,0,2,4,7,1180,580,1950,0,98178,47.5045,-122.24,1990,6240,343500,24,6,2014,0,64,4444,4250,0,1,1
4,1.75,2180,4066,1.5,0,0,3,6,1270,910,1911,0,98118,47.5487,-122.277,1400,1343,334900,23,4,2015,0,104,1886,-57,0,1,1
4,1.75,1560,9000,1.0,0,0,5,7,1560,0,1969,0,98052,47.6707,-122.149,1510,8848,544300,5,11,2014,0,45,7440,7338,0,0,0
3,2.5,1780,4050,2.0,0,0,3,7,1780,0,2001,0,98155,47.7346,-122.308,1571,4976,370000,26,5,2014,0,13,2270,3405,0,0,1
3,1.75,1260,6908,1.0,0,0,3,7,1260,0,1994,0,98038,47.385,-122.031,1810,7159,245000,24,5,2014,0,20,5648,5349,0,0,0
4,1.75,1570,3250,1.5,0,0,5,8,1570,0,1928,0,98136,47.5405,-122.393,1570,5720,535000,10,2,2015,0,87,1680,4150,0,0,1
2,1.0,740,6550,1.0,0,0,4,5,740,0,1946,0,98168,47.4807,-122.332,1080,8515,202000,6,4,2015,0,69,5810,7435,0,0,1
4,2.25,2020,4960,2.0,0,0,3,7,1710,310,1938,0,98117,47.6867,-122.369,1590,4550,490000,18,11,2014,0,76,2940,2960,0,1,1
4,1.5,1500,3075,2.0,0,0,5,7,1420,80,1929,0,98103,47.6893,-122.35,1480,3774,651500,16,12,2014,0,85,1575,2294,0,1,1
4,2.5,1670,8056,1.0,0,0,3,7,1170,500,1961,0,98168,47.4884,-122.319,1360,8056,270000,14,1,2015,0,54,6386,6696,0,1,1
3,3.5,3620,8072,2.0,0,0,3,10,2920,700,1999,0,98006,47.5646,-122.127,3680,9624,1160000,7,4,2015,0,16,4452,5944,0,1,0
2,1.5,1010,1309,2.0,0,0,3,7,860,150,2007,0,98118,47.5659,-122.286,1190,3060,289000,16,7,2014,0,7,299,1870,0,1,1
3,1.5,1460,13503,1.0,0,0,4,6,1460,0,1977,0,98010,47.3119,-122.015,1460,13394,240000,17,4,2015,0,38,12043,11934,0,0,0
3,1.75,1790,6117,1.0,0,2,3,8,1350,440,1940,0,98199,47.6366,-122.401,1960,5554,790000,15,5,2014,0,74,4327,3594,0,1,1
3,2.25,1760,9621,2.0,0,0,3,7,1760,0,1995,0,98019,47.7466,-121.979,1810,6589,350000,22,12,2014,0,19,7861,4779,0,0,0
3,3.5,1790,1682,2.0,0,0,3,7,1480,310,2006,0,98108,47.542,-122.321,1150,4000,246950,29,10,2014,0,8,-108,2850,0,1,1
3,1.0,1050,6000,1.0,0,0,3,7,1050,0,1952,0,98116,47.5709,-122.401,1720,6000,400000,5,1,2015,0,63,4950,4280,0,0,1
4,2.5,2590,6394,2.0,0,0,3,8,2590,0,2003,0,98028,47.7599,-122.233,2500,5328,533000,25,2,2015,0,12,3804,2828,0,0,0
3,1.0,1040,8645,1.0,0,0,4,7,1040,0,1962,0,98042,47.3631,-122.116,1290,8645,198400,21,10,2014,0,52,7605,7355,0,0,0
4,2.5,4060,8547,2.0,0,0,3,9,2790,1270,2007,0,98038,47.3694,-122.056,2810,8313,495000,29,10,2014,0,7,4487,5503,0,1,0
4,1.75,2180,9726,1.0,0,0,4,9,2180,0,1966,0,98040,47.5359,-122.233,2560,10244,875000,24,2,2015,0,49,7546,7684,0,0,0
6,3.5,2120,5840,2.0,0,0,5,7,2120,0,1979,0,98055,47.4788,-122.227,1860,8000,317000,3,9,2014,0,35,3720,6140,0,0,0
4,2.75,2110,6838,2.0,0,0,4,8,2110,0,1991,0,98031,47.3877,-122.171,2100,7280,325000,25,7,2014,0,23,4728,5180,0,0,0
2,1.5,1210,5000,1.5,0,0,5,6,1210,0,1907,0,98117,47.6793,-122.397,1570,5000,615000,20,9,2014,0,107,3790,3430,0,0,1
4,2.5,2410,7846,2.0,0,0,3,8,2410,0,1992,0,98003,47.2641,-122.312,2380,7914,334950,21,7,2014,0,22,5436,5534,0,0,0
3,2.5,1980,7807,2.0,0,0,4,9,1980,0,1989,0,98033,47.6884,-122.204,1590,7579,775000,21,8,2014,0,25,5827,5989,0,0,0
4,2.5,2370,9135,1.0,0,0,4,8,1600,770,1967,0,98006,47.5564,-122.177,2050,9468,600000,22,8,2014,0,47,6765,7418,0,1,0
3,1.75,1720,2218,1.5,0,0,3,7,1270,450,1931,2003,98103,47.649,-122.335,1130,1600,565000,28,7,2014,72,83,498,470,1,1,1
2,1.0,750,5026,1.0,0,0,4,6,750,0,1942,0,98126,47.5368,-122.374,1260,5040,292500,28,10,2014,0,72,4276,3780,0,0,1
3,2.25,2510,10418,1.0,0,0,3,8,1810,700,1968,0,98115,47.7003,-122.285,2510,9435,825000,29,4,2015,0,47,7908,6925,0,1,1
3,1.5,1540,4773,2.0,0,0,3,8,1540,0,1941,2009,98126,47.5678,-122.378,1540,5750,525000,20,5,2014,68,73,3233,4210,1,0,1
1,1.0,720,2500,1.0,0,0,3,7,720,0,1910,0,98103,47.6597,-122.345,1520,3750,438600,11,5,2015,0,105,1780,2230,0,0,1
3,2.25,1810,8158,1.0,0,0,3,8,1450,360,1984,0,98074,47.6258,-122.038,1740,9532,507000,14,8,2014,0,30,6348,7792,0,1,0
3,1.75,1380,8400,1.0,0,0,3,7,1380,0,1967,0,98003,47.3117,-122.321,1540,8400,275900,29,4,2015,0,48,7020,6860,0,0,0
4,2.5,2570,6251,2.0,0,0,3,9,2570,0,2000,0,98004,47.593,-122.197,2570,9588,1170000,17,6,2014,0,14,3681,7018,0,0,0
4,1.75,1690,6000,1.0,0,0,3,7,1690,0,1957,0,98178,47.497,-122.227,1350,6000,275000,9,12,2014,0,57,4310,4650,0,0,1
3,0.75,1420,3060,1.0,0,0,4,7,860,560,1923,0,98103,47.6872,-122.346,1350,4000,355000,27,10,2014,0,91,1640,2650,0,1,1
4,2.0,2130,9579,1.0,0,0,4,7,1250,880,1968,0,98001,47.3069,-122.271,1590,9800,233000,26,1,2015,0,47,7449,8210,0,1,0
3,2.5,3000,5000,1.5,0,0,4,7,2110,890,1918,0,98144,47.5781,-122.293,1970,5000,666000,4,9,2014,0,96,2000,3030,0,1,1
4,2.5,2150,9000,1.0,0,0,4,7,1360,790,1979,0,98059,47.4785,-122.16,1620,8400,317500,11,8,2014,0,35,6850,6780,0,1,0
4,2.0,2280,10319,1.0,0,3,4,8,1270,1010,1989,0,98198,47.3594,-122.322,2280,9767,420000,22,7,2014,0,25,8039,7487,0,1,1
4,2.0,1560,8800,2.0,0,0,5,6,1560,0,1942,1967,98168,47.4927,-122.312,1480,10000,290000,12,3,2015,25,73,7240,8520,1,0,1
3,2.5,2320,5284,2.0,0,0,3,8,2320,0,2004,0,98075,47.591,-122.017,2320,4383,650000,23,3,2015,0,11,2964,2063,0,0,0
3,1.75,1010,7171,1.0,0,0,4,7,1010,0,1967,0,98034,47.7317,-122.231,1250,7560,325000,14,7,2014,0,47,6161,6310,0,0,0
3,1.0,1120,5000,1.0,0,0,3,6,1120,0,1917,0,98146,47.5109,-122.357,1050,5000,165000,20,8,2014,0,97,3880,3950,0,0,1
4,1.5,1860,12197,1.0,0,0,3,7,1860,0,1964,0,98034,47.729,-122.235,1510,11761,443000,16,7,2014,0,50,10337,10251,0,0,0
3,1.5,1150,8686,1.0,0,0,4,7,1150,0,1963,0,98055,47.4417,-122.194,1760,8798,213400,9,6,2014,0,51,7536,7038,0,0,0
4,1.75,1920,9380,1.0,0,0,3,7,1920,0,1964,0,98008,47.6344,-122.118,1580,8580,480000,2,10,2014,0,50,7460,7000,0,0,0
4,2.25,2490,7233,1.0,0,0,3,8,1460,1030,1978,0,98023,47.3115,-122.396,2000,8000,275000,15,1,2015,0,37,4743,6000,0,1,0
3,2.5,1460,3044,2.0,0,0,3,7,1460,0,2000,0,98108,47.544,-122.296,1490,3044,299880,9,7,2014,0,14,1584,1554,0,0,1
3,3.5,1820,1501,2.0,0,0,3,8,1430,390,2014,0,98144,47.596,-122.298,1550,1501,499950,27,5,2014,0,0,-319,-49,0,1,1
4,2.75,2230,9460,1.0,0,0,5,7,1480,750,1960,0,98027,47.5246,-122.044,1760,10878,550000,6,8,2014,0,54,7230,9118,0,1,0
4,2.5,2070,7476,2.0,0,0,3,8,2070,0,2003,0,98092,47.3352,-122.189,2430,5500,300000,2,6,2014,0,11,5406,3070,0,0,0
3,1.75,2480,4000,1.0,0,0,3,8,1240,1240,1948,2014,98122,47.615,-122.288,2450,4000,920000,14,10,2014,66,66,1520,1550,1,1,1
4,2.75,2290,3060,1.5,0,0,5,7,1550,740,1928,0,98115,47.6793,-122.316,1460,3060,620000,24,7,2014,0,86,770,1600,0,1,1
4,2.75,2620,13777,1.5,0,2,4,9,1720,900,1926,0,98144,47.58,-122.285,3530,9287,978000,20,5,2014,0,88,11157,5757,0,1,1
4,2.5,3190,9856,2.0,0,0,3,8,3190,0,1979,0,98058,47.4445,-122.126,2260,7996,387500,2,12,2014,0,35,6666,5736,0,0,0
3,1.0,850,6906,1.0,0,0,3,6,850,0,1948,0,98155,47.7441,-122.314,1150,6907,325000,24,6,2014,0,66,6056,5757,0,0,1
3,2.5,1740,1308,3.0,0,0,3,8,1740,0,2008,0,98116,47.5892,-122.387,1740,1280,568000,10,4,2015,0,7,-432,-460,0,0,1
4,2.5,2140,7754,2.0,0,0,3,8,2140,0,1996,0,98133,47.7173,-122.338,1690,7775,525000,22,9,2014,0,18,5614,6085,0,0,1
3,2.5,2070,12708,2.0,0,0,3,8,2070,0,1996,0,98056,47.5295,-122.18,2620,9617,560000,4,6,2014,0,18,10638,6997,0,0,0
3,2.5,1680,4075,2.0,0,0,3,7,1680,0,2008,0,98053,47.6964,-122.024,1710,4075,394000,20,10,2014,0,6,2395,2365,0,0,0
2,1.0,1000,4956,1.0,0,2,4,7,1000,0,1916,0,98107,47.6753,-122.36,1830,4959,484950,28,10,2014,0,98,3956,3129,0,0,1
3,2.75,3340,12690,1.0,0,0,3,10,2550,790,1956,1988,98105,47.6665,-122.27,3340,9480,1300000,5,11,2014,32,58,9350,6140,1,1,1
3,2.5,1260,2767,2.0,0,0,3,8,1260,0,1999,0,98059,47.4914,-122.155,1310,2767,315000,29,7,2014,0,15,1507,1457,0,0,0
1,1.0,560,5700,1.0,0,0,3,5,560,0,1947,0,98146,47.511,-122.359,1120,5000,106000,26,11,2014,0,67,5140,3880,0,0,1
3,2.5,3380,9528,2.0,0,0,3,10,3380,0,1994,0,98059,47.5275,-122.148,3630,14089,751000,18,11,2014,0,20,6148,10459,0,0,0
2,1.0,1100,3500,1.0,0,0,5,7,1100,0,1908,0,98115,47.6741,-122.323,2050,4000,474000,17,10,2014,0,106,2400,1950,0,0,1
2,2.0,1700,3171,1.0,0,0,5,5,850,850,1927,0,98002,47.3025,-122.224,1380,5906,189000,28,5,2014,0,87,1471,4526,0,1,0
3,2.5,1600,3172,2.0,0,0,3,7,1600,0,2002,0,98053,47.6868,-122.042,1690,3698,440500,24,10,2014,0,12,1572,2008,0,0,0
3,2.5,2605,2216,2.0,0,2,4,9,2090,515,1979,0,98033,47.6529,-122.202,2605,1979,1020000,18,3,2015,0,36,-389,-626,0,1,0
2,2.0,1850,4667,1.0,0,0,3,8,1850,0,2010,0,98053,47.7101,-122.014,1860,6008,589000,11,5,2015,0,5,2817,4148,0,0,0
3,2.25,1830,7651,2.0,0,0,3,8,1830,0,1986,0,98092,47.2642,-122.219,2160,8442,273000,29,8,2014,0,28,5821,6282,0,0,0
2,1.5,1240,1055,2.0,0,0,3,8,1200,40,1967,0,98008,47.6104,-122.112,1410,1340,277700,10,11,2014,0,47,-185,-70,0,1,0
3,2.25,2100,8163,2.0,0,0,3,7,2100,0,1984,0,98001,47.3336,-122.269,1410,7515,299900,24,11,2014,0,30,6063,6105,0,0,0
3,1.0,1250,15603,1.0,0,0,4,7,1250,0,1959,0,98056,47.5093,-122.172,1720,10220,235000,3,6,2014,0,55,14353,8500,0,0,0
2,2.0,1230,4800,2.0,0,0,3,7,1230,0,1952,2004,98133,47.7145,-122.35,1560,7200,464000,6,5,2015,52,63,3570,5640,1,0,1
3,1.75,1690,9826,1.0,0,0,4,7,1690,0,1988,0,98023,47.314,-122.365,1980,9826,281000,17,3,2015,0,27,8136,7846,0,0,0
3,1.0,1520,8870,1.5,0,0,4,7,1520,0,1951,0,98155,47.7638,-122.317,1520,7800,320000,7,11,2014,0,63,7350,6280,0,0,1
4,2.0,1890,6302,2.0,0,0,3,7,1890,0,1997,0,98030,47.3846,-122.205,1690,5369,282000,20,6,2014,0,17,4412,3679,0,0,0
4,1.75,1990,8900,1.0,0,0,4,8,1990,0,1972,0,98006,47.5639,-122.149,2620,8925,745000,20,2,2015,0,43,6910,6305,0,0,0
3,1.75,1480,3900,1.0,0,0,4,7,1480,0,1980,0,98023,47.2977,-122.367,1830,6956,245000,20,8,2014,0,34,2420,5126,0,0,0
3,1.75,1480,3900,1.0,0,0,4,7,1480,0,1980,0,98023,47.2977,-122.367,1830,6956,250000,20,10,2014,0,34,2420,5126,0,0,0
3,2.5,2120,2374,2.0,0,0,3,8,1770,350,2005,0,98052,47.674,-122.142,2480,3043,470000,22,9,2014,0,9,254,563,0,1,0
3,3.5,1480,1077,2.0,0,0,3,7,1300,180,2007,0,98109,47.5421,-122.322,1140,2003,216650,15,10,2014,0,7,-403,863,0,1,1
3,1.0,1250,8412,1.0,0,0,4,7,1250,0,1975,0,98052,47.7012,-122.131,1840,8976,440000,5,5,2015,0,40,7162,7136,0,0,0
4,2.5,2010,7972,2.0,0,0,4,8,2010,0,1989,0,98029,47.5782,-122.018,2100,8511,590000,13,6,2014,0,25,5962,6411,0,0,0
3,3.5,3010,5717,2.0,0,0,3,10,3010,0,2000,0,98007,47.5943,-122.15,2780,5138,848000,22,9,2014,0,14,2707,2358,0,0,0
5,4.25,3920,5823,2.0,0,0,3,9,3000,920,2000,0,98029,47.5492,-122.008,3000,5297,827500,12,3,2015,0,15,1903,2297,0,1,0
6,3.0,2880,3192,2.0,0,0,4,8,2180,700,1919,0,98103,47.6506,-122.332,1870,4533,1130000,20,5,2014,0,95,312,2663,0,1,1
2,2.25,2550,5663,1.0,0,0,3,10,1720,830,2011,0,98056,47.5304,-122.202,2560,3828,630000,7,5,2014,0,3,3113,1268,0,1,0
5,1.0,1120,9022,1.5,0,0,4,7,1120,0,1962,0,98034,47.7296,-122.24,1310,7500,340000,5,5,2014,0,52,7902,6190,0,0,0
4,2.75,3140,10918,1.0,0,0,3,8,1900,1240,1968,1986,98034,47.7086,-122.243,3170,10918,570000,23,9,2014,18,46,7778,7748,1,1,0
4,4.0,4130,5575,2.0,1,4,4,10,2860,1270,1993,0,98075,47.5968,-122.083,2980,5575,2750000,9,12,2014,0,21,1445,2595,0,1,0
4,2.5,2990,9614,1.0,0,2,4,9,1740,1250,1976,0,98003,47.3424,-122.329,3370,12085,514500,2,1,2015,0,39,6624,8715,0,1,0
2,1.0,1120,12625,1.0,0,3,3,7,1120,0,1940,0,98136,47.5397,-122.385,1880,6828,360000,13,4,2015,0,75,11505,4948,0,0,1
4,1.5,1570,8775,1.0,0,0,3,7,1570,0,1943,0,98166,47.4789,-122.335,980,8775,228900,17,12,2014,0,71,7205,7795,0,0,1
3,2.75,2210,4000,2.0,0,0,3,8,2210,0,2008,0,98053,47.6954,-122.017,2230,4674,660000,25,6,2014,0,6,1790,2444,0,0,0
4,2.5,2390,5800,2.0,0,0,3,9,2390,0,2000,0,98075,47.5965,-122.038,2590,6507,647000,3,3,2015,0,15,3410,3917,0,0,0
3,1.75,1520,8625,1.0,0,0,3,8,1520,0,1976,0,98011,47.7687,-122.223,2080,9200,366000,10,6,2014,0,38,7105,7120,0,0,0
5,1.75,1830,7986,1.0,0,0,4,7,1060,770,1962,0,98106,47.5208,-122.35,1410,7260,354000,18,7,2014,0,52,6156,5850,0,1,1
4,3.5,2640,5900,2.0,0,2,3,8,2640,0,1937,1998,98136,47.5421,-122.383,1700,5900,850000,19,5,2014,61,77,3260,4200,1,0,1
3,2.5,1740,5782,2.0,0,0,4,8,1740,0,1989,0,98029,47.5783,-122.001,2080,5782,496700,24,5,2014,0,25,4042,3702,0,0,0
3,2.0,1550,8300,1.0,0,0,4,8,1550,0,1965,0,98055,47.4654,-122.195,1860,8000,300000,4,11,2014,0,49,6750,6140,0,0,0
3,1.0,1040,8075,1.0,0,0,4,7,1040,0,1961,0,98033,47.6701,-122.176,1450,8075,390000,17,10,2014,0,53,7035,6625,0,0,0
3,2.25,1640,7200,2.0,0,0,4,8,1640,0,1985,0,98007,47.5948,-122.153,1830,8372,350000,19,5,2014,0,29,5560,6542,0,0,0
3,2.25,1640,7200,2.0,0,0,4,8,1640,0,1985,0,98007,47.5948,-122.153,1830,8372,561000,22,9,2014,0,29,5560,6542,0,0,0
3,1.75,1260,10065,1.0,0,0,3,7,1260,0,1954,2014,98006,47.5727,-122.138,1320,10278,475000,30,7,2014,60,60,8805,8958,1,0,0
3,1.5,1170,1174,2.0,0,0,3,7,840,330,2007,0,98126,47.5459,-122.376,1170,2537,275000,16,10,2014,0,7,4,1367,0,1,1
3,1.75,1590,13500,1.0,0,0,4,7,1090,500,1980,0,98038,47.3621,-122.031,1540,10375,290000,28,10,2014,0,34,11910,8835,0,1,0
3,2.5,1750,6725,1.0,0,0,3,7,1330,420,1993,0,98038,47.352,-122.058,1670,7744,199000,11,2,2015,0,22,4975,6074,0,1,0
4,2.5,1770,4338,2.0,0,0,3,7,1770,0,2001,0,98042,47.3672,-122.099,1770,6606,279900,24,3,2015,0,14,2568,4836,0,0,0
4,2.25,3530,5500,2.0,0,0,3,8,2860,670,1940,0,98105,47.6618,-122.273,2840,5500,1660000,5,5,2015,0,75,1970,2660,0,1,1
3,2.5,2160,10200,1.0,0,0,3,7,1360,800,1978,0,98133,47.7295,-122.331,2010,7850,405000,13,4,2015,0,37,8040,5840,0,1,1
4,2.25,2360,15860,1.0,0,0,3,9,2360,0,1977,0,98074,47.6307,-122.051,2650,11798,615000,27,1,2015,0,38,13500,9148,0,0,0
3,1.75,1980,12543,1.0,0,0,3,8,1180,800,1978,0,98023,47.3104,-122.394,2090,8539,268000,2,10,2014,0,36,10563,6449,0,1,0
4,1.5,1620,5444,1.5,0,0,3,8,1620,0,1955,0,98125,47.7065,-122.297,1620,6912,451000,25,8,2014,0,59,3824,5292,0,0,1
2,2.75,2700,9854,1.0,0,0,3,9,2700,0,2012,0,98053,47.7187,-122.024,1440,4168,850000,15,12,2014,0,2,7154,2728,0,0,0
2,1.0,870,6150,1.0,0,0,3,6,870,0,1941,0,98106,47.5256,-122.347,1120,6150,245000,16,5,2014,0,73,5280,5030,0,0,1
2,1.75,840,3340,1.0,0,0,3,6,700,140,1912,0,98107,47.6692,-122.359,1700,3980,450000,26,6,2014,0,102,2500,2280,0,1,1
3,3.5,1340,1168,2.0,0,2,3,8,1080,260,2002,0,98133,47.711,-122.356,1650,1378,370350,9,4,2015,0,13,-172,-272,0,1,1
3,2.5,1540,1256,3.0,0,0,3,8,1540,0,2004,0,98103,47.6498,-122.346,1500,1350,543000,29,7,2014,0,10,-284,-150,0,0,1
2,2.0,1650,8975,1.0,0,0,5,6,1650,0,1942,0,98146,47.5073,-122.36,1260,8668,265000,27,1,2015,0,73,7325,7408,0,0,1
3,2.5,2630,4611,2.0,0,0,3,8,2630,0,2001,0,98065,47.5322,-121.868,2220,5250,497000,25,3,2015,0,14,1981,3030,0,0,0
4,2.25,1880,9727,1.0,0,0,3,7,1100,780,1979,0,98028,47.7731,-122.257,1790,10274,419000,12,4,2015,0,36,7847,8484,0,1,0
4,2.5,1980,4500,2.0,0,0,3,8,1980,0,1989,0,98029,47.579,-122.001,1770,4595,545800,24,7,2014,0,25,2520,2825,0,0,0
3,1.0,1500,10730,1.0,0,0,3,7,1000,500,1977,0,98053,47.6385,-121.966,1570,12210,403000,3,4,2015,0,38,9230,10640,0,1,0
3,2.0,1230,8235,1.5,0,0,3,6,1230,0,1959,0,98168,47.4853,-122.304,1080,10281,195000,10,11,2014,0,55,7005,9201,0,0,1
4,2.5,2520,2600,2.0,0,0,5,8,1670,850,1925,0,98119,47.6434,-122.358,2290,3600,1130000,11,12,2014,0,89,80,1310,0,1,1
5,1.75,1970,8925,1.0,0,0,5,7,1170,800,1977,0,98002,47.2925,-122.196,1910,8025,255000,29,9,2014,0,37,6955,6115,0,1,0
2,1.5,1520,8040,1.0,0,0,5,7,1520,0,1951,0,98125,47.7131,-122.306,1440,8040,500000,27,6,2014,0,63,6520,6600,0,0,1
4,2.75,2600,5390,1.0,0,0,4,8,1300,1300,1960,0,98199,47.6382,-122.397,2550,5600,855000,5,5,2014,0,54,2790,3050,0,1,1
4,2.0,2290,9200,1.5,0,0,3,7,2290,0,1920,0,98166,47.4678,-122.363,2140,9200,390000,7,1,2015,0,95,6910,7060,0,0,1
3,2.0,1979,8470,1.0,0,2,4,7,1329,650,1956,0,98198,47.3912,-122.301,1650,8591,339000,24,3,2015,0,59,6491,6941,0,1,1
4,3.5,2170,3672,2.0,0,0,3,9,2170,0,1905,1989,98115,47.6828,-122.329,1950,3450,1330000,6,3,2015,84,110,1502,1500,1,0,1
4,1.5,1820,17918,1.0,0,0,4,8,1190,630,1962,0,98056,47.521,-122.179,1890,15241,429900,17,2,2015,0,53,16098,13351,0,1,0
3,1.5,1200,8560,1.0,0,0,4,7,1200,0,1975,0,98011,47.7392,-122.194,1550,7800,370900,25,9,2014,0,39,7360,6250,0,0,0
3,1.0,1210,7636,1.0,0,0,4,7,1210,0,1952,0,98118,47.5377,-122.266,1530,5900,457500,29,4,2015,0,63,6426,4370,0,0,1
4,2.5,1970,2601,2.0,0,0,3,7,1440,530,1999,0,98144,47.5949,-122.308,1760,3025,499000,27,2,2015,0,16,631,1265,0,1,1
2,1.0,1040,11500,1.0,0,0,5,7,1040,0,1947,0,98003,47.2791,-122.3,1300,11954,225000,12,2,2015,0,68,10460,10654,0,0,0
3,1.75,1920,4000,1.0,0,0,3,7,1070,850,1950,0,98102,47.6392,-122.318,2280,4000,615000,15,9,2014,0,64,2080,1720,0,1,1
2,1.5,1020,1146,3.0,0,0,3,7,1020,0,2001,0,98115,47.6774,-122.325,1138,1156,455000,13,1,2015,0,14,126,18,0,0,1
3,1.0,1660,7500,1.0,0,0,4,7,1060,600,1940,0,98125,47.7105,-122.306,1450,7500,458000,14,5,2014,0,74,5840,6050,0,1,1
3,2.25,1670,7416,1.0,0,0,4,7,1220,450,1974,0,98005,47.6028,-122.172,1710,7416,580000,30,10,2014,0,40,5746,5706,0,1,0
5,4.5,3810,8019,2.0,0,0,3,10,3810,0,2008,0,98074,47.5915,-122.058,3390,7713,966000,14,5,2014,0,6,4209,4323,0,0,0
4,1.75,2020,10332,1.0,0,0,3,7,1010,1010,1954,0,98168,47.5059,-122.303,2240,8379,240000,7,10,2014,0,60,8312,6139,0,1,1
1,1.0,420,3298,1.0,0,0,4,4,420,0,1949,0,98136,47.5375,-122.391,1460,4975,229050,31,3,2015,0,66,2878,3515,0,0,1
3,2.25,1390,1407,3.0,0,0,3,7,1390,0,2004,0,98125,47.7227,-122.296,1390,1628,328500,23,2,2015,0,11,17,238,0,0,1
3,1.5,2010,10100,1.0,0,0,4,7,1110,900,1964,0,98168,47.4738,-122.266,1900,10100,319000,21,1,2015,0,51,8090,8200,0,1,1
4,2.0,1820,5000,1.5,0,1,3,7,1640,180,1945,0,98115,47.6815,-122.269,2060,5000,650000,2,5,2014,0,69,3180,2940,0,1,1
3,2.5,1630,1971,2.0,0,0,3,8,1630,0,1996,0,98177,47.7753,-122.375,1630,3451,398500,17,2,2015,0,19,341,1821,0,0,1
1,1.0,800,16306,1.0,0,0,2,6,680,120,1931,0,98168,47.4916,-122.308,1270,8666,250000,20,6,2014,0,83,15506,7396,0,1,1
3,2.0,2270,11989,1.0,0,0,4,9,2270,0,1968,0,98040,47.5434,-122.229,2880,12439,815000,26,6,2014,0,46,9719,9559,0,0,0
3,2.75,2290,5002,2.0,0,0,4,9,1950,340,1995,0,98033,47.6811,-122.207,2290,5100,1070000,16,3,2015,0,20,2712,2810,0,1,0
2,1.75,590,6138,1.0,0,0,2,5,590,0,1947,0,98118,47.545,-122.278,1360,7112,156000,14,11,2014,0,67,5548,5752,0,0,1
4,2.75,2570,7264,2.0,0,0,3,8,1720,850,1998,0,98092,47.258,-122.208,2420,7911,254500,22,5,2014,0,16,4694,5491,0,1,0
3,2.5,2050,15020,1.0,0,2,3,9,1600,450,1960,0,98177,47.759,-122.371,2930,15050,760000,21,7,2014,0,54,12970,12120,0,1,1
3,2.5,1610,6732,2.0,0,0,3,7,1610,0,1994,0,98030,47.3658,-122.172,1680,7414,210000,6,5,2015,0,21,5122,5734,0,0,0
3,2.5,2140,7715,2.0,0,0,3,7,2140,0,1991,0,98198,47.384,-122.322,1990,7628,349950,25,8,2014,0,23,5575,5638,0,0,1
3,2.0,1730,6784,2.5,0,0,4,7,1730,0,1942,0,98199,47.6462,-122.403,1210,6784,676000,2,4,2015,0,73,5054,5574,0,0,1
4,3.5,2440,3052,2.0,0,0,3,8,1940,500,2006,0,98108,47.555,-122.309,2390,4600,475000,2,1,2015,0,9,612,2210,0,1,1
4,2.75,3220,4392,1.5,0,0,4,9,2320,900,1931,0,98105,47.6713,-122.276,2310,5795,880000,30,6,2014,0,83,1172,3485,0,1,1
3,1.5,1780,5000,1.0,0,4,4,7,1030,750,1958,0,98118,47.5168,-122.256,1780,7500,420000,12,12,2014,0,56,3220,5720,0,1,1
3,1.0,1230,8114,1.0,0,0,4,7,1230,0,1951,0,98004,47.5822,-122.196,2220,8114,607000,23,5,2014,0,63,6884,5894,0,0,0
2,1.75,1400,2500,1.0,0,0,5,7,710,690,1916,0,98116,47.5628,-122.391,1250,5700,395000,22,10,2014,0,98,1100,4450,0,1,1
4,1.75,1900,10454,1.0,0,0,4,7,1180,720,1954,0,98004,47.5933,-122.195,2060,11325,650000,20,2,2015,0,61,8554,9265,0,1,0
3,1.5,2010,9480,1.0,0,0,3,8,1570,440,1951,0,98125,47.7102,-122.281,1920,8791,429950,10,6,2014,0,63,7470,6871,0,1,1
3,2.5,3760,5260,2.0,0,0,3,9,3230,530,2002,0,98029,47.5489,-122.007,3080,5312,825000,28,10,2014,0,12,1500,2232,0,1,0
2,1.0,1020,5000,1.0,0,0,4,7,1020,0,1916,0,98117,47.6781,-122.363,1480,5000,505000,29,8,2014,0,98,3980,3520,0,0,1
2,1.0,1290,2828,2.0,0,0,3,7,1290,0,2008,0,98053,47.6968,-122.025,1290,2628,265000,12,5,2014,0,6,1538,1338,0,0,0
3,1.0,890,8400,1.0,0,0,4,6,890,0,1954,0,98056,47.5168,-122.204,1850,5565,283000,25,6,2014,0,60,7510,3715,0,0,0
3,2.75,1620,7500,1.0,0,0,5,7,1140,480,1979,0,98074,47.6175,-122.065,1900,7500,560000,7,4,2015,0,36,5880,5600,0,1,0
4,2.5,3360,13636,2.0,0,0,3,10,3360,0,1987,0,98074,47.6373,-122.042,2980,10615,765000,13,11,2014,0,27,10276,7635,0,0,0
3,2.5,2940,4799,1.0,0,0,3,9,1710,1230,1996,0,98033,47.6681,-122.184,2540,4616,589000,3,9,2014,0,18,1859,2076,0,1,0
3,1.0,1080,8580,1.5,0,0,3,6,1080,0,1900,0,98168,47.4716,-122.262,1800,12672,192500,18,6,2014,0,114,7500,10872,0,0,1
3,3.25,4560,13363,1.0,0,4,3,11,2760,1800,1995,0,98004,47.6205,-122.214,4060,13362,3200000,9,1,2015,0,20,8803,9302,0,1,0
3,1.0,1010,6120,1.0,0,0,3,7,860,150,1940,0,98115,47.6861,-122.296,1930,6120,550000,13,2,2015,0,75,5110,4190,0,1,1
2,1.5,1790,3760,1.5,0,0,4,8,1280,510,1928,0,98117,47.6871,-122.373,1540,5080,460000,14,10,2014,0,86,1970,3540,0,1,1
4,2.25,2060,11385,1.0,0,0,4,7,1200,860,1962,0,98023,47.314,-122.363,2110,11385,264500,3,7,2014,0,52,9325,9275,0,1,0
3,1.0,1150,2496,1.0,0,0,3,6,1010,140,1947,0,98126,47.5194,-122.376,1340,1203,339000,27,4,2015,0,68,1346,-137,0,1,1
4,3.5,4030,4200,3.0,0,0,3,9,4030,0,1992,0,98199,47.6416,-122.386,2130,5000,950000,12,11,2014,0,22,170,2870,0,0,1
3,1.75,2020,9718,1.0,0,0,3,8,2020,0,1956,0,98040,47.574,-122.21,2370,8604,677500,22,8,2014,0,58,7698,6234,0,0,0
4,2.5,2740,8120,2.0,0,0,3,9,2740,0,1999,0,98074,47.6123,-122.006,2780,8344,690000,5,12,2014,0,15,5380,5564,0,0,0
4,2.25,1930,7452,1.0,0,0,3,7,1430,500,1984,0,98031,47.4098,-122.189,1714,7200,312000,9,5,2014,0,30,5522,5486,0,1,0
5,1.75,2500,11617,1.0,0,0,4,9,1560,940,1966,0,98040,47.5361,-122.217,3370,11617,840000,22,10,2014,0,48,9117,8247,0,1,0
3,3.5,2080,5100,2.0,0,0,3,8,2080,0,2004,0,98038,47.35,-122.005,2080,5100,357500,1,7,2014,0,10,3020,3020,0,0,0
3,1.5,1460,6480,1.0,0,2,4,7,980,480,1940,0,98117,47.6962,-122.397,2180,6912,675000,27,4,2015,0,75,5020,4732,0,1,1
3,2.75,3290,11441,2.0,0,0,4,10,3290,0,1988,0,98023,47.3052,-122.34,2600,12070,515000,21,10,2014,0,26,8151,9470,0,0,0
4,2.5,1540,1860,2.0,0,0,3,8,1540,0,2014,0,98029,47.5521,-121.999,1210,1090,491234,23,6,2014,0,0,320,-120,0,0,0
3,2.0,1310,6265,1.0,0,0,3,7,1310,0,1988,0,98038,47.3893,-122.051,1100,6360,290000,19,3,2015,0,27,4955,5260,0,0,0
4,2.5,2120,7820,1.0,0,0,3,8,1280,840,1975,0,98052,47.6743,-122.145,2350,8605,490000,21,8,2014,0,39,5700,6255,0,1,0
4,2.0,2920,10424,1.0,0,0,5,8,1520,1400,1964,0,98005,47.5876,-122.172,2360,10696,810000,28,4,2015,0,51,7504,8336,0,1,0
3,1.5,1150,13200,1.0,0,0,3,7,1150,0,1956,0,98166,47.4752,-122.345,1220,13066,252000,20,2,2015,0,59,12050,11846,0,0,1
3,2.5,2380,9719,2.0,0,0,3,8,2380,0,2001,0,98001,47.2932,-122.283,2830,11505,299999,10,4,2015,0,14,7339,8675,0,0,0
3,2.75,2220,5000,2.0,0,0,3,7,2220,0,1993,0,98108,47.5515,-122.324,960,5000,400000,9,3,2015,0,22,2780,4040,0,0,1
5,2.0,3020,6000,1.5,0,0,5,7,1860,1160,1925,0,98126,47.5207,-122.378,1380,6000,530000,29,12,2014,0,89,2980,4620,0,1,1
3,1.75,1820,5555,1.0,0,0,4,7,1030,790,1939,0,98103,47.6867,-122.352,1420,4000,365000,10,3,2015,0,76,3735,2580,0,1,1
4,2.5,2620,5060,2.0,0,0,3,9,2620,0,2005,0,98116,47.5634,-122.394,900,5060,804000,3,2,2015,0,10,2440,4160,0,0,1
3,2.0,1750,2640,1.0,0,0,3,8,1010,740,1914,2005,98119,47.6419,-122.368,1750,4560,808250,4,9,2014,91,100,890,2810,1,1,1
4,2.5,2020,7289,2.0,0,0,3,7,2020,0,1994,0,98031,47.401,-122.171,2090,7259,360000,14,5,2015,0,21,5269,5169,0,0,0
3,1.75,1240,10956,1.0,0,0,3,6,1240,0,1987,0,98042,47.3705,-122.15,1240,8137,240000,23,10,2014,0,27,9716,6897,0,0,0
2,2.0,1380,5840,1.0,0,0,3,7,1380,0,1988,0,98011,47.7732,-122.172,1810,5035,335000,22,7,2014,0,26,4460,3225,0,0,0
3,1.75,1920,8775,1.0,0,0,3,7,1920,0,1953,0,98166,47.4544,-122.351,1560,8100,380000,29,8,2014,0,61,6855,6540,0,0,1
3,1.0,1400,7955,1.0,0,0,3,7,1400,0,1964,0,98055,47.4848,-122.221,1160,14959,194000,25,9,2014,0,50,6555,13799,0,0,0
3,1.0,1240,7194,1.0,0,0,3,6,1090,150,1936,0,98011,47.7636,-122.202,2090,8514,310000,25,3,2015,0,79,5954,6424,0,1,0
3,1.75,1440,8050,1.0,0,0,3,8,1440,0,1985,0,98023,47.3187,-122.39,1790,7488,258950,8,12,2014,0,29,6610,5698,0,0,0
2,2.25,1230,932,2.0,0,0,3,8,1020,210,2004,0,98112,47.6192,-122.301,1230,1064,479000,17,6,2014,0,10,-298,-166,0,1,1
5,1.5,1550,9750,1.0,0,0,4,7,1550,0,1966,0,98033,47.6811,-122.169,1970,9750,510000,10,11,2014,0,48,8200,7780,0,0,0
3,2.0,1760,6875,1.0,0,0,4,8,1760,0,1967,0,98072,47.74,-122.093,1670,13650,400000,9,7,2014,0,47,5115,11980,0,0,0
5,2.0,2140,5000,1.5,0,0,4,7,2020,120,1913,0,98122,47.6044,-122.299,1810,4400,680000,29,10,2014,0,101,2860,2590,0,1,1
6,3.0,3510,5760,2.5,0,0,4,10,3510,0,1906,0,98112,47.6263,-122.312,3450,5760,1750000,8,5,2014,0,108,2250,2310,0,0,1
3,1.75,2010,9417,1.0,0,0,4,8,1500,510,1967,0,98030,47.373,-122.185,1200,8250,335000,4,8,2014,0,47,7407,7050,0,1,0
5,2.5,3390,9760,1.0,0,0,5,8,1750,1640,1978,0,98058,47.4462,-122.137,2360,9600,460000,23,6,2014,0,36,6370,7240,0,1,0
4,2.25,2160,8119,1.0,0,0,3,8,1080,1080,1966,0,98006,47.5443,-122.177,1850,9000,440000,2,5,2014,0,48,5959,7150,0,1,0
2,2.0,1300,2983,1.0,0,0,3,8,1300,0,2006,0,98053,47.703,-122.015,1510,3876,412250,26,3,2015,0,9,1683,2366,0,0,0
3,1.5,1280,4031,2.0,0,0,4,6,1280,0,1985,0,98002,47.3342,-122.215,1150,4500,185000,20,11,2014,0,29,2751,3350,0,0,0
3,2.0,1840,8140,1.0,0,0,4,7,1040,800,1975,0,98003,47.3106,-122.325,1600,6720,286500,7,4,2015,0,40,6300,5120,0,1,0
4,2.5,3200,6691,2.0,0,0,3,7,3200,0,2002,0,98038,47.367,-122.031,2610,6510,422000,2,5,2015,0,13,3491,3900,0,0,0
4,2.5,2600,5188,2.0,0,0,3,8,2600,0,2005,0,98038,47.3451,-122.04,2610,5188,359900,13,4,2015,0,10,2588,2578,0,0,0
3,2.5,1960,6058,2.0,0,0,3,8,1960,0,2002,0,98053,47.6319,-122.007,2480,6656,560000,9,7,2014,0,12,4098,4176,0,0,0
1,1.0,550,16345,1.0,0,0,3,4,550,0,1945,0,98106,47.5181,-122.339,1100,9240,188000,7,10,2014,0,69,15795,8140,0,0,1
4,3.25,2500,5801,1.5,0,0,3,8,1960,540,1926,0,98112,47.632,-122.29,3670,7350,1140000,15,6,2014,0,88,3301,3680,0,1,1
3,1.0,1250,10094,1.0,0,0,4,6,1250,0,1927,0,98045,47.4987,-121.781,1300,10094,255000,10,10,2014,0,87,8844,8794,0,0,0
4,2.75,3020,8622,2.0,0,0,3,9,3020,0,1976,2003,98004,47.5866,-122.201,3060,14303,1190000,30,7,2014,27,38,5602,11243,1,0,0
4,1.75,1640,4240,1.0,0,0,5,7,920,720,1921,0,98117,47.6766,-122.368,1300,4240,635200,29,5,2014,0,93,2600,2940,0,1,1
3,1.75,1870,8250,2.0,0,0,3,7,1870,0,1956,1979,98188,47.445,-122.285,1350,8714,355000,28,4,2015,23,59,6380,7364,1,0,1
3,2.5,1760,1755,3.5,0,0,3,8,1760,0,1998,0,98105,47.6688,-122.279,1700,1721,544000,30,1,2015,0,17,-5,21,0,0,1
3,1.5,1320,3145,2.0,0,0,3,7,1320,0,1998,0,98144,47.5909,-122.297,1320,3002,402000,22,4,2015,0,17,1825,1682,0,0,1
4,1.5,1430,4163,1.5,0,0,3,7,1430,0,1910,0,98199,47.6606,-122.397,1500,4000,575000,26,12,2014,0,104,2733,2500,0,0,1
3,1.75,1580,9705,1.0,0,0,4,7,1580,0,1977,0,98042,47.3819,-122.09,1580,9942,216000,24,7,2014,0,37,8125,8362,0,0,0
4,3.5,4170,9748,2.0,0,0,3,11,4170,0,2004,0,98059,47.528,-122.132,4560,10589,1200000,17,6,2014,0,10,5578,6029,0,0,0
4,3.25,3090,6744,2.0,0,4,3,9,3090,0,1923,2015,98177,47.768,-122.388,2020,6656,850000,22,5,2014,92,91,3654,4636,1,0,1
3,2.0,1020,1204,2.0,0,0,3,7,720,300,2004,0,98126,47.5445,-122.376,1360,1506,238000,16,5,2014,0,10,184,146,0,1,1
4,1.75,2180,4431,1.5,0,0,3,8,2020,160,1912,0,98112,47.636,-122.302,1890,4400,625000,13,4,2015,0,103,2251,2510,0,1,1
5,3.25,3350,4000,2.0,0,0,4,8,2510,840,1997,0,98105,47.6645,-122.291,1620,4000,1110000,1,7,2014,0,17,650,2380,0,1,1
3,2.5,2510,5503,2.0,0,2,3,9,2510,0,1995,0,98136,47.5419,-122.383,1790,6099,820000,28,5,2014,0,19,2993,4309,0,0,1
3,2.5,1880,5290,1.0,0,0,3,8,1250,630,1974,0,98108,47.5401,-122.3,2030,5092,355000,1,12,2014,0,40,3410,3062,0,1,1
4,1.5,1810,7998,1.0,0,0,3,8,1210,600,1960,0,98125,47.726,-122.297,1830,7763,495000,3,3,2015,0,55,6188,5933,0,1,1
3,2.5,2230,4000,2.0,0,0,3,7,2230,0,1954,0,98144,47.5801,-122.306,1310,4000,398750,5,5,2014,0,60,1770,2690,0,0,1
4,2.5,3650,7784,2.0,0,0,3,9,3650,0,2006,0,98052,47.7066,-122.101,3150,6442,835000,16,7,2014,0,8,4134,3292,0,0,0
6,2.75,2830,10579,1.0,0,0,4,8,1430,1400,1967,0,98005,47.636,-122.171,2060,10745,705000,2,10,2014,0,47,7749,8685,0,1,0
4,1.5,2120,5000,2.0,0,0,4,8,2120,0,1900,0,98122,47.6024,-122.296,1830,5000,625000,4,5,2015,0,115,2880,3170,0,0,1
4,2.5,2090,6926,2.0,0,0,3,8,2090,0,1990,0,98074,47.6339,-122.022,2000,7151,550000,11,2,2015,0,25,4836,5151,0,0,0
3,1.5,2600,5085,1.0,0,0,4,7,1400,1200,1940,0,98126,47.5659,-122.376,1320,4000,540000,29,5,2014,0,74,2485,2680,0,1,1
2,1.0,830,2820,1.0,0,0,4,7,830,0,1920,0,98103,47.689,-122.347,1460,3150,519000,4,6,2014,0,94,1990,1690,0,0,1
4,2.5,1975,8734,2.0,0,0,3,7,1975,0,1996,0,98038,47.363,-122.034,1975,8538,311000,28,1,2015,0,19,6759,6563,0,0,0
4,2.5,1900,7000,1.0,0,0,2,7,1420,480,1968,0,98023,47.3092,-122.376,1600,7600,305000,6,4,2015,0,47,5100,6000,0,1,0
4,1.5,1610,6923,1.0,0,0,3,6,1010,600,1969,0,98198,47.3747,-122.306,1320,7684,275000,7,11,2014,0,45,5313,6364,0,1,1
3,3.25,1770,1863,2.0,0,0,3,8,1430,340,2003,0,98029,47.5478,-122.005,1410,1375,450000,7,8,2014,0,11,93,-35,0,1,0
2,1.0,1070,6000,1.0,0,0,3,7,1070,0,1955,0,98133,47.7307,-122.332,1490,7622,324000,11,9,2014,0,59,4930,6132,0,0,1
5,3.25,4590,12793,2.0,0,2,5,11,3590,1000,1928,0,98199,47.6453,-122.41,2920,8609,2800000,15,4,2015,0,87,8203,5689,0,1,1
4,1.0,1540,2452,1.5,0,0,4,7,1540,0,1906,0,98103,47.6522,-122.348,1290,3360,565000,16,7,2014,0,108,912,2070,0,0,1
4,1.75,1590,7920,2.0,0,0,4,7,1590,0,1960,0,98133,47.7456,-122.336,1720,7998,373000,7,7,2014,0,54,6330,6278,0,0,1
2,2.0,1170,1890,1.5,0,1,4,8,1170,0,1927,0,98119,47.6402,-122.371,2160,4000,613000,8,7,2014,0,87,720,1840,0,0,1
4,2.25,2880,9996,1.0,0,0,4,8,1920,960,1981,0,98072,47.7584,-122.143,2410,10584,614000,7,11,2014,0,33,7116,8174,0,1,0
4,1.75,2510,8989,1.0,0,0,4,8,1680,830,1964,0,98006,47.5569,-122.172,2510,8931,595000,5,5,2015,0,51,6479,6421,0,1,0
2,1.0,1280,12086,1.0,0,0,3,7,850,430,1983,0,98074,47.634,-122.033,1280,10452,440000,21,8,2014,0,31,10806,9172,0,1,0
3,1.5,1570,12412,1.0,0,3,3,8,1570,0,1954,0,98166,47.438,-122.349,2130,12412,425000,17,3,2015,0,61,10842,10282,0,0,1
2,1.0,740,6380,1.0,0,0,3,6,740,0,1912,0,98115,47.6929,-122.318,1800,6380,407000,25,9,2014,0,102,5640,4580,0,0,1
3,1.5,1740,9038,1.0,0,0,4,7,1740,0,1955,0,98007,47.5897,-122.136,1390,9770,472000,25,8,2014,0,59,7298,8380,0,0,0
3,2.5,1180,1262,3.0,0,0,3,8,1180,0,2010,0,98119,47.6381,-122.375,1180,2632,472000,17,6,2014,0,4,82,1452,0,0,1
3,1.75,1880,5752,1.0,0,0,4,7,940,940,1945,0,98126,47.5354,-122.378,1110,5201,412000,8,7,2014,0,69,3872,4091,0,1,1
3,1.0,1150,5000,1.0,0,0,3,8,1150,0,1959,2015,98117,47.6805,-122.369,1160,5000,717000,6,4,2015,56,56,3850,3840,1,0,1
3,1.0,1320,7076,1.0,0,0,4,7,1320,0,1959,0,98008,47.6131,-122.123,1510,9000,425000,12,8,2014,0,55,5756,7490,0,0,0
4,2.0,1640,7200,1.0,0,0,5,6,820,820,1944,0,98166,47.4791,-122.347,1640,8200,299999,19,8,2014,0,70,5560,6560,0,1,1
3,2.0,1470,7694,1.0,0,0,4,7,1470,0,1992,0,98038,47.3539,-122.054,1580,7480,254000,7,5,2015,0,23,6224,5900,0,0,0
3,1.0,900,10511,1.0,0,0,4,6,900,0,1961,0,98001,47.2883,-122.272,1460,10643,178500,12,2,2015,0,54,9611,9183,0,0,0
3,1.75,1510,3600,1.0,0,0,5,8,1230,280,1910,0,98119,47.6387,-122.363,1300,3600,800000,21,11,2014,0,104,2090,2300,0,1,1
3,1.0,1440,5623,1.0,0,0,4,6,720,720,1922,0,98115,47.696,-122.319,1280,5623,420000,11,9,2014,0,92,4183,4343,0,1,1
2,1.0,1380,9251,1.0,0,0,3,7,1380,0,1940,0,98028,47.7486,-122.249,1870,12158,319900,12,3,2015,0,75,7871,10288,0,0,0
2,1.5,1150,7552,1.0,0,1,3,7,1150,0,1944,0,98125,47.7298,-122.286,1910,8145,350000,2,3,2015,0,71,6402,6235,0,0,1
6,2.75,3610,17580,1.0,0,4,5,9,2070,1540,1959,0,98075,47.5739,-122.069,2890,14060,968000,28,5,2014,0,55,13970,11170,0,1,0
3,2.0,1250,1306,3.0,0,0,3,7,1250,0,2000,0,98107,47.6705,-122.39,1320,1306,491000,25,2,2015,0,15,56,-14,0,0,1
3,2.5,3510,9824,2.0,0,0,3,9,3510,0,2002,0,98075,47.5635,-122.032,3510,10588,948000,21,4,2015,0,13,6314,7078,0,0,0
3,2.5,2260,9577,2.0,0,0,3,8,1700,560,1925,2004,98117,47.6928,-122.399,1740,10240,900000,24,9,2014,79,89,7317,8500,1,1,1
3,1.75,2840,9800,1.0,0,0,4,7,1420,1420,1977,0,98042,47.3516,-122.119,1650,9590,270000,9,3,2015,0,38,6960,7940,0,1,0
3,1.5,1430,7347,1.0,0,0,3,7,820,610,1980,0,98023,47.2927,-122.369,1430,8723,198000,17,6,2014,0,34,5917,7293,0,1,0
4,2.5,2120,3720,2.0,0,0,3,8,2120,0,2004,0,98029,47.5526,-121.994,2170,3720,615000,30,7,2014,0,10,1600,1550,0,0,0
3,2.5,2080,7749,2.0,0,0,3,8,2080,0,1988,0,98029,47.5723,-122.021,2210,7471,550000,16,9,2014,0,26,5669,5261,0,0,0
2,2.5,1370,3438,2.0,0,0,3,7,1370,0,1987,0,98188,47.4606,-122.283,1370,2308,190000,17,10,2014,0,27,2068,938,0,0,1
4,2.25,1900,11171,1.0,0,0,3,8,1280,620,1984,0,98006,47.561,-122.126,2330,9934,629000,7,10,2014,0,30,9271,7604,0,1,0
3,1.75,1660,8301,1.0,0,0,5,7,1660,0,1955,0,98028,47.7647,-122.263,1660,9489,434000,7,10,2014,0,59,6641,7829,0,0,0
3,1.0,1310,4163,1.0,0,0,4,7,1310,0,1964,0,98126,47.5301,-122.381,1120,4166,415885,8,10,2014,0,50,2853,3046,0,0,1
3,2.5,1840,3035,1.0,0,0,3,7,920,920,1926,0,98105,47.6557,-122.327,1780,4000,550000,2,6,2014,0,88,1195,2220,0,1,1
1,0.75,1040,6034,1.0,0,1,3,7,580,460,1991,0,98178,47.5078,-122.251,1560,5650,272000,21,1,2015,0,24,4994,4090,0,1,1
3,2.0,1990,7405,1.0,0,0,5,7,1990,0,1971,0,98006,47.5421,-122.172,2120,6462,510000,9,10,2014,0,43,5415,4342,0,0,0
3,2.0,3080,17700,1.0,0,0,4,8,1740,1340,1965,0,98166,47.4695,-122.366,2100,15100,530000,4,9,2014,0,49,14620,13000,0,1,1
4,1.0,1250,9102,1.0,0,0,3,7,1250,0,1955,0,98148,47.4258,-122.327,1260,9180,255000,23,2,2015,0,60,7852,7920,0,0,1
4,2.75,2640,9000,2.0,0,0,3,10,2640,0,1990,0,98052,47.6481,-122.125,2980,9137,790000,24,7,2014,0,24,6360,6157,0,0,0
5,1.75,1790,9335,2.0,0,0,5,8,1790,0,1952,0,98004,47.5945,-122.201,1840,9612,695000,2,12,2014,0,62,7545,7772,0,0,0
2,2.0,1140,8400,1.0,0,0,2,7,1140,0,1954,0,98148,47.4351,-122.335,1130,9375,255000,7,11,2014,0,60,7260,8245,0,0,1
3,2.25,1790,5794,1.5,0,0,3,7,1380,410,1985,0,98072,47.7477,-122.171,2140,7769,410000,23,7,2014,0,29,4004,5629,0,1,0
4,2.75,1910,16532,1.0,0,0,4,7,1420,490,1940,0,98117,47.6952,-122.39,2300,8250,650000,25,6,2014,0,74,14622,5950,0,1,1
4,1.75,1530,3615,1.5,0,0,4,7,1530,0,1913,0,98103,47.6529,-122.334,1650,4200,675000,18,3,2015,0,102,2085,2550,0,0,1
2,2.5,1050,1029,2.0,0,0,3,8,950,100,2007,0,98122,47.6018,-122.299,1350,3600,332888,1,7,2014,0,7,-21,2250,0,1,1
3,1.75,1730,6900,1.0,0,0,4,7,1130,600,1976,0,98031,47.3915,-122.188,1950,7200,300000,20,2,2015,0,39,5170,5250,0,1,0
4,1.5,1100,11824,1.0,0,0,4,7,1100,0,1954,0,98006,47.5704,-122.141,1380,11796,320000,1,8,2014,0,60,10724,10416,0,0,0
5,2.25,2100,10726,1.0,0,0,4,7,1050,1050,1963,0,98059,47.4922,-122.134,2100,10726,342500,8,5,2015,0,52,8626,8626,0,1,0
1,0.5,880,1642,1.0,0,0,3,6,500,380,1910,0,98126,47.5732,-122.372,1410,2992,255000,14,8,2014,0,104,762,1582,0,1,1
3,2.5,1470,9337,2.0,0,0,3,7,1470,0,1991,0,98155,47.7651,-122.323,1360,8684,244000,3,11,2014,0,23,7867,7324,0,0,1
5,3.25,3950,11438,2.0,0,2,3,10,3430,520,2006,0,98033,47.6898,-122.189,2070,10751,1420000,1,4,2015,0,9,7488,8681,0,1,0
3,1.0,980,12812,1.0,0,0,3,7,980,0,1956,0,98168,47.4892,-122.306,1430,8986,218000,10,11,2014,0,58,11832,7556,0,0,1
4,1.0,2180,10617,1.5,0,0,3,7,2180,0,1950,0,98155,47.7522,-122.307,1360,9519,359000,3,12,2014,0,64,8437,8159,0,0,1
4,2.75,3040,13559,2.0,0,0,3,11,3040,0,2003,0,98059,47.522,-122.149,3830,12202,840000,27,10,2014,0,11,10519,8372,0,0,0
3,2.5,1600,7295,2.0,0,0,2,7,1600,0,1993,0,98042,47.3904,-122.165,1410,9000,205000,21,1,2015,0,22,5695,7590,0,0,0
2,1.5,2070,5432,2.0,0,0,3,7,1370,700,1951,0,98108,47.5571,-122.299,2070,5505,500000,8,4,2015,0,64,3362,3435,0,1,1
4,2.5,3180,5405,2.0,0,0,3,7,3180,0,2001,0,98059,47.4905,-122.14,2610,5403,510000,9,1,2015,0,14,2225,2793,0,0,0
4,2.25,2640,3000,2.0,0,0,3,7,2080,560,1908,0,98109,47.6313,-122.344,1910,3000,1550000,30,4,2015,0,107,360,1090,0,1,1
3,1.0,1660,6992,1.0,0,0,5,7,1260,400,1952,0,98155,47.7576,-122.318,1390,7359,412000,21,8,2014,0,62,5332,5969,0,1,1
2,1.5,1390,1756,3.0,0,0,3,7,1390,0,2005,0,98133,47.7274,-122.357,1340,1756,299950,25,3,2015,0,10,366,416,0,0,1
4,3.0,2490,4325,1.5,0,0,3,8,1690,800,1922,2003,98105,47.6628,-122.326,1960,4284,1080000,23,4,2015,81,93,1835,2324,1,1,1
4,2.5,2550,8824,2.0,0,0,3,9,2550,0,1990,0,98031,47.3979,-122.212,2630,11237,422500,18,11,2014,0,24,6274,8607,0,0,0
3,2.0,1270,10227,1.0,0,0,4,6,1270,0,1968,0,98033,47.6876,-122.168,1470,9750,410000,14,7,2014,0,46,8957,8280,0,0,0
4,3.25,2980,7000,2.0,0,3,3,10,2140,840,1900,2014,98144,47.5933,-122.292,2200,4800,1400000,28,5,2014,114,114,4020,2600,1,1,1
3,2.0,1470,8000,1.0,0,0,4,8,1470,0,1974,0,98023,47.3191,-122.385,1980,8000,245000,15,7,2014,0,40,6530,6020,0,0,0
4,3.0,3550,12327,1.5,0,0,4,10,2180,1370,1990,0,98011,47.7533,-122.205,3170,12937,720000,2,7,2014,0,24,8777,9767,0,1,0
2,1.0,780,7200,1.0,0,0,2,6,780,0,1935,0,98118,47.5609,-122.279,1750,7200,315000,24,10,2014,0,79,6420,5450,0,0,1
2,2.5,1390,1302,2.0,0,0,3,7,1390,0,1987,0,98003,47.3081,-122.329,1390,2052,191950,24,2,2015,0,28,-88,662,0,0,0
4,2.5,2440,5001,2.0,0,0,3,8,2440,0,2005,0,98056,47.5108,-122.193,2260,5001,455000,23,9,2014,0,9,2561,2741,0,0,0
3,1.5,1260,3135,1.5,0,0,3,8,1260,0,1931,0,98116,47.5755,-122.388,1700,4180,523000,16,5,2014,0,83,1875,2480,0,0,1
3,2.25,1640,4420,2.0,0,0,4,7,1640,0,1918,1983,98002,47.311,-122.21,1230,6632,250000,24,10,2014,65,96,2780,5402,1,0,0
3,3.0,1670,4120,1.5,0,0,3,7,1140,530,1929,2012,98055,47.4881,-122.199,1010,4120,294000,13,1,2015,83,86,2450,3110,1,1,0
3,2.25,2380,6000,1.0,0,0,3,8,2040,340,1961,0,98115,47.6955,-122.275,1680,7200,490000,10,10,2014,0,53,3620,5520,0,1,1
4,1.0,1030,5750,1.0,0,0,3,7,1030,0,1971,0,98126,47.553,-122.37,1250,5750,310000,16,9,2014,0,43,4720,4500,0,0,1
3,1.5,1560,10489,1.0,0,0,5,7,1560,0,1961,0,98022,47.2048,-121.999,1400,10489,265000,21,7,2014,0,53,8929,9089,0,0,0
4,1.75,1640,10500,1.0,0,0,4,7,1010,630,1968,0,98052,47.6933,-122.116,1680,7650,402000,11,8,2014,0,46,8860,5970,0,1,0
4,2.5,3190,7941,2.0,0,0,3,10,3190,0,2005,0,98038,47.353,-122.002,3190,7255,589450,24,11,2014,0,9,4751,4065,0,0,0
3,1.5,1200,8404,1.0,0,0,3,7,1200,0,1964,0,98188,47.4482,-122.269,2120,12000,219950,23,12,2014,0,50,7204,9880,0,0,1
3,2.25,2250,5301,2.0,0,0,4,8,1510,740,1975,0,98115,47.6741,-122.271,2240,7200,750000,13,8,2014,0,39,3051,4960,0,1,1
2,1.75,1960,6000,1.0,0,0,4,7,980,980,1904,0,98199,47.6531,-122.401,1650,6000,478000,21,8,2014,0,110,4040,4350,0,1,1
3,1.0,1250,7015,1.0,0,0,3,7,1250,0,1958,0,98188,47.4548,-122.29,1510,11460,170000,14,7,2014,0,56,5765,9950,0,0,1
2,2.25,2460,16940,1.5,0,4,4,9,1930,530,1936,0,98117,47.6792,-122.404,2260,6851,1370000,6,6,2014,0,78,14480,4591,0,1,1
3,2.5,1700,7000,2.0,0,0,3,7,1700,0,1996,0,98038,47.3798,-122.025,1950,7000,319950,2,3,2015,0,19,5300,5050,0,0,0
2,1.0,840,4200,1.0,0,0,3,5,840,0,1938,0,98108,47.5292,-122.316,830,5000,208417,24,11,2014,0,76,3360,4170,0,0,1
4,2.0,1900,5100,1.0,0,0,3,6,950,950,1914,1973,98117,47.6767,-122.38,1230,5100,410000,17,11,2014,59,100,3200,3870,1,1,1
4,2.75,2160,4205,1.0,0,3,3,7,1080,1080,1969,0,98125,47.7081,-122.276,2450,6014,590000,25,7,2014,0,45,2045,3564,0,1,1
3,1.75,1610,10229,1.0,0,0,5,8,1610,0,1961,0,98006,47.553,-122.174,2270,8800,648000,29,4,2015,0,54,8619,6530,0,0,0
3,2.5,1720,6194,2.0,0,0,3,8,1720,0,1998,0,98092,47.2624,-122.221,1720,6211,255000,27,6,2014,0,16,4474,4491,0,0,0
4,2.75,2190,3267,2.0,0,0,3,8,2190,0,2004,0,98072,47.7751,-122.168,2190,3619,465000,25,8,2014,0,10,1077,1429,0,0,0
4,1.75,3020,10714,1.0,0,0,5,8,1510,1510,1958,0,98006,47.56,-122.181,2230,14400,622000,28,1,2015,0,57,7694,12170,0,1,0
3,1.75,1980,9800,1.0,0,0,3,7,1980,0,1991,0,98030,47.3745,-122.224,1630,7650,306000,15,9,2014,0,23,7820,6020,0,0,0
3,2.5,1880,5500,2.0,0,0,4,7,1880,0,1947,2007,98199,47.657,-122.393,1230,5500,617000,10,10,2014,60,67,3620,4270,1,0,1
3,1.75,1610,6480,1.0,0,0,4,7,1610,0,1947,0,98125,47.7137,-122.307,1230,8040,438750,28,5,2014,0,67,4870,6810,0,0,1
4,3.0,3260,4500,2.0,0,0,3,9,2300,960,1930,2014,98109,47.6314,-122.353,2410,4995,1280000,25,9,2014,84,84,1240,2585,1,1,1
5,3.25,3970,8029,2.0,0,2,3,9,2970,1000,1979,0,98177,47.7764,-122.385,2520,8214,995000,24,11,2014,0,35,4059,5694,0,1,1
5,2.75,2620,5500,1.5,0,0,3,7,1710,910,1911,0,98117,47.6806,-122.388,1790,5500,635000,22,4,2015,0,104,2880,3710,0,1,1
3,1.0,1180,9000,1.0,0,0,4,7,1180,0,1970,0,98031,47.39,-122.166,1290,8316,215000,28,7,2014,0,44,7820,7026,0,0,0
3,2.5,1365,1090,3.0,0,0,3,7,1315,50,2003,0,98115,47.6776,-122.324,1360,1124,530000,27,10,2014,0,11,-275,-236,0,1,1
2,1.0,720,4125,1.0,0,0,4,6,720,0,1943,0,98106,47.5245,-122.354,1000,6100,295000,20,3,2015,0,72,3405,5100,0,0,1
3,2.25,1350,6775,1.0,0,0,3,7,930,420,1981,0,98032,47.3593,-122.289,1460,7210,245000,2,3,2015,0,34,5425,5750,0,1,0
3,2.75,1850,8820,2.0,0,0,4,8,1850,0,1993,0,98022,47.1928,-122.01,1850,8651,303000,21,7,2014,0,21,6970,6801,0,0,0
3,1.75,1320,9675,1.5,0,0,4,7,1320,0,1970,0,98024,47.5695,-121.902,1160,9675,330000,15,10,2014,0,44,8355,8515,0,0,0
3,1.75,1990,13000,2.0,0,3,3,9,1990,0,1980,0,98028,47.7439,-122.262,2880,11340,700000,4,3,2015,0,35,11010,8460,0,0,0
1,1.0,610,4400,1.0,0,0,3,5,610,0,1922,0,98055,47.4865,-122.197,1090,4930,126000,26,8,2014,0,92,3790,3840,0,0,0
3,2.0,1440,7425,1.0,0,0,4,7,1440,0,1965,0,98034,47.7243,-122.185,1800,8344,405000,18,12,2014,0,49,5985,6544,0,0,0
6,4.5,2750,4400,2.0,0,0,3,8,1770,980,1987,0,98103,47.6883,-122.335,1860,4400,869900,19,8,2014,0,27,1650,2540,0,1,1
3,1.75,1790,6775,1.0,0,2,3,8,1790,0,1951,0,98126,47.5412,-122.377,1310,6028,485000,31,3,2015,0,64,4985,4718,0,0,1
2,2.0,1050,1173,2.0,0,0,3,8,720,330,2004,0,98122,47.6181,-122.302,1340,1317,400000,28,1,2015,0,11,123,-23,0,1,1
3,2.5,1780,4650,2.0,0,0,3,7,1780,0,2011,0,98038,47.386,-122.047,3050,3848,299950,11,9,2014,0,3,2870,798,0,0,0
4,2.5,2200,9099,2.0,0,0,3,8,2200,0,1994,0,98034,47.733,-122.225,2270,8900,585000,27,3,2015,0,21,6899,6630,0,0,0
4,2.0,1720,5413,2.0,0,0,3,7,1470,250,1938,1980,98115,47.6929,-122.321,1510,5413,495000,6,5,2015,42,77,3693,3903,1,1,1
5,4.5,5840,17168,2.0,0,0,3,12,4570,1270,2006,0,98029,47.5457,-121.991,4850,15017,2200000,11,3,2015,0,9,11328,10167,0,1,0
3,2.25,1520,14080,2.0,0,0,3,7,1520,0,1984,0,98074,47.6273,-122.059,1530,9758,447000,10,11,2014,0,30,12560,8228,0,0,0
3,1.0,1320,9239,1.0,0,0,4,7,1320,0,1968,0,98092,47.312,-122.183,1320,8415,206000,17,4,2015,0,47,7919,7095,0,0,0
3,1.0,1070,4600,1.0,0,0,3,7,950,120,1930,0,98116,47.5627,-122.383,1090,4600,500000,21,10,2014,0,84,3530,3510,0,1,1
4,2.5,1990,5511,2.0,0,0,3,8,1990,0,1994,0,98030,47.3585,-122.191,1850,6031,302500,21,11,2014,0,20,3521,4181,0,0,0
4,4.25,4980,13000,2.0,0,3,3,9,3080,1900,1982,0,98052,47.6406,-122.101,2840,11308,1250000,25,11,2014,0,32,8020,8468,0,1,0
2,1.0,890,5423,1.0,0,0,3,6,890,0,1946,0,98117,47.6966,-122.368,1690,5993,391000,23,7,2014,0,68,4533,4303,0,0,1
3,2.0,1440,5457,2.0,0,0,3,7,1440,0,1986,0,98038,47.3784,-122.046,1480,6286,250000,10,7,2014,0,28,4017,4806,0,0,0
4,2.5,2440,5350,2.0,0,0,3,7,2440,0,2003,0,98059,47.4891,-122.149,2440,5090,435000,23,7,2014,0,11,2910,2650,0,0,0
4,2.25,1800,14722,1.0,0,0,3,7,1440,360,1962,0,98055,47.4874,-122.223,2400,10000,160000,11,2,2015,0,53,12922,7600,0,1,0
5,3.0,2260,6508,1.0,0,0,3,7,1330,930,2003,0,98155,47.7508,-122.322,1940,9450,451000,22,7,2014,0,11,4248,7510,0,1,1
2,1.0,810,7158,1.0,0,0,5,6,810,0,1944,0,98168,47.4882,-122.325,1090,7158,206000,5,5,2014,0,70,6348,6068,0,0,1
4,2.75,2240,5400,2.0,0,0,4,7,1540,700,1940,0,98116,47.5785,-122.402,1830,5000,590000,23,9,2014,0,74,3160,3170,0,1,1
3,2.5,4560,17622,2.0,0,0,4,9,3800,760,1986,0,98074,47.621,-122.03,2360,15000,695000,15,5,2014,0,28,13062,12640,0,1,0
5,3.5,3180,4628,2.0,0,0,3,10,2420,760,2001,0,98199,47.6423,-122.394,2060,4640,1240000,26,3,2015,0,14,1448,2580,0,1,1
6,2.25,2950,11200,1.0,0,0,4,7,1700,1250,1970,0,98072,47.7476,-122.087,1790,11200,395000,30,3,2015,0,45,8250,9410,0,1,0
5,3.0,2190,9652,2.0,0,0,3,7,2190,0,1999,0,98178,47.5049,-122.239,1440,6710,419000,5,4,2015,0,16,7462,5270,0,0,1
2,2.0,1570,4665,1.0,0,0,3,8,1570,0,2006,0,98053,47.709,-122.017,2165,6262,592350,8,7,2014,0,8,3095,4097,0,0,0
5,3.25,3420,5669,2.0,0,0,3,9,2620,800,2003,0,98027,47.5366,-122.067,3310,6006,855000,6,8,2014,0,11,2249,2696,0,1,0
4,2.5,2420,7200,2.0,0,0,3,9,2420,0,1991,0,98033,47.6893,-122.197,2650,7800,771000,30,12,2014,0,23,4780,5150,0,0,0
5,3.25,3680,6060,2.0,0,0,5,9,2630,1050,1925,0,98112,47.6341,-122.304,3050,5850,1850000,18,10,2014,0,89,2380,2800,0,1,1
4,1.75,1910,6731,1.0,0,0,4,7,1210,700,1953,0,98116,47.5693,-122.391,1780,6350,545000,29,7,2014,0,61,4821,4570,0,1,1
3,1.75,1780,5175,1.0,0,0,4,7,990,790,1927,0,98116,47.5696,-122.386,1780,5175,615000,26,2,2015,0,88,3395,3395,0,1,1
2,1.0,2160,7439,1.0,0,0,4,6,1300,860,1953,0,98115,47.6981,-122.286,1680,7439,625500,10,4,2015,0,62,5279,5759,0,1,1
3,1.5,1460,15000,1.0,0,0,3,7,1460,0,1966,0,98001,47.3182,-122.271,1510,15000,232000,8,7,2014,0,48,13540,13490,0,0,0
3,1.5,1370,7439,1.0,0,0,4,6,1370,0,1963,0,98055,47.4499,-122.189,2350,3370,168000,14,7,2014,0,51,6069,1020,0,0,0
3,1.5,1370,7439,1.0,0,0,4,6,1370,0,1963,0,98055,47.4499,-122.189,2350,3370,238000,28,1,2015,0,52,6069,1020,0,0,0
3,2.5,1500,7401,2.0,0,0,3,8,1500,0,1998,0,98092,47.2625,-122.221,1720,7171,260000,14,4,2015,0,17,5901,5451,0,0,0
3,1.75,1210,7500,1.0,0,0,3,7,1210,0,1951,0,98027,47.5294,-122.033,1250,6000,460000,2,3,2015,0,64,6290,4750,0,0,0
3,2.5,2850,11535,1.0,0,1,3,8,1680,1170,1952,2008,98155,47.748,-122.288,2670,9942,900000,25,8,2014,56,62,8685,7272,1,1,1
3,1.0,1090,8280,1.0,0,0,3,6,1090,0,1947,2006,98155,47.7562,-122.318,1060,7609,289950,21,10,2014,59,67,7190,6549,1,0,1
3,1.75,1450,5858,1.0,0,0,4,7,1450,0,1991,0,98038,47.3482,-122.037,1520,6573,265000,20,2,2015,0,24,4408,5053,0,0,0
3,1.5,1320,7201,1.0,0,0,3,7,1320,0,1971,0,98034,47.7126,-122.211,1380,7201,370000,13,11,2014,0,43,5881,5821,0,0,0
2,1.5,1670,9880,1.0,0,0,4,7,1670,0,1941,1963,98146,47.4864,-122.348,1670,9807,240000,6,8,2014,22,73,8210,8137,1,0,1
4,2.0,1440,5911,1.0,0,0,5,5,1440,0,1943,0,98056,47.5072,-122.181,1500,11089,232000,17,9,2014,0,71,4471,9589,0,0,0
3,1.0,980,7560,1.0,0,0,3,7,980,0,1951,0,98126,47.5256,-122.375,1300,7560,237502,29,7,2014,0,63,6580,6260,0,0,1
4,3.5,4340,5500,2.0,0,0,3,10,2850,1490,2008,0,98199,47.6427,-122.397,1290,5500,1280000,15,12,2014,0,6,1160,4210,0,1,1
4,2.25,2860,11545,1.0,0,0,4,8,1430,1430,1966,0,98005,47.588,-122.168,2190,11396,957000,24,4,2015,0,49,8685,9206,0,1,0
3,1.5,1140,4875,1.0,0,0,5,6,1140,0,1970,0,98042,47.3684,-122.08,980,5070,218000,5,3,2015,0,45,3735,4090,0,0,0
3,1.5,1120,8366,1.0,0,0,3,7,1120,0,1968,0,98042,47.3632,-122.11,1260,9000,205000,20,8,2014,0,46,7246,7740,0,0,0
3,3.25,1460,1592,2.0,0,0,3,8,1130,330,2006,0,98126,47.5481,-122.374,1560,1701,350000,11,6,2014,0,8,132,141,0,1,1
4,2.5,2050,5787,2.0,0,0,3,7,2050,0,2002,0,98198,47.3527,-122.315,2030,6615,256000,2,7,2014,0,12,3737,4585,0,0,1
3,1.0,1250,7654,1.0,0,0,3,7,1000,250,1952,0,98125,47.7289,-122.291,1310,7350,275000,30,7,2014,0,62,6404,6040,0,1,1
4,2.5,2520,9604,2.0,0,0,3,9,2520,0,1990,0,98031,47.3893,-122.216,2540,9793,372000,3,4,2015,0,25,7084,7253,0,0,0
3,3.25,2580,9825,1.5,0,1,4,9,1760,820,1978,0,98027,47.5314,-122.054,2140,10270,688888,19,3,2015,0,37,7245,8130,0,1,0
5,2.25,2140,7910,1.0,0,0,3,7,1070,1070,1962,0,98007,47.6071,-122.137,1680,8700,530000,25,6,2014,0,52,5770,7020,0,1,0
4,3.25,3440,7661,2.0,0,0,3,11,3440,0,2006,0,98029,47.5429,-121.995,3580,6478,905000,23,6,2014,0,8,4221,2898,0,0,0
4,2.5,1800,5070,1.0,0,0,5,7,1080,720,1979,0,98118,47.5303,-122.28,1870,5365,365000,25,8,2014,0,35,3270,3495,0,1,1
4,2.5,1790,10584,1.0,0,0,4,7,1290,500,1981,0,98031,47.4061,-122.188,1730,9120,312000,6,4,2015,0,34,8794,7390,0,1,0
2,1.75,1250,7680,1.0,0,0,3,7,1250,0,1922,1968,98126,47.5242,-122.371,1250,7680,400000,22,8,2014,46,92,6430,6430,1,0,1
2,2.0,800,5765,1.0,0,0,4,6,800,0,1936,0,98133,47.7024,-122.346,1160,3844,278750,12,9,2014,0,78,4965,2684,0,0,1
3,2.0,1410,11995,1.0,0,0,4,8,1410,0,1965,0,98006,47.5718,-122.127,2690,12650,510000,1,4,2015,0,50,10585,9960,0,0,0
2,2.25,1330,806,3.0,0,0,3,8,1330,0,2009,0,98117,47.6904,-122.395,1320,1389,527700,14,4,2015,0,6,-524,69,0,0,1
4,2.75,2890,4000,1.5,0,0,4,9,2190,700,1931,0,98109,47.6419,-122.351,2280,4000,740000,15,4,2015,0,84,1110,1720,0,1,1
4,2.5,2550,17209,2.0,0,0,3,9,2550,0,1996,0,98059,47.4836,-122.136,2840,12560,512000,8,8,2014,0,18,14659,9720,0,0,0
5,2.5,2880,8216,2.0,0,0,3,8,2880,0,2001,0,98030,47.3747,-122.185,1960,7200,362000,12,11,2014,0,13,5336,5240,0,0,0
3,1.0,660,6600,1.0,0,0,4,5,660,0,1940,0,98168,47.4842,-122.33,1320,6600,225000,6,2,2015,0,75,5940,5280,0,0,1
3,2.25,1470,4322,2.0,0,0,3,7,1470,0,1985,0,98029,47.5672,-122.018,1610,4322,491500,30,6,2014,0,29,2852,2712,0,0,0
4,1.75,1700,10230,1.0,0,0,3,8,1320,380,1959,0,98133,47.7453,-122.351,2000,8006,429950,4,2,2015,0,56,8530,6006,0,1,1
3,1.0,1040,9800,1.0,0,0,4,7,1040,0,1955,0,98006,47.5765,-122.155,1280,8880,375000,17,11,2014,0,59,8760,7600,0,0,0
2,1.0,880,4000,1.0,0,0,4,6,880,0,1916,0,98106,47.5331,-122.352,1430,4000,199400,13,8,2014,0,98,3120,2570,0,0,1
4,2.5,2490,9346,2.0,0,2,3,9,2490,0,1996,0,98042,47.3831,-122.147,2650,9454,364900,26,1,2015,0,19,6856,6804,0,0,0
3,1.5,1210,7560,1.0,0,0,3,7,1210,0,1941,0,98126,47.5255,-122.374,980,7560,324950,12,9,2014,0,73,6350,6580,0,0,1
5,2.0,2080,4000,1.0,0,0,4,6,1040,1040,1909,0,98144,47.5858,-122.308,1940,6000,467000,30,3,2015,0,106,1920,4060,0,1,1
3,1.0,1380,5400,1.0,0,0,4,7,1380,0,1954,0,98125,47.7134,-122.288,1190,6075,380000,22,8,2014,0,60,4020,4885,0,0,1
3,2.25,1620,10850,1.0,0,0,3,7,1620,0,1966,0,98055,47.4437,-122.194,1910,10568,250000,3,11,2014,0,48,9230,8658,0,0,0
4,1.0,1680,4021,1.5,0,0,3,7,1680,0,1921,0,98103,47.6663,-122.332,1710,4021,700000,20,5,2014,0,93,2341,2311,0,0,1
3,1.0,1330,9620,1.0,0,0,5,6,1330,0,1976,0,98092,47.3174,-122.127,1300,10360,206990,13,11,2014,0,38,8290,9060,0,0,0
3,1.75,1730,3400,1.0,0,0,5,7,970,760,1928,0,98107,47.6662,-122.364,1640,5000,670000,6,4,2015,0,87,1670,3360,0,1,1
2,1.0,790,6969,1.0,0,0,3,6,790,0,1955,1984,98052,47.6978,-122.164,1380,12196,315000,20,5,2014,29,59,6179,10816,1,0,0
3,2.5,2240,7500,2.0,0,0,3,8,2240,0,1985,0,98092,47.265,-122.22,2190,7506,319950,10,4,2015,0,30,5260,5316,0,0,0
3,1.5,1500,8272,1.0,0,0,4,7,1500,0,1958,0,98177,47.7741,-122.38,1630,8270,419000,30,7,2014,0,56,6772,6640,0,0,1
3,2.0,1800,11419,1.0,0,0,3,8,1800,0,1989,0,98092,47.2623,-122.217,2220,11406,205000,22,8,2014,0,25,9619,9186,0,0,0
4,2.5,1980,4745,2.0,0,0,3,7,1980,0,2004,0,98038,47.3495,-122.04,1980,4878,335000,23,10,2014,0,10,2765,2898,0,0,0
3,1.75,1340,5100,1.0,0,0,3,7,1340,0,1953,0,98103,47.694,-122.348,1550,5100,397000,24,10,2014,0,61,3760,3550,0,0,1
2,1.0,750,2020,1.0,0,0,3,7,750,0,1908,1995,98122,47.6175,-122.301,1630,2383,370000,29,4,2015,87,107,1270,753,1,0,1
4,2.25,1790,9920,1.0,0,0,4,7,1170,620,1969,0,98059,47.5126,-122.149,1990,9648,330000,18,9,2014,0,45,8130,7658,0,1,0
4,3.5,5490,14300,1.0,0,4,3,12,2910,2580,1996,0,98006,47.5511,-122.114,4290,13822,1790000,30,10,2014,0,18,8810,9532,0,1,0
3,2.0,1940,16300,1.0,0,0,3,7,1140,800,1978,0,98155,47.774,-122.283,1940,11250,399000,8,8,2014,0,36,14360,9310,0,1,1
3,2.0,1220,6404,1.0,0,0,3,7,1220,0,1994,0,98038,47.3523,-122.059,1570,7000,249900,17,7,2014,0,20,5184,5430,0,0,0
3,1.5,1310,3880,1.0,0,0,3,7,1090,220,1956,0,98117,47.6821,-122.392,1570,3880,717000,13,5,2014,0,58,2570,2310,0,1,1
4,2.5,1930,8336,2.0,0,0,3,8,1930,0,1995,0,98031,47.4016,-122.166,2280,7959,319000,7,8,2014,0,19,6406,5679,0,0,0
4,3.0,2100,3800,2.0,0,0,3,8,2100,0,1972,0,98115,47.6807,-122.291,1320,3800,635000,3,4,2015,0,43,1700,2480,0,0,1
3,1.0,1180,7573,1.0,0,0,4,7,1180,0,1977,0,98155,47.7372,-122.294,1320,7573,355000,10,9,2014,0,37,6393,6253,0,0,1
4,1.75,3140,12519,1.0,0,0,3,7,2320,820,1951,1983,98033,47.6941,-122.173,2240,7308,585000,14,7,2014,32,63,9379,5068,1,1,0
3,2.0,2320,7800,1.0,0,0,4,7,1160,1160,1960,0,98168,47.5141,-122.316,1380,7800,320000,29,12,2014,0,54,5480,6420,0,1,1
3,1.75,2110,10200,2.0,0,0,4,7,2110,0,1966,0,98059,47.4744,-122.154,1800,10200,305495,14,5,2014,0,48,8090,8400,0,0,0
4,2.0,1790,14690,1.0,0,1,4,7,1670,120,1960,0,98198,47.3965,-122.321,2440,10664,240000,19,6,2014,0,54,12900,8224,0,1,1
5,2.5,1740,8750,1.0,0,0,4,7,1740,0,1959,0,98198,47.3904,-122.299,1740,8750,199950,23,6,2014,0,55,7010,7010,0,0,1
4,3.25,3820,8114,2.0,0,0,3,10,3820,0,2005,0,98004,47.5837,-122.194,2440,9195,1620000,26,8,2014,0,9,4294,6755,0,0,0
4,2.25,1680,3179,2.0,0,0,3,8,1680,0,2002,0,98092,47.3258,-122.186,1678,3590,255000,2,7,2014,0,12,1499,1912,0,0,0
4,2.25,1930,8925,1.0,0,0,4,8,1930,0,1974,0,98058,47.4501,-122.128,1930,8400,289000,15,9,2014,0,40,6995,6470,0,0,0
4,3.0,3760,8804,2.0,0,0,3,8,2470,1290,2002,0,98056,47.5161,-122.191,1960,7225,494500,18,7,2014,0,12,5044,5265,0,1,0
3,2.25,2370,9619,1.0,0,0,4,8,1650,720,1973,0,98052,47.6366,-122.099,1960,9712,746000,4,6,2014,0,41,7249,7752,0,1,0
4,3.0,2120,13000,2.0,0,0,4,8,2120,0,1978,0,98059,47.4745,-122.141,2180,11440,385000,23,10,2014,0,36,10880,9260,0,0,0
4,2.5,2370,10513,2.0,0,0,4,8,2370,0,1987,0,98052,47.6915,-122.099,2110,9540,688100,18,11,2014,0,27,8143,7430,0,0,0
4,2.5,2350,3150,1.5,0,0,4,8,1690,660,1910,0,98103,47.6605,-122.335,1750,3150,870300,12,5,2014,0,104,800,1400,0,1,1
3,1.0,1180,8474,1.5,0,0,3,7,1180,0,1956,0,98155,47.7416,-122.327,1180,7200,310000,22,10,2014,0,58,7294,6020,0,0,1
3,2.5,2270,5654,2.0,0,0,3,8,2270,0,1999,0,98133,47.7733,-122.351,1770,7840,500000,12,3,2015,0,16,3384,6070,0,0,1
3,2.25,1830,7770,1.0,0,0,4,7,1400,430,1977,0,98042,47.3925,-122.161,1960,7272,255000,14,8,2014,0,37,5940,5312,0,1,0
3,2.75,3910,7080,1.0,0,0,5,9,1970,1940,1949,0,98112,47.6324,-122.289,3480,7370,1480000,18,2,2015,0,66,3170,3890,0,1,1
3,1.0,890,9465,1.0,0,0,3,6,890,0,1957,0,98148,47.4388,-122.328,1590,9147,154500,24,9,2014,0,57,8575,7557,0,0,1
3,2.25,1820,8058,1.0,0,0,3,7,1260,560,1974,0,98034,47.7241,-122.168,1850,7384,425000,30,5,2014,0,40,6238,5534,0,1,0
4,2.5,2440,7491,2.0,0,0,4,10,2440,0,1988,0,98029,47.561,-122.019,2490,8580,700000,21,7,2014,0,26,5051,6090,0,0,0
2,1.0,1110,3943,1.0,0,0,5,6,740,370,1916,0,98109,47.6436,-122.352,1590,4311,410500,21,11,2014,0,98,2833,2721,0,1,1
3,2.0,1870,7080,1.0,0,0,4,7,1210,660,1969,0,98034,47.7244,-122.179,1620,8000,432000,14,7,2014,0,45,5210,6380,0,1,0
3,1.5,1240,4080,1.5,0,0,3,8,1240,0,1914,0,98144,47.5745,-122.291,1420,4080,530000,14,4,2015,0,101,2840,2660,0,0,1
3,2.0,1560,8640,1.0,0,0,5,7,1560,0,1967,0,98034,47.7294,-122.186,1970,8625,465000,27,5,2014,0,47,7080,6655,0,0,0
3,2.5,1910,5600,2.0,0,0,3,8,1910,0,1989,0,98029,47.5752,-122.009,1800,4928,498688,23,9,2014,0,25,3690,3128,0,0,0
4,2.75,2530,13474,2.0,0,0,4,8,2530,0,1994,0,98023,47.289,-122.344,2490,13140,349900,15,10,2014,0,20,10944,10650,0,0,0
3,1.0,1130,12519,1.0,0,0,3,7,1130,0,1958,0,98056,47.4965,-122.176,1460,12507,220000,18,6,2014,0,56,11389,11047,0,0,0
2,1.0,820,6771,1.0,0,0,4,6,820,0,1918,0,98106,47.52,-122.354,1000,4440,260000,31,7,2014,0,96,5951,3440,0,0,1
2,1.0,960,4000,1.0,0,0,3,6,960,0,1918,0,98118,47.5554,-122.267,1210,4000,290000,11,9,2014,0,96,3040,2790,0,0,1
4,1.5,1980,3240,1.5,0,0,4,8,1780,200,1930,0,98144,47.584,-122.294,2250,4000,615000,2,4,2015,0,85,1260,1750,0,1,1
4,3.5,3370,5638,2.0,0,0,3,10,2250,1120,2001,0,98034,47.7196,-122.223,3080,7200,730000,22,10,2014,0,13,2268,4120,0,1,0
3,2.25,1800,10500,2.0,0,0,3,7,1800,0,1995,0,98038,47.3879,-122.032,1870,8555,332500,21,5,2014,0,19,8700,6685,0,0,0
5,3.5,3990,10120,2.0,0,0,3,9,2820,1170,1990,0,98011,47.741,-122.208,2750,9622,650000,24,12,2014,0,24,6130,6872,0,1,0
4,2.5,4070,7800,3.0,0,0,4,8,3390,680,2002,0,98115,47.6838,-122.327,2020,6760,1400000,29,8,2014,0,12,3730,4740,0,1,1
4,1.75,1640,7194,1.5,0,0,4,7,1480,160,1915,0,98011,47.7649,-122.205,1440,9405,465000,13,5,2015,0,100,5554,7965,0,1,0
4,3.25,3730,11820,2.0,0,0,3,10,2460,1270,1990,0,98029,47.5775,-122.019,3680,10667,690000,22,7,2014,0,24,8090,6987,0,1,0
3,1.75,1220,7004,1.0,0,0,5,7,1220,0,1966,0,98058,47.4492,-122.157,1640,7210,289900,11,7,2014,0,48,5784,5570,0,0,0
3,3.5,3490,4000,2.0,0,0,3,9,2570,920,2009,0,98112,47.6385,-122.281,1880,4000,1620000,18,12,2014,0,5,510,2120,0,1,1
3,2.5,1730,4286,2.0,0,0,3,7,1730,0,1999,0,98148,47.432,-122.329,1780,4343,339950,22,4,2015,0,16,2556,2563,0,0,1
4,2.75,3430,8000,1.5,0,0,4,8,3430,0,1972,0,98023,47.3183,-122.382,2090,8000,367999,23,4,2015,0,43,4570,5910,0,0,0
4,2.5,2320,10079,2.0,0,0,3,7,2320,0,1994,0,98038,47.3828,-122.026,2010,7438,380000,18,2,2015,0,21,7759,5428,0,0,0
3,1.75,2030,17100,1.0,0,0,4,7,2030,0,1953,0,98166,47.451,-122.365,1950,14400,440000,25,6,2014,0,61,15070,12450,0,0,1
3,1.5,1340,13560,1.0,0,0,3,7,1340,0,1968,0,98028,47.741,-122.234,1540,15000,309500,5,8,2014,0,46,12220,13460,0,0,0
3,1.0,1130,8201,1.0,0,0,5,6,1130,0,1948,0,98155,47.7359,-122.306,1180,8203,350000,23,7,2014,0,66,7071,7023,0,0,1
2,2.0,1180,2521,2.0,0,0,3,6,1180,0,2005,0,98038,47.3487,-122.021,1310,3003,215000,16,3,2015,0,10,1341,1693,0,0,0
2,1.0,910,6000,1.0,0,0,3,6,910,0,1943,0,98118,47.5253,-122.266,1460,5800,254000,26,8,2014,0,71,5090,4340,0,0,1
3,1.75,1630,4275,1.5,0,3,3,7,1630,0,1908,0,98115,47.6851,-122.322,1800,4275,567000,20,4,2015,0,107,2645,2475,0,0,1
2,1.0,710,1173,2.0,0,0,4,7,710,0,1943,0,98102,47.6412,-122.329,1370,1173,402000,29,5,2014,0,71,463,-197,0,0,1
4,2.5,2820,8408,2.0,0,0,3,9,2820,0,2014,0,98155,47.7538,-122.325,1300,8408,625000,2,5,2014,0,0,5588,7108,0,0,1
4,1.75,1970,5160,1.5,0,0,3,7,1970,0,1942,0,98126,47.534,-122.373,1230,4920,432000,23,4,2015,0,73,3190,3690,0,0,1
2,1.75,1860,5940,1.0,0,2,5,8,1020,840,1956,0,98116,47.5751,-122.407,2130,5940,672500,6,8,2014,0,58,4080,3810,0,1,1
4,1.0,1780,4310,1.5,0,0,5,6,1780,0,1919,0,98118,47.5486,-122.278,1460,4310,336000,22,7,2014,0,95,2530,2850,0,0,1
4,2.5,1788,10183,2.0,0,0,4,7,1788,0,1990,0,98002,47.2883,-122.218,1700,6600,294400,24,11,2014,0,24,8395,4900,0,0,0
3,2.5,1880,3054,2.0,0,0,3,8,1880,0,1988,0,98007,47.6091,-122.147,1840,3815,541900,20,4,2015,0,27,1174,1975,0,0,0
3,1.75,2300,11400,1.0,0,0,4,8,1520,780,1977,0,98052,47.6884,-122.128,2300,10140,505000,17,12,2014,0,37,9100,7840,0,1,0
3,2.5,1610,6176,2.0,0,0,3,7,1610,0,1994,0,98030,47.3657,-122.173,1680,7414,255000,5,6,2014,0,20,4566,5734,0,0,0
6,2.5,2270,11970,1.0,0,0,3,7,1470,800,1964,0,98011,47.7722,-122.204,2270,10640,435000,22,1,2015,0,51,9700,8370,0,1,0
2,1.75,1230,3600,1.5,0,0,5,7,1230,0,1925,0,98119,47.6423,-122.361,1210,4500,636000,8,5,2014,0,89,2370,3290,0,0,1
3,1.5,1670,6988,1.0,0,0,3,7,1370,300,1953,0,98148,47.4283,-122.323,1090,7753,280500,18,3,2015,0,62,5318,6663,0,1,1
2,1.0,1120,6141,1.0,0,0,3,7,900,220,1946,0,98117,47.6924,-122.372,1500,7529,520000,22,4,2015,0,69,5021,6029,0,1,1
4,2.5,2580,5476,2.0,0,0,3,8,2580,0,2005,0,98031,47.4042,-122.205,2900,5476,354000,26,6,2014,0,9,2896,2576,0,0,0
4,2.75,3580,12000,1.0,0,0,3,10,1840,1740,1979,0,98074,47.6319,-122.05,2910,12428,879900,7,1,2015,0,36,8420,9518,0,1,0
5,4.0,4050,11358,2.0,0,0,4,10,2780,1270,1980,0,98040,47.56,-122.225,3120,13555,1290000,20,3,2015,0,35,7308,10435,0,1,0
3,1.75,1540,8400,1.5,0,0,3,7,1540,0,1902,0,98122,47.6187,-122.295,1330,4800,900000,13,5,2015,0,113,6860,3470,0,0,1
4,2.5,2550,7200,2.0,0,2,3,7,2550,0,2003,0,98056,47.4793,-122.18,2560,5715,419500,17,7,2014,0,11,4650,3155,0,0,0
4,2.0,2340,6000,1.0,0,0,5,8,1270,1070,1953,0,98199,47.6495,-122.401,1600,6000,685000,3,11,2014,0,61,3660,4400,0,1,1
4,2.5,2320,4524,2.0,0,0,3,8,2320,0,2004,0,98059,47.4798,-122.136,2330,4524,429950,7,11,2014,0,10,2204,2194,0,0,0
4,2.5,1640,6000,2.0,0,0,3,7,1640,0,2011,0,98106,47.559,-122.365,1640,4800,464950,23,4,2015,0,4,4360,3160,0,0,1
2,1.0,910,9000,1.0,0,0,4,6,910,0,1983,0,98045,47.4463,-121.771,1410,9440,239900,10,10,2014,0,31,8090,8030,0,0,0
4,3.25,2550,11524,2.0,0,0,3,8,2550,0,1990,0,98019,47.7324,-121.963,2370,14001,406250,18,2,2015,0,25,8974,11631,0,0,0
4,2.5,2660,8027,2.0,0,0,3,8,2660,0,1997,0,98045,47.4831,-121.781,2480,8095,447000,27,10,2014,0,17,5367,5615,0,0,0
3,2.5,1480,14250,2.0,0,0,3,7,1480,0,1996,0,98033,47.6595,-122.186,1660,14250,466800,5,6,2014,0,18,12770,12590,0,0,0
4,2.5,2810,11560,1.0,0,0,5,7,1740,1070,1962,0,98008,47.5846,-122.12,1970,11560,674000,17,9,2014,0,52,8750,9590,0,1,0
1,1.0,830,3200,1.0,0,0,3,7,830,0,1924,0,98103,47.6557,-122.348,1350,2512,525000,26,11,2014,0,90,2370,1162,0,0,1
3,2.5,2480,4950,2.0,0,0,3,7,2480,0,2004,0,98058,47.4389,-122.116,2230,5298,374900,29,4,2015,0,11,2470,3068,0,0,0
4,3.0,3720,5000,2.5,0,0,5,9,2720,1000,1905,0,98102,47.6282,-122.322,2610,5000,1440000,6,10,2014,0,109,1280,2390,0,1,1
3,2.25,2150,9250,2.0,0,0,3,8,2150,0,1984,0,98052,47.7179,-122.113,2240,9266,559500,5,12,2014,0,30,7100,7026,0,0,0
3,2.5,2370,7875,2.0,0,0,3,9,2370,0,2003,0,98065,47.5427,-121.863,2660,7752,522500,16,5,2014,0,11,5505,5092,0,0,0
5,2.75,2990,7420,2.0,0,0,3,8,2990,0,1996,0,98059,47.4944,-122.162,2290,7678,498500,12,6,2014,0,18,4430,5388,0,0,0
4,1.0,1350,4000,1.5,0,0,3,8,1350,0,1930,0,98117,47.6885,-122.386,1520,4000,571000,25,8,2014,0,84,2650,2480,0,0,1
3,2.0,1410,10248,1.0,0,0,3,7,1410,0,1985,0,98001,47.3315,-122.265,2090,9414,271920,4,3,2015,0,30,8838,7324,0,0,0
2,1.0,1170,8254,1.0,0,0,2,6,1170,0,1949,0,98146,47.497,-122.346,1820,8922,104950,8,12,2014,0,65,7084,7102,0,0,1
4,2.5,1800,4500,2.0,0,0,3,8,1800,0,1999,0,98075,47.5998,-122.014,1800,4500,485500,29,9,2014,0,15,2700,2700,0,0,0
4,2.75,3650,6982,2.0,0,2,4,9,2530,1120,1951,2003,98115,47.6756,-122.275,3140,7894,1210000,28,5,2014,52,63,3332,4754,1,1,1
3,1.75,1490,8357,1.0,0,0,4,7,1490,0,1993,0,98038,47.3473,-122.037,1490,7376,260250,22,1,2015,0,22,6867,5886,0,0,0
4,2.5,3610,13292,2.0,0,0,3,10,3610,0,1996,0,98075,47.5868,-121.974,3000,10776,875909,13,4,2015,0,19,9682,7776,0,0,0
3,1.0,1092,7500,1.5,0,0,3,6,1092,0,1918,0,98106,47.5321,-122.354,930,4000,309000,20,5,2014,0,96,6408,3070,0,0,1
4,2.25,2010,7688,1.0,0,0,3,8,1170,840,1979,0,98023,47.3086,-122.396,1990,7688,229000,9,7,2014,0,35,5678,5698,0,1,0
3,2.5,2510,5186,2.0,0,0,3,7,2510,0,2001,0,98053,47.6895,-122.041,2530,5186,571000,17,11,2014,0,13,2676,2656,0,0,0
5,2.75,3190,16920,1.0,0,3,3,9,1690,1500,1976,0,98006,47.5641,-122.16,3100,13100,1030000,5,5,2014,0,38,13730,10000,0,1,0
4,3.25,4690,14930,2.0,0,2,3,10,3680,1010,1995,0,98155,47.7718,-122.283,2910,13320,600000,24,6,2014,0,19,10240,10410,0,1,1
3,2.25,1850,12000,1.0,0,0,4,7,1300,550,1977,0,98072,47.7408,-122.101,1580,12616,469500,28,4,2015,0,38,10150,11036,0,1,0
4,3.0,4160,13170,2.0,0,0,3,11,3040,1120,2001,0,98059,47.5182,-122.149,3780,13148,1150000,2,4,2015,0,14,9010,9368,0,1,0
4,1.5,2220,4000,1.5,0,0,3,8,1970,250,1925,0,98105,47.6564,-122.325,1984,4000,785000,25,8,2014,0,89,1780,2016,0,1,1
3,2.5,2870,13695,2.0,0,0,3,10,2870,0,1991,0,98052,47.6944,-122.102,2840,8472,872750,28,4,2015,0,24,10825,5632,0,0,0
4,2.75,3950,10214,1.0,0,3,3,10,2050,1900,1955,0,98117,47.6969,-122.384,3130,8608,900000,15,8,2014,0,59,6264,5478,0,1,1
2,1.75,1740,6620,1.5,0,0,3,8,1740,0,2002,0,98065,47.526,-121.828,1560,5400,350000,17,7,2014,0,12,4880,3840,0,0,0
2,1.5,1540,6549,2.0,0,0,3,7,1540,0,1980,0,98133,47.7189,-122.353,1470,6552,499000,7,1,2015,0,35,5009,5082,0,0,1
4,2.5,1970,5190,2.0,0,0,3,7,1970,0,2002,0,98059,47.515,-122.164,1840,5564,315000,8,4,2015,0,13,3220,3724,0,0,0
3,2.5,1880,4668,2.0,0,0,3,8,1880,0,1993,0,98029,47.5666,-121.999,2060,4668,509950,6,8,2014,0,21,2788,2608,0,0,0
3,2.75,2000,6405,1.0,0,0,3,8,1260,740,1964,0,98178,47.5066,-122.259,2130,6510,286300,25,2,2015,0,51,4405,4380,0,1,1
3,2.5,1990,8325,2.0,0,0,4,8,1310,680,1997,0,98034,47.705,-122.201,2450,10606,590000,28,7,2014,0,17,6335,8156,0,1,0
4,1.0,1400,9384,1.5,0,0,4,6,1400,0,1948,0,98106,47.5166,-122.361,1600,8432,325000,4,9,2014,0,66,7984,6832,0,0,1
3,1.5,1000,6914,1.0,0,0,3,7,1000,0,1947,0,98125,47.7144,-122.319,1000,6947,378000,13,11,2014,0,67,5914,5947,0,0,1
3,1.75,1670,6900,1.0,0,0,3,7,1170,500,1978,0,98023,47.2975,-122.38,1740,7000,239950,18,6,2014,0,36,5230,5260,0,1,0
4,2.0,2100,4500,1.0,0,0,5,7,1060,1040,1924,0,98105,47.6699,-122.317,1920,3900,550000,11,11,2014,0,90,2400,1980,0,1,1
2,1.0,1010,6180,1.0,0,0,3,6,1010,0,1903,0,98118,47.5532,-122.28,1560,6180,325000,22,4,2015,0,112,5170,4620,0,0,1
4,2.5,2030,3905,1.5,0,0,4,7,1630,400,1926,0,98103,47.6547,-122.34,2000,3905,831000,9,6,2014,0,88,1875,1905,0,1,1
3,1.0,1090,10296,1.0,0,0,4,6,1090,0,1950,0,98028,47.7743,-122.26,1910,10296,249000,12,12,2014,0,64,9206,8386,0,0,0
4,1.75,2440,16730,1.0,0,0,3,7,1390,1050,1976,0,98072,47.7406,-122.11,1390,11600,484000,26,1,2015,0,39,14290,10210,0,1,0
4,3.0,2500,6278,2.0,0,0,3,9,2500,0,2002,0,98092,47.3325,-122.168,2700,7200,395000,21,11,2014,0,12,3778,4500,0,0,0
4,2.5,3420,7462,2.0,0,0,3,9,3420,0,2002,0,98074,47.6388,-122.064,3080,8031,839900,19,11,2014,0,12,4042,4951,0,0,0
4,2.5,2850,11000,2.0,0,0,3,8,2850,0,1998,0,98052,47.6759,-122.161,1720,11000,760000,13,11,2014,0,16,8150,9280,0,0,0
4,1.5,2030,3300,1.5,0,0,4,8,1530,500,1927,0,98116,47.5855,-122.383,2610,5400,750000,12,5,2015,0,88,1270,2790,0,1,1
5,3.75,4590,11265,2.0,0,0,4,11,3450,1140,1927,0,98112,47.6389,-122.288,3870,8996,3000000,8,4,2015,0,88,6675,5126,0,1,1
3,2.5,2230,5800,2.0,0,0,3,7,2230,0,2004,0,98065,47.5308,-121.847,2230,6088,440000,15,9,2014,0,10,3570,3858,0,0,0
2,1.75,1810,7523,1.0,0,0,3,8,1170,640,1962,1980,98027,47.5695,-122.087,2090,7523,501000,3,12,2014,18,52,5713,5433,1,1,0
6,4.5,4000,7500,2.0,0,0,3,7,4000,0,1978,0,98122,47.6146,-122.306,1380,6298,739000,24,9,2014,0,36,3500,4918,0,0,1
4,1.75,2120,4000,1.5,0,0,4,8,1920,200,1929,0,98105,47.6601,-122.275,2300,4000,980000,16,9,2014,0,85,1880,1700,0,1,1
3,1.5,1030,7184,1.0,0,0,4,7,1030,0,1968,0,98056,47.5069,-122.189,1330,7262,275000,30,9,2014,0,46,6154,5932,0,0,0
4,1.75,2310,8045,1.0,0,0,4,7,1650,660,1976,0,98058,47.4569,-122.165,1790,8086,319950,19,5,2014,0,38,5735,6296,0,1,0
3,2.25,1830,7943,2.0,0,0,3,8,1830,0,1985,0,98028,47.7466,-122.249,2100,8070,448500,20,3,2015,0,30,6113,5970,0,0,0
4,1.5,2500,9448,1.0,0,0,4,7,1250,1250,1966,0,98106,47.5212,-122.339,1640,9490,330000,7,11,2014,0,48,6948,7850,0,1,1
3,2.5,2470,7700,2.0,0,0,4,8,2470,0,1990,0,98031,47.4096,-122.17,2400,7700,365000,17,12,2014,0,24,5230,5300,0,0,0
2,1.0,940,7700,1.0,0,0,4,6,940,0,1916,0,98133,47.7067,-122.354,1290,7375,329000,12,11,2014,0,98,6760,6085,0,0,1
5,2.75,3260,11700,1.0,0,0,3,8,1630,1630,1964,0,98008,47.6169,-122.104,2860,11700,681500,20,6,2014,0,50,8440,8840,0,1,0
3,2.25,1660,10140,1.0,0,0,4,8,1370,290,1980,0,98052,47.6889,-122.128,2100,10125,566000,9,5,2014,0,34,8480,8025,0,1,0
3,2.5,2620,9112,2.0,0,0,3,9,2620,0,1995,0,98052,47.6972,-122.116,2620,9067,738000,29,12,2014,0,19,6492,6447,0,0,0
3,1.75,1500,7800,1.0,0,0,3,7,1500,0,1968,0,98092,47.3141,-122.192,1490,7800,185000,20,4,2015,0,47,6300,6310,0,0,0
2,1.0,910,7200,1.0,0,1,4,7,830,80,1936,0,98136,47.5145,-122.39,1700,7200,445000,4,3,2015,0,79,6290,5500,0,1,1
3,1.75,1430,4920,1.0,0,0,2,6,1430,0,1957,0,98118,47.5388,-122.275,1550,5646,175000,25,3,2015,0,58,3490,4096,0,0,1
2,1.0,900,8556,1.0,0,0,3,6,760,140,1941,0,98136,47.5148,-122.386,1500,8556,315000,21,11,2014,0,73,7656,7056,0,1,1
4,1.75,1250,7400,1.0,0,0,5,6,1250,0,1959,0,98008,47.62,-122.12,990,7600,445000,24,6,2014,0,55,6150,6610,0,0,0
5,3.0,3850,14990,1.0,0,0,4,9,2290,1560,1964,0,98004,47.6425,-122.218,3010,15001,1400000,5,8,2014,0,50,11140,11991,0,1,0
4,3.5,3950,12320,2.0,0,0,3,10,3950,0,2001,0,98065,47.5414,-121.869,3920,11086,771150,17,7,2014,0,13,8370,7166,0,0,0
4,1.5,1950,12559,1.5,0,0,3,6,1950,0,1939,0,98188,47.4364,-122.282,1950,9178,225000,13,5,2014,0,75,10609,7228,0,0,1
3,2.5,1700,6396,2.0,0,0,3,7,1700,0,2003,0,98065,47.5333,-121.87,1700,4444,389950,23,9,2014,0,11,4696,2744,0,0,0
3,2.5,2370,6082,2.0,0,0,3,7,2370,0,2004,0,98065,47.5288,-121.846,2690,6152,435000,4,8,2014,0,10,3712,3462,0,0,0
3,1.75,1600,2538,2.0,0,0,3,7,1600,0,1929,0,98102,47.6447,-122.327,1660,1750,845000,16,3,2015,0,86,938,90,0,0,1
4,1.75,4060,5500,2.0,0,0,5,9,2660,1400,1924,0,98102,47.6437,-122.321,3320,5500,1300000,25,7,2014,0,90,1440,2180,0,1,1
3,2.25,1322,1796,2.0,0,0,3,8,1087,235,2005,0,98144,47.5976,-122.298,1690,2025,350000,14,7,2014,0,9,474,335,0,1,1
3,1.75,1140,10400,1.0,0,0,4,7,1140,0,1983,0,98003,47.2598,-122.311,1280,9800,250000,8,7,2014,0,31,9260,8520,0,0,0
2,1.5,1280,2096,2.0,0,0,3,7,1080,200,2007,0,98144,47.5872,-122.308,1340,7452,370000,30,4,2015,0,8,816,6112,0,1,1
4,2.5,3080,4553,2.5,0,0,3,8,3080,0,2008,0,98052,47.7066,-122.112,2750,4929,750000,29,7,2014,0,6,1473,2179,0,0,0
2,1.75,1210,3000,1.0,0,0,5,7,910,300,1906,0,98117,47.6789,-122.365,1260,3000,439950,25,8,2014,0,108,1790,1740,0,1,1
4,1.75,1950,10219,1.0,0,0,3,7,1950,0,1962,0,98133,47.7492,-122.336,1500,9099,395000,3,11,2014,0,52,8269,7599,0,0,1
4,1.0,1450,6820,1.5,0,0,3,6,1450,0,1947,0,98133,47.7061,-122.347,1450,6820,375000,7,8,2014,0,67,5370,5370,0,0,1
3,2.25,1590,7748,2.0,0,0,4,7,1590,0,1991,0,98003,47.2857,-122.3,1590,7606,263000,15,5,2014,0,23,6158,6016,0,0,0
3,1.0,1240,9198,1.5,0,0,4,7,1240,0,1959,0,98032,47.37,-122.297,1170,8970,185000,8,12,2014,0,55,7958,7800,0,0,0
4,2.5,3470,10045,2.0,0,0,3,10,3470,0,1993,0,98027,47.554,-122.095,4370,12359,920000,26,9,2014,0,21,6575,7989,0,0,0
3,1.75,2430,12757,1.0,0,2,4,8,1340,1090,1952,0,98004,47.6201,-122.209,2930,12450,1500000,8,5,2014,0,62,10327,9520,0,1,0
3,2.25,2420,7200,1.0,0,0,3,8,1420,1000,1948,0,98115,47.6867,-122.275,2500,7200,1100000,27,10,2014,0,66,4780,4700,0,1,1
3,2.5,1510,10875,1.0,0,0,3,7,1150,360,1990,0,98003,47.3482,-122.3,1810,9916,247000,2,1,2015,0,25,9365,8106,0,1,0
3,1.0,1200,5525,1.0,0,0,2,7,1200,0,1947,0,98115,47.6981,-122.325,1580,7200,289500,25,4,2015,0,68,4325,5620,0,0,1
3,2.5,2240,6396,2.0,0,0,3,7,2240,0,2002,0,98065,47.5356,-121.881,2610,5128,432500,2,6,2014,0,12,4156,2518,0,0,0
3,1.75,1870,4320,1.0,0,0,4,7,970,900,1920,0,98103,47.6663,-122.357,1810,3900,680000,27,3,2015,0,95,2450,2090,0,1,1
3,1.0,1110,6000,1.5,0,0,5,7,1110,0,1932,0,98199,47.6496,-122.403,1420,6000,589000,28,5,2014,0,82,4890,4580,0,0,1
4,2.0,3210,8400,1.5,0,0,5,7,2040,1170,1914,0,98136,47.5322,-122.391,2540,6458,756450,23,12,2014,0,100,5190,3918,0,1,1
3,1.75,2090,8910,1.0,0,0,3,8,1230,860,1975,0,98034,47.7149,-122.222,2310,10695,536650,7,4,2015,0,40,6820,8385,0,1,0
3,2.25,1320,1800,2.0,0,0,3,7,1320,0,1994,0,98122,47.6081,-122.289,2010,4500,540000,2,7,2014,0,20,480,2490,0,0,1
3,1.75,1340,3850,1.0,0,0,4,7,1340,0,1960,0,98125,47.7134,-122.292,1540,7645,385000,28,4,2015,0,55,2510,6105,0,0,1
3,1.0,1020,6120,1.0,0,0,3,7,1020,0,1941,0,98115,47.6787,-122.285,2370,6695,485000,2,9,2014,0,73,5100,4325,0,0,1
3,2.0,1390,2688,1.5,0,0,5,7,1390,0,1915,0,98117,47.6783,-122.366,1440,2900,550000,13,11,2014,0,99,1298,1460,0,0,1
4,2.0,2970,5400,2.5,0,0,4,9,2970,0,1900,0,98112,47.6235,-122.309,2500,5040,1260000,29,9,2014,0,114,2430,2540,0,0,1
2,1.75,1550,4257,1.0,0,3,3,7,830,720,1953,0,98136,47.5274,-122.384,1920,5100,415000,12,11,2014,0,61,2707,3180,0,1,1
4,2.5,1904,8200,2.0,0,0,5,7,1904,0,1999,0,98010,47.3107,-122.001,1560,12426,365000,28,1,2015,0,16,6296,10866,0,0,0
4,1.5,1400,8500,2.0,0,0,3,7,1400,0,1975,0,98001,47.3314,-122.275,1580,7650,257000,10,12,2014,0,39,7100,6070,0,0,0
3,2.5,2140,3821,2.0,0,0,3,8,2140,0,2005,0,98029,47.5541,-121.995,2860,3841,420000,24,6,2014,0,9,1681,981,0,0,0
3,1.75,1320,9450,1.0,0,0,5,7,1320,0,1943,0,98166,47.4557,-122.348,1320,8315,338995,16,9,2014,0,71,8130,6995,0,0,1
3,1.75,2620,8280,1.0,0,0,4,7,1330,1290,1948,0,98177,47.7235,-122.359,1530,8160,615000,10,4,2015,0,67,5660,6630,0,1,1
4,0.5,2300,5570,2.0,0,0,3,8,2300,0,1996,0,98092,47.3285,-122.168,1820,6371,312500,12,12,2014,0,18,3270,4551,0,0,0
4,2.5,2000,5684,2.0,0,0,3,8,2000,0,1996,0,98028,47.7443,-122.22,2210,7066,513000,6,5,2014,0,18,3684,4856,0,0,0
4,2.75,2960,5040,2.0,0,3,3,9,2210,750,1952,1993,98116,47.5747,-122.408,2270,5500,857500,27,1,2015,41,63,2080,3230,1,1,1
3,1.75,1740,9500,1.0,0,3,4,8,1150,590,1958,0,98146,47.4919,-122.365,2110,9450,585000,22,7,2014,0,56,7760,7340,0,1,1
2,2.5,1770,4950,1.0,0,0,3,7,1770,0,2003,0,98038,47.3497,-122.025,1770,4500,350500,8,10,2014,0,11,3180,2730,0,0,0
3,2.0,1290,9312,1.0,0,0,3,7,1290,0,1947,0,98168,47.4811,-122.325,1650,7300,215000,6,10,2014,0,67,8022,5650,0,0,1
4,2.0,1450,8400,1.5,0,0,4,7,1450,0,1962,0,98034,47.7285,-122.24,1450,7440,440000,17,6,2014,0,52,6950,5990,0,0,0
3,2.25,1420,7800,1.0,0,0,4,7,1130,290,1985,0,98042,47.3598,-122.157,1460,7800,270000,27,4,2015,0,30,6380,6340,0,1,0
3,0.75,1330,7020,1.0,0,0,5,7,1330,0,1924,0,98126,47.5377,-122.376,1410,5802,385000,23,10,2014,0,90,5690,4392,0,0,1
3,1.75,1760,4125,1.5,0,3,4,7,1760,0,1927,0,98103,47.6748,-122.352,1760,4000,688500,17,11,2014,0,87,2365,2240,0,0,1
3,1.75,2010,4905,1.0,0,0,5,7,1230,780,1912,0,98122,47.6105,-122.309,2210,1834,700000,19,5,2014,0,102,2895,-376,0,1,1
5,2.0,2560,14467,1.0,0,0,3,8,1280,1280,1960,0,98006,47.5547,-122.178,2200,10267,585000,22,8,2014,0,54,11907,8067,0,1,0
2,1.5,1260,2625,2.0,0,0,4,7,1260,0,1983,0,98052,47.6747,-122.151,1260,2625,401000,26,2,2015,0,32,1365,1365,0,0,0
4,2.25,2420,7725,1.0,0,0,4,8,1890,530,1972,0,98052,47.6287,-122.093,1740,7944,655000,6,3,2015,0,43,5305,6204,0,1,0
3,1.0,1010,5400,1.0,0,0,3,6,1010,0,1959,0,98144,47.5746,-122.293,960,5400,317000,4,6,2014,0,55,4390,4440,0,0,1
4,2.5,1770,8155,1.5,0,0,4,6,1770,0,1970,1993,98034,47.719,-122.173,1460,7360,500000,5,5,2015,23,45,6385,5900,1,0,0
2,1.0,890,6350,1.0,0,0,3,6,890,0,1943,0,98103,47.6975,-122.357,1490,6350,314963,21,10,2014,0,71,5460,4860,0,0,1
3,1.5,1670,5060,2.0,0,2,5,7,1670,0,1925,0,98126,47.5671,-122.379,1670,5118,715000,27,10,2014,0,89,3390,3448,0,0,1
3,2.25,1360,9600,2.0,0,0,3,7,1360,0,1992,0,98045,47.4687,-121.749,1200,10400,280000,14,10,2014,0,22,8240,9200,0,0,0
3,2.5,2120,9736,2.0,0,0,3,9,2120,0,1988,0,98011,47.7374,-122.219,2490,8763,531000,12,6,2014,0,26,7616,6273,0,0,0
3,2.5,1910,4488,2.0,0,0,3,8,1910,0,1998,0,98007,47.6176,-122.14,1530,3696,617000,23,9,2014,0,16,2578,2166,0,0,0
4,1.0,1480,7560,1.5,0,0,3,7,1480,0,1940,0,98177,47.7079,-122.358,1480,7560,440000,9,10,2014,0,74,6080,6080,0,0,1
3,1.0,1090,10114,1.0,0,0,4,7,1090,0,1955,0,98002,47.2975,-122.223,1380,7800,140000,29,7,2014,0,59,9024,6420,0,0,0
4,1.75,1670,13125,1.0,0,0,5,8,1670,0,1973,0,98052,47.6315,-122.101,2360,12500,661000,13,2,2015,0,42,11455,10140,0,0,0
4,1.75,1670,13125,1.0,0,0,5,8,1670,0,1973,0,98052,47.6315,-122.101,2360,12500,697000,29,4,2015,0,42,11455,10140,0,0,0
5,2.75,3650,13297,2.0,0,0,5,9,2750,900,1969,0,98040,47.5497,-122.228,2900,11568,1200000,27,6,2014,0,45,9647,8668,0,1,0
4,2.0,1970,3515,1.0,0,0,5,8,1030,940,1969,0,98115,47.6873,-122.314,1650,4275,535000,20,9,2014,0,45,1545,2625,0,1,1
2,2.0,1320,3060,1.5,0,0,4,6,1320,0,1910,0,98118,47.5643,-122.284,1410,3264,404500,24,3,2015,0,105,1740,1854,0,0,1
3,1.0,1710,5110,1.0,0,0,3,7,1100,610,1954,0,98126,47.5256,-122.379,1310,5110,396500,12,11,2014,0,60,3400,3800,0,1,1
3,2.25,1740,9488,1.0,0,0,4,8,1180,560,1977,0,98056,47.5339,-122.174,1880,8615,450000,20,3,2015,0,38,7748,6735,0,1,0
3,3.25,2200,2400,2.0,0,0,3,8,1740,460,1988,0,98119,47.6325,-122.371,2200,3600,605000,16,1,2015,0,27,200,1400,0,1,1
3,2.0,2010,4320,2.0,0,2,3,9,2010,0,1999,0,98118,47.5153,-122.256,1640,5225,699000,11,9,2014,0,15,2310,3585,0,0,1
3,3.0,3910,19023,2.0,0,0,3,11,3910,0,1985,0,98014,47.6953,-121.914,1860,15001,805000,19,6,2014,0,29,15113,13141,0,0,0
4,2.5,2330,7064,1.0,0,0,4,8,1780,550,1984,0,98052,47.6955,-122.097,1740,8075,595000,6,3,2015,0,31,4734,6335,0,1,0
3,1.75,1930,7200,1.5,0,0,3,6,1930,0,1929,0,98065,47.5263,-121.809,1350,9000,285000,28,7,2014,0,85,5270,7650,0,0,0
4,2.5,3270,6055,2.0,0,0,3,9,3270,0,2007,0,98056,47.5374,-122.192,2740,7367,725000,25,3,2015,0,8,2785,4627,0,0,0
3,2.5,1650,5000,2.0,0,0,3,8,1650,0,1985,0,98023,47.3206,-122.394,1720,5000,216300,25,11,2014,0,29,3350,3280,0,0,0
4,2.75,2220,8450,1.0,0,0,4,7,1260,960,1983,0,98059,47.4804,-122.157,1580,8450,410000,20,10,2014,0,31,6230,6870,0,1,0
2,1.75,2470,4600,1.0,0,3,4,7,1140,1330,1916,0,98126,47.5599,-122.378,1790,5175,597000,3,9,2014,0,98,2130,3385,0,1,1
3,1.0,1300,9300,1.0,0,0,4,7,1300,0,1977,0,98077,47.7562,-122.073,1300,10064,325000,18,2,2015,0,38,8000,8764,0,0,0
5,2.75,2530,9375,1.0,0,0,5,7,1530,1000,1966,0,98030,47.3738,-122.214,2250,8200,355000,1,4,2015,0,49,6845,5950,0,1,0
3,1.5,2400,8215,1.0,0,0,3,7,1200,1200,1961,0,98146,47.5001,-122.338,1460,8217,338000,18,12,2014,0,53,5815,6757,0,1,1
4,2.25,1500,5393,2.0,0,0,3,7,1500,0,1999,0,98001,47.3378,-122.263,1700,5917,210000,18,11,2014,0,15,3893,4217,0,0,0
4,1.75,1700,9000,1.0,0,0,3,7,1700,0,1967,0,98034,47.7308,-122.18,1930,7818,423000,14,8,2014,0,47,7300,5888,0,0,0
4,1.5,2120,8554,1.0,0,0,4,7,1170,950,1977,0,98002,47.2933,-122.195,1790,8554,249500,11,2,2015,0,38,6434,6764,0,1,0
4,2.5,2240,5105,2.0,0,0,4,8,2240,0,2002,0,98042,47.3922,-122.165,1920,5288,325000,10,1,2015,0,13,2865,3368,0,0,0
3,1.75,1540,8223,1.0,0,0,4,7,1070,470,1987,0,98042,47.3666,-122.089,1240,8113,257000,25,3,2015,0,28,6683,6873,0,1,0
3,1.0,1260,9638,2.0,0,0,4,7,1260,0,1920,0,98033,47.6773,-122.178,1760,7822,490000,14,11,2014,0,94,8378,6062,0,0,0
2,1.5,1160,3838,2.0,0,0,3,7,1160,0,1983,0,98034,47.7255,-122.164,1410,3780,299000,2,2,2015,0,32,2678,2370,0,0,0
4,2.5,3220,14463,2.0,0,0,3,8,3220,0,1978,0,98074,47.6261,-122.047,2550,12109,630000,29,10,2014,0,36,11243,9559,0,0,0
4,1.5,2020,8474,1.0,0,0,5,7,1010,1010,1962,0,98058,47.4579,-122.17,1720,8166,320000,24,4,2015,0,53,6454,6446,0,1,0
4,2.5,2990,8640,1.0,0,0,5,8,2100,890,1959,0,98005,47.5932,-122.172,2270,8800,1110000,24,4,2015,0,56,5650,6530,0,1,0
4,1.0,1420,6458,1.0,0,0,4,7,1420,0,1953,0,98117,47.6988,-122.358,1670,6350,398000,22,9,2014,0,61,5038,4680,0,0,1
3,1.0,1020,7874,1.0,0,0,3,7,1020,0,1956,0,98106,47.5175,-122.346,1290,7320,218000,21,5,2014,0,58,6854,6030,0,0,1
5,3.0,3640,8239,2.0,0,3,3,10,2540,1100,1982,0,98008,47.5842,-122.111,3330,10643,1600000,1,6,2014,0,32,4599,7313,0,1,0
2,2.25,1550,1824,2.0,0,0,3,8,1550,0,2007,0,98106,47.5396,-122.368,1460,1826,348500,18,12,2014,0,7,274,366,0,0,1
2,2.0,1870,4751,1.0,0,0,3,8,1870,0,2006,0,98053,47.7082,-122.015,2170,5580,592500,25,7,2014,0,8,2881,3410,0,0,0
3,2.5,2340,5957,2.0,0,0,3,8,2340,0,1995,0,98028,47.7347,-122.236,2340,6604,505000,10,6,2014,0,19,3617,4264,0,0,0
5,4.25,3350,3600,2.0,0,0,3,10,2260,1090,2014,0,98119,47.6351,-122.364,1810,3600,1430000,29,10,2014,0,0,250,1790,0,1,1
3,1.0,1710,5000,1.0,0,0,5,7,1140,570,1921,0,98116,47.5719,-122.385,1670,4000,502000,21,7,2014,0,93,3290,2330,0,1,1
3,1.5,1600,7500,1.0,0,0,3,7,1600,0,1966,0,98034,47.721,-122.182,1700,7500,405000,11,7,2014,0,48,5900,5800,0,0,0
3,1.75,1300,5111,1.0,0,0,4,7,1300,0,1959,0,98115,47.7005,-122.314,1370,5111,427000,17,3,2015,0,56,3811,3741,0,0,1
3,1.5,1040,9997,1.0,0,0,4,7,1040,0,1955,0,98155,47.7583,-122.302,1040,8699,290000,4,12,2014,0,59,8957,7659,0,0,1
3,1.0,1220,7695,1.0,0,0,3,7,1220,0,1954,0,98106,47.5191,-122.339,1210,7412,222000,24,3,2015,0,61,6475,6202,0,0,1
3,2.5,2240,6097,2.0,0,0,3,8,2240,0,2002,0,98038,47.3503,-122.042,2240,5574,315000,18,12,2014,0,12,3857,3334,0,0,0
3,1.5,1420,4500,1.0,0,0,3,7,1420,0,1959,0,98103,47.694,-122.332,1540,6375,371000,4,6,2014,0,55,3080,4835,0,0,1
3,1.75,1580,6620,1.0,0,0,3,7,1580,0,1988,0,98003,47.2798,-122.303,1580,8137,279900,26,6,2014,0,26,5040,6557,0,0,0
2,1.75,1830,7200,1.0,0,2,4,7,1070,760,1949,0,98118,47.5592,-122.273,1570,6000,585000,11,12,2014,0,65,5370,4430,0,1,1
3,1.75,1000,8268,1.0,0,0,3,6,1000,0,1969,0,98072,47.7417,-122.172,1220,7800,350000,14,4,2015,0,46,7268,6580,0,0,0
3,1.75,2180,7700,1.0,0,0,3,8,1480,700,1961,0,98177,47.7594,-122.361,2180,7604,506000,17,6,2014,0,53,5520,5424,0,1,1
3,1.0,840,4495,1.0,0,0,3,6,840,0,1921,0,98146,47.496,-122.349,1260,7434,151100,4,11,2014,0,93,3655,6174,0,0,1
3,1.0,840,4495,1.0,0,0,3,6,840,0,1921,0,98146,47.496,-122.349,1260,7434,251000,21,4,2015,0,94,3655,6174,0,0,1
4,2.25,2350,8140,1.0,0,0,4,8,1430,920,1977,0,98006,47.5579,-122.129,2640,8700,555000,22,5,2014,0,37,5790,6060,0,1,0
5,2.0,1590,9350,1.0,0,0,5,7,1060,530,1962,0,98001,47.3398,-122.286,1460,8210,247000,16,4,2015,0,53,7760,6750,0,1,0
3,1.0,1380,10875,1.0,0,0,3,7,1380,0,1977,0,98045,47.4653,-121.745,1040,10875,299500,23,1,2015,0,38,9495,9835,0,0,0
4,1.5,1940,8970,1.5,0,0,3,7,1270,670,1980,0,98125,47.7297,-122.326,1960,8470,306888,7,5,2015,0,35,7030,6510,0,1,1
2,1.0,1090,5265,1.5,0,0,4,7,1090,0,1947,0,98105,47.6638,-122.292,2080,4000,577000,21,4,2015,0,68,4175,1920,0,0,1
3,1.5,1650,9936,1.0,0,0,3,7,1090,560,1967,0,98003,47.3285,-122.328,1560,9890,219950,20,5,2014,0,47,8286,8330,0,1,0
3,1.5,1110,5500,1.0,0,0,3,6,1110,0,1940,1997,98033,47.6717,-122.184,1670,6600,375000,23,7,2014,57,74,4390,4930,1,0,0
4,2.5,2110,6820,1.0,0,0,5,7,1530,580,1942,0,98115,47.6882,-122.306,1420,6431,650000,7,11,2014,0,72,4710,5011,0,1,1
3,3.0,1850,5000,1.5,0,0,2,6,1850,0,1900,0,98107,47.6711,-122.386,1360,2500,975000,6,4,2015,0,115,3150,1140,0,0,1
1,1.0,600,3720,1.0,0,0,3,6,600,0,1920,0,98106,47.5558,-122.363,1480,4800,229000,29,4,2015,0,95,3120,3320,0,0,1
5,2.5,2760,4000,1.5,0,0,3,8,1730,1030,1926,2014,98122,47.6074,-122.299,1680,4000,575000,21,9,2014,88,88,1240,2320,1,1,1
4,1.75,2970,14880,1.0,0,4,5,9,1560,1410,1962,0,98075,47.5907,-122.086,3310,13388,815000,28,4,2015,0,53,11910,10078,0,1,0
3,2.5,2030,2805,2.0,0,0,3,8,1720,310,2001,0,98027,47.5305,-122.047,1670,2898,471000,6,6,2014,0,13,775,1228,0,1,0
4,1.75,2160,4333,1.0,0,0,4,8,1260,900,1942,0,98117,47.6893,-122.388,1670,4426,450000,23,6,2014,0,72,2173,2756,0,1,1
3,2.0,1650,6150,2.0,0,0,4,7,1650,0,1926,1993,98116,47.5713,-122.394,1280,6150,590000,28,5,2014,67,88,4500,4870,1,0,1
4,2.5,3140,7260,2.0,0,0,3,8,2200,940,2004,0,98006,47.5664,-122.124,2860,8186,744000,1,8,2014,0,10,4120,5326,0,1,0
5,2.5,1940,9389,1.0,0,0,4,7,1290,650,1960,0,98155,47.7438,-122.328,1810,9390,299000,13,3,2015,0,55,7449,7580,0,1,1
4,1.0,1220,5120,1.5,0,0,5,6,1220,0,1940,0,98022,47.205,-121.996,1540,7670,231000,29,1,2015,0,75,3900,6130,0,0,0
3,1.0,1300,9600,1.0,0,0,4,6,1300,0,1975,0,98092,47.3037,-122.107,1150,10222,195000,20,8,2014,0,39,8300,9072,0,0,0
3,1.75,1660,11500,1.0,0,0,3,7,1130,530,1979,0,98045,47.4473,-121.774,1250,11000,305000,23,4,2015,0,36,9840,9750,0,1,0
4,1.5,3390,6200,2.0,0,0,4,8,2530,860,1916,0,98144,47.58,-122.29,3080,6000,895000,2,3,2015,0,99,2810,2920,0,1,1
4,1.5,2310,13300,1.0,0,0,3,7,1890,420,1950,0,98004,47.6232,-122.21,2840,12744,1110000,7,5,2014,0,64,10990,9904,0,1,0
2,1.0,950,7954,1.0,0,0,4,7,950,0,1941,0,98108,47.557,-122.306,1180,6828,339000,26,6,2014,0,73,7004,5648,0,0,1
4,3.75,2400,3520,1.0,0,0,3,7,1370,1030,1924,2005,98109,47.6295,-122.346,2230,1419,885000,11,4,2015,81,91,1120,-811,1,1,1
3,1.0,1780,5236,1.5,0,0,5,6,1050,730,1944,0,98146,47.5119,-122.386,1260,5320,375000,3,11,2014,0,70,3456,4060,0,1,1
4,1.5,1280,7400,1.0,0,0,3,7,1280,0,1958,0,98008,47.6023,-122.123,1310,7400,367400,4,8,2014,0,56,6120,6090,0,0,0
4,2.0,1930,5398,1.0,0,0,3,7,1430,500,1953,0,98119,47.646,-122.363,1910,4902,700000,24,4,2015,0,62,3468,2992,0,1,1
5,2.25,2560,10360,1.0,0,0,4,8,1870,690,1966,0,98008,47.5819,-122.126,2070,7875,667000,30,1,2015,0,49,7800,5805,0,1,0
2,1.0,920,5250,1.0,0,0,4,6,920,0,1906,0,98118,47.5177,-122.266,1210,5250,200000,22,12,2014,0,108,4330,4040,0,0,1
3,2.5,2080,16050,1.0,0,0,5,8,1360,720,1978,0,98059,47.4694,-122.069,1790,14550,418000,21,11,2014,0,36,13970,12760,0,1,0
3,1.75,1460,10128,1.0,0,0,3,8,1460,0,1968,2000,98033,47.6709,-122.167,2240,10154,601500,12,2,2015,32,47,8668,7914,1,0,0
4,2.5,2810,6481,2.0,0,0,3,9,2810,0,1998,0,98092,47.333,-122.172,2660,6958,340000,24,4,2015,0,17,3671,4298,0,0,0
3,2.5,2370,6752,2.0,0,0,3,8,2370,0,1994,0,98003,47.2703,-122.312,1870,7455,310000,26,8,2014,0,20,4382,5585,0,0,0
2,1.75,1700,18000,1.0,0,0,3,8,1700,0,1972,0,98056,47.5066,-122.194,1700,8225,290000,17,12,2014,0,42,16300,6525,0,0,0
2,1.0,1630,9255,1.0,0,0,3,7,1630,0,1941,0,98133,47.7222,-122.332,1800,8000,438000,24,4,2015,0,74,7625,6200,0,0,1
4,2.75,2930,4408,1.0,0,0,5,8,1660,1270,1939,0,98144,47.5841,-122.295,2200,4000,718000,24,2,2015,0,76,1478,1800,0,1,1
2,1.0,860,6600,1.0,0,0,5,6,860,0,1949,0,98168,47.4878,-122.324,1030,6732,200000,20,6,2014,0,65,5740,5702,0,0,1
3,2.0,1980,12150,1.0,0,0,3,9,1980,0,1994,0,98042,47.3657,-122.152,2200,12150,479900,28,5,2014,0,20,10170,9950,0,0,0
3,2.5,2080,7877,2.0,0,0,3,9,2080,0,1987,0,98058,47.4395,-122.151,2550,7660,400000,23,4,2015,0,28,5797,5110,0,0,0
3,1.0,1060,10042,1.0,0,0,4,7,1060,0,1957,0,98188,47.4434,-122.283,1130,10925,219950,23,3,2015,0,58,8982,9795,0,0,1
3,2.5,1590,3381,2.0,0,0,3,7,1590,0,2000,0,98019,47.7344,-121.986,1820,3383,300000,27,8,2014,0,14,1791,1563,0,0,0
3,2.25,1980,8775,1.0,0,0,3,7,1290,690,1959,0,98177,47.7753,-122.359,1550,9240,437000,5,8,2014,0,55,6795,7690,0,1,1
4,2.0,1720,7210,1.0,0,0,3,7,860,860,1971,0,98034,47.7307,-122.239,1250,7210,350000,10,7,2014,0,43,5490,5960,0,1,0
4,1.75,1350,9293,1.0,0,0,4,7,1350,0,1954,0,98004,47.6335,-122.196,1890,9293,626000,29,9,2014,0,60,7943,7403,0,0,0
3,2.5,2080,12032,2.0,0,0,3,8,2080,0,1978,0,98077,47.7455,-122.073,2320,9900,490000,24,2,2015,0,37,9952,7580,0,0,0
3,2.5,2090,4700,2.0,0,0,3,8,2090,0,2002,0,98042,47.3724,-122.104,2740,5040,289000,20,5,2014,0,12,2610,2300,0,0,0
3,2.5,2030,5100,2.0,0,0,3,7,2030,0,2008,0,98199,47.6594,-122.397,1790,4380,595000,14,11,2014,0,6,3070,2590,0,0,1
3,1.75,1820,8028,1.0,0,0,3,7,1220,600,1980,0,98133,47.7466,-122.355,1940,11100,389000,14,4,2015,0,35,6208,9160,0,1,1
3,2.0,1300,5000,1.0,0,0,4,7,1300,0,1983,0,98198,47.3837,-122.304,1630,7500,240000,15,9,2014,0,31,3700,5870,0,0,1
4,2.5,2210,7079,2.0,0,0,3,8,2210,0,1993,0,98031,47.4206,-122.183,1970,7000,382500,17,6,2014,0,21,4869,5030,0,0,0
3,2.0,1400,7293,1.0,0,0,4,7,1400,0,1963,0,98008,47.586,-122.12,1600,7960,511555,9,5,2014,0,51,5893,6360,0,0,0
3,1.75,2040,4125,1.5,0,0,4,8,1540,500,1917,0,98107,47.6608,-122.359,1620,4400,710500,10,9,2014,0,97,2085,2780,0,1,1
4,1.75,1920,7500,1.0,0,0,4,7,1920,0,1962,0,98198,47.4222,-122.318,1490,8000,170000,23,7,2014,0,52,5580,6510,0,0,1
5,2.75,2760,7200,1.0,0,0,3,7,1430,1330,1979,0,98072,47.7563,-122.147,2460,8750,480000,8,4,2015,0,36,4440,6290,0,1,0
4,3.75,3450,8395,2.0,0,4,4,10,2640,810,1993,0,98122,47.6134,-122.282,3180,5183,1670000,20,7,2014,0,21,4945,2003,0,1,1
3,1.0,1040,6535,1.0,0,0,3,6,1040,0,1947,0,98168,47.4906,-122.306,1100,6535,225000,13,5,2014,0,67,5495,5435,0,0,1
3,1.75,2220,7224,1.0,0,2,3,8,2040,180,1975,0,98177,47.774,-122.384,2540,9990,615000,1,12,2014,0,39,5004,7450,0,1,1
3,1.75,1300,9856,1.0,0,0,4,7,1300,0,1962,0,98003,47.3448,-122.298,1400,9600,242000,4,3,2015,0,53,8556,8200,0,0,0
3,2.5,1960,9686,1.0,0,0,3,8,1460,500,1989,0,98074,47.6339,-122.026,1960,8254,560000,16,7,2014,0,25,7726,6294,0,1,0
3,1.5,2040,3960,2.0,0,2,5,8,2040,0,1928,0,98103,47.6658,-122.355,1540,3400,857500,3,10,2014,0,86,1920,1860,0,0,1
4,2.5,3030,7864,2.0,0,0,3,9,3030,0,1999,0,98074,47.6075,-122.017,2790,7034,685000,6,5,2014,0,15,4834,4244,0,0,0
4,3.0,2260,7336,2.0,0,0,4,7,2260,0,1977,0,98034,47.7297,-122.219,2200,7724,486000,3,4,2015,0,38,5076,5524,0,0,0
3,2.5,2670,10338,2.0,0,0,3,9,2670,0,1987,0,98007,47.6599,-122.146,2670,8866,749000,5,6,2014,0,27,7668,6196,0,0,0
3,2.5,1520,6298,2.0,0,0,3,7,1520,0,1986,0,98030,47.3687,-122.182,1670,7207,260000,14,11,2014,0,28,4778,5537,0,0,0
3,1.75,3610,8502,1.5,0,2,3,10,2610,1000,1930,0,98126,47.583,-122.379,2900,5016,1020000,14,1,2015,0,85,4892,2116,0,1,1
3,1.75,1130,5111,1.0,0,0,4,7,930,200,1942,0,98199,47.6379,-122.4,1360,4424,565000,10,3,2015,0,73,3981,3064,0,1,1
3,2.0,1480,2502,2.0,0,0,3,7,1480,0,1991,0,98103,47.6969,-122.338,1850,5000,355000,14,10,2014,0,23,1022,3150,0,0,1
5,2.0,3540,9970,2.0,0,3,3,9,3540,0,1970,0,98125,47.7108,-122.277,2280,7195,775000,30,7,2014,0,44,6430,4915,0,0,1
4,2.25,2100,7305,1.0,0,0,4,7,1050,1050,1963,0,98188,47.4676,-122.296,1760,7308,335000,22,4,2015,0,52,5205,5548,0,1,1
5,4.0,3366,7800,2.5,0,2,3,8,2966,400,1937,0,98199,47.6466,-122.391,2340,6000,1300000,20,6,2014,0,77,4434,3660,0,1,1
3,1.75,1810,3000,1.5,0,0,4,7,1810,0,1903,0,98107,47.6599,-122.363,1140,3000,545000,3,6,2014,0,111,1190,1860,0,0,1
3,1.75,1680,4240,1.5,0,0,4,7,1680,0,1926,0,98144,47.5745,-122.311,1460,4240,540000,18,11,2014,0,88,2560,2780,0,0,1
3,1.75,2450,9377,1.0,0,2,4,8,1540,910,1962,0,98125,47.7296,-122.284,2520,9725,687500,15,9,2014,0,52,6927,7205,0,1,1
1,2.0,1150,9812,1.0,0,0,4,7,1150,0,1962,0,98001,47.2951,-122.284,1200,9812,115000,8,7,2014,0,52,8662,8612,0,0,0
1,2.0,1150,9812,1.0,0,0,4,7,1150,0,1962,0,98001,47.2951,-122.284,1200,9812,227000,25,11,2014,0,52,8662,8612,0,0,0
4,2.5,3240,7621,2.0,0,2,3,9,3240,0,2003,0,98075,47.5641,-122.032,4610,7150,870000,29,4,2015,0,12,4381,2540,0,0,0
4,2.5,2800,5000,2.0,0,0,3,9,2800,0,2006,0,98038,47.3596,-122.036,2960,5092,375000,10,9,2014,0,8,2200,2132,0,0,0
3,2.75,3240,7200,1.0,0,2,3,8,1620,1620,1960,0,98118,47.567,-122.273,2700,7200,902000,28,8,2014,0,54,3960,4500,0,1,1
2,1.5,1480,7276,1.0,0,0,4,6,940,540,1978,0,98056,47.4942,-122.166,1090,6710,269500,17,6,2014,0,36,5796,5620,0,1,0
3,1.0,1700,4750,1.5,0,0,4,6,1200,500,1909,0,98117,47.6819,-122.389,1550,4750,570000,10,3,2015,0,106,3050,3200,0,1,1
2,1.0,1240,7590,1.0,0,0,4,7,1040,200,1939,0,98133,47.7061,-122.34,1190,5692,359950,21,8,2014,0,75,6350,4502,0,1,1
4,3.5,3720,8301,2.0,0,0,3,10,2880,840,2008,0,98004,47.5885,-122.199,2080,9676,1450000,25,3,2015,0,7,4581,7596,0,1,0
3,2.5,1910,3427,2.0,0,0,3,8,1910,0,2001,0,98052,47.6324,-122.11,2240,3720,615000,17,7,2014,0,13,1517,1480,0,0,0
4,2.0,2120,8701,1.5,0,0,4,7,2120,0,1960,0,98198,47.3722,-122.308,1720,8527,250000,4,6,2014,0,54,6581,6807,0,0,1
4,2.5,3020,6788,2.0,0,0,3,7,3020,0,2002,0,98065,47.5346,-121.881,2640,5325,530000,16,9,2014,0,12,3768,2685,0,0,0
4,2.0,1650,6480,2.0,0,0,5,7,1650,0,1947,0,98125,47.7117,-122.286,1650,6350,490000,22,2,2015,0,68,4830,4700,0,0,1
2,1.5,880,1157,2.0,0,0,3,7,880,0,2007,0,98126,47.5188,-122.376,1070,1203,210000,28,5,2014,0,7,277,133,0,0,1
3,1.0,1860,9225,1.0,0,0,3,7,1860,0,1957,0,98198,47.3904,-122.3,1740,12204,265500,14,11,2014,0,57,7365,10464,0,0,1
5,3.25,3840,4800,3.0,0,3,3,10,2750,1090,2008,0,98144,47.5929,-122.29,2060,4800,1460000,20,6,2014,0,6,960,2740,0,1,1
4,2.25,2192,12128,2.0,0,0,3,8,2192,0,2006,0,98030,47.3644,-122.2,1914,4649,310000,5,6,2014,0,8,9936,2735,0,0,0
3,2.5,1590,4108,2.0,0,0,3,7,1590,0,2003,0,98056,47.4832,-122.181,2160,3912,324500,9,4,2015,0,12,2518,1752,0,0,0
4,4.75,3700,11000,1.0,0,0,4,7,1840,1860,1962,0,98028,47.768,-122.251,1720,11564,599000,29,9,2014,0,52,7300,9844,0,1,0
4,2.5,3670,9958,2.0,0,0,3,10,3670,0,2005,0,98058,47.4617,-122.159,3300,10679,525000,9,7,2014,0,9,6288,7379,0,0,0
3,1.0,1630,10304,1.0,0,0,5,7,1630,0,1953,0,98155,47.7548,-122.317,1480,8515,400000,15,5,2014,0,61,8674,7035,0,0,1
2,1.0,1060,3325,1.5,0,0,4,6,770,290,1932,0,98115,47.6896,-122.307,1820,4275,344000,23,7,2014,0,82,2265,2455,0,1,1
3,2.5,2700,7434,2.0,0,0,3,9,2700,0,1991,0,98072,47.7434,-122.174,2660,8405,525000,15,5,2014,0,23,4734,5745,0,0,0
3,2.25,2110,8000,2.0,0,0,3,8,2110,0,1975,0,98034,47.7311,-122.204,1740,7270,385000,22,8,2014,0,39,5890,5530,0,0,0
4,2.5,3720,8633,2.0,0,0,3,10,3720,0,1999,0,98074,47.6085,-122.013,3515,9660,820000,17,12,2014,0,15,4913,6145,0,0,0
4,3.5,3440,5000,2.0,0,0,3,11,2560,880,2006,0,98199,47.6672,-122.409,3090,10241,1310000,27,4,2015,0,9,1560,7151,0,1,1
3,1.0,1090,6771,1.5,0,0,3,7,1090,0,1929,0,98106,47.5177,-122.353,1230,4662,180000,25,2,2015,0,86,5681,3432,0,0,1
4,2.5,2910,5776,2.0,0,2,3,8,2910,0,1998,0,98065,47.5388,-121.87,2550,6750,589000,21,5,2014,0,16,2866,4200,0,0,0
3,1.0,1050,5518,1.0,0,0,3,7,1050,0,1948,0,98118,47.5564,-122.278,1490,4269,350000,27,1,2015,0,67,4468,2779,0,0,1
3,2.0,1610,7575,1.0,0,0,4,7,1110,500,1965,0,98003,47.334,-122.3,1920,8400,197400,9,4,2015,0,50,5965,6480,0,1,0
3,2.5,1760,6477,2.0,0,0,4,8,1760,0,1986,0,98030,47.3731,-122.172,1890,6800,267000,6,8,2014,0,28,4717,4910,0,0,0
4,2.5,2580,9450,1.0,0,0,4,8,1660,920,1959,0,98125,47.703,-122.28,2060,9450,650000,13,10,2014,0,55,6870,7390,0,1,1
2,1.0,1370,5000,1.5,0,0,3,7,1370,0,1905,0,98107,47.6744,-122.383,1500,5000,600000,13,2,2015,0,110,3630,3500,0,0,1
2,1.75,1440,6265,1.0,0,0,3,8,1440,0,2005,0,98053,47.7028,-122.013,1810,5209,490000,30,4,2015,0,10,4825,3399,0,0,0
3,1.0,1410,7700,1.0,0,0,3,7,980,430,1962,0,98058,47.4577,-122.171,1510,7700,225000,21,11,2014,0,52,6290,6190,0,1,0
3,2.25,1980,10115,1.0,0,0,3,8,1980,0,1959,0,98005,47.6384,-122.174,2800,10143,640000,3,7,2014,0,55,8135,7343,0,0,0
3,3.5,2440,3427,2.0,0,0,3,7,1990,450,2000,0,98005,47.589,-122.165,2440,2601,710000,10,6,2014,0,14,987,161,0,1,0
3,2.0,1350,11805,1.0,0,0,3,7,1350,0,1986,0,98019,47.7313,-121.971,1350,14200,325000,9,6,2014,0,28,10455,12850,0,0,0
3,1.0,880,7004,1.0,0,0,3,5,880,0,1950,0,98002,47.3019,-122.216,880,7828,128750,18,7,2014,0,64,6124,6948,0,0,0
3,2.25,1920,7300,1.0,0,0,3,7,1240,680,1961,0,98008,47.6078,-122.128,1920,7700,465000,17,10,2014,0,53,5380,5780,0,1,0
4,1.75,2700,7625,1.0,0,0,4,8,1450,1250,1937,0,98115,47.6838,-122.323,1760,3300,710000,26,7,2014,0,77,4925,1540,0,1,1
4,2.75,1670,6000,1.0,0,0,5,7,840,830,1917,0,98136,47.5496,-122.385,1100,6000,605000,6,3,2015,0,98,4330,4900,0,1,1
3,2.25,1820,7326,2.0,0,0,3,8,1820,0,1983,0,98034,47.7133,-122.217,2430,7696,489950,19,6,2014,0,31,5506,5266,0,0,0
3,1.5,1310,8160,1.0,0,0,3,7,1310,0,1950,0,98133,47.7291,-122.339,1090,7560,365000,6,5,2014,0,64,6850,6470,0,0,1
3,2.0,1790,7212,1.0,0,0,4,8,1790,0,1998,0,98042,47.3898,-122.154,2330,7212,359950,2,2,2015,0,17,5422,4882,0,0,0
4,2.5,2460,4774,2.0,0,0,3,8,2460,0,2006,0,98059,47.4912,-122.145,2510,4399,495000,29,9,2014,0,8,2314,1889,0,0,0
3,1.5,1060,9039,1.0,0,0,3,7,1060,0,1973,2013,98058,47.4293,-122.151,1410,9515,255000,21,5,2014,40,41,7979,8105,1,0,0
3,1.75,1340,10276,1.0,0,0,4,7,1340,0,1961,0,98034,47.7207,-122.222,2950,7987,330000,12,8,2014,0,53,8936,5037,0,0,0
3,1.75,1480,8394,1.0,0,0,4,8,1480,0,1971,0,98052,47.6634,-122.144,1920,9184,450000,7,7,2014,0,43,6914,7264,0,0,0
4,2.5,3500,11306,2.0,0,2,3,9,3500,0,2005,0,98065,47.5428,-121.861,3180,8028,655000,18,3,2015,0,10,7806,4848,0,0,0
4,2.75,2910,16362,1.0,0,2,4,9,2120,790,1969,0,98003,47.3397,-122.322,2850,14904,485000,21,4,2015,0,46,13452,12054,0,1,0
4,1.75,1940,15909,1.0,0,0,3,8,970,970,1974,0,98072,47.7578,-122.094,1940,15120,375000,12,8,2014,0,40,13969,13180,0,1,0
4,2.5,2280,4534,2.0,0,0,3,8,2280,0,2003,0,98075,47.5902,-122.018,2246,4534,570000,17,10,2014,0,11,2254,2288,0,0,0
3,2.25,1190,1022,3.0,0,0,3,8,1190,0,1998,0,98103,47.6972,-122.349,1210,1171,350000,23,4,2015,0,17,-168,-39,0,0,1
3,1.0,1260,6000,1.0,0,3,3,7,1260,0,1951,0,98146,47.5058,-122.384,2020,6600,550000,25,2,2015,0,64,4740,4580,0,0,1
5,2.0,2270,8652,1.0,0,0,3,7,1150,1120,1965,0,98052,47.6692,-122.151,1950,8050,513000,31,7,2014,0,49,6382,6100,0,1,0
4,2.25,1990,7320,1.0,0,0,4,7,1030,960,1965,0,98126,47.5237,-122.376,1320,7320,450000,5,12,2014,0,49,5330,6000,0,1,1
4,1.75,1500,1856,1.0,0,0,5,7,750,750,1901,0,98144,47.5917,-122.296,1220,1739,432500,9,2,2015,0,114,356,519,0,1,1
3,2.25,1950,8892,2.0,0,0,3,8,1950,0,1983,0,98052,47.7213,-122.11,1900,8750,480000,23,1,2015,0,32,6942,6850,0,0,0
3,1.75,1790,6980,1.0,0,0,3,7,1330,460,1980,0,98034,47.7311,-122.226,1770,8081,402200,28,7,2014,0,34,5190,6311,0,1,0
3,1.0,1520,10227,1.0,0,0,4,6,1520,0,1951,0,98004,47.5872,-122.196,2710,10912,650000,13,4,2015,0,64,8707,8202,0,0,0
4,2.5,3240,13044,2.0,0,0,4,9,3240,0,1984,0,98040,47.5825,-122.242,2920,13044,1200000,24,4,2015,0,31,9804,10124,0,0,0
3,2.0,2440,13250,1.0,0,0,4,8,1440,1000,1977,0,98030,47.375,-122.227,2400,10650,312000,28,7,2014,0,37,10810,8250,0,1,0
4,2.0,2220,5821,1.5,0,0,4,7,1380,840,1916,0,98116,47.5723,-122.382,1850,5000,610000,2,4,2015,0,99,3601,3150,0,1,1
5,1.75,2640,7722,1.5,0,0,4,7,1650,990,1915,0,98117,47.6802,-122.361,1750,4000,823000,23,3,2015,0,100,5082,2250,0,1,1
4,1.75,1450,3750,1.0,0,0,4,7,950,500,1925,0,98105,47.6706,-122.3,1850,4000,471000,13,11,2014,0,89,2300,2150,0,1,1
3,2.25,1550,5511,2.0,0,0,3,8,1550,0,1987,0,98033,47.6946,-122.185,1620,5511,481015,2,7,2014,0,27,3961,3891,0,0,0
4,3.25,2810,11250,1.0,0,0,3,8,1680,1130,1980,0,98052,47.692,-122.099,2110,11250,624000,23,9,2014,0,34,8440,9140,0,1,0
4,2.5,2080,7966,1.0,0,0,3,7,1200,880,1970,0,98011,47.7393,-122.181,1920,7500,480000,20,3,2015,0,45,5886,5580,0,1,0
3,1.5,1370,8671,1.0,0,0,3,7,1370,0,1955,0,98004,47.6217,-122.198,1580,8671,815000,15,7,2014,0,59,7301,7091,0,0,0
3,1.0,1000,18513,1.0,0,0,3,6,1000,0,1940,0,98146,47.5118,-122.348,1280,8113,180000,16,5,2014,0,74,17513,6833,0,0,1
2,1.75,1210,9750,1.0,0,0,3,7,1210,0,1984,0,98038,47.3438,-122.037,1650,9750,156601,17,2,2015,0,31,8540,8100,0,0,0
4,2.5,2790,4650,2.0,0,0,3,8,2790,0,2004,0,98038,47.3557,-122.026,2850,4650,374950,19,7,2014,0,10,1860,1800,0,0,0
2,1.5,1660,4680,1.0,0,0,5,6,830,830,1908,0,98146,47.5134,-122.388,1930,5400,368000,19,5,2014,0,106,3020,3470,0,1,1
3,2.0,1650,3952,2.0,0,0,3,7,1650,0,1950,0,98103,47.6727,-122.33,1210,4560,550000,2,12,2014,0,64,2302,3350,0,0,1
3,1.75,1300,6318,1.0,0,0,3,7,1300,0,1980,0,98001,47.2752,-122.251,1150,8002,198000,17,7,2014,0,34,5018,6852,0,0,0
3,1.75,1090,7200,1.0,0,0,3,7,1090,0,1968,0,98034,47.7227,-122.179,1240,7200,345000,13,5,2014,0,46,6110,5960,0,0,0
5,2.5,2660,6572,1.0,0,0,5,9,1960,700,1959,0,98039,47.6176,-122.223,3960,14595,1710000,9,3,2015,0,56,3912,10635,0,1,0
3,1.0,940,10890,1.0,0,0,4,5,940,0,1909,0,98001,47.2763,-122.257,1370,10255,185900,30,1,2015,0,106,9950,8885,0,0,0
3,2.75,2750,18029,1.0,0,2,5,9,1810,940,1978,0,98006,47.5617,-122.134,2850,10021,950000,17,6,2014,0,36,15279,7171,0,1,0
4,4.5,3850,13551,2.0,0,2,3,10,3000,850,1998,0,98006,47.5522,-122.103,3480,10737,995000,20,6,2014,0,16,9701,7257,0,1,0
2,1.0,860,8250,1.0,0,0,3,7,860,0,1940,0,98133,47.7132,-122.334,1780,11200,345000,2,8,2014,0,74,7390,9420,0,0,1
4,2.75,2070,10125,1.0,0,0,3,7,1390,680,1962,0,98040,47.5697,-122.219,1850,10125,741000,5,11,2014,0,52,8055,8275,0,1,0
2,2.25,2290,9772,1.0,0,0,3,8,2290,0,2007,0,98053,47.7199,-122.025,1810,6077,737000,9,7,2014,0,7,7482,4267,0,0,0
4,2.5,2340,6420,1.0,0,2,3,8,1590,750,1964,0,98177,47.7728,-122.386,2110,10856,668750,21,5,2014,0,50,4080,8746,0,1,1
3,1.75,2680,8625,1.0,0,0,5,8,1590,1090,1974,0,98027,47.5316,-122.056,2620,14275,575000,2,7,2014,0,40,5945,11655,0,1,0
4,2.0,1710,5440,1.0,0,0,5,8,1030,680,1976,0,98042,47.366,-122.093,1620,6696,280000,17,10,2014,0,38,3730,5076,0,1,0
3,1.5,1800,10050,1.0,0,0,3,7,1800,0,1955,0,98008,47.6344,-122.126,1610,10050,583000,4,8,2014,0,59,8250,8440,0,0,0
3,2.25,1510,9600,1.0,0,0,1,7,1090,420,1966,0,98028,47.7758,-122.238,1870,10681,196000,28,1,2015,0,49,8090,8811,0,1,0
3,2.5,1700,7496,2.0,0,0,3,8,1700,0,1994,0,98055,47.432,-122.189,2280,7496,349950,15,5,2014,0,20,5796,5216,0,0,0
4,1.0,1350,3333,1.5,0,0,3,7,1350,0,1912,0,98107,47.6727,-122.397,1530,5000,429000,11,12,2014,0,102,1983,3470,0,0,1
5,2.5,2140,10320,1.0,0,0,4,7,1330,810,1967,0,98031,47.3927,-122.194,2050,8964,270000,20,2,2015,0,48,8180,6914,0,1,0
6,4.0,2700,7416,1.0,0,0,3,7,1350,1350,1969,0,98108,47.5525,-122.3,2260,5324,385000,9,9,2014,0,45,4716,3064,0,1,1
1,1.0,920,5000,1.0,0,3,4,7,920,0,1906,0,98103,47.6748,-122.352,1890,5000,535000,22,9,2014,0,108,4080,3110,0,0,1
3,1.75,1500,10269,1.0,0,0,3,7,1030,470,1958,0,98133,47.7672,-122.348,2090,10269,352500,20,4,2015,0,57,8769,8179,0,1,1
3,1.75,1510,5200,1.0,0,0,4,7,860,650,1922,0,98117,47.6864,-122.365,1650,4160,624000,1,3,2015,0,93,3690,2510,0,1,1
5,1.5,1980,7958,1.5,0,0,3,7,1980,0,1962,0,98058,47.4571,-122.17,1510,8438,215000,17,12,2014,0,52,5978,6928,0,0,0
4,2.5,3220,8256,2.0,0,0,3,8,2610,610,2006,0,98059,47.495,-122.155,2500,9472,440000,29,7,2014,0,8,5036,6972,0,1,0
2,1.5,1140,1149,2.0,0,0,3,7,940,200,2001,0,98122,47.6124,-122.314,1460,1149,518000,5,5,2015,0,14,9,-311,0,1,1
3,2.25,1490,7589,2.0,0,0,3,7,1490,0,1993,0,98038,47.3474,-122.037,1510,6603,259500,25,3,2015,0,22,6099,5093,0,0,0
3,1.0,960,9000,1.0,0,0,4,7,960,0,1955,0,98006,47.5765,-122.154,1520,9000,290000,18,8,2014,0,59,8040,7480,0,0,0
4,3.0,2253,7700,2.0,0,0,3,7,2253,0,1957,2014,98198,47.3935,-122.3,1786,9052,385000,23,4,2015,57,58,5447,7266,1,0,1
2,1.0,770,6542,1.0,0,0,3,6,770,0,1948,0,98155,47.747,-122.301,1120,8149,259950,7,10,2014,0,66,5772,7029,0,0,1
2,2.5,1310,2915,2.0,0,0,3,8,1310,0,1999,0,98059,47.4911,-122.154,1310,3425,330000,29,4,2015,0,16,1605,2115,0,0,0
3,1.0,980,7480,1.0,0,0,3,6,830,150,1948,0,98106,47.5206,-122.363,1140,7480,280000,19,12,2014,0,66,6500,6340,0,1,1
4,3.75,3980,7828,2.0,0,0,3,10,3980,0,2001,0,98074,47.6303,-122.065,3980,8910,925900,17,11,2014,0,13,3848,4930,0,0,0
3,2.25,3010,9600,2.0,0,0,3,8,2410,600,1978,0,98028,47.7671,-122.263,2620,9660,499000,8,8,2014,0,36,6590,7040,0,1,0
4,2.5,1830,7762,2.0,0,0,3,8,1830,0,1993,0,98003,47.267,-122.31,2109,8966,325000,3,4,2015,0,22,5932,6857,0,0,0
2,1.0,800,8960,1.0,0,0,4,6,800,0,1944,0,98058,47.4756,-122.174,850,8082,162248,29,4,2015,0,71,8160,7232,0,0,0
3,1.5,1810,5080,1.0,0,0,3,7,1030,780,1958,0,98115,47.6819,-122.287,1780,7620,430000,3,7,2014,0,56,3270,5840,0,1,1
3,1.5,1810,5080,1.0,0,0,3,7,1030,780,1958,0,98115,47.6819,-122.287,1780,7620,615500,29,1,2015,0,57,3270,5840,0,1,1
3,1.0,940,5650,1.0,0,0,3,6,940,0,1949,0,98118,47.5551,-122.292,1180,5276,260000,16,4,2015,0,66,4710,4096,0,0,1
3,1.75,2550,6117,2.0,0,0,3,9,1650,900,1951,2004,98122,47.6109,-122.285,2100,4967,1190000,24,9,2014,53,63,3567,2867,1,1,1
4,2.5,2370,2971,2.0,0,2,3,9,2080,290,2008,0,98034,47.7064,-122.224,2970,7500,749950,20,11,2014,0,6,601,4530,0,1,0
6,1.0,1370,5080,1.5,0,0,3,6,1120,250,1931,0,98106,47.5238,-122.35,1020,5080,175000,18,6,2014,0,83,3710,4060,0,1,1
6,1.0,1370,5080,1.5,0,0,3,6,1120,250,1931,0,98106,47.5238,-122.35,1020,5080,415000,20,1,2015,0,84,3710,4060,0,1,1
3,1.0,1200,8316,1.0,0,0,4,6,1200,0,1953,0,98002,47.3231,-122.215,1250,8316,190000,19,11,2014,0,61,7116,7066,0,0,0
3,1.75,2100,3264,1.5,0,0,5,7,1350,750,1912,0,98107,47.6702,-122.364,1720,3750,625000,17,4,2015,0,103,1164,2030,0,1,1
4,1.5,1570,9210,1.0,0,2,3,7,1400,170,1965,0,98030,47.3864,-122.22,2326,9210,339900,16,4,2015,0,50,7640,6884,0,1,0
4,2.5,1830,5331,2.0,0,0,3,7,1830,0,2002,0,98038,47.3557,-122.016,1830,5175,353000,15,12,2014,0,12,3501,3345,0,0,0
3,2.0,1010,14183,1.0,0,0,3,8,1010,0,1982,0,98074,47.6232,-122.043,1750,11700,390000,6,2,2015,0,33,13173,9950,0,0,0
4,2.5,1770,9858,1.0,0,2,3,8,1770,0,1971,0,98155,47.7382,-122.287,2470,9858,675000,5,3,2015,0,44,8088,7388,0,0,1
3,2.5,2120,3757,2.0,0,0,3,7,2120,0,2006,0,98059,47.4787,-122.128,2230,4103,400000,13,3,2015,0,9,1637,1873,0,0,0
4,3.5,3190,5040,2.0,0,3,3,10,2160,1030,2003,0,98144,47.5928,-122.29,2390,4800,1340000,26,6,2014,0,11,1850,2410,0,1,1
4,2.5,2780,11904,1.0,0,1,5,8,1730,1050,1951,0,98004,47.6209,-122.216,3590,13860,1650000,9,2,2015,0,64,9124,10270,0,1,0
5,3.0,3350,9450,2.0,0,0,5,8,2180,1170,1912,1980,98103,47.6705,-122.34,2660,4500,1000000,25,8,2014,68,102,6100,1840,1,1,1
3,1.5,1060,6954,1.0,0,0,4,6,1060,0,1983,0,98106,47.5498,-122.355,1560,6954,275000,15,7,2014,0,31,5894,5394,0,0,1
3,2.5,1670,2589,2.0,0,0,3,8,1670,0,2000,0,98027,47.5314,-122.047,1670,2897,450000,13,8,2014,0,14,919,1227,0,0,0
4,1.75,2251,12731,1.0,0,1,4,8,1390,861,1957,0,98003,47.3369,-122.32,2520,12539,305000,13,11,2014,0,57,10480,10019,0,1,0
3,2.5,1770,3744,1.5,0,0,3,7,1270,500,1929,0,98117,47.6807,-122.364,1400,4680,643002,2,9,2014,0,85,1974,3280,0,1,1
2,1.75,1510,4500,1.0,0,0,3,8,1510,0,1978,0,98052,47.6644,-122.13,1740,6000,468000,13,4,2015,0,37,2990,4260,0,0,0
4,2.5,1770,5000,2.0,0,0,3,7,1770,0,2004,0,98038,47.3506,-122.006,2080,5100,324950,20,2,2015,0,11,3230,3020,0,0,0
3,2.0,1260,7346,1.0,0,0,3,7,1260,0,1987,0,98031,47.4034,-122.176,1460,7363,290000,26,3,2015,0,28,6086,5903,0,0,0
3,2.0,1710,10959,1.0,0,0,4,7,1030,680,1981,0,98033,47.697,-122.199,1710,10498,488500,29,4,2015,0,34,9249,8788,0,1,0
3,1.75,2290,8234,1.0,0,0,4,7,1250,1040,1950,0,98133,47.7611,-122.351,1660,7200,367950,13,8,2014,0,64,5944,5540,0,1,1
2,1.0,790,6555,1.0,0,0,2,6,790,0,1956,0,98146,47.5015,-122.35,1440,7601,285000,20,2,2015,0,59,5765,6161,0,0,1
3,2.5,2390,8102,2.0,0,0,4,8,2390,0,1986,0,98058,47.4378,-122.16,2310,8606,380000,28,4,2015,0,29,5712,6296,0,0,0
4,2.5,2500,5264,2.0,0,0,3,7,2500,0,2003,0,98038,47.3853,-122.028,1960,5250,336500,16,11,2014,0,11,2764,3290,0,0,0
4,2.0,2290,6000,1.5,0,3,5,7,2290,0,1900,0,98115,47.6807,-122.318,2000,3150,685000,18,2,2015,0,115,3710,1150,0,0,1
3,1.0,1600,16868,1.0,0,1,3,7,990,610,1946,0,98040,47.5872,-122.241,2600,12735,670000,11,12,2014,0,68,15268,10135,0,1,0
2,1.0,1120,2000,1.5,0,0,3,7,1120,0,1910,0,98109,47.6454,-122.354,1500,4000,524000,16,6,2014,0,104,880,2500,0,0,1
3,1.0,1340,10260,1.0,0,0,3,7,1340,0,1968,0,98003,47.3173,-122.317,1250,8775,172000,11,12,2014,0,46,8920,7525,0,0,0
6,2.0,1670,3000,1.0,0,0,5,7,900,770,1911,0,98105,47.6637,-122.316,1330,1099,680000,19,6,2014,0,103,1330,-231,0,1,1
3,1.5,910,5120,1.0,0,0,3,6,910,0,1973,0,98106,47.5238,-122.356,1410,5132,107000,28,8,2014,0,41,4210,3722,0,0,1
3,1.5,910,5120,1.0,0,0,3,6,910,0,1973,0,98106,47.5238,-122.356,1410,5132,232900,2,12,2014,0,41,4210,3722,0,0,1
4,3.5,2370,3302,2.0,0,0,3,8,1610,760,1926,2014,98103,47.684,-122.341,2170,3800,800000,12,1,2015,88,89,932,1630,1,1,1
2,1.5,880,1498,2.0,0,0,3,7,880,0,1999,0,98133,47.7063,-122.342,880,5060,248500,27,3,2015,0,16,618,4180,0,0,1
3,2.5,2050,6420,1.0,0,3,3,8,1730,320,1956,0,98116,47.5708,-122.405,2370,7620,670000,12,6,2014,0,58,4370,5250,0,1,1
3,1.0,1070,8250,1.0,0,0,3,7,1070,0,1961,0,98092,47.2899,-122.192,1190,8250,164000,3,11,2014,0,53,7180,7060,0,0,0
2,1.0,1380,1800,2.0,0,0,3,7,1080,300,1954,0,98119,47.6416,-122.361,1600,3600,570500,17,2,2015,0,61,420,2000,0,1,1
3,2.25,2680,9162,1.0,0,0,3,8,1570,1110,1978,0,98027,47.5683,-122.091,2480,8261,599990,25,6,2014,0,36,6482,5781,0,1,0
5,1.75,2100,9599,1.0,0,0,3,7,1060,1040,1961,0,98034,47.7097,-122.216,1680,10712,395000,6,10,2014,0,53,7499,9032,0,1,0
3,1.0,920,5546,1.0,0,0,2,6,920,0,1928,0,98125,47.7114,-122.284,1300,5546,207000,29,9,2014,0,86,4626,4246,0,0,1
3,1.0,920,5546,1.0,0,0,2,6,920,0,1928,0,98125,47.7114,-122.284,1300,5546,237000,12,1,2015,0,87,4626,4246,0,0,1
4,2.5,1950,7350,1.0,0,0,3,7,1150,800,1963,0,98052,47.656,-122.134,2050,9068,385000,1,12,2014,0,51,5400,7018,0,1,0
2,1.75,1660,11437,2.0,0,0,3,7,1660,0,1958,1992,98146,47.4899,-122.339,1290,7860,335000,13,8,2014,34,56,9777,6570,1,0,1
4,1.5,2670,10026,2.0,0,0,3,8,2670,0,1996,0,98092,47.2659,-122.215,2420,11900,347000,24,5,2014,0,18,7356,9480,0,0,0
3,1.0,980,8000,1.0,0,0,4,6,980,0,1954,0,98198,47.42,-122.317,1240,8000,204000,26,3,2015,0,61,7020,6760,0,0,1
4,2.25,1780,10260,2.0,0,0,3,8,1780,0,1971,0,98052,47.6647,-122.142,2360,10080,615000,7,5,2015,0,44,8480,7720,0,0,0
3,2.25,2370,10890,2.0,0,0,4,7,2370,0,1980,0,98004,47.5827,-122.197,2370,9514,943500,28,10,2014,0,34,8520,7144,0,0,0
3,2.0,1640,7333,1.0,0,0,4,7,1020,620,1941,0,98108,47.5636,-122.316,2130,4933,560000,23,4,2015,0,74,5693,2803,0,1,1
4,2.5,2610,7254,1.0,0,0,2,8,1610,1000,1975,0,98006,47.5618,-122.176,2250,7407,547500,7,4,2015,0,40,4644,5157,0,1,0
4,1.75,2030,7210,1.0,0,0,3,7,1450,580,1968,0,98059,47.5067,-122.164,1750,8387,359500,10,10,2014,0,46,5180,6637,0,1,0
3,1.75,1620,7540,1.0,0,0,3,7,1310,310,1988,0,98038,47.3635,-122.052,1580,7540,258000,23,5,2014,0,26,5920,5960,0,1,0
2,1.0,810,4800,1.0,0,0,3,7,810,0,1948,0,98126,47.5232,-122.375,1240,7740,253500,6,6,2014,0,66,3990,6500,0,0,1
3,1.0,1270,8920,1.0,0,0,5,7,1270,0,1969,0,98056,47.534,-122.172,1590,8589,422500,15,4,2015,0,46,7650,6999,0,0,0
2,2.0,1470,2052,1.5,0,0,3,7,1470,0,1986,0,98003,47.3086,-122.328,1470,2052,239000,13,11,2014,0,28,582,582,0,0,0
3,2.25,1720,8521,1.0,0,0,4,7,1140,580,1984,0,98033,47.6882,-122.184,1530,8692,628000,3,4,2015,0,31,6801,7162,0,1,0
2,2.5,1320,1957,1.0,0,0,3,8,660,660,2004,0,98106,47.5364,-122.365,1420,2198,352000,10,3,2015,0,11,637,778,0,1,1
3,2.25,1358,1196,3.0,0,0,3,7,1358,0,2007,0,98133,47.7052,-122.346,1358,1196,311600,3,2,2015,0,8,-162,-162,0,0,1
4,1.5,2070,7245,1.0,0,0,4,7,1060,1010,1964,0,98001,47.3417,-122.281,1450,7350,235000,9,10,2014,0,50,5175,5900,0,1,0
5,2.25,2910,9525,2.0,0,0,4,9,2910,0,1968,0,98040,47.5633,-122.218,2740,9525,870000,11,8,2014,0,46,6615,6785,0,0,0
4,1.5,1370,7904,1.0,0,0,3,7,900,470,1970,0,98001,47.3344,-122.28,1370,7900,190848,19,3,2015,0,45,6534,6530,0,1,0
4,1.75,2340,5080,1.0,0,0,5,7,1170,1170,1924,0,98115,47.6746,-122.32,1270,3270,570000,1,10,2014,0,90,2740,2000,0,1,1
4,4.0,2290,6250,1.5,0,0,5,7,1690,600,1940,0,98116,47.5824,-122.384,1920,4335,661254,23,5,2014,0,74,3960,2415,0,1,1
4,2.0,1650,5000,1.0,0,0,3,7,1650,0,1955,0,98117,47.6781,-122.374,1690,2276,575000,7,5,2014,0,59,3350,586,0,0,1
2,0.75,650,5360,1.0,0,0,4,5,650,0,1931,0,98133,47.7281,-122.335,1110,6700,230000,13,5,2014,0,83,4710,5590,0,0,1
3,2.25,2300,9914,2.0,0,0,4,8,2300,0,1980,0,98027,47.5677,-122.086,2240,9032,680000,2,4,2015,0,35,7614,6792,0,0,0
1,1.0,620,8261,1.0,0,0,3,5,620,0,1939,0,98106,47.5138,-122.364,1180,8244,148000,11,6,2014,0,75,7641,7064,0,0,1
1,1.0,620,8261,1.0,0,0,3,5,620,0,1939,0,98106,47.5138,-122.364,1180,8244,244900,8,12,2014,0,75,7641,7064,0,0,1
3,1.0,1400,6600,1.0,0,0,3,6,1280,120,1954,0,98168,47.4845,-122.331,1730,6600,214950,30,10,2014,0,60,5200,4870,0,1,1
3,1.5,1800,6250,1.0,0,0,3,8,1420,380,1947,0,98116,47.5778,-122.389,1800,5625,580000,30,10,2014,0,67,4450,3825,0,1,1
3,1.5,1300,7885,1.0,0,0,3,7,1300,0,1968,0,98055,47.4556,-122.209,1840,7600,263000,28,8,2014,0,46,6585,5760,0,0,0
5,2.5,2360,11375,1.0,0,0,4,7,1180,1180,1962,0,98178,47.4875,-122.255,1160,7800,317000,24,6,2014,0,52,9015,6640,0,1,1
4,3.0,3320,13500,1.0,0,0,3,7,1750,1570,1963,0,98059,47.4596,-122.065,1830,13800,302000,22,10,2014,0,51,10180,11970,0,1,0
3,1.0,1480,6978,2.0,0,0,4,8,1480,0,1949,1985,98004,47.6497,-122.217,2660,13062,899000,23,6,2014,36,65,5498,10402,1,0,0
3,2.5,2190,11394,1.0,0,0,3,8,1550,640,1956,0,98199,47.6685,-122.409,2190,9540,1290000,23,6,2014,0,58,9204,7350,0,1,1
3,1.0,1360,9310,1.0,0,0,4,7,1020,340,1980,0,98056,47.4901,-122.185,1480,8330,230000,7,11,2014,0,34,7950,6850,0,1,0
3,1.0,1210,5200,1.0,0,0,3,6,1210,0,1941,0,98126,47.531,-122.373,890,5200,430000,4,5,2015,0,74,3990,4310,0,0,1
5,4.25,4610,13252,2.0,0,4,3,11,4610,0,2004,0,98075,47.5878,-121.969,4400,15154,1170000,18,8,2014,0,10,8642,10754,0,0,0
3,1.0,860,6380,1.5,0,0,4,7,860,0,1927,0,98115,47.6942,-122.315,1250,6380,397000,14,10,2014,0,87,5520,5130,0,0,1
3,2.5,2250,8300,2.0,0,0,3,8,2250,0,2003,0,98125,47.7174,-122.308,1790,7626,595000,25,2,2015,0,12,6050,5836,0,0,1
3,1.75,2030,10089,1.0,0,0,4,8,1330,700,1976,0,98027,47.5217,-122.05,2030,9827,485000,10,3,2015,0,39,8059,7797,0,1,0
3,1.0,1840,8100,1.0,0,0,4,7,920,920,1953,0,98166,47.455,-122.35,1250,8100,185000,6,6,2014,0,61,6260,6850,0,1,1
3,1.0,1840,8100,1.0,0,0,4,7,920,920,1953,0,98166,47.455,-122.35,1250,8100,340000,19,2,2015,0,62,6260,6850,0,1,1
4,2.75,2000,5827,2.0,0,0,3,7,2000,0,1997,0,98038,47.3629,-122.026,1710,6929,236000,24,6,2014,0,17,3827,5219,0,0,0
4,2.5,2810,7549,2.0,0,0,3,9,2810,0,1992,0,98072,47.7441,-122.173,2750,7642,550000,19,9,2014,0,22,4739,4892,0,0,0
3,2.0,1780,5720,1.0,0,0,5,7,980,800,1925,0,98103,47.6794,-122.351,1620,5050,680000,9,7,2014,0,89,3940,3430,0,1,1
4,2.5,2540,8706,2.0,0,0,3,9,2540,0,1997,0,98075,47.5855,-122.031,2540,6239,630000,21,4,2015,0,18,6166,3699,0,0,0
3,2.0,2340,3477,1.0,0,1,5,7,1170,1170,1971,0,98118,47.54,-122.267,2110,6300,560000,17,6,2014,0,43,1137,4190,0,1,1
3,2.0,1480,6600,1.0,0,2,3,7,740,740,1943,0,98146,47.5081,-122.385,1250,7300,385000,13,5,2014,0,71,5120,6050,0,1,1
3,2.25,1358,1141,3.0,0,0,3,7,1358,0,2007,0,98133,47.7052,-122.346,1358,1196,280000,22,10,2014,0,7,-217,-162,0,0,1
3,2.5,1750,7490,1.0,0,0,4,7,1180,570,1979,0,98042,47.3746,-122.149,1570,7490,225000,25,8,2014,0,35,5740,5920,0,1,0
3,2.0,1170,6750,1.0,0,0,5,7,800,370,1947,0,98115,47.6752,-122.281,1330,6750,592500,9,12,2014,0,67,5580,5420,0,1,1
4,2.75,3170,7634,2.0,0,0,3,10,3170,0,1992,0,98075,47.5774,-122.054,2940,7846,750000,9,10,2014,0,22,4464,4906,0,0,0
4,1.0,1530,4875,2.0,0,0,3,7,1530,0,1977,0,98042,47.3638,-122.091,1470,4875,164000,23,10,2014,0,37,3345,3405,0,0,0
2,1.0,1100,8281,1.0,0,0,4,7,1100,0,1947,0,98155,47.7414,-122.315,1510,8281,320000,12,6,2014,0,67,7181,6771,0,0,1
4,2.5,2030,3974,2.0,0,0,3,8,2030,0,1994,0,98029,47.5692,-122.006,1780,3953,544000,25,6,2014,0,20,1944,2173,0,0,0
3,1.75,1870,7500,1.0,0,0,5,8,1320,550,1978,0,98058,47.4428,-122.134,1870,7275,344950,9,9,2014,0,36,5630,5405,0,1,0
3,2.5,3080,12476,2.0,0,0,3,10,3080,0,1990,0,98038,47.3752,-122.029,3130,13631,539500,6,6,2014,0,24,9396,10501,0,0,0
2,1.0,810,5100,1.0,0,0,3,6,810,0,1955,0,98133,47.7317,-122.343,1500,5100,229000,1,12,2014,0,59,4290,3600,0,0,1
5,3.5,3990,9938,2.0,0,0,3,11,3990,0,2001,0,98059,47.5198,-122.156,3490,11734,1070000,19,6,2014,0,13,5948,8244,0,0,0
3,2.25,1430,1383,3.0,0,0,3,8,1430,0,2005,0,98103,47.6917,-122.341,1430,1347,397500,8,8,2014,0,9,-47,-83,0,0,1
4,2.0,2190,8402,2.0,0,0,4,6,2190,0,1928,0,98033,47.6944,-122.175,2210,7802,540000,1,4,2015,0,87,6212,5592,0,0,0
4,2.5,2290,10186,2.0,0,0,3,8,2290,0,1985,0,98008,47.6353,-122.124,2150,10186,650000,23,9,2014,0,29,7896,8036,0,0,0
6,4.0,3020,13237,2.0,1,4,3,8,2840,180,1942,1983,98144,47.5924,-122.287,3680,12620,1900000,24,7,2014,41,72,10217,8940,1,1,1
4,2.75,2620,4743,1.0,0,2,4,8,1310,1310,1949,0,98117,47.6829,-122.4,1900,4764,815000,26,6,2014,0,65,2123,2864,0,1,1
2,2.5,2830,8630,2.0,0,0,3,10,2830,0,2001,0,98074,47.6481,-122.081,3190,7515,795000,9,12,2014,0,13,5800,4325,0,0,0
3,1.75,1700,9840,1.0,0,0,4,8,1200,500,1976,0,98027,47.5192,-122.046,2040,14169,502775,30,1,2015,0,39,8140,12129,0,1,0
2,1.0,1110,6411,1.0,0,0,3,6,1110,0,1944,0,98178,47.4962,-122.242,1150,6504,222900,12,1,2015,0,71,5301,5354,0,0,1
4,2.5,2650,13684,2.0,0,0,3,9,2650,0,1994,0,98052,47.6278,-122.108,2650,12032,728000,23,8,2014,0,20,11034,9382,0,0,0
4,2.75,2530,17856,2.0,0,0,3,8,2530,0,1998,0,98019,47.7356,-121.959,2530,14640,525000,2,10,2014,0,16,15326,12110,0,0,0
3,1.0,1450,7850,1.5,0,0,5,7,1450,0,1910,0,98055,47.4299,-122.199,1360,10400,257000,3,9,2014,0,104,6400,9040,0,0,0
3,2.5,2200,3360,2.0,0,0,3,8,2200,0,2009,0,98118,47.5418,-122.287,2130,3423,433500,19,5,2014,0,5,1160,1293,0,0,1
4,1.75,1890,9623,1.0,0,0,4,7,1290,600,1969,0,98001,47.2901,-122.279,1510,9711,314950,23,4,2015,0,46,7733,8201,0,1,0
3,1.75,1530,14633,1.0,0,0,3,7,1100,430,1977,0,98052,47.6949,-122.119,1780,8100,500000,22,9,2014,0,37,13103,6320,0,1,0
3,1.5,1590,8911,1.0,0,0,3,7,1590,0,1956,0,98028,47.7394,-122.252,1590,9625,300000,27,6,2014,0,58,7321,8035,0,0,0
4,2.5,2690,18653,2.0,0,0,3,8,2690,0,1985,0,98074,47.6449,-122.059,2230,9744,645000,7,7,2014,0,29,15963,7514,0,0,0
3,1.0,990,10125,1.0,0,0,3,7,990,0,1972,0,98042,47.3422,-122.089,1360,10125,222500,2,10,2014,0,42,9135,8765,0,0,0
3,1.75,1300,8099,1.0,0,0,4,7,1080,220,1976,0,98056,47.5026,-122.172,1270,8099,275000,15,7,2014,0,38,6799,6829,0,1,0
3,1.5,1720,6570,1.5,0,0,4,8,1720,0,1909,0,98118,47.5284,-122.265,1360,6000,498000,16,4,2015,0,106,4850,4640,0,0,1
3,2.5,1840,8234,2.0,0,0,3,8,1840,0,1994,0,98003,47.267,-122.312,1940,7601,297000,14,8,2014,0,20,6394,5661,0,0,0
5,3.5,4010,6000,2.0,0,3,3,9,2560,1450,1997,0,98178,47.4928,-122.229,2440,6000,625000,12,5,2015,0,18,1990,3560,0,1,1
4,2.5,3560,6187,2.0,0,0,3,9,3560,0,2003,0,98029,47.5593,-122.016,3190,6981,770000,30,10,2014,0,11,2627,3791,0,0,0
3,2.25,1640,4635,1.5,0,0,3,8,1540,100,1930,0,98115,47.6793,-122.319,1530,4635,517000,17,9,2014,0,84,2995,3105,0,1,1
1,1.0,530,6350,1.0,0,0,5,5,530,0,1941,0,98103,47.6946,-122.357,1200,6350,238000,29,8,2014,0,73,5820,5150,0,0,1
3,1.0,1990,15375,1.0,0,0,3,7,1140,850,1946,0,98168,47.4778,-122.288,1160,10236,234550,21,10,2014,0,68,13385,9076,0,1,1
3,2.25,1690,7245,1.0,0,1,3,7,1160,530,1973,0,98003,47.3505,-122.305,1690,6720,230500,29,9,2014,0,41,5555,5030,0,1,0
5,2.5,2670,16777,1.5,0,0,4,7,1620,1050,1920,0,98125,47.7015,-122.301,1610,8227,585000,28,6,2014,0,94,14107,6617,0,1,1
4,1.75,1930,3876,1.5,0,0,5,7,1450,480,1924,0,98105,47.6604,-122.324,1280,3825,733000,22,8,2014,0,90,1946,2545,0,1,1
2,1.0,810,3880,1.0,0,0,3,7,810,0,1952,0,98107,47.6631,-122.365,900,4365,357950,14,11,2014,0,62,3070,3465,0,0,1
3,1.75,1550,3680,1.0,0,0,3,7,1050,500,1927,0,98117,47.6817,-122.36,1560,4000,530000,11,6,2014,0,87,2130,2440,0,1,1
4,2.5,2640,10720,2.0,0,0,3,8,2640,0,1999,0,98188,47.4485,-122.278,1680,10018,377500,29,12,2014,0,15,8080,8338,0,0,1
4,2.5,2320,10046,2.0,0,0,3,7,2320,0,2006,0,98065,47.5406,-121.887,2320,5253,475000,6,2,2015,0,9,7726,2933,0,0,0
3,2.0,2080,5750,1.0,0,0,5,7,1040,1040,1926,0,98116,47.5791,-122.392,1710,4830,660000,26,11,2014,0,88,3670,3120,0,1,1
5,2.25,2070,10488,1.0,0,0,4,7,1080,990,1958,0,98008,47.6095,-122.122,1740,9225,400000,7,10,2014,0,56,8418,7485,0,1,0
2,1.0,800,4850,1.0,0,0,4,7,800,0,1944,0,98107,47.6639,-122.364,1150,4365,440000,2,5,2014,0,70,4050,3215,0,0,1
4,2.25,2040,14383,1.0,0,0,4,8,1270,770,1977,0,98042,47.3849,-122.163,2030,11500,366400,6,2,2015,0,38,12343,9470,0,1,0
4,2.5,2830,10677,2.0,0,0,3,9,2830,0,1993,0,98011,47.742,-122.208,2970,9619,627250,20,3,2015,0,22,7847,6649,0,0,0
3,1.75,1480,7560,1.0,0,0,3,6,1100,380,1920,1985,98117,47.6985,-122.364,1510,7250,375950,30,7,2014,65,94,6080,5740,1,1,1
3,2.25,1810,6750,1.0,0,0,3,7,1280,530,1978,0,98023,47.2976,-122.377,1690,7770,162000,18,2,2015,0,37,4940,6080,0,1,0
3,2.75,1970,2600,2.5,0,0,3,8,1970,0,1924,1994,98103,47.663,-122.335,1680,3120,780000,24,7,2014,70,90,630,1440,1,0,1
4,2.5,2650,4316,1.5,0,0,3,8,1520,1130,1905,2013,98116,47.5866,-122.389,1690,5625,705000,7,5,2014,108,109,1666,3935,1,1,1
4,2.5,2820,15233,1.0,0,2,4,9,1820,1000,1972,0,98003,47.3426,-122.321,2560,11998,450000,23,12,2014,0,42,12413,9438,0,1,0
3,2.75,1400,7880,1.0,0,0,3,7,1000,400,1981,0,98056,47.5095,-122.193,1400,7279,311000,17,11,2014,0,33,6480,5879,0,1,0
3,2.5,1580,6065,2.0,0,0,3,8,1580,0,1985,0,98029,47.5692,-122.021,1770,6700,485000,13,6,2014,0,29,4485,4930,0,0,0
3,2.5,1800,11034,2.0,0,0,4,8,1800,0,1987,0,98072,47.7558,-122.142,1940,8900,485000,16,7,2014,0,27,9234,6960,0,0,0
5,3.75,3360,6000,2.0,0,0,3,8,2640,720,1963,1999,98118,47.558,-122.277,1930,6000,725000,10,10,2014,36,51,2640,4070,1,1,1
3,1.0,1510,17040,1.0,0,0,4,6,1510,0,1975,0,98001,47.2649,-122.285,1520,14000,185000,15,7,2014,0,39,15530,12480,0,0,0
4,4.25,4285,9345,2.0,0,0,3,10,4285,0,2013,0,98004,47.6332,-122.199,1570,8994,1890000,1,12,2014,0,1,5060,7424,0,0,0
3,2.25,1610,7423,2.0,0,0,4,7,1610,0,1990,0,98042,47.3713,-122.091,1530,8102,260000,8,5,2015,0,25,5813,6572,0,0,0
4,2.5,2470,5074,2.0,0,0,3,8,2470,0,2004,0,98038,47.3457,-122.041,2470,5078,356000,30,4,2015,0,11,2604,2608,0,0,0
3,1.0,1200,7220,1.0,0,0,3,6,1200,0,1977,0,98030,47.3746,-122.183,1200,7200,225205,19,3,2015,0,38,6020,6000,0,0,0
3,1.0,1260,8910,1.0,0,0,4,7,1260,0,1949,0,98117,47.7,-122.375,1560,8910,445000,29,12,2014,0,65,7650,7350,0,0,1
2,1.0,920,4095,1.0,0,0,4,6,920,0,1914,0,98118,47.5484,-122.278,1460,4945,356000,5,6,2014,0,100,3175,3485,0,0,1
5,2.75,2540,8250,1.0,0,0,4,7,1440,1100,1953,0,98040,47.5875,-122.24,2540,11000,760250,10,10,2014,0,61,5710,8460,0,1,0
2,2.0,1870,5143,1.0,0,0,3,8,1870,0,2005,0,98053,47.7142,-122.033,1810,5143,572000,30,4,2015,0,10,3273,3333,0,0,0
3,2.25,3060,9950,1.5,0,2,4,9,1810,1250,1930,0,98144,47.579,-122.284,4950,10655,970000,24,6,2014,0,84,6890,5705,0,1,1
4,2.5,1950,8628,2.0,0,0,3,8,1950,0,1994,0,98038,47.3817,-122.035,2210,9019,348450,31,8,2014,0,20,6678,6809,0,0,0
5,2.5,2570,9600,1.0,0,2,3,8,1620,950,1956,0,98125,47.7216,-122.282,2680,9900,710000,13,10,2014,0,58,7030,7220,0,1,1
3,1.75,1490,9800,1.0,0,0,4,7,1140,350,1947,0,98004,47.584,-122.198,2310,9800,745000,28,5,2014,0,67,8310,7490,0,1,0
4,2.5,2040,8265,2.0,0,0,3,7,2040,0,1996,0,98146,47.4973,-122.341,2160,8265,355000,20,6,2014,0,18,6225,6105,0,0,1
4,2.5,2690,5505,2.0,0,0,3,8,2690,0,2004,0,98042,47.3666,-122.119,2690,5505,333000,23,3,2015,0,11,2815,2815,0,0,0
3,2.5,1610,6000,2.0,0,0,4,7,1610,0,1993,0,98038,47.349,-122.036,1570,6000,282000,26,8,2014,0,21,4390,4430,0,0,0
3,2.0,2520,5400,1.5,0,0,4,8,1410,1110,1906,0,98119,47.6365,-122.361,1960,5400,840500,28,5,2014,0,108,2880,3440,0,1,1
3,1.75,1550,8134,1.0,0,0,4,7,1550,0,1959,0,98008,47.6136,-122.121,1360,8000,432000,7,4,2015,0,56,6584,6640,0,0,0
3,1.0,1800,4800,1.0,0,2,4,9,900,900,1927,0,98126,47.5672,-122.372,1400,4800,625000,29,10,2014,0,87,3000,3400,0,1,1
3,1.0,1170,6134,1.0,0,0,4,7,1170,0,1948,0,98168,47.4941,-122.312,1440,9823,209977,10,9,2014,0,66,4964,8383,0,0,1
2,1.0,900,13531,1.0,0,0,3,6,900,0,1979,0,98001,47.2616,-122.251,1767,8308,174000,1,7,2014,0,35,12631,6541,0,0,0
4,2.0,2800,8540,1.0,0,0,4,8,1730,1070,1977,0,98052,47.6869,-122.126,2470,9400,740000,22,4,2015,0,38,5740,6930,0,1,0
3,1.75,1830,4500,1.5,0,0,4,7,1830,0,1909,0,98115,47.676,-122.308,1830,4080,518000,17,9,2014,0,105,2670,2250,0,0,1
3,1.75,1380,3225,1.0,0,0,4,7,940,440,1915,0,98103,47.6652,-122.338,1250,3750,539000,5,3,2015,0,100,1845,2500,0,1,1
3,2.75,1990,9600,1.0,0,0,3,8,1530,460,1978,0,98027,47.532,-122.05,2170,10400,575000,29,4,2015,0,37,7610,8230,0,1,0
2,1.75,1170,976,2.0,0,0,3,9,780,390,2010,0,98102,47.6192,-122.316,1280,1183,530000,9,2,2015,0,5,-194,-97,0,1,1
4,2.5,2620,11200,1.0,0,0,4,8,1770,850,1962,0,98004,47.5876,-122.193,2360,11200,1030000,6,3,2015,0,53,8580,8840,0,1,0
3,1.0,880,7500,1.0,0,0,3,7,880,0,1978,0,98198,47.3837,-122.307,880,7500,230000,26,8,2014,0,36,6620,6620,0,0,1
4,2.5,2260,7500,1.0,0,0,3,8,1460,800,1965,0,98055,47.4645,-122.196,2260,7500,350000,7,1,2015,0,50,5240,5240,0,1,0
3,1.0,1300,11520,1.0,0,0,3,6,1300,0,1958,0,98033,47.6829,-122.195,1440,8064,595000,29,4,2015,0,57,10220,6624,0,0,0
3,1.75,1450,6829,1.0,0,0,3,8,1450,0,1983,0,98052,47.7222,-122.108,1950,7622,440000,11,7,2014,0,31,5379,5672,0,0,0
3,1.0,1110,6000,1.0,0,0,3,7,1110,0,1904,0,98109,47.6461,-122.357,1460,6000,550000,20,2,2015,0,111,4890,4540,0,0,1
4,2.25,1890,5940,1.0,0,1,3,9,1470,420,1963,0,98112,47.6316,-122.303,2430,5940,940000,7,5,2014,0,51,4050,3510,0,1,1
3,1.5,1100,1751,2.0,0,0,3,8,940,160,2007,0,98144,47.5927,-122.306,1380,1751,375000,16,5,2014,0,7,651,371,0,1,1
2,1.5,1350,4592,1.0,0,0,3,7,1070,280,1939,0,98199,47.6511,-122.405,1610,5102,567500,5,12,2014,0,75,3242,3492,0,1,1
2,1.0,730,5200,1.0,0,0,3,6,730,0,1928,0,98146,47.4943,-122.337,1220,6240,114000,17,10,2014,0,86,4470,5020,0,0,1
2,1.0,1390,3600,1.0,0,0,4,7,1010,380,1913,0,98119,47.6422,-122.36,1590,3600,608000,25,8,2014,0,101,2210,2010,0,1,1
4,2.0,1530,5250,1.0,0,0,3,7,1110,420,1981,0,98133,47.7336,-122.339,1100,5250,381800,16,10,2014,0,33,3720,4150,0,1,1
3,2.0,2170,3978,1.0,0,0,5,7,1340,830,1919,0,98116,47.571,-122.391,1350,4680,330000,24,7,2014,0,95,1808,3330,0,1,1
2,1.0,790,2640,1.0,0,0,3,7,790,0,1973,0,98034,47.7351,-122.178,1310,2064,90000,13,5,2014,0,41,1850,754,0,0,0
2,1.75,1160,8625,1.0,0,0,4,6,1160,0,1941,0,98106,47.5509,-122.366,960,5750,312000,24,7,2014,0,73,7465,4790,0,0,1
3,1.0,1080,8100,1.0,0,0,4,7,1080,0,1955,0,98155,47.777,-122.307,1080,8100,339000,12,5,2014,0,59,7020,7020,0,0,1
3,1.75,2190,8000,1.0,0,0,4,8,2190,0,1967,0,98023,47.3098,-122.381,1980,8000,313000,7,5,2014,0,47,5810,6020,0,0,0
3,2.5,2030,6500,2.0,0,0,3,8,2030,0,1988,0,98027,47.5654,-122.092,2030,8485,618080,7,5,2014,0,26,4470,6455,0,0,0
3,2.25,2480,8755,2.0,0,0,3,8,2480,0,1979,0,98058,47.4543,-122.125,2280,9940,325000,6,10,2014,0,35,6275,7660,0,0,0
4,1.0,2240,7620,1.0,0,0,3,7,1120,1120,1966,0,98146,47.5089,-122.346,1080,7620,242000,15,7,2014,0,48,5380,6540,0,1,1
2,1.5,1650,7311,1.0,0,0,3,7,860,790,1978,0,98133,47.7772,-122.357,1660,7255,364000,18,12,2014,0,36,5661,5595,0,1,1
3,1.75,1700,5750,1.5,0,2,5,7,1450,250,1925,0,98126,47.5643,-122.38,1700,5750,545000,15,8,2014,0,89,4050,4050,0,1,1
3,2.5,2790,16173,2.0,0,0,3,10,2790,0,1988,0,98023,47.3043,-122.343,2890,11632,445000,23,12,2014,0,26,13383,8742,0,0,0
4,2.75,3010,10830,2.0,0,3,4,9,3010,0,1980,0,98034,47.7005,-122.232,3010,10650,1090000,28,7,2014,0,34,7820,7640,0,0,0
4,2.5,2550,10000,1.0,0,0,3,8,1290,1260,1964,0,98007,47.6208,-122.141,2270,8640,660000,12,5,2014,0,50,7450,6370,0,1,0
4,2.0,2090,4000,1.0,0,0,3,6,1060,1030,1907,0,98144,47.5893,-122.299,1590,4000,417000,23,9,2014,0,107,1910,2410,0,1,1
2,1.0,740,5200,1.0,0,0,4,5,740,0,1952,0,98056,47.4934,-122.173,750,5200,213800,28,4,2015,0,63,4460,4450,0,0,0
2,1.75,960,6200,1.0,0,0,4,7,960,0,1946,0,98136,47.5551,-122.396,1000,6000,400000,28,10,2014,0,68,5240,5000,0,0,1
4,3.5,2100,7560,2.0,0,0,5,8,2100,0,2005,0,98133,47.7076,-122.356,1250,7560,759950,5,3,2015,0,10,5460,6310,0,0,1
4,2.5,2540,5930,2.0,0,0,3,9,2540,0,2003,0,98199,47.6451,-122.387,1400,4000,990000,23,4,2015,0,12,3390,2600,0,0,1
3,1.75,1650,10250,1.0,0,0,5,8,1650,0,1963,0,98005,47.6118,-122.169,2400,10250,710000,20,8,2014,0,51,8600,7850,0,0,0
1,0.75,770,4600,1.0,0,0,4,6,770,0,1910,0,98126,47.5565,-122.377,1550,4600,315000,16,10,2014,0,104,3830,3050,0,0,1
4,2.5,2280,14810,1.0,0,0,5,8,1500,780,1977,0,98056,47.5392,-122.186,2690,12196,515000,2,9,2014,0,37,12530,9506,0,1,0
3,2.0,1660,3729,1.0,0,0,5,7,970,690,1922,0,98116,47.5741,-122.414,1560,3729,638000,26,6,2014,0,92,2069,2169,0,1,1
4,2.0,2020,8100,1.5,0,0,4,7,1160,860,1946,0,98125,47.7307,-122.297,1840,8680,370000,18,2,2015,0,69,6080,6840,0,1,1
3,1.0,970,14850,1.0,0,0,3,7,970,0,1968,0,98001,47.3251,-122.268,1410,14850,184000,29,1,2015,0,47,13880,13440,0,0,0
3,2.5,2480,6600,2.0,0,0,3,8,2480,0,2002,0,98053,47.6313,-122.008,2310,6656,583800,28,7,2014,0,12,4120,4346,0,0,0
3,1.0,1250,7320,1.0,0,0,3,7,1250,0,1968,0,98059,47.5074,-122.163,1770,7320,309500,28,10,2014,0,46,6070,5550,0,0,0
1,1.0,740,5000,1.0,0,0,3,7,740,0,1923,0,98118,47.5519,-122.292,1400,4400,299000,5,8,2014,0,91,4260,3000,0,0,1
2,1.0,710,7200,1.0,0,0,3,6,710,0,1943,0,98178,47.4903,-122.245,960,7200,215000,13,6,2014,0,71,6490,6240,0,0,1
4,2.0,1970,10500,1.0,0,0,3,8,1820,150,1961,0,98166,47.479,-122.356,2090,12300,410000,18,6,2014,0,53,8530,10210,0,1,1
2,1.0,820,6000,1.0,0,0,3,7,820,0,1939,0,98199,47.6494,-122.395,1630,6000,478000,30,10,2014,0,75,5180,4370,0,0,1
2,1.0,1000,6500,1.0,0,0,4,7,1000,0,1918,0,98136,47.5474,-122.388,1280,6500,431000,10,9,2014,0,96,5500,5220,0,0,1
5,2.25,2410,12000,2.0,0,0,4,8,2410,0,1973,0,98006,47.5434,-122.175,2080,12000,648000,8,4,2015,0,42,9590,9920,0,0,0
3,2.5,2370,11172,2.0,0,0,3,9,2370,0,1993,0,98056,47.5345,-122.179,2550,11558,640000,3,6,2014,0,21,8802,9008,0,0,0
5,4.5,4690,6705,2.0,0,0,3,10,3450,1240,1995,0,98006,47.5539,-122.108,4070,11505,932808,15,12,2014,0,19,2015,7435,0,1,0
2,2.0,2280,6815,1.0,0,0,3,8,2280,0,2002,0,98053,47.7103,-122.027,2280,6750,835000,6,6,2014,0,12,4535,4470,0,0,0
2,1.75,1530,7020,1.0,0,0,3,7,1030,500,1942,0,98199,47.6465,-122.395,2090,6600,469775,28,7,2014,0,72,5490,4510,0,1,1
3,2.0,1740,3600,1.0,0,0,5,7,990,750,1923,0,98119,47.6448,-122.358,1250,3600,677915,21,7,2014,0,91,1860,2350,0,1,1
4,3.0,3600,9200,1.0,0,4,4,9,2100,1500,1976,0,98008,47.5866,-122.116,2700,9775,1080000,22,5,2014,0,38,5600,7075,0,1,0
4,3.0,3130,5700,1.5,0,0,3,7,1750,1380,1953,0,98115,47.6811,-122.283,2080,5700,671000,5,7,2014,0,61,2570,3620,0,1,1
5,3.25,3940,9780,2.0,0,0,3,9,3940,0,2007,0,98065,47.5435,-121.888,3550,8468,695000,3,9,2014,0,7,5840,4918,0,0,0
4,2.0,2200,13320,1.0,0,0,3,6,1100,1100,1944,0,98168,47.481,-122.292,1330,6099,205000,29,7,2014,0,70,11120,4769,0,1,1
4,1.0,1510,7200,1.5,0,0,4,7,1510,0,1955,0,98155,47.761,-122.307,1950,10656,350000,30,4,2015,0,60,5690,8706,0,0,1
3,1.75,1560,7930,2.0,0,0,4,7,1560,0,1980,0,98059,47.4779,-122.161,1720,8073,360000,4,8,2014,0,34,6370,6353,0,0,0
4,2.25,1870,4198,2.0,0,0,3,7,1870,0,2008,0,98038,47.3657,-122.021,1870,4184,313999,8,11,2014,0,6,2328,2314,0,0,0
3,2.25,2070,7225,1.0,0,0,3,8,1690,380,1979,0,98042,47.3551,-122.148,2070,7400,300000,21,4,2015,0,36,5155,5330,0,1,0
3,1.75,1820,7194,1.0,0,0,4,7,1820,0,1967,0,98003,47.3352,-122.307,1420,7560,227490,17,2,2015,0,48,5374,6140,0,0,0
4,2.75,2450,4187,2.0,0,2,3,8,2450,0,2010,0,98027,47.5471,-122.016,2320,4187,735000,14,6,2014,0,4,1737,1867,0,0,0
7,2.75,3110,4400,1.5,0,0,5,7,2010,1100,1914,0,98105,47.6684,-122.319,1240,4280,730000,15,10,2014,0,100,1290,3040,0,1,1
3,2.5,2210,7000,2.0,0,0,4,8,2210,0,1985,0,98058,47.4377,-122.132,2260,7224,412000,3,12,2014,0,29,4790,4964,0,0,0
4,2.5,2630,6326,2.0,0,0,3,9,2630,0,2008,0,98065,47.5222,-121.874,3240,6229,589500,6,6,2014,0,6,3696,2989,0,0,0
7,1.0,2350,8636,1.0,0,0,3,7,1550,800,1962,0,98118,47.5432,-122.277,1500,7366,291000,4,11,2014,0,52,6286,5866,0,1,1
5,3.75,4450,7680,2.0,0,0,3,9,3460,990,2010,0,98199,47.6418,-122.392,2550,6400,1300000,2,4,2015,0,5,3230,3850,0,1,1
3,1.0,1200,10458,1.0,0,0,4,6,1200,0,1961,0,98023,47.3262,-122.342,1160,9000,190000,20,10,2014,0,53,9258,7840,0,0,0
2,1.75,1210,7733,1.0,0,0,3,6,1210,0,1904,0,98125,47.7148,-122.282,1670,7733,456200,22,4,2015,0,111,6523,6063,0,0,1
3,1.0,1290,8470,1.0,0,0,4,7,970,320,1966,0,98023,47.3054,-122.371,1300,7350,225000,19,9,2014,0,48,7180,6050,0,1,0
4,2.5,3360,15091,2.0,0,0,3,9,3360,0,1997,0,98052,47.6649,-122.135,1930,9936,740000,9,7,2014,0,17,11731,8006,0,0,0
3,1.75,2660,5511,1.0,0,0,3,8,1330,1330,1948,0,98108,47.5575,-122.3,2030,6111,467000,1,12,2014,0,66,2851,4081,0,1,1
2,1.0,770,7554,1.0,0,0,3,6,770,0,1946,0,98177,47.7057,-122.36,1390,7500,385000,8,10,2014,0,68,6784,6110,0,0,1
3,2.5,1800,4763,2.0,0,0,3,7,1240,560,1985,0,98119,47.646,-122.362,1790,4763,670000,20,10,2014,0,29,2963,2973,0,1,1
4,2.5,2900,5760,1.0,0,0,4,8,1660,1240,1959,0,98118,47.55,-122.272,2250,6098,500000,22,4,2015,0,56,2860,3848,0,1,1
3,2.0,1430,6000,1.0,0,0,5,7,1430,0,1945,0,98155,47.7564,-122.316,1630,6315,352450,19,6,2014,0,69,4570,4685,0,0,1
4,2.75,2550,7591,2.0,0,0,3,9,2550,0,1989,0,98059,47.5302,-122.147,2670,7796,669888,28,10,2014,0,25,5041,5126,0,0,0
3,2.75,1310,7300,1.0,0,0,3,7,1310,0,1957,0,98008,47.6016,-122.123,1310,7030,405000,24,6,2014,0,57,5990,5720,0,0,0
3,1.5,1430,8000,1.0,0,0,4,7,1430,0,1956,0,98007,47.5874,-122.136,1450,8000,518000,6,5,2014,0,58,6570,6550,0,0,0
4,1.0,1880,6288,1.0,0,0,3,7,1120,760,1974,0,98178,47.5101,-122.259,1880,6334,280000,1,10,2014,0,40,4408,4454,0,1,1
3,2.5,1600,2375,2.0,0,0,3,7,1600,0,2005,0,98029,47.5531,-121.996,1830,2375,435000,18,7,2014,0,9,775,545,0,0,0
3,2.0,1760,9732,1.0,0,0,3,7,1760,0,1996,0,98022,47.1923,-122.014,1910,9231,314950,7,5,2015,0,19,7972,7321,0,0,0
2,2.0,1180,3003,2.0,0,0,3,6,1180,0,2005,0,98038,47.3491,-122.02,1310,3003,209900,24,2,2015,0,10,1823,1693,0,0,0
4,1.5,1960,12688,1.5,0,0,4,7,1960,0,1962,0,98052,47.6304,-122.097,2050,9375,442000,18,7,2014,0,52,10728,7325,0,0,0
4,1.0,1140,13440,1.0,0,0,2,5,1140,0,1944,0,98166,47.4619,-122.344,1450,7560,340000,2,4,2015,0,71,12300,6110,0,0,1
3,1.75,1400,6956,1.0,0,0,4,7,1400,0,1957,0,98031,47.4233,-122.198,1400,9375,230000,16,6,2014,0,57,5556,7975,0,0,0
4,2.5,3510,6745,2.0,0,0,3,10,3510,0,1998,0,98075,47.6016,-122.074,3320,8370,900000,31,3,2015,0,17,3235,5050,0,0,0
2,1.0,910,4600,1.0,0,0,3,5,910,0,1917,0,98117,47.6916,-122.362,1020,4600,265000,13,3,2015,0,98,3690,3580,0,0,1
3,3.25,3050,12700,2.0,0,0,3,8,2240,810,1990,0,98011,47.7445,-122.214,3050,12386,585000,5,12,2014,0,24,9650,9336,0,1,0
4,2.25,2010,7200,1.0,0,1,4,8,1010,1000,1950,0,98118,47.5591,-122.267,2010,7200,800000,17,10,2014,0,64,5190,5190,0,1,1
3,1.0,1270,8000,1.0,0,0,4,6,1270,0,1959,0,98008,47.6175,-122.118,1210,7875,475000,12,8,2014,0,55,6730,6665,0,0,0
3,2.0,1670,8800,1.0,0,0,4,7,1150,520,1961,0,98008,47.6096,-122.132,2020,8250,520000,24,11,2014,0,53,7130,6230,0,1,0
4,2.5,1800,4338,2.0,0,0,3,8,1800,0,2001,0,98075,47.5962,-122.015,1800,4507,515000,28,1,2015,0,14,2538,2707,0,0,0
2,1.0,1640,5515,1.0,0,0,4,7,940,700,1926,0,98103,47.6912,-122.334,2054,5515,577500,3,5,2015,0,89,3875,3461,0,1,1
3,2.25,1740,9672,1.0,0,0,4,7,1110,630,1963,0,98031,47.4149,-122.181,1640,9600,269900,16,7,2014,0,51,7932,7960,0,1,0
3,1.0,1600,5952,1.0,0,0,4,7,1150,450,1964,0,98106,47.5292,-122.362,1460,6200,329000,27,5,2014,0,50,4352,4740,0,1,1
3,1.5,1280,1920,1.5,0,0,3,7,1280,0,1905,1990,98122,47.6117,-122.301,1280,3150,458500,24,4,2015,85,110,640,1870,1,0,1
4,2.5,1980,7334,2.0,0,0,3,7,1980,0,2003,0,98038,47.3528,-122.041,1850,7134,361500,1,4,2015,0,12,5354,5284,0,0,0
2,1.0,900,8374,1.0,0,0,3,7,900,0,1984,0,98034,47.7282,-122.225,1580,8965,325000,22,8,2014,0,30,7474,7385,0,0,0
4,3.25,3480,6000,3.0,0,0,3,8,3480,0,2014,0,98109,47.6353,-122.353,2200,4080,1850000,5,11,2014,0,0,2520,1880,0,0,1
4,2.0,2840,13367,1.0,0,0,3,7,1420,1420,1952,0,98004,47.6237,-122.21,2840,12744,945000,23,5,2014,0,62,10527,9904,0,1,0
3,2.5,2490,4244,2.0,0,0,3,9,2490,0,2005,0,98042,47.3705,-122.131,2490,4748,370000,28,8,2014,0,9,1754,2258,0,0,0
2,2.0,1510,4908,1.0,0,0,3,8,1510,0,2006,0,98053,47.7196,-122.024,1440,3921,450000,15,9,2014,0,8,3398,2481,0,0,0
3,2.5,2240,3825,2.0,0,0,3,7,2240,0,1995,0,98117,47.6786,-122.389,1460,5100,676000,11,12,2014,0,19,1585,3640,0,0,1
4,1.75,2040,5000,2.0,0,0,4,9,2040,0,1921,0,98102,47.6279,-122.315,3220,5600,1270000,2,4,2015,0,94,2960,2380,0,0,1
3,1.75,1460,7980,1.0,0,0,3,7,1460,0,1972,0,98028,47.7713,-122.265,1920,7980,290000,28,10,2014,0,42,6520,6060,0,0,0
3,1.5,990,8925,1.0,0,0,4,7,990,0,1962,0,98003,47.3294,-122.331,1360,8625,158000,18,11,2014,0,52,7935,7265,0,0,0
4,1.75,1970,9389,1.0,0,0,5,7,1140,830,1960,0,98133,47.7771,-122.339,1820,8135,379950,5,5,2014,0,54,7419,6315,0,1,1
4,2.5,2660,4000,2.0,0,0,3,8,2660,0,2001,0,98053,47.6876,-122.038,2330,4517,583000,9,5,2014,0,13,1340,2187,0,0,0
2,1.0,870,5700,1.0,0,0,4,6,870,0,1957,0,98056,47.498,-122.17,1020,5700,150000,30,12,2014,0,57,4830,4680,0,0,0
3,2.5,1740,6992,2.0,0,0,3,7,1740,0,1990,0,98042,47.3574,-122.158,1260,6825,261500,21,7,2014,0,24,5252,5565,0,0,0
4,2.5,2290,3777,2.0,0,0,3,7,2290,0,2004,0,98198,47.3617,-122.308,1480,3608,278000,14,10,2014,0,10,1487,2128,0,0,1
4,2.75,2170,7140,1.0,0,0,3,8,1290,880,1977,0,98052,47.691,-122.113,2120,7820,555000,23,9,2014,0,37,4970,5700,0,1,0
3,1.75,2040,8173,1.0,0,0,3,7,1470,570,1958,0,98133,47.7439,-122.333,1900,8172,355000,27,8,2014,0,56,6133,6272,0,1,1
4,1.5,1770,6650,1.0,0,0,3,7,1770,0,1958,0,98008,47.6011,-122.124,1600,7000,375000,17,9,2014,0,56,4880,5400,0,0,0
3,1.75,2380,12681,1.0,0,0,1,6,1380,1000,1918,0,98118,47.5294,-122.279,1720,6377,227000,29,7,2014,0,96,10301,4657,0,1,1
2,1.75,1390,5025,1.5,0,0,4,8,1390,0,1928,0,98105,47.6701,-122.288,2160,5000,686500,5,2,2015,0,87,3635,2840,0,0,1
2,1.0,1430,13300,1.5,0,0,3,6,1230,200,1921,0,98033,47.6996,-122.203,1950,11421,425000,26,8,2014,0,93,11870,9471,0,1,0
3,2.5,2030,7549,1.0,0,0,3,8,2030,0,1988,0,98074,47.6187,-122.044,2040,7130,562500,10,3,2015,0,27,5519,5090,0,0,0
4,2.5,2390,6976,2.0,0,0,3,7,2390,0,2003,0,98056,47.4807,-122.182,2390,6346,345000,14,10,2014,0,11,4586,3956,0,0,0
4,2.5,2540,11500,1.0,0,0,4,8,1640,900,1979,0,98006,47.5609,-122.15,2820,9800,627500,14,4,2015,0,36,8960,6980,0,1,0
3,2.25,1870,5876,2.0,0,0,3,7,1870,0,1986,0,98038,47.3779,-122.045,1670,6203,335000,1,5,2015,0,29,4006,4533,0,0,0
4,3.0,1780,4228,1.0,0,0,3,7,1780,0,1953,0,98118,47.5488,-122.287,1730,5304,350000,11,3,2015,0,62,2448,3574,0,0,1
3,2.0,1420,6788,2.0,0,0,3,7,1420,0,1990,0,98023,47.2887,-122.351,1790,6607,252000,17,7,2014,0,24,5368,4817,0,0,0
5,4.0,4440,9270,1.0,0,0,5,10,2220,2220,1968,0,98040,47.5708,-122.212,2720,9614,1300000,21,4,2015,0,47,4830,6894,0,1,0
4,2.0,1820,5001,2.0,0,0,3,7,1820,0,1947,2002,98119,47.6438,-122.373,1440,5408,705000,19,11,2014,55,67,3181,3968,1,0,1
3,2.0,1620,8400,1.0,0,0,3,7,1180,440,1968,0,98052,47.6574,-122.128,2120,8424,498000,14,7,2014,0,46,6780,6304,0,1,0
2,1.0,870,7227,1.0,0,0,3,7,870,0,1948,0,98133,47.7288,-122.331,1250,7252,312500,21,9,2014,0,66,6357,6002,0,0,1
4,1.75,1830,5375,1.0,0,0,2,7,1060,770,1962,0,98198,47.4169,-122.316,1040,7500,260000,24,11,2014,0,52,3545,6460,0,1,1
3,1.5,2290,9600,1.0,0,0,4,7,2290,0,1967,0,98042,47.3643,-122.111,1310,9600,209950,18,3,2015,0,48,7310,8290,0,0,0
3,1.75,1110,10402,1.0,0,0,4,7,1110,0,1967,0,98006,47.5676,-122.177,2050,9660,610000,10,2,2015,0,48,9292,7610,0,0,0
4,1.0,1440,7100,1.5,0,0,3,7,1440,0,1906,0,98107,47.6725,-122.396,1490,5000,500000,27,6,2014,0,108,5660,3510,0,0,1
3,3.5,3070,7050,1.0,0,3,3,8,1570,1500,1928,1996,98125,47.7076,-122.276,2350,5881,850000,24,2,2015,68,87,3980,3531,1,1,1
4,2.5,2440,11700,1.0,0,0,5,8,1480,960,1961,0,98006,47.5606,-122.184,2140,10807,689000,19,2,2015,0,54,9260,8667,0,1,0
4,2.0,2410,4680,2.0,0,0,3,9,2410,0,1974,0,98008,47.6234,-122.113,1910,4611,470000,10,11,2014,0,40,2270,2701,0,0,0
3,3.0,2270,5175,2.0,0,0,3,9,2130,140,2002,0,98056,47.516,-122.203,2850,5661,640000,7,5,2014,0,12,2905,2811,0,1,0
4,1.75,2340,7200,1.0,0,0,3,8,1590,750,1960,0,98146,47.497,-122.369,1970,7800,290000,12,8,2014,0,54,4860,5830,0,1,1
3,2.5,1800,9000,2.0,0,0,3,7,1800,0,1983,0,98003,47.3186,-122.331,1670,8486,258500,18,12,2014,0,31,7200,6816,0,0,0
4,3.5,2210,7597,1.0,0,0,4,9,1550,660,1977,2006,98004,47.5816,-122.197,2370,8811,1100000,14,7,2014,29,37,5387,6441,1,1,0
3,1.0,1190,9083,1.0,0,0,3,7,1190,0,1955,0,98198,47.4116,-122.293,1190,9450,230000,16,9,2014,0,59,7893,8260,0,0,1
3,1.5,1400,6865,1.0,0,0,4,7,1400,0,1986,0,98038,47.3639,-122.048,1480,8125,252000,2,4,2015,0,29,5465,6645,0,0,0
3,2.5,2600,4506,2.0,0,0,3,8,2600,0,2003,0,98028,47.7353,-122.222,2600,4658,515000,30,6,2014,0,11,1906,2058,0,0,0
2,1.0,910,4635,1.0,0,0,4,6,910,0,1905,0,98107,47.675,-122.393,1740,5000,425000,9,6,2014,0,109,3725,3260,0,0,1
3,2.5,1760,2320,2.0,0,2,3,8,1760,0,1994,0,98126,47.5723,-122.376,1760,4698,575000,25,1,2015,0,21,560,2938,0,0,1
2,1.0,860,5160,1.0,0,0,4,7,860,0,1909,0,98117,47.6823,-122.388,1090,5356,390000,26,10,2014,0,105,4300,4266,0,0,1
4,2.25,2310,9800,1.0,0,0,3,8,1780,530,1968,0,98033,47.6657,-122.178,2310,9800,561500,17,9,2014,0,46,7490,7490,0,1,0
4,1.75,2000,3728,1.5,0,0,4,9,1820,180,1926,0,98112,47.643,-122.299,1950,3728,1350000,7,5,2015,0,89,1728,1778,0,1,1
5,2.75,2460,7830,1.0,0,0,5,9,1490,970,1955,0,98115,47.6938,-122.31,2050,7830,835000,25,9,2014,0,59,5370,5780,0,1,1
2,1.0,1020,15000,1.5,0,0,3,6,1020,0,1933,0,98168,47.4956,-122.321,1480,14519,245000,18,2,2015,0,82,13980,13039,0,0,1
3,2.5,1670,3980,2.0,0,0,3,8,1670,0,2000,0,98027,47.5317,-122.047,1670,2897,475200,11,8,2014,0,14,2310,1227,0,0,0
2,1.0,790,5024,1.0,0,0,4,7,790,0,1941,0,98117,47.6833,-122.395,1330,5024,425000,13,11,2014,0,73,4234,3694,0,0,1
2,1.5,2010,7755,2.0,0,0,3,7,2010,0,1952,0,98178,47.4947,-122.233,1360,8037,218000,2,2,2015,0,63,5745,6677,0,0,1
4,2.5,2600,6536,2.0,0,0,3,9,2600,0,1999,0,98056,47.5232,-122.191,2640,6185,600000,22,8,2014,0,15,3936,3545,0,0,0
4,2.25,1890,7210,1.0,0,0,3,8,1890,0,1967,0,98008,47.6342,-122.117,1920,7210,545000,10,4,2015,0,48,5320,5290,0,0,0
5,3.0,2008,5050,1.0,0,0,3,7,1216,792,1992,0,98118,47.5376,-122.292,2040,5297,460000,6,5,2015,0,23,3042,3257,0,1,1
2,1.0,880,6413,1.0,0,0,3,7,880,0,1950,0,98116,47.573,-122.395,1360,6413,425000,23,6,2014,0,64,5533,5053,0,0,1
3,1.75,1700,8360,1.0,0,0,4,7,850,850,1955,0,98006,47.5766,-122.147,1520,8360,455000,21,10,2014,0,59,6660,6840,0,1,0
3,2.0,1730,12821,1.0,0,0,3,8,1730,0,1994,0,98001,47.353,-122.272,1980,11336,313100,21,4,2015,0,21,11091,9356,0,0,0
4,2.5,2160,9682,2.0,0,0,3,8,2160,0,1999,0,98031,47.4106,-122.204,1770,9600,345500,23,12,2014,0,15,7522,7830,0,0,0
3,1.75,1200,8034,1.0,0,0,5,7,1200,0,1975,0,98031,47.4135,-122.18,1270,7600,243000,19,1,2015,0,40,6834,6330,0,0,0
5,3.5,3860,9600,1.0,0,3,4,8,2660,1200,1973,0,98034,47.7139,-122.223,2440,9600,670000,8,12,2014,0,41,5740,7160,0,1,0
3,1.5,1320,7560,1.0,0,0,3,6,840,480,1983,0,98019,47.7451,-121.98,1210,7560,325000,11,2,2015,0,32,6240,6350,0,1,0
3,1.0,1100,5100,1.0,0,0,4,7,1100,0,1913,0,98108,47.5231,-122.332,1450,5100,130000,5,3,2015,0,102,4000,3650,0,0,1
3,2.5,2170,9798,2.0,0,0,3,7,2170,0,1995,0,98038,47.3817,-122.023,2020,8121,340000,30,7,2014,0,19,7628,6101,0,0,0
4,2.75,2520,6398,2.0,0,0,3,8,2520,0,2014,0,98072,47.7685,-122.159,2520,6398,642860,17,12,2014,0,0,3878,3878,0,0,0
3,1.75,2560,4800,1.0,0,0,3,7,1280,1280,1911,0,98112,47.6207,-122.295,1620,4800,747000,3,10,2014,0,103,2240,3180,0,1,1
4,2.5,2650,7200,2.0,0,0,3,8,2250,400,1979,0,98133,47.7317,-122.354,2110,7269,559950,29,7,2014,0,35,4550,5159,0,1,1
4,2.75,2870,7200,2.0,0,0,3,9,2870,0,2008,0,98108,47.5688,-122.317,2030,5400,577288,17,11,2014,0,6,4330,3370,0,0,1
2,1.0,1230,2726,1.5,0,0,3,7,880,350,1920,0,98117,47.6815,-122.359,1710,3750,575000,24,9,2014,0,94,1496,2040,0,1,1
3,1.0,1450,6000,1.0,0,0,4,7,1450,0,1953,0,98118,47.5238,-122.287,1170,6464,287000,5,5,2014,0,61,4550,5294,0,0,1
4,3.75,3180,9889,2.0,0,0,3,9,2500,680,2012,0,98033,47.6853,-122.204,2910,8558,1150000,10,11,2014,0,2,6709,5648,0,1,0
2,1.0,1800,8900,1.0,0,0,3,6,900,900,1945,0,98168,47.51,-122.323,2040,10450,335000,24,4,2015,0,70,7100,8410,0,1,1
4,2.25,2020,12500,2.0,0,0,2,8,2020,0,1966,0,98056,47.5403,-122.175,1800,13175,375000,6,1,2015,0,49,10480,11375,0,0,0
2,1.0,620,14823,1.0,0,0,3,6,620,0,1926,0,98125,47.7322,-122.3,1400,7930,325000,6,1,2015,0,89,14203,6530,0,0,1
4,2.25,1980,7081,1.0,0,0,3,7,1470,510,1977,0,98032,47.3669,-122.288,1980,7081,287000,12,1,2015,0,38,5101,5101,0,1,0
5,3.0,2970,7000,1.0,0,0,3,8,1810,1160,1979,0,98023,47.3079,-122.341,2630,8062,320000,26,2,2015,0,36,4030,5432,0,1,0
4,2.5,2270,4400,2.0,0,0,3,7,2270,0,2006,0,98065,47.5381,-121.888,2090,4400,425000,22,8,2014,0,8,2130,2310,0,0,0
3,1.0,1630,6009,1.0,0,3,4,8,1630,0,1954,0,98117,47.693,-122.383,2120,6009,550000,6,8,2014,0,60,4379,3889,0,0,1
3,1.0,1520,8450,1.0,0,0,2,6,1120,400,1961,0,98023,47.328,-122.337,1320,8450,135000,2,12,2014,0,53,6930,7130,0,1,0
3,1.75,2080,5687,1.5,0,0,4,8,2080,0,1924,0,98144,47.5776,-122.289,2300,5995,695000,17,7,2014,0,90,3607,3695,0,0,1
5,2.5,3020,9648,1.0,0,2,4,9,1980,1040,1977,0,98006,47.5586,-122.134,2890,12598,975000,6,5,2015,0,38,6628,9708,0,1,0
4,1.75,1780,8768,1.0,0,0,4,7,1050,730,1951,0,98125,47.7085,-122.283,1590,8100,518000,31,12,2014,0,63,6988,6510,0,1,1
3,1.0,1370,6780,2.0,0,0,3,6,1370,0,1930,0,98125,47.7156,-122.291,1450,7214,335500,9,7,2014,0,84,5410,5764,0,0,1
4,3.5,3050,7020,2.0,0,3,3,9,2050,1000,1984,0,98126,47.571,-122.374,2170,5900,750000,26,11,2014,0,30,3970,3730,0,1,1
3,1.75,1490,12000,1.0,0,0,4,7,1490,0,1956,0,98006,47.569,-122.175,1630,12000,515000,23,12,2014,0,58,10510,10370,0,0,0
4,2.75,1800,5453,1.0,0,0,3,7,1050,750,2002,0,98055,47.4632,-122.209,1820,6900,344500,21,5,2014,0,12,3653,5080,0,1,0
3,1.5,1760,6723,1.0,0,0,3,7,1160,600,1958,0,98118,47.5514,-122.266,2080,8965,470000,16,6,2014,0,56,4963,6885,0,1,1
4,1.75,1770,9848,1.0,0,0,3,8,1370,400,1967,0,98008,47.6208,-122.099,2040,9587,606150,4,9,2014,0,47,8078,7547,0,1,0
4,2.75,2910,7712,1.0,0,0,3,7,1600,1310,1998,0,98002,47.2842,-122.198,2220,6649,292000,20,11,2014,0,16,4802,4429,0,1,0
3,1.75,2520,5043,1.0,0,0,3,8,1260,1260,1957,0,98126,47.5339,-122.372,1360,4920,429000,19,8,2014,0,57,2523,3560,0,1,1
2,1.0,540,2500,1.0,0,0,3,5,540,0,1905,0,98107,47.6729,-122.383,1290,5000,425000,15,4,2015,0,110,1960,3710,0,0,1
4,2.5,3170,5340,2.0,0,0,3,7,3170,0,2000,0,98059,47.4911,-122.138,3010,5340,505000,12,2,2015,0,15,2170,2330,0,0,0
3,1.75,1830,7371,1.0,0,0,3,7,1830,0,1957,0,98008,47.6059,-122.121,1600,7700,544950,17,3,2015,0,58,5541,6100,0,0,0
3,2.0,1360,4840,1.5,0,0,3,8,1360,0,1936,0,98126,47.5487,-122.376,1450,4840,382000,24,9,2014,0,78,3480,3390,0,0,1
3,1.5,1370,4790,2.0,0,0,4,7,1370,0,1982,0,98034,47.7253,-122.164,1370,3799,355000,17,4,2015,0,33,3420,2429,0,0,0
4,2.5,1700,9000,1.0,0,0,5,7,1700,0,1972,0,98034,47.7306,-122.233,1370,7592,410000,3,7,2014,0,42,7300,6222,0,0,0
4,2.0,1960,5008,1.0,0,0,3,6,980,980,1900,1988,98144,47.5958,-122.299,1175,2315,450000,3,2,2015,88,115,3048,1140,1,1,1
7,4.5,4140,9066,1.0,0,0,3,7,2070,2070,1978,0,98125,47.7302,-122.291,1440,1865,565000,28,5,2014,0,36,4926,425,0,1,1
2,1.0,1290,6528,1.5,0,0,4,7,1290,0,1941,0,98115,47.694,-122.29,1670,5712,529100,14,4,2015,0,74,5238,4042,0,0,1
4,2.5,2460,6454,2.0,0,0,3,7,2460,0,2006,0,98065,47.5381,-121.89,2320,4578,452500,12,2,2015,0,9,3994,2258,0,0,0
4,2.0,1580,8000,1.0,0,0,3,7,1040,540,1967,0,98003,47.3467,-122.304,1550,8000,245000,22,5,2014,0,47,6420,6450,0,1,0
1,1.0,700,2550,1.0,0,0,3,6,700,0,1954,0,98117,47.6783,-122.383,1330,4110,415000,30,3,2015,0,61,1850,2780,0,0,1
4,2.5,2410,15899,2.0,0,3,3,9,2410,0,1990,0,98074,47.6242,-122.04,2360,11412,610000,24,7,2014,0,24,13489,9052,0,0,0
4,1.75,2180,9702,1.0,0,0,5,7,1090,1090,1962,0,98178,47.4973,-122.268,2020,9792,363500,16,10,2014,0,52,7522,7772,0,1,1
3,2.75,1950,12630,1.0,0,0,4,8,1230,720,1969,0,98052,47.6301,-122.107,1990,12196,510000,4,2,2015,0,46,10680,10206,0,1,0
4,2.5,2050,9015,2.0,0,0,4,7,2050,0,1973,0,98058,47.4357,-122.168,1780,8820,290000,14,1,2015,0,42,6965,7040,0,0,0
3,1.0,790,6750,1.0,0,0,2,6,790,0,1944,0,98178,47.4984,-122.24,960,6298,170000,18,3,2015,0,71,5960,5338,0,0,1
2,1.0,1070,5280,1.0,0,0,3,6,1070,0,1900,0,98122,47.6168,-122.303,1380,2370,510000,30,3,2015,0,115,4210,990,0,0,1
4,2.5,2320,7379,2.0,0,0,3,8,2320,0,1987,0,98003,47.3432,-122.316,2230,7614,316000,22,9,2014,0,27,5059,5384,0,0,0
4,2.5,2670,13463,2.0,0,0,4,9,2670,0,1989,0,98029,47.5627,-122.018,2560,10982,690000,12,5,2014,0,25,10793,8422,0,0,0
2,1.0,700,5200,1.0,0,0,5,5,700,0,1952,0,98056,47.4924,-122.174,970,5200,199950,8,8,2014,0,62,4500,4230,0,0,0
3,1.0,860,7740,1.0,0,0,3,6,860,0,1960,0,98178,47.4906,-122.244,980,7200,207000,13,8,2014,0,54,6880,6220,0,0,1
4,2.25,3490,8400,1.5,0,0,4,8,3490,0,1976,0,98058,47.4513,-122.128,2320,8723,449950,16,4,2015,0,39,4910,6403,0,0,0
3,1.75,1550,10050,1.0,0,0,5,7,1550,0,1957,0,98008,47.6345,-122.123,1720,10050,537000,6,1,2015,0,58,8500,8330,0,0,0
4,2.5,2620,9525,2.5,0,0,4,9,2620,0,1974,0,98040,47.5631,-122.219,2580,9525,838400,5,8,2014,0,40,6905,6945,0,0,0
2,1.0,720,4758,1.0,0,0,3,6,720,0,1947,0,98126,47.5176,-122.376,990,4920,225000,11,9,2014,0,67,4038,3930,0,0,1
3,2.0,1380,5198,1.0,0,0,4,7,1380,0,1982,0,98106,47.5514,-122.357,1320,6827,329900,23,4,2015,0,33,3818,5507,0,0,1
3,1.75,1170,11960,1.0,0,0,4,7,1170,0,1969,0,98042,47.3279,-122.136,1230,9800,229950,6,4,2015,0,46,10790,8570,0,0,0
2,1.0,1630,12059,1.0,0,0,3,7,1270,360,1947,0,98125,47.7228,-122.314,1660,8800,500000,31,3,2015,0,68,10429,7140,0,1,1
3,1.75,1890,6557,1.0,0,0,3,8,1890,0,1967,0,98125,47.7032,-122.286,1920,6793,495000,4,11,2014,0,47,4667,4873,0,0,1
3,1.0,1010,9450,1.0,0,0,4,7,1010,0,1959,0,98198,47.3592,-122.315,1240,9450,149500,10,6,2014,0,55,8440,8210,0,0,1
3,2.5,2040,10033,1.0,0,0,4,8,1420,620,1974,0,98005,47.6375,-122.173,2260,10115,726000,18,8,2014,0,40,7993,7855,0,1,0
4,2.5,4080,10295,2.0,0,0,3,10,4080,0,1998,0,98075,47.5933,-121.982,3470,10295,899000,9,4,2015,0,17,6215,6825,0,0,0
3,1.0,1270,8925,1.0,0,0,5,7,1270,0,1955,0,98056,47.5124,-122.165,1270,8996,317000,15,3,2015,0,60,7655,7726,0,0,0
1,1.0,790,3000,1.0,0,0,3,6,790,0,1953,0,98199,47.6544,-122.386,1110,4100,395000,26,3,2015,0,62,2210,2990,0,0,1
4,3.0,2580,6740,2.0,0,0,3,8,2580,0,1999,0,98058,47.4296,-122.185,2010,6740,360000,2,2,2015,0,16,4160,4730,0,0,0
4,2.5,2290,6738,2.0,0,0,3,8,2290,0,1996,0,98029,47.5714,-122.005,2100,6261,570000,18,6,2014,0,18,4448,4161,0,0,0
4,2.5,3490,5000,2.0,0,0,3,8,3490,0,2003,0,98042,47.3772,-122.127,2910,5025,320000,19,6,2014,0,11,1510,2115,0,0,0
5,2.5,2400,4564,2.0,0,0,3,7,2400,0,2004,0,98042,47.369,-122.126,1880,4109,268000,12,3,2015,0,11,2164,2229,0,0,0
2,1.0,900,3400,1.0,0,0,5,6,900,0,1905,0,98108,47.5269,-122.314,940,6000,191000,27,6,2014,0,109,2500,5060,0,0,1
2,1.0,1270,7440,1.0,0,0,4,7,910,360,1949,0,98126,47.5285,-122.372,1040,7500,400000,4,8,2014,0,65,6170,6460,0,1,1
2,1.0,1050,5000,1.0,0,0,5,7,1050,0,1907,0,98107,47.6699,-122.369,1340,5000,515000,1,7,2014,0,107,3950,3660,0,0,1
4,2.5,2950,9010,2.0,0,0,3,9,2950,0,2004,0,98065,47.531,-121.86,3160,8813,610000,16,4,2015,0,11,6060,5653,0,0,0
2,1.75,1850,3060,1.0,0,0,3,7,1060,790,1929,1992,98115,47.6821,-122.308,1850,4080,538000,24,10,2014,63,85,1210,2230,1,1,1
3,2.5,1970,4036,2.0,0,0,4,7,1970,0,2003,0,98065,47.5335,-121.869,1960,5020,432000,3,6,2014,0,11,2066,3060,0,0,0
4,2.25,2400,8592,2.0,0,0,3,8,2400,0,1978,0,98055,47.4383,-122.193,2180,8100,335000,27,1,2015,0,37,6192,5920,0,0,0
5,1.75,2360,8642,1.5,0,0,5,7,2060,300,1926,0,98133,47.7617,-122.335,1950,8491,302000,20,2,2015,0,89,6282,6541,0,1,1
4,1.75,1580,9382,1.0,0,0,3,7,1080,500,1963,0,98039,47.6353,-122.232,2010,9382,787500,4,8,2014,0,51,7802,7372,0,1,0
3,1.0,1790,7055,1.0,0,0,5,8,1520,270,1937,0,98133,47.718,-122.355,1710,7055,420000,18,12,2014,0,77,5265,5345,0,1,1
3,2.5,1970,6634,2.0,0,0,3,8,1970,0,1989,0,98029,47.5759,-122.012,2090,6176,535000,23,4,2015,0,26,4664,4086,0,0,0
3,2.5,1780,6771,1.0,0,0,3,7,1230,550,1990,0,98106,47.5237,-122.353,1780,6771,310000,10,6,2014,0,24,4991,4991,0,1,1
5,2.0,3920,5250,1.5,0,0,5,7,2560,1360,1910,0,98144,47.5798,-122.294,1830,4240,760000,8,12,2014,0,104,1330,2410,0,1,1
3,1.75,1550,1905,2.0,0,0,3,7,1550,0,2005,0,98055,47.4331,-122.195,1550,1866,242500,22,9,2014,0,9,355,316,0,0,0
6,3.0,2980,7200,1.5,0,2,3,8,2980,0,1911,0,98119,47.6366,-122.362,1720,3600,1310000,20,2,2015,0,104,4220,1880,0,0,1
3,1.0,1270,7153,1.0,0,0,5,6,1270,0,1949,0,98055,47.4815,-122.226,1650,7153,235000,16,10,2014,0,65,5883,5503,0,0,0
4,2.25,3040,12160,1.0,0,0,4,7,1520,1520,1963,0,98007,47.5911,-122.133,2560,12090,598780,23,2,2015,0,52,9120,9530,0,1,0
2,1.0,1110,9920,1.0,0,0,5,6,700,410,1942,0,98056,47.5454,-122.192,2830,10091,343000,11,5,2015,0,73,8810,7261,0,1,0
2,1.0,800,8125,1.0,0,0,3,6,800,0,1964,0,98033,47.6836,-122.174,2390,8125,145000,10,11,2014,0,50,7325,5735,0,0,0
3,1.0,1680,7910,1.0,0,0,3,7,1680,0,1949,0,98146,47.5085,-122.385,1330,7910,599950,18,3,2015,0,66,6230,6580,0,0,1
4,1.75,2780,11000,1.0,0,0,3,9,1560,1220,1964,0,98004,47.595,-122.203,2350,11700,870000,19,3,2015,0,51,8220,9350,0,1,0
4,2.75,2000,9083,2.0,0,0,4,7,2000,0,1992,0,98038,47.3511,-122.058,1690,7735,323000,8,5,2015,0,23,7083,6045,0,0,0
4,3.0,3150,9703,2.0,0,0,3,9,3150,0,2001,0,98075,47.5962,-122.018,3150,8819,727000,25,8,2014,0,13,6553,5669,0,0,0
4,1.75,1740,12204,1.0,0,0,3,7,1270,470,1961,0,98155,47.7675,-122.277,2190,12204,450000,30,4,2015,0,54,10464,10014,0,1,1
2,1.0,1190,7408,1.0,0,0,3,6,830,360,1941,0,98168,47.5094,-122.31,1140,7408,229000,5,6,2014,0,73,6218,6268,0,1,1
1,1.0,900,7500,1.0,0,0,3,5,900,0,1946,1987,98155,47.7553,-122.283,1470,7500,305000,13,10,2014,41,68,6600,6030,1,0,1
3,3.25,2950,4446,2.0,0,0,3,9,2450,500,2001,0,98116,47.5852,-122.391,1930,4255,930000,15,9,2014,0,13,1496,2325,0,1,1
3,2.5,1990,15985,1.0,0,0,3,8,1540,450,1964,0,98007,47.6205,-122.141,2470,10125,542000,23,9,2014,0,50,13995,7655,0,1,0
3,1.0,1020,9147,1.0,0,0,4,6,1020,0,1900,1965,98010,47.3127,-122.002,1600,9700,214000,9,9,2014,65,114,8127,8100,1,0,0
3,2.5,2070,7200,2.0,0,0,3,8,2070,0,2001,0,98033,47.6946,-122.211,1650,8877,718000,9,9,2014,0,13,5130,7227,0,0,0
3,2.5,1430,1002,3.0,0,0,3,8,1430,0,2002,0,98103,47.698,-122.349,1430,1530,349000,11,6,2014,0,12,-428,100,0,0,1
3,2.5,2030,8000,2.0,0,0,3,7,2030,0,1997,0,98031,47.4024,-122.216,2290,7945,305000,5,5,2015,0,18,5970,5655,0,0,0
3,2.5,1620,2640,2.0,0,0,4,7,1620,0,1900,1993,98122,47.6036,-122.305,1370,3840,498000,15,7,2014,93,114,1020,2470,1,0,1
3,2.5,2300,7800,2.0,0,2,3,9,2300,0,1997,0,98052,47.6842,-122.155,2300,8187,737000,5,5,2015,0,18,5500,5887,0,0,0
4,3.25,3830,10005,2.0,0,0,3,10,3830,0,2001,0,98075,47.5953,-122.039,2555,5204,860000,26,12,2014,0,13,6175,2649,0,0,0
3,2.25,1440,7673,1.0,0,0,3,7,940,500,1982,0,98031,47.4034,-122.178,1440,8418,249000,16,5,2014,0,32,6233,6978,0,1,0
2,1.0,910,5525,1.0,0,0,2,6,910,0,1910,0,98126,47.5322,-122.379,1620,5525,370000,7,5,2015,0,105,4615,3905,0,0,1
3,2.0,1550,12262,1.0,0,0,4,7,1550,0,1964,0,98040,47.5755,-122.216,2900,12372,725000,13,10,2014,0,50,10712,9472,0,0,0
4,2.75,2060,8100,1.0,0,0,4,7,1310,750,1988,0,98198,47.3581,-122.317,1540,8100,310000,17,3,2015,0,27,6040,6560,0,1,1
4,2.25,1880,9163,2.0,0,0,3,8,1880,0,1981,0,98058,47.4362,-122.165,1900,7980,315000,27,10,2014,0,33,7283,6080,0,0,0
4,2.5,3470,4160,2.0,0,0,3,9,2480,990,1927,0,98119,47.63,-122.363,2280,5440,1300000,2,10,2014,0,87,690,3160,0,1,1
3,2.0,2360,12744,2.0,0,0,5,7,2360,0,1964,0,98059,47.483,-122.164,1650,8625,435000,5,11,2014,0,50,10384,6975,0,0,0
3,1.75,1970,10800,1.0,0,0,4,7,1300,670,1979,0,98056,47.5107,-122.172,1970,8768,350000,16,7,2014,0,35,8830,6798,0,1,0
3,1.0,1040,7800,1.0,0,0,3,7,1040,0,1948,0,98055,47.4804,-122.229,1780,8400,240000,8,9,2014,0,66,6760,6620,0,0,0
3,2.25,1420,3750,2.0,0,0,3,7,1420,0,1987,0,98116,47.5725,-122.383,1430,4664,410000,28,4,2015,0,28,2330,3234,0,0,1
4,2.75,2290,5249,2.0,0,0,3,7,2290,0,2003,0,98059,47.4916,-122.162,2270,4348,430000,23,9,2014,0,11,2959,2078,0,0,0
4,2.5,1530,8375,1.0,0,0,3,7,1020,510,1974,0,98034,47.7174,-122.236,1650,9794,446000,18,8,2014,0,40,6845,8144,0,1,0
3,1.5,1360,9760,1.5,0,0,5,7,1360,0,1984,0,98045,47.4648,-121.757,1310,11456,240000,11,6,2014,0,30,8400,10146,0,0,0
3,1.0,920,4770,1.0,0,0,4,6,920,0,1969,0,98042,47.3654,-122.082,920,4770,215150,6,3,2015,0,46,3850,3850,0,0,0
2,1.0,1070,5824,1.0,0,2,5,7,1070,0,1949,0,98178,47.507,-122.242,2090,7980,319950,22,5,2014,0,65,4754,5890,0,0,1
3,2.0,1590,9912,2.0,0,0,3,8,1590,0,2000,0,98070,47.3731,-122.43,1670,9912,385000,16,6,2014,0,14,8322,8242,0,0,0
3,2.5,1600,6700,2.0,0,0,3,8,1600,0,1991,0,98042,47.3618,-122.074,1790,7577,280000,25,3,2015,0,24,5100,5787,0,0,0
3,2.5,1510,7300,1.0,0,0,3,7,1040,470,1974,0,98034,47.7153,-122.211,1360,7300,399950,11,5,2015,0,41,5790,5940,0,1,0
3,1.0,1080,10500,1.0,0,0,3,7,1080,0,1967,0,98001,47.32,-122.278,1200,9607,132500,23,5,2014,0,47,9420,8407,0,0,0
2,0.75,1330,2856,1.0,0,0,4,7,930,400,1916,0,98126,47.5671,-122.37,1330,2856,399950,23,4,2015,0,99,1526,1526,0,1,1
2,1.0,850,6800,1.0,0,0,3,7,850,0,1948,0,98133,47.7282,-122.337,870,6800,290000,21,7,2014,0,66,5950,5930,0,0,1
5,2.25,1960,8592,1.0,0,0,4,8,1290,670,1958,0,98004,47.6066,-122.192,1720,8592,860000,12,5,2015,0,57,6632,6872,0,1,0
4,1.0,1530,7200,1.5,0,0,3,7,1400,130,1948,0,98178,47.5015,-122.262,1530,7200,245000,16,5,2014,0,66,5670,5670,0,1,1
3,1.5,1320,7980,1.0,0,0,3,7,1320,0,1956,0,98178,47.5068,-122.259,2000,7700,255000,15,12,2014,0,58,6660,5700,0,0,1
4,3.0,2320,7200,2.0,0,0,3,7,2320,0,1976,0,98155,47.7703,-122.312,2050,10000,310000,13,11,2014,0,38,4880,7950,0,0,1
3,1.0,960,8100,1.0,0,0,3,7,960,0,1955,0,98155,47.7763,-122.305,1080,8100,299000,13,8,2014,0,59,7140,7020,0,0,1
4,2.5,2040,5508,2.0,0,0,4,8,2040,0,1996,0,98029,47.5719,-122.007,2130,5496,575000,10,11,2014,0,18,3468,3366,0,0,0
3,1.0,1080,8214,1.0,0,0,3,7,1080,0,1944,0,98133,47.7401,-122.348,1850,13560,284000,14,11,2014,0,70,7134,11710,0,0,1
3,1.75,2020,4800,1.0,0,0,4,8,1090,930,1926,0,98115,47.6726,-122.294,1680,4800,840000,7,4,2015,0,89,2780,3120,0,1,1
3,1.75,1780,7567,1.0,0,0,3,7,1290,490,1980,0,98034,47.7314,-122.225,1910,8645,442573,13,8,2014,0,34,5787,6735,0,1,0
3,1.0,1140,7028,1.0,0,0,3,8,1140,0,1931,0,98115,47.6948,-122.322,1350,6923,560000,8,10,2014,0,83,5888,5573,0,0,1
3,2.0,1610,4160,1.0,0,0,4,7,1010,600,1917,0,98136,47.5421,-122.388,1040,4400,485000,7,5,2014,0,97,2550,3360,0,1,1
4,1.75,1440,8536,1.0,0,0,4,7,1440,0,1961,0,98033,47.6775,-122.18,1720,9748,472500,18,3,2015,0,54,7096,8028,0,0,0
8,3.75,3460,4600,2.0,0,0,3,7,2860,600,1987,0,98105,47.6617,-122.289,2170,3750,808000,19,12,2014,0,27,1140,1580,0,1,1
3,1.75,1890,16001,1.5,0,0,4,7,1890,0,1950,0,98011,47.7663,-122.201,1820,11450,398000,22,10,2014,0,64,14111,9630,0,0,0
3,2.5,2240,6000,2.0,0,0,3,8,2240,0,2003,0,98059,47.4837,-122.138,2400,6000,340000,17,2,2015,0,12,3760,3600,0,0,0
2,1.0,760,4000,1.5,0,0,3,6,760,0,1910,0,98108,47.5462,-122.32,1130,4000,380000,13,5,2015,0,105,3240,2870,0,0,1
3,1.0,1020,6173,1.0,0,0,3,6,780,240,1948,0,98168,47.5042,-122.329,1330,5909,235000,12,9,2014,0,66,5153,4579,0,1,1
3,1.5,1330,9900,1.0,0,0,3,7,1330,0,1956,0,98034,47.7167,-122.233,1940,9900,400000,27,10,2014,0,58,8570,7960,0,0,0
5,2.5,2780,12335,1.0,0,0,4,8,1590,1190,1968,0,98006,47.5681,-122.128,2750,9930,582000,11,7,2014,0,46,9555,7180,0,1,0
2,1.0,1070,6120,1.0,0,0,3,6,1070,0,1962,0,98168,47.4989,-122.317,1130,6120,209000,31,12,2014,0,52,5050,4990,0,0,1
5,3.0,2660,7700,1.5,0,0,4,7,1670,990,1962,0,98058,47.46,-122.174,1610,7700,335000,3,4,2015,0,53,5040,6090,0,1,0
2,1.0,710,7120,1.0,0,0,5,6,710,0,1942,0,98146,47.5122,-122.374,1100,7020,285950,12,12,2014,0,72,6410,5920,0,0,1
2,1.0,1160,7500,1.5,0,0,4,7,1160,0,1916,0,98014,47.6499,-121.916,1110,7500,312000,23,12,2014,0,98,6340,6390,0,0,0
3,2.0,1060,5750,1.0,0,0,3,7,1060,0,1981,0,98126,47.5523,-122.372,1080,5750,315000,30,5,2014,0,33,4690,4670,0,0,1
4,1.5,1730,10396,1.0,0,0,3,7,1730,0,1964,0,98058,47.4497,-122.168,1510,10396,302200,23,3,2015,0,51,8666,8886,0,0,0
3,2.5,2190,2658,2.0,0,3,4,9,2190,0,1979,0,98033,47.6528,-122.203,2315,2538,770000,8,1,2015,0,36,468,223,0,0,0
4,1.75,1660,8160,1.0,0,0,3,8,1660,0,1974,0,98058,47.4483,-122.129,1800,7684,374950,22,1,2015,0,41,6500,5884,0,0,0
3,2.5,2210,7557,2.0,0,0,3,9,2210,0,1989,0,98023,47.3079,-122.393,2440,8641,330000,11,6,2014,0,25,5347,6201,0,0,0
2,1.0,870,7020,1.0,0,0,4,6,570,300,1942,0,98106,47.5404,-122.352,1730,7020,230000,20,10,2014,0,72,6150,5290,0,1,1
4,2.5,3100,7250,2.0,0,0,3,9,3100,0,2010,0,98115,47.6961,-122.316,1240,6670,967000,27,4,2015,0,5,4150,5430,0,0,1
4,2.5,1720,3515,2.0,0,2,3,8,1470,250,2000,0,98144,47.591,-122.293,1140,2208,536500,8,9,2014,0,14,1795,1068,0,1,1
6,4.0,3120,4240,2.0,0,2,4,7,2090,1030,1993,0,98106,47.5305,-122.353,1460,4240,315000,27,6,2014,0,21,1120,2780,0,1,1
3,1.0,1040,4240,1.0,0,0,4,7,860,180,1924,0,98117,47.6768,-122.367,1170,4240,626000,16,7,2014,0,90,3200,3070,0,1,1
4,2.0,1650,9305,1.0,0,0,4,6,1650,0,1960,0,98034,47.7183,-122.213,1860,7486,334009,18,7,2014,0,54,7655,5626,0,0,0
2,1.0,1010,5000,1.0,0,0,2,7,1010,0,1924,0,98107,47.6715,-122.365,1410,5000,429000,29,1,2015,0,91,3990,3590,0,0,1
5,2.75,2166,6342,2.0,0,0,3,8,2166,0,2013,0,98042,47.3461,-122.152,2474,5948,326000,28,8,2014,0,1,4176,3474,0,0,0
5,3.0,1880,5000,1.0,0,0,3,7,1100,780,1997,0,98106,47.5453,-122.363,1640,5000,310000,12,6,2014,0,17,3120,3360,0,1,1
4,2.0,2260,7680,1.0,0,0,4,7,1130,1130,1947,0,98177,47.7193,-122.361,1800,7680,525000,21,4,2015,0,68,5420,5880,0,1,1
3,2.25,2010,4400,1.5,0,0,3,7,2010,0,1986,0,98055,47.4735,-122.189,1720,4187,350000,3,4,2015,0,29,2390,2467,0,0,0
4,2.5,3330,8897,2.0,0,0,3,10,3330,0,2001,0,98074,47.6484,-122.08,3150,7515,936000,2,4,2015,0,14,5567,4365,0,0,0
3,1.0,1520,7200,1.0,0,0,3,7,1030,490,1954,0,98166,47.4527,-122.352,1530,7201,226000,29,11,2014,0,60,5680,5671,0,1,1
5,3.5,3510,4798,2.0,0,0,3,10,2700,810,2008,0,98105,47.669,-122.282,1460,1684,1250000,1,5,2015,0,7,1288,224,0,1,1
3,1.5,1460,5040,1.0,0,0,3,7,1100,360,1971,0,98133,47.7112,-122.357,2330,7560,329932,29,5,2014,0,43,3580,5230,0,1,1
3,1.5,1460,5040,1.0,0,0,3,7,1100,360,1971,0,98133,47.7112,-122.357,2330,7560,539000,20,1,2015,0,44,3580,5230,0,1,1
3,1.75,1650,7700,1.0,0,0,4,8,1650,0,1977,0,98023,47.3155,-122.365,2020,7700,275000,10,3,2015,0,38,6050,5680,0,0,0
4,2.5,2120,9603,2.0,0,0,3,8,2120,0,1985,0,98027,47.5348,-122.053,1990,9611,575000,16,6,2014,0,29,7483,7621,0,0,0
3,2.25,1780,9315,2.0,0,0,3,7,1780,0,1996,0,98133,47.7484,-122.353,1780,8545,509000,14,1,2015,0,19,7535,6765,0,0,1
4,2.5,2000,13300,1.0,0,0,4,7,1200,800,1968,0,98001,47.353,-122.294,1800,9810,290000,9,5,2014,0,46,11300,8010,0,1,0
3,1.0,1300,9000,1.0,0,0,3,7,1300,0,1956,0,98133,47.7352,-122.337,1500,9600,305240,28,7,2014,0,58,7700,8100,0,0,1
3,2.0,2180,4976,1.5,0,2,4,8,1680,500,1930,0,98126,47.573,-122.38,1850,5000,555000,10,6,2014,0,84,2796,3150,0,1,1
3,2.0,1790,8228,1.0,0,0,3,7,1390,400,1980,0,98058,47.4658,-122.172,1880,8228,317000,25,7,2014,0,34,6438,6348,0,1,0
3,2.0,1910,5040,1.5,0,0,3,8,1910,0,1971,0,98074,47.6312,-122.061,1980,4275,430000,13,6,2014,0,43,3130,2295,0,0,0
2,1.5,1800,4144,1.0,0,4,4,7,900,900,1962,0,98116,47.5934,-122.39,2090,4173,850000,24,2,2015,0,53,2344,2083,0,1,1
3,2.25,2620,10659,1.0,0,0,3,7,1660,960,1976,0,98155,47.7643,-122.273,1820,12071,469000,26,11,2014,0,38,8039,10251,0,1,1
2,2.0,1440,8425,1.0,0,0,4,6,1440,0,1942,1983,98168,47.4831,-122.296,1430,12037,327200,30,7,2014,41,72,6985,10607,1,0,1
3,3.0,2790,12523,2.0,1,4,4,8,1600,1190,1977,0,98198,47.3571,-122.324,2990,11476,835000,12,6,2014,0,37,9733,8486,0,1,1
4,2.5,2340,13445,2.0,0,0,3,8,2340,0,1990,0,98042,47.374,-122.125,2340,11188,360000,3,9,2014,0,24,11105,8848,0,0,0
4,2.5,2070,8658,2.0,0,0,3,8,2070,0,1999,0,98178,47.5072,-122.257,2010,7215,372000,11,12,2014,0,15,6588,5205,0,0,1
3,1.0,2160,11484,1.5,0,0,4,7,2160,0,1968,0,98034,47.7277,-122.185,2270,10080,453000,26,3,2015,0,47,9324,7810,0,0,0
2,1.75,2090,11317,1.0,0,0,5,7,1090,1000,1931,0,98188,47.4594,-122.279,1940,11317,275000,13,8,2014,0,83,9227,9377,0,1,1
4,2.5,2040,7260,2.0,0,0,4,7,2040,0,1963,0,98133,47.7399,-122.332,2040,7360,475000,2,7,2014,0,51,5220,5320,0,0,1
4,2.75,1950,9720,1.0,0,0,3,7,1400,550,1986,0,98031,47.3969,-122.205,2300,10530,310000,13,2,2015,0,29,7770,8230,0,1,0
4,2.0,1200,8460,1.0,0,0,5,7,1200,0,1957,0,98188,47.4413,-122.277,1350,8623,173000,10,2,2015,0,58,7260,7273,0,0,1
3,2.5,1360,1489,2.0,0,0,3,8,1360,0,2007,0,98126,47.549,-122.372,1360,1688,345000,29,7,2014,0,7,129,328,0,0,1
3,1.5,1500,10200,1.0,0,0,3,8,1300,200,1955,0,98177,47.7598,-122.359,1950,9500,436000,16,3,2015,0,60,8700,7550,0,1,1
2,1.75,1300,14500,1.0,0,0,3,6,650,650,1939,0,98168,47.4989,-122.329,1370,12986,244500,24,9,2014,0,75,13200,11616,0,1,1
3,1.75,1140,9800,1.0,0,0,4,7,1140,0,1968,0,98001,47.3063,-122.27,1370,9800,206000,11,7,2014,0,46,8660,8430,0,0,0
4,2.5,2930,9158,2.0,0,0,3,9,2930,0,2005,0,98052,47.7065,-122.13,3590,8065,890000,21,4,2015,0,10,6228,4475,0,0,0
4,2.25,2140,8874,2.0,0,0,3,8,2140,0,1986,0,98092,47.2654,-122.217,2140,8789,329950,22,1,2015,0,29,6734,6649,0,0,0
4,1.75,1910,8117,1.0,0,0,3,7,1460,450,1975,0,98072,47.7344,-122.173,1810,8100,395000,24,9,2014,0,39,6207,6290,0,1,0
3,1.0,820,5150,1.0,0,0,5,6,820,0,1918,0,98118,47.5514,-122.284,1100,5150,305000,26,9,2014,0,96,4330,4050,0,0,1
3,2.25,1470,8682,1.0,0,0,3,7,1160,310,1985,0,98003,47.2729,-122.299,1670,8359,160000,23,9,2014,0,29,7212,6689,0,1,0
3,2.25,1470,8682,1.0,0,0,3,7,1160,310,1985,0,98003,47.2729,-122.299,1670,8359,269000,26,2,2015,0,30,7212,6689,0,1,0
3,1.0,1060,10023,1.0,0,0,3,6,1060,0,1962,0,98023,47.2869,-122.36,1060,10023,169500,11,8,2014,0,52,8963,8963,0,0,0
4,2.75,3130,8920,2.0,0,0,3,8,3130,0,2014,0,98155,47.7397,-122.316,1450,9183,690500,5,12,2014,0,0,5790,7733,0,0,1
2,1.5,1260,9693,1.0,0,0,3,7,1260,0,1957,0,98177,47.7775,-122.365,1800,9693,245560,3,12,2014,0,57,8433,7893,0,0,1
4,2.75,2200,13498,2.0,0,0,3,8,2200,0,1987,0,98023,47.3148,-122.35,2190,11850,345000,11,3,2015,0,28,11298,9660,0,0,0
3,2.25,1350,944,2.0,0,0,3,8,1050,300,2007,0,98144,47.5997,-122.312,1350,1245,388500,27,8,2014,0,7,-406,-105,0,1,1
3,1.75,1350,8548,1.0,0,0,3,7,1350,0,1985,0,98003,47.3179,-122.33,1660,8538,250000,18,9,2014,0,29,7198,6878,0,0,0
3,1.75,2290,19000,1.0,0,0,4,9,1650,640,1973,0,98042,47.3837,-122.158,2900,13034,455500,3,2,2015,0,42,16710,10134,0,1,0
3,1.0,1220,8573,1.0,0,0,4,7,1220,0,1954,0,98004,47.6088,-122.193,1390,8573,672000,1,12,2014,0,60,7353,7183,0,0,0
3,1.75,1430,12632,1.0,0,0,3,7,1430,0,1959,0,98008,47.6371,-122.123,1750,10350,487000,6,5,2015,0,56,11202,8600,0,0,0
4,2.5,2220,6233,2.0,0,0,3,7,2220,0,2001,0,98059,47.4887,-122.15,2220,5352,291375,20,8,2014,0,13,4013,3132,0,0,0
3,1.0,1490,15850,1.0,0,0,3,7,1490,0,1946,0,98133,47.7411,-122.347,1950,13228,225000,4,3,2015,0,69,14360,11278,0,0,1
5,3.5,2440,10200,2.0,0,0,4,7,2440,0,1974,0,98075,47.5814,-122.003,2000,10568,519950,11,11,2014,0,40,7760,8568,0,0,0
3,2.5,2070,8400,2.0,0,0,4,8,2070,0,1990,0,98002,47.3099,-122.206,2070,9239,250000,26,8,2014,0,24,6330,7169,0,0,0
3,1.0,1500,2400,1.5,0,0,5,7,1500,0,1900,0,98119,47.6333,-122.362,1780,3600,614950,18,9,2014,0,114,900,1820,0,0,1
4,2.25,2020,10260,2.0,0,0,4,7,2020,0,1984,0,98052,47.6801,-122.114,2020,10311,599500,14,1,2015,0,31,8240,8291,0,0,0
2,1.0,780,10064,1.0,0,0,4,7,780,0,1958,0,98168,47.4913,-122.318,1090,14750,248500,6,5,2015,0,57,9284,13660,0,0,1
5,2.0,1220,4200,1.0,0,0,4,6,1090,130,1921,0,98105,47.6677,-122.321,1790,4200,469950,30,9,2014,0,93,2980,2410,0,1,1
3,1.5,1840,10956,1.0,0,0,4,8,1840,0,1970,0,98033,47.6746,-122.164,1680,10950,525000,22,4,2015,0,45,9116,9270,0,0,0
2,2.5,2390,6928,2.0,0,3,4,8,1810,580,1949,1982,98146,47.5101,-122.391,2390,12852,787500,2,9,2014,33,65,4538,10462,1,1,1
2,1.0,750,5379,1.0,0,0,3,6,750,0,1919,0,98118,47.5324,-122.272,1030,5511,310000,7,4,2015,0,96,4629,4481,0,0,1
5,2.0,2110,7919,1.0,0,0,3,7,1110,1000,1966,0,98118,47.5164,-122.267,1590,5250,280000,10,10,2014,0,48,5809,3660,0,1,1
3,2.5,3080,7363,2.0,0,0,3,9,3080,0,2006,0,98055,47.4473,-122.205,2860,5273,490000,10,10,2014,0,8,4283,2413,0,0,0
3,1.0,900,4770,1.0,0,0,3,6,900,0,1969,2009,98023,47.3038,-122.362,900,3480,146000,31,12,2014,40,45,3870,2580,1,0,0
3,1.0,940,7380,1.0,0,0,3,6,940,0,1959,0,98058,47.4516,-122.175,1210,8095,242500,10,9,2014,0,55,6440,6885,0,0,0
3,1.0,1040,7288,1.0,0,0,3,7,1040,0,1959,0,98125,47.7287,-122.311,1160,7287,324950,6,10,2014,0,55,6248,6127,0,0,1
2,1.0,1000,7615,1.0,0,0,4,6,1000,0,1943,0,98056,47.49,-122.191,1060,8000,231500,16,4,2015,0,72,6615,6940,0,0,0
3,2.5,2080,9827,2.0,0,0,3,8,2080,0,1989,0,98023,47.3058,-122.394,2660,9861,300000,29,5,2014,0,25,7747,7201,0,0,0
3,1.0,1050,8583,1.0,0,0,5,6,1050,0,1955,0,98133,47.7451,-122.339,1460,7351,350000,17,2,2015,0,60,7533,5891,0,0,1
3,1.75,1620,8645,1.0,0,0,3,7,1190,430,1973,0,98052,47.6651,-122.151,2010,8645,467100,23,5,2014,0,41,7025,6635,0,1,0
3,1.0,1610,8500,1.5,0,0,3,7,1610,0,1959,0,98032,47.3717,-122.297,1070,8750,180000,8,4,2015,0,56,6890,7680,0,0,0
4,1.5,2130,5000,2.0,0,0,4,8,2130,0,1920,0,98144,47.5828,-122.291,2560,5000,749000,10,7,2014,0,94,2870,2440,0,0,1
3,2.5,1460,11593,2.0,0,0,3,7,1460,0,1989,0,98023,47.2984,-122.385,1640,9703,245000,9,10,2014,0,25,10133,8063,0,0,0
5,1.0,1600,7350,1.0,0,0,5,7,1600,0,1962,0,98031,47.3943,-122.196,1600,7725,260000,19,8,2014,0,52,5750,6125,0,0,0
3,3.0,1730,2940,3.0,0,0,3,7,1730,0,1985,0,98117,47.6911,-122.392,1690,4410,490000,7,6,2014,0,29,1210,2720,0,0,1
4,2.5,2280,4602,2.0,0,0,3,8,2280,0,2003,0,98075,47.5895,-122.019,2280,4193,565000,27,8,2014,0,11,2322,1913,0,0,0
4,2.25,2430,7490,2.0,0,0,3,8,2430,0,1983,0,98058,47.4406,-122.139,2070,7469,330000,25,8,2014,0,31,5060,5399,0,0,0
3,1.0,1380,7575,1.0,0,0,4,7,1380,0,1963,0,98056,47.5139,-122.187,1320,7600,295000,4,11,2014,0,51,6195,6280,0,0,0
3,1.5,1790,6000,1.5,0,0,4,7,1790,0,1903,0,98115,47.6754,-122.325,1290,3500,725000,9,10,2014,0,111,4210,2210,0,0,1
4,2.5,3370,10602,2.0,0,0,3,10,3370,0,1999,0,98007,47.6591,-122.147,2950,9949,1140000,3,9,2014,0,15,7232,6999,0,0,0
3,2.25,2920,6300,1.0,0,0,3,8,1710,1210,1956,0,98177,47.7065,-122.37,1940,6300,680000,4,8,2014,0,58,3380,4360,0,1,1
2,1.0,2180,9300,1.0,0,0,4,7,1090,1090,1947,0,98177,47.7032,-122.371,1830,7378,490000,30,10,2014,0,67,7120,5548,0,1,1
3,1.75,1480,6985,1.5,0,0,4,7,1200,280,1926,0,98117,47.686,-122.374,1480,5588,635000,27,4,2015,0,89,5505,4108,0,1,1
4,2.25,2440,8098,2.0,0,0,3,8,2440,0,1983,0,98023,47.3126,-122.346,2110,7911,330000,9,12,2014,0,31,5658,5801,0,0,0
3,2.5,1350,1189,2.0,0,0,3,7,1080,270,2007,0,98106,47.5218,-122.358,1300,1182,270000,24,3,2015,0,8,-161,-118,0,1,1
3,2.25,1970,3716,2.0,0,0,3,7,1970,0,1997,0,98056,47.4907,-122.167,1780,3716,340000,14,5,2014,0,17,1746,1936,0,0,0
3,0.75,1110,3960,1.0,0,0,3,7,1110,0,1951,0,98117,47.6834,-122.366,1610,5530,413252,4,3,2015,0,64,2850,3920,0,0,1
4,2.75,2950,5803,2.0,0,0,3,9,2950,0,2007,0,98028,47.7368,-122.231,2940,5803,600000,10,2,2015,0,8,2853,2863,0,0,0
5,3.0,2970,7261,2.0,0,0,3,9,2970,0,1999,0,98075,47.5994,-122.019,2970,8437,726888,15,4,2015,0,16,4291,5467,0,0,0
2,1.0,720,6400,1.0,0,0,4,6,720,0,1943,0,98126,47.5286,-122.368,1030,6400,285000,6,12,2014,0,71,5680,5370,0,0,1
2,1.0,770,5680,1.0,0,0,4,6,770,0,1929,0,98117,47.6951,-122.366,1170,5514,365000,6,2,2015,0,86,4910,4344,0,0,1
4,2.0,1650,7200,1.0,0,0,3,7,1650,0,1964,0,98133,47.7543,-122.344,1410,7200,295000,9,3,2015,0,51,5550,5790,0,0,1
3,2.25,1620,7350,1.0,0,0,3,7,1170,450,1969,0,98034,47.7248,-122.179,1800,7350,460000,18,3,2015,0,46,5730,5550,0,1,0
3,1.5,1510,10588,1.5,0,0,3,7,1510,0,1947,0,98198,47.3775,-122.319,1360,2873,230000,25,9,2014,0,67,9078,1513,0,0,1
3,1.0,1070,6109,1.0,0,0,5,7,1070,0,1951,0,98125,47.7207,-122.32,1170,7200,337000,22,5,2014,0,63,5039,6030,0,0,1
3,1.0,1010,6300,1.0,0,0,3,7,1010,0,1957,0,98133,47.7304,-122.352,1480,7480,300000,8,9,2014,0,57,5290,6000,0,0,1
4,2.5,3370,8402,1.0,0,0,5,10,2240,1130,1962,0,98112,47.6349,-122.29,3190,8700,2300000,30,1,2015,0,53,5032,5510,0,1,1
4,2.5,2000,5500,2.0,0,0,3,8,2000,0,2003,0,98038,47.3552,-122.014,2000,5512,360000,10,12,2014,0,11,3500,3512,0,0,0
3,2.5,2060,10839,2.0,0,0,3,8,2060,0,1987,0,98029,47.5675,-122.016,2180,8126,585000,16,3,2015,0,28,8779,5946,0,0,0
3,2.25,1740,6650,1.0,0,0,3,7,1240,500,1978,0,98023,47.2979,-122.379,1740,7000,182700,8,10,2014,0,36,4910,5260,0,1,0
3,2.25,1740,6650,1.0,0,0,3,7,1240,500,1978,0,98023,47.2979,-122.379,1740,7000,305000,28,4,2015,0,37,4910,5260,0,1,0
3,2.5,1880,7838,2.0,0,0,3,7,1880,0,1994,0,98055,47.4439,-122.19,1810,7915,309950,5,5,2014,0,20,5958,6105,0,0,0
3,1.0,960,12527,1.0,0,0,3,7,960,0,1972,0,98033,47.6891,-122.203,1220,7579,550000,16,3,2015,0,43,11567,6359,0,0,0
2,1.0,1570,4400,1.5,0,0,4,8,1570,0,1914,0,98122,47.6112,-122.293,1850,4400,998500,1,10,2014,0,100,2830,2550,0,0,1
4,2.5,2990,5342,2.0,0,0,3,8,2990,0,2004,0,98074,47.6124,-122.009,2990,5936,644500,1,11,2014,0,10,2352,2946,0,0,0
3,2.0,1250,8636,1.0,0,0,5,7,1250,0,1968,0,98059,47.5066,-122.159,1620,7653,320000,12,1,2015,0,47,7386,6033,0,0,0
3,2.5,1920,4803,2.0,0,0,3,7,1920,0,2005,0,98042,47.3745,-122.127,2240,5231,266950,15,10,2014,0,9,2883,2991,0,0,0
2,1.0,960,6700,1.0,0,0,3,7,960,0,1951,0,98103,47.6955,-122.357,1350,6700,395000,5,8,2014,0,63,5740,5350,0,0,1
3,1.0,940,5904,1.0,0,0,3,6,940,0,1947,0,98103,47.699,-122.35,870,5728,259250,16,3,2015,0,68,4964,4858,0,0,1
3,1.0,1260,5000,1.0,0,0,4,6,1260,0,1968,0,98014,47.6492,-121.915,1180,7500,300000,6,11,2014,0,46,3740,6320,0,0,0
3,2.25,1740,8491,1.0,0,0,3,8,1240,500,1958,0,98177,47.7758,-122.379,2080,8494,435000,1,8,2014,0,56,6751,6414,0,1,1
4,1.75,2430,5481,1.0,0,0,3,8,1430,1000,1953,0,98108,47.5569,-122.298,2050,5508,402000,1,8,2014,0,61,3051,3458,0,1,1
2,1.5,1220,5000,1.0,0,2,4,7,1220,0,1938,0,98103,47.6624,-122.348,2090,3850,580000,23,3,2015,0,77,3780,1760,0,0,1
2,1.0,730,6000,1.0,0,0,3,6,730,0,1950,1985,98198,47.3832,-122.3,1750,7200,174950,8,12,2014,35,64,5270,5450,1,0,1
2,1.0,760,3001,1.0,0,0,3,6,760,0,1913,0,98144,47.5874,-122.311,1750,5000,300000,7,5,2014,0,101,2241,3250,0,0,1
3,1.5,1740,6988,1.0,0,0,3,7,1600,140,1950,0,98133,47.7211,-122.33,1650,7500,435000,23,9,2014,0,64,5248,5850,0,1,1
4,2.5,3420,8405,2.0,0,0,3,10,3420,0,2000,0,98074,47.6328,-122.064,3230,8460,840000,28,5,2014,0,14,4985,5230,0,0,0
5,2.5,2240,7543,1.0,0,0,3,7,1140,1100,1966,0,98177,47.7756,-122.372,2110,7408,469000,18,6,2014,0,48,5303,5298,0,1,1
4,1.75,1920,3600,2.0,0,0,4,8,1920,0,1907,0,98119,47.6382,-122.368,1920,3600,870000,12,11,2014,0,107,1680,1680,0,0,1
4,1.75,2020,7029,1.0,0,0,4,7,1430,590,1979,0,98052,47.6983,-122.127,1780,7200,532000,4,6,2014,0,35,5009,5420,0,1,0
4,1.5,1880,11400,1.0,0,0,3,7,1280,600,1955,0,98177,47.7718,-122.381,1880,11400,455000,26,3,2015,0,60,9520,9520,0,1,1
5,3.25,3990,13087,2.0,0,0,3,9,2400,1590,1991,0,98042,47.3632,-122.061,2580,13633,649000,23,9,2014,0,23,9097,11053,0,1,0
2,1.75,1390,6670,1.0,0,0,3,6,720,670,1941,0,98115,47.6914,-122.308,920,6380,445500,24,5,2015,0,74,5280,5460,0,1,1
3,2.0,1230,11502,1.0,0,0,4,7,1230,0,1984,0,98052,47.7017,-122.127,1660,11727,475000,27,5,2014,0,30,10272,10067,0,0,0
4,1.5,2190,8296,2.0,0,0,3,7,2190,0,1935,1963,98136,47.5158,-122.385,1160,8160,565000,24,2,2015,28,80,6106,7000,1,0,1
1,1.0,640,10280,1.0,0,0,2,5,640,0,1920,0,98126,47.5144,-122.368,1090,9000,110000,15,9,2014,0,94,9640,7910,0,0,1
3,2.5,1670,7740,1.0,0,0,3,7,1130,540,1974,0,98126,47.5222,-122.37,1220,7740,375000,19,12,2014,0,40,6070,6520,0,1,1
3,1.5,1240,8528,1.0,0,0,4,7,1240,0,1967,0,98058,47.4478,-122.157,1570,8064,255000,18,7,2014,0,47,7288,6494,0,0,0
5,1.75,1850,14800,1.5,0,0,3,6,1760,90,1937,0,98168,47.4935,-122.321,1250,14800,315000,29,4,2015,0,78,12950,13550,0,1,1
4,2.25,2020,8400,1.0,0,0,4,8,1350,670,1961,0,98006,47.5488,-122.171,2060,8400,496600,20,11,2014,0,53,6380,6340,0,1,0
3,1.0,1020,4800,1.0,0,0,3,7,1020,0,1944,0,98118,47.5615,-122.272,1400,5465,380000,14,7,2014,0,70,3780,4065,0,0,1
5,2.5,2840,5000,1.0,0,0,4,7,1620,1220,1913,0,98144,47.5817,-122.291,2200,5000,739000,16,8,2014,0,101,2160,2800,0,1,1
4,1.75,1290,3060,2.0,0,0,4,7,1290,0,1906,0,98103,47.6798,-122.348,1510,4080,549000,19,6,2014,0,108,1770,2570,0,0,1
3,2.25,1670,7881,1.0,0,0,4,7,1190,480,1977,0,98031,47.4105,-122.18,1870,7820,252000,24,6,2014,0,37,6211,5950,0,1,0
4,4.5,3860,15246,2.0,0,4,3,11,2940,920,2004,0,98006,47.56,-122.161,3750,14790,1700000,22,9,2014,0,10,11386,11040,0,1,0
4,1.75,2460,5100,1.5,0,0,5,7,1450,1010,1909,0,98115,47.6782,-122.3,1560,5100,735000,11,6,2014,0,105,2640,3540,0,1,1
4,2.5,1660,8063,1.0,0,0,4,7,1660,0,1978,0,98198,47.3761,-122.32,1060,8437,270000,9,7,2014,0,36,6403,7377,0,0,1
3,2.5,3420,8700,1.0,0,0,3,9,2890,530,1951,0,98112,47.6352,-122.29,3370,8700,2250000,4,2,2015,0,64,5280,5330,0,1,1
4,2.5,2240,5624,1.0,0,0,3,7,1520,720,1961,0,98108,47.5574,-122.308,2240,7495,469000,2,3,2015,0,54,3384,5255,0,1,1
4,2.25,2340,5250,2.0,0,0,5,7,2340,0,1965,0,98118,47.5183,-122.266,1540,5250,305000,8,1,2015,0,50,2910,3710,0,0,1
3,1.75,1920,4500,1.0,0,0,5,7,960,960,1924,0,98107,47.6645,-122.357,1190,4000,675000,10,7,2014,0,90,2580,2810,0,1,1
3,2.5,2460,6600,1.5,0,0,4,8,1560,900,1929,0,98109,47.6364,-122.351,2090,3400,931000,31,12,2014,0,85,4140,1310,0,1,1
3,1.0,1470,11398,1.0,0,0,3,8,1470,0,1950,0,98155,47.746,-122.296,1710,11407,385000,5,2,2015,0,65,9928,9697,0,0,1
3,2.5,3400,12442,2.0,0,0,3,9,3400,0,2001,0,98075,47.5611,-122.032,3250,8635,815000,14,2,2015,0,14,9042,5385,0,0,0
3,2.25,1910,8390,1.0,0,0,3,7,1910,0,1979,0,98034,47.73,-122.216,2410,8390,531000,30,3,2015,0,36,6480,5980,0,0,0
4,1.0,1400,3600,1.0,0,0,4,6,700,700,1901,0,98144,47.5972,-122.295,1690,3600,386500,23,3,2015,0,114,2200,1910,0,1,1
3,1.75,1520,11085,1.0,0,0,3,8,1520,0,1983,0,98074,47.646,-122.068,2310,9647,475580,26,6,2014,0,31,9565,7337,0,0,0
2,1.0,930,5077,1.0,0,0,3,6,930,0,1939,0,98133,47.7095,-122.35,1080,5803,358000,20,8,2014,0,75,4147,4723,0,0,1
5,1.0,2340,4730,2.0,0,0,3,8,1810,530,1918,0,98116,47.5895,-122.385,2100,4970,677500,22,10,2014,0,96,2390,2870,0,1,1
3,2.5,2920,3942,3.0,0,0,3,10,2920,0,2008,0,98056,47.531,-122.204,2920,3942,868500,8,5,2014,0,6,1022,1022,0,0,0
3,1.75,1270,7350,1.0,0,0,4,7,1270,0,1967,0,98005,47.6046,-122.168,1880,7350,599380,9,2,2015,0,48,6080,5470,0,0,0
4,2.25,2450,11960,1.0,0,0,3,10,2450,0,1979,0,98074,47.6351,-122.06,2600,11960,712000,8,10,2014,0,35,9510,9360,0,0,0
5,1.75,1380,7620,1.0,0,0,3,7,1180,200,1955,0,98106,47.5279,-122.345,1990,7620,350000,30,4,2015,0,60,6240,5630,0,1,1
4,2.0,2520,6000,1.0,0,0,3,8,1400,1120,1921,2007,98103,47.6767,-122.35,1580,3720,875000,10,5,2014,86,93,3480,2140,1,1,1
3,2.25,2290,7350,2.0,0,0,3,8,2290,0,1988,0,98058,47.429,-122.162,2170,7529,365000,4,3,2015,0,27,5060,5359,0,0,0
4,2.0,1660,6150,1.0,0,0,3,6,850,810,1945,0,98126,47.5371,-122.368,1110,6250,452000,21,5,2014,0,69,4490,5140,0,1,1
3,2.75,2800,9750,1.0,0,0,5,7,1400,1400,1957,0,98004,47.5862,-122.202,2800,9530,915000,17,2,2015,0,58,6950,6730,0,1,0
3,2.5,1690,3068,2.0,0,0,3,7,1690,0,2005,0,98053,47.6763,-122.028,1690,3260,482500,5,1,2015,0,10,1378,1570,0,0,0
3,1.0,1180,7200,1.5,0,0,4,7,1180,0,1949,0,98133,47.7121,-122.333,2240,7875,425000,14,10,2014,0,65,6020,5635,0,0,1
2,1.75,1390,4160,1.0,0,0,5,6,790,600,1916,0,98105,47.6681,-122.324,1090,4160,460000,11,12,2014,0,98,2770,3070,0,1,1
4,2.0,2320,7400,1.5,0,0,5,7,1620,700,1913,0,98118,47.5558,-122.269,1740,4000,666570,20,7,2014,0,101,5080,2260,0,1,1
4,1.75,2640,8215,1.0,0,0,4,7,1500,1140,1966,0,98008,47.5819,-122.125,2070,7875,650000,9,10,2014,0,48,5575,5805,0,1,0
3,2.0,1680,8487,1.0,0,0,3,7,1680,0,1993,0,98022,47.1959,-122.01,2080,8560,305000,1,10,2014,0,21,6807,6480,0,0,0
3,1.0,990,8100,1.0,0,0,3,6,990,0,1949,0,98146,47.4839,-122.341,1210,8100,250000,5,8,2014,0,65,7110,6890,0,0,1
4,2.5,2770,4432,2.0,0,0,3,9,2770,0,2004,0,98058,47.4541,-122.117,2770,5423,438800,6,4,2015,0,11,1662,2653,0,0,0
2,1.0,950,5650,1.0,0,0,5,6,950,0,1943,0,98118,47.5149,-122.257,1250,5650,290000,15,12,2014,0,71,4700,4400,0,0,1
4,2.0,2160,4800,2.0,0,0,4,7,1290,870,1929,0,98055,47.4777,-122.212,1570,4800,324950,1,5,2015,0,86,2640,3230,0,1,0
3,2.5,1650,1838,2.0,0,0,4,7,1270,380,1991,0,98107,47.6666,-122.367,1550,1558,453000,1,12,2014,0,23,188,8,0,1,1
3,1.0,1800,4005,1.5,0,0,4,7,1160,640,1929,0,98117,47.6876,-122.38,1240,4005,556000,19,9,2014,0,85,2205,2765,0,1,1
3,2.0,1660,11135,1.0,0,0,3,8,1660,0,1971,0,98045,47.4897,-121.787,1660,11560,315000,18,11,2014,0,43,9475,9900,0,0,0
3,2.5,1870,5449,2.0,0,0,3,8,1870,0,2003,0,98011,47.7557,-122.22,2000,7687,445830,27,5,2014,0,11,3579,5687,0,0,0
3,3.5,3220,3960,2.0,0,4,3,10,2760,460,1991,0,98116,47.5909,-122.384,3080,4444,1260000,10,10,2014,0,23,740,1364,0,1,1
4,1.5,1580,6360,1.5,0,0,3,7,1290,290,1945,0,98115,47.6873,-122.286,1690,6360,525000,23,9,2014,0,69,4780,4670,0,1,1
4,4.25,4590,17621,2.0,0,0,3,10,3160,1430,2003,0,98033,47.6973,-122.205,3800,12268,1140000,26,12,2014,0,11,13031,8468,0,1,0
3,1.75,1020,7020,1.5,0,0,4,7,1020,0,1953,0,98155,47.7362,-122.314,1020,5871,360000,6,6,2014,0,61,6000,4851,0,0,1
5,3.5,2950,2932,3.0,0,0,3,8,2950,0,2004,0,98144,47.5923,-122.298,1580,2047,619000,4,5,2015,0,11,-18,467,0,0,1
2,1.0,710,5100,1.0,0,0,5,7,710,0,1905,0,98117,47.6765,-122.381,1530,5100,402000,9,10,2014,0,109,4390,3570,0,0,1
3,2.5,2080,8690,1.0,0,0,3,8,1430,650,1974,0,98166,47.4424,-122.344,2400,9625,549950,10,9,2014,0,40,6610,7225,0,1,1
4,2.0,2360,7440,1.0,0,0,3,7,1180,1180,1955,0,98178,47.5044,-122.245,1680,7800,300000,20,8,2014,0,59,5080,6120,0,1,1
6,2.0,2210,9870,2.0,0,0,4,7,2210,0,1969,1995,98059,47.4751,-122.145,1390,9912,360000,25,3,2015,26,46,7660,8522,1,0,0
7,3.25,4340,8521,2.0,0,0,3,7,2550,1790,1986,0,98106,47.52,-122.338,1890,8951,419000,10,9,2014,0,28,4181,7061,0,1,1
3,3.0,1320,1012,3.0,0,0,3,8,1320,0,2009,0,98117,47.6904,-122.395,1320,1536,510000,7,4,2015,0,6,-308,216,0,0,1
3,2.5,1980,9907,2.0,0,0,3,8,1980,0,1991,0,98022,47.1903,-122.013,2050,9907,319950,16,9,2014,0,23,7927,7857,0,0,0
4,2.5,2130,6003,2.0,0,0,3,8,2130,0,2003,0,98058,47.4518,-122.12,1940,4529,381000,3,10,2014,0,11,3873,2589,0,0,0
3,2.5,1720,3951,2.0,0,0,3,7,1720,0,1992,0,98031,47.4033,-122.187,1720,3605,256900,5,5,2015,0,23,2231,1885,0,0,0
2,2.25,1390,1222,3.0,0,0,3,7,1340,50,2009,0,98052,47.6754,-122.121,1480,1369,465000,8,12,2014,0,5,-168,-111,0,1,0
3,2.0,1900,9975,1.0,0,0,3,8,1500,400,1973,0,98027,47.5307,-122.054,2140,9825,545000,6,5,2015,0,42,8075,7685,0,1,0
2,1.75,1640,3090,1.0,0,0,4,7,910,730,1925,0,98115,47.679,-122.319,1510,4120,516000,30,7,2014,0,89,1450,2610,0,1,1
4,2.5,2700,5100,1.0,0,0,4,8,1440,1260,1968,0,98136,47.5331,-122.384,1880,5100,550000,9,6,2014,0,46,2400,3220,0,1,1
4,2.25,2200,7150,2.0,0,0,4,7,2200,0,1990,0,98042,47.3595,-122.089,1740,7150,339950,5,5,2015,0,25,4950,5410,0,0,0
3,1.0,1310,8514,1.0,0,0,4,7,1310,0,1953,0,98133,47.7502,-122.353,1310,8514,417000,25,3,2015,0,62,7204,7204,0,0,1
4,2.5,2480,5000,1.0,0,3,3,8,1480,1000,1951,0,98105,47.6653,-122.272,2240,6071,906000,25,2,2015,0,64,2520,3831,0,1,1
4,2.25,3010,9800,2.0,0,0,4,9,3010,0,1973,0,98040,47.5336,-122.223,2510,9800,980000,12,11,2014,0,41,6790,7290,0,0,0
4,2.5,2450,5079,2.0,0,0,3,9,2450,0,2001,0,98056,47.5214,-122.191,2690,6675,555000,13,4,2015,0,14,2629,3985,0,0,0
2,1.75,1250,7029,1.0,0,0,4,7,1250,0,1986,0,98033,47.6936,-122.186,1680,8470,468000,10,11,2014,0,28,5779,6790,0,0,0
4,2.5,3120,14300,2.0,0,0,3,9,3120,0,2003,0,98027,47.5318,-122.055,2580,10005,730100,16,5,2014,0,11,11180,7425,0,0,0
4,1.5,1370,7944,1.5,0,0,3,7,1370,0,1961,0,98198,47.4224,-122.289,1370,9181,219000,4,9,2014,0,53,6574,7811,0,0,1
3,2.5,2420,11953,1.0,0,0,3,9,2420,0,1990,0,98074,47.6285,-122.054,2420,12215,570000,21,11,2014,0,24,9533,9795,0,0,0
4,2.75,1500,7036,1.0,0,0,3,7,1060,440,1979,0,98032,47.3665,-122.276,1620,7200,262500,19,11,2014,0,35,5536,5580,0,1,0
5,2.5,2630,9216,2.0,0,0,3,8,2630,0,2003,0,98019,47.7379,-121.966,2020,4980,525000,29,5,2014,0,11,6586,2960,0,0,0
2,1.0,950,3880,1.0,0,0,4,6,950,0,1919,0,98117,47.687,-122.389,1660,3880,520000,2,4,2015,0,96,2930,2220,0,0,1
3,3.0,2680,12285,1.0,0,0,4,8,2680,0,1970,0,98055,47.4633,-122.196,2610,9558,417400,9,12,2014,0,44,9605,6948,0,0,0
4,3.25,3680,5759,2.0,0,0,3,9,2840,840,2003,0,98027,47.5367,-122.067,3620,6006,788000,12,5,2014,0,11,2079,2386,0,1,0
3,1.0,1270,7400,1.0,0,2,4,7,1270,0,1956,0,98056,47.4831,-122.191,1800,7400,320000,24,12,2014,0,58,6130,5600,0,0,0
6,1.0,2330,5000,1.5,0,0,4,7,2330,0,1920,0,98117,47.6789,-122.397,1570,5000,950000,5,9,2014,0,94,2670,3430,0,0,1
3,1.0,960,8100,1.0,0,0,3,7,960,0,1955,0,98155,47.7766,-122.307,1120,8100,255000,27,5,2014,0,59,7140,6980,0,0,1
4,2.5,1990,6671,2.0,0,0,3,7,1990,0,1989,0,98023,47.3078,-122.358,1862,6566,260000,20,5,2014,0,25,4681,4704,0,0,0
3,1.0,1450,7930,1.0,0,0,4,6,1150,300,1923,0,98126,47.5212,-122.371,1040,7740,394000,12,3,2015,0,92,6480,6700,0,1,1
4,2.25,1830,7200,2.0,0,2,3,8,1750,80,1923,0,98112,47.6315,-122.282,3100,7200,1250000,19,3,2015,0,92,5370,4100,0,1,1
3,2.25,1650,7800,1.0,0,0,3,7,1260,390,1969,0,98011,47.7377,-122.197,1760,8268,385000,4,8,2014,0,45,6150,6508,0,1,0
4,2.5,1710,5000,1.0,0,0,3,8,1110,600,1979,0,98115,47.6772,-122.285,1750,5304,637000,6,5,2015,0,36,3290,3554,0,1,1
5,1.5,1420,9900,1.0,0,0,3,7,1050,370,1964,0,98008,47.6348,-122.118,1580,8075,485000,10,11,2014,0,50,8480,6495,0,1,0
3,1.75,1440,8040,1.0,0,0,3,7,960,480,1951,0,98125,47.7128,-122.306,1500,8040,315275,12,5,2014,0,63,6600,6540,0,1,1
2,1.5,1280,8710,1.0,0,0,3,7,1280,0,1967,0,98058,47.4472,-122.16,1520,9375,252500,23,9,2014,0,47,7430,7855,0,0,0
4,2.5,2560,12760,1.0,0,0,4,7,1760,800,1949,0,98115,47.6947,-122.303,1760,6384,790000,12,11,2014,0,65,10200,4624,0,1,1
3,1.0,1480,7830,1.0,0,0,3,7,1480,0,1952,0,98133,47.7703,-122.336,1450,7830,310000,14,5,2014,0,62,6350,6380,0,0,1
2,1.0,1160,5038,1.0,0,0,5,7,740,420,1942,0,98126,47.5304,-122.38,1160,5076,425000,28,1,2015,0,73,3878,3916,0,1,1
3,2.5,2110,4099,2.0,0,0,3,8,2110,0,2001,0,98072,47.7508,-122.17,2110,4871,548000,3,6,2014,0,13,1989,2761,0,0,0
3,2.5,1950,9906,2.0,0,0,3,8,1950,0,1988,0,98074,47.6363,-122.025,1860,7689,530000,30,5,2014,0,26,7956,5829,0,0,0
3,1.0,1270,4000,1.5,0,2,3,7,1270,0,1928,0,98126,47.5695,-122.376,1560,4000,435000,27,5,2014,0,86,2730,2440,0,0,1
3,2.25,1790,10209,1.0,0,0,3,7,1290,500,1967,0,98072,47.7492,-122.086,1840,9900,425000,20,6,2014,0,47,8419,8060,0,1,0
3,2.5,1930,7266,2.0,0,0,3,8,1930,0,2005,0,98125,47.7191,-122.309,1930,7266,490000,15,7,2014,0,9,5336,5336,0,0,1
4,1.0,1200,6000,1.5,0,0,3,6,1200,0,1923,0,98106,47.5307,-122.352,950,4000,220000,3,7,2014,0,91,4800,3050,0,0,1
4,2.5,2050,3784,2.0,0,0,3,8,2050,0,2001,0,98034,47.7189,-122.181,2050,3366,540000,7,1,2015,0,14,1734,1316,0,0,0
3,1.0,1710,6195,1.0,0,0,3,7,1410,300,1946,0,98105,47.6706,-122.265,1610,6195,670000,22,12,2014,0,68,4485,4585,0,1,1
3,3.5,1700,2197,2.0,0,0,3,8,1260,440,2010,0,98116,47.5767,-122.41,1360,1418,585000,16,9,2014,0,4,497,58,0,1,1
3,1.5,1390,12500,1.0,0,0,4,6,1390,0,1976,0,98014,47.6496,-121.908,1390,9000,225000,18,11,2014,0,38,11110,7610,0,0,0
3,1.0,1230,9877,1.0,0,0,3,7,1230,0,1954,0,98006,47.5745,-122.136,1240,9965,375000,19,8,2014,0,60,8647,8725,0,0,0
3,2.0,1490,8847,1.0,0,0,4,7,1490,0,1967,0,98177,47.7639,-122.363,1640,7572,335000,24,11,2014,0,47,7357,5932,0,0,1
5,3.25,2440,15815,2.0,0,0,3,8,1990,450,2014,0,98155,47.774,-122.28,2500,14201,680000,11,3,2015,0,1,13375,11701,0,1,1
3,1.0,970,4800,1.0,0,0,3,6,970,0,1950,0,98112,47.6212,-122.298,1500,2042,600000,23,1,2015,0,65,3830,542,0,0,1
4,2.0,1700,8043,1.0,0,0,3,7,850,850,1954,0,98168,47.4758,-122.288,1540,13260,161000,5,8,2014,0,60,6343,11720,0,1,1
4,2.0,1700,8043,1.0,0,0,3,7,850,850,1954,0,98168,47.4758,-122.288,1540,13260,220000,14,1,2015,0,61,6343,11720,0,1,1
3,1.75,1720,5000,1.5,0,0,3,8,1720,0,1932,2009,98019,47.738,-121.983,1410,8300,420000,4,12,2014,77,82,3280,6890,1,0,0
3,1.0,1400,2250,1.5,0,0,3,7,1400,0,1909,0,98119,47.6373,-122.358,1630,3600,710000,27,3,2015,0,106,850,1970,0,0,1
4,2.5,2570,7221,1.0,0,0,4,8,1570,1000,1958,0,98117,47.6921,-122.387,2440,7274,626000,22,1,2015,0,57,4651,4834,0,1,1
3,1.5,1200,8040,1.0,0,0,4,7,1200,0,1959,0,98146,47.4901,-122.341,1450,9315,279500,22,7,2014,0,55,6840,7865,0,0,1
4,3.5,4390,11600,2.0,0,3,3,11,3060,1330,1990,0,98040,47.5862,-122.246,3240,12000,1610000,23,5,2014,0,24,7210,8760,0,1,0
2,1.0,1080,5000,1.0,0,0,3,7,1080,0,1954,0,98106,47.5682,-122.359,1010,5000,325000,1,8,2014,0,60,3920,3990,0,0,1
4,2.25,1860,7980,1.0,0,0,4,8,1860,0,1966,0,98058,47.4524,-122.15,1860,8814,380000,17,7,2014,0,48,6120,6954,0,0,0
4,2.75,2150,9820,1.0,0,0,4,8,1220,930,1979,0,98011,47.7758,-122.2,2060,9830,470000,26,8,2014,0,35,7670,7770,0,1,0
4,3.0,2250,12142,2.0,0,0,3,8,2250,0,1986,0,98058,47.4338,-122.16,2300,9003,363000,5,12,2014,0,28,9892,6703,0,0,0
4,2.25,2050,7700,2.0,0,0,3,7,2050,0,1977,0,98023,47.3009,-122.375,1780,7700,245000,19,2,2015,0,38,5650,5920,0,0,0
3,1.0,1010,3520,1.0,0,0,3,7,1010,0,1902,0,98102,47.6208,-122.319,1300,1233,525000,26,2,2015,0,113,2510,-67,0,0,1
4,2.25,1900,5000,1.0,0,0,3,7,1400,500,1963,0,98199,47.6456,-122.387,1710,4994,658500,4,5,2015,0,52,3100,3284,0,1,1
2,1.0,1020,8442,1.0,0,4,4,7,920,100,1941,0,98136,47.5145,-122.391,2550,10323,680000,24,4,2015,0,74,7422,7773,0,1,1
4,2.5,1990,2175,2.0,0,0,3,8,1680,310,2005,0,98107,47.6696,-122.371,1560,2087,595000,6,6,2014,0,9,185,527,0,1,1
4,2.5,3190,4980,2.0,0,0,3,9,3190,0,2005,0,98038,47.3657,-122.034,2830,6720,419000,16,4,2015,0,10,1790,3890,0,0,0
2,1.0,1210,18700,1.0,0,0,4,7,1210,0,1940,0,98042,47.3752,-122.166,2250,10048,198900,15,9,2014,0,74,17490,7798,0,0,0
4,1.75,2440,8100,1.0,0,0,4,9,1620,820,1960,0,98177,47.7201,-122.361,2030,8100,575000,11,7,2014,0,54,5660,6070,0,1,1
2,1.5,1230,1516,3.0,0,0,3,8,1230,0,2000,0,98125,47.7265,-122.314,1352,1411,324950,2,4,2015,0,15,286,59,0,0,1
3,2.5,2740,7980,2.0,0,0,4,7,2740,0,1964,0,98168,47.473,-122.3,1470,8611,259000,26,2,2015,0,51,5240,7141,0,0,1
2,2.0,2260,9604,1.0,0,0,3,9,2260,0,1990,0,98011,47.7718,-122.208,2260,10747,551000,16,5,2014,0,24,7344,8487,0,0,0
2,1.5,1000,5125,1.0,0,0,3,7,1000,0,1942,1968,98103,47.6926,-122.347,1090,5100,488000,8,8,2014,26,72,4125,4010,1,0,1
3,2.5,2300,8938,2.0,0,0,3,9,2300,0,1989,0,98031,47.4181,-122.211,2570,9694,395000,11,3,2015,0,26,6638,7124,0,0,0
3,1.0,1440,8287,1.5,0,0,4,7,1440,0,1928,0,98155,47.7438,-122.315,1330,8285,370000,18,8,2014,0,86,6847,6955,0,0,1
4,3.0,2780,5000,1.5,0,0,5,7,1710,1070,1919,0,98116,47.5721,-122.381,1150,5000,675000,24,10,2014,0,95,2220,3850,0,1,1
3,1.0,1200,6825,1.0,0,0,3,7,1200,0,1954,2013,98133,47.7491,-122.353,1470,8100,402000,2,4,2015,59,61,5625,6630,1,0,1
5,2.0,1510,3000,2.0,0,0,3,6,1510,0,1983,0,98122,47.6029,-122.304,1610,3600,455000,25,2,2015,0,32,1490,1990,0,0,1
3,2.5,1780,6527,2.0,0,0,3,8,1780,0,1989,0,98092,47.2578,-122.217,2040,8840,265000,22,7,2014,0,25,4747,6800,0,0,0
5,2.75,2920,9163,1.0,0,0,4,8,1520,1400,1976,0,98006,47.5668,-122.169,2250,9163,713500,1,12,2014,0,38,6243,6913,0,1,0
3,1.0,1550,12670,1.0,0,0,4,7,1550,0,1962,0,98056,47.5024,-122.169,1550,8880,240000,6,1,2015,0,53,11120,7330,0,0,0
2,1.0,940,3864,1.0,0,0,4,8,940,0,1918,0,98103,47.6631,-122.345,1440,3956,543000,12,12,2014,0,96,2924,2516,0,0,1
3,2.25,2160,7500,2.0,0,0,3,10,2160,0,1982,0,98112,47.6232,-122.299,1550,3839,1010000,8,10,2014,0,32,5340,2289,0,0,1
4,2.5,2800,6567,2.0,0,0,3,9,2800,0,2006,0,98038,47.3555,-122.002,3400,5900,459950,25,9,2014,0,8,3767,2500,0,0,0
4,2.0,1460,7254,1.0,0,0,3,6,1460,0,1959,0,98178,47.5056,-122.254,1460,7236,150000,31,10,2014,0,55,5794,5776,0,0,1
3,1.5,1820,5756,1.5,0,0,3,7,1640,180,1946,0,98119,47.6479,-122.367,1760,6169,683500,24,6,2014,0,68,3936,4409,0,1,1
3,2.5,1520,2208,2.0,0,0,3,8,1040,480,2007,0,98119,47.6419,-122.374,1610,1618,499950,4,6,2014,0,7,688,8,0,1,1
2,1.0,1320,9967,1.0,0,0,3,6,940,380,1919,0,98108,47.5693,-122.296,1970,7587,255000,30,6,2014,0,95,8647,5617,0,1,1
3,2.5,1920,7779,2.0,0,0,3,7,1920,0,1989,0,98031,47.4024,-122.171,1960,7536,279000,26,3,2015,0,26,5859,5576,0,0,0
5,3.0,2640,5096,2.0,0,0,3,10,2640,0,2009,0,98115,47.6809,-122.288,1610,5217,910000,1,12,2014,0,5,2456,3607,0,0,1
4,2.5,2650,7945,2.0,0,0,3,9,2650,0,2006,0,98125,47.7113,-122.296,1200,7920,699000,20,5,2014,0,8,5295,6720,0,0,1
4,3.25,3640,13530,1.0,0,0,3,9,2570,1070,1924,2000,98039,47.6293,-122.238,2760,15000,1650000,8,4,2015,76,91,9890,12240,1,1,0
3,1.0,1420,8800,1.0,0,0,4,6,1090,330,1981,0,98030,47.3746,-122.181,1480,8000,248000,25,3,2015,0,34,7380,6520,0,1,0
2,1.0,730,5040,1.0,0,0,3,6,730,0,1927,0,98126,47.5387,-122.374,790,5040,316000,31,7,2014,0,87,4310,4250,0,0,1
2,1.0,2020,7540,1.0,0,0,3,7,1010,1010,1921,0,98118,47.5359,-122.28,1270,4652,410000,10,3,2015,0,94,5520,3382,0,1,1
2,1.0,1240,6400,1.0,0,1,4,7,1060,180,1938,0,98126,47.5493,-122.377,1240,6400,559000,18,6,2014,0,76,5160,5160,0,1,1
3,2.5,1640,3804,2.0,0,0,3,8,1640,0,1998,0,98122,47.6103,-122.3,1440,3230,602000,14,7,2014,0,16,2164,1790,0,0,1
4,2.0,1640,5000,2.0,0,0,3,7,1640,0,1907,1983,98107,47.6662,-122.365,1240,5000,492000,22,5,2014,76,107,3360,3760,1,0,1
3,2.5,1610,5024,2.0,0,0,3,7,1610,0,2004,0,98038,47.3833,-122.043,1790,3717,293500,27,3,2015,0,11,3414,1927,0,0,0
3,2.75,2290,14810,1.0,0,0,5,7,1400,890,1967,0,98056,47.5343,-122.185,2540,8640,481000,22,7,2014,0,47,12520,6100,0,1,0
4,2.25,2130,8078,1.0,0,0,4,7,1380,750,1977,0,98055,47.4482,-122.209,2300,8112,311100,9,5,2014,0,37,5948,5812,0,1,0
3,1.75,2140,13598,1.5,0,0,4,7,1620,520,1970,0,98014,47.7139,-121.321,930,10150,375000,17,4,2015,0,45,11458,9220,0,1,0
5,2.5,2030,8400,1.0,0,0,3,7,1330,700,1968,0,98052,47.6713,-122.152,1920,8400,500000,28,4,2015,0,47,6370,6480,0,1,0
3,1.0,1380,6250,1.0,0,0,4,7,1380,0,1918,0,98136,47.5514,-122.385,2270,6250,553000,1,4,2015,0,97,4870,3980,0,0,1
3,2.0,1780,1750,1.0,0,2,3,8,1400,380,1927,2014,98103,47.6797,-122.357,1780,3750,760000,6,12,2014,87,87,-30,1970,1,1,1
4,1.5,1440,3200,1.0,0,1,4,7,960,480,1960,0,98136,47.5269,-122.383,1650,6400,589500,9,5,2015,0,55,1760,4750,0,1,1
4,3.0,4190,8805,2.5,0,2,5,9,3490,700,1928,0,98112,47.6181,-122.284,3780,8558,2550000,1,8,2014,0,86,4615,4778,0,1,1
3,2.5,1850,7875,1.0,0,0,3,7,1250,600,1968,0,98058,47.434,-122.171,1930,8062,260000,1,12,2014,0,46,6025,6132,0,1,0
3,2.25,1550,1469,3.0,0,0,3,8,1550,0,2004,0,98103,47.6911,-122.341,1520,1465,430000,16,7,2014,0,10,-81,-55,0,0,1
3,2.5,1920,1896,3.0,0,3,3,8,1920,0,2000,0,98103,47.6616,-122.356,1670,2994,781000,4,3,2015,0,15,-24,1324,0,0,1
2,1.0,790,13170,1.0,0,0,3,6,790,0,1947,0,98106,47.5487,-122.357,970,12700,280000,28,3,2015,0,68,12380,11730,0,0,1
3,1.5,1340,8856,1.0,0,0,4,7,1340,0,1959,0,98008,47.6094,-122.126,1850,8740,466200,10,2,2015,0,56,7516,6890,0,0,0
3,1.75,1620,3975,1.0,0,0,5,7,940,680,1926,0,98117,47.6786,-122.368,1320,3922,641000,23,5,2014,0,88,2355,2602,0,1,1
3,1.0,1680,8010,1.0,0,0,3,7,840,840,1951,0,98117,47.6993,-122.376,1890,8778,350000,24,3,2015,0,64,6330,6888,0,1,1
3,2.0,1610,4364,2.0,0,0,3,8,1610,0,1996,0,98029,47.5672,-122.004,2010,4364,450000,4,2,2015,0,19,2754,2354,0,0,0
4,3.5,4460,16953,1.0,0,0,3,9,2550,1910,1962,1994,98039,47.6338,-122.232,1980,13370,1800000,20,5,2014,32,52,12493,11390,1,1,0
3,1.5,1200,1848,2.0,0,0,3,8,1200,0,1966,0,98055,47.4658,-122.191,1270,1848,185000,9,3,2015,0,49,648,578,0,0,0
2,1.0,1250,12507,1.0,0,0,5,7,1250,0,1958,0,98056,47.4972,-122.176,1250,12498,290000,23,1,2015,0,57,11257,11248,0,0,0
3,2.5,3630,9475,2.0,0,0,3,11,3630,0,1999,0,98074,47.6544,-122.085,3250,11605,964000,30,4,2015,0,16,5845,8355,0,0,0
3,2.25,1760,10350,1.0,0,0,4,7,1330,430,1979,0,98033,47.6605,-122.188,2210,11337,609950,12,3,2015,0,36,8590,9127,0,1,0
4,2.0,1820,7626,1.0,0,0,5,7,990,830,1941,0,98103,47.6878,-122.342,1390,5904,605000,4,8,2014,0,73,5806,4514,0,1,1
4,2.5,2120,9163,1.0,0,0,4,8,1450,670,1961,0,98006,47.5551,-122.172,2120,9166,550000,8,9,2014,0,53,7043,7046,0,1,0
4,2.75,2730,4268,2.0,0,1,3,9,2730,0,2009,0,98199,47.6397,-122.395,2340,5000,905000,20,1,2015,0,6,1538,2660,0,0,1
3,2.5,2430,7613,2.0,0,0,4,8,2430,0,1986,0,98058,47.4383,-122.135,2440,8342,384200,23,10,2014,0,28,5183,5902,0,0,0
3,1.0,1170,1105,1.0,0,0,3,7,1170,0,1965,0,98126,47.5448,-122.375,1380,1399,370000,11,7,2014,0,49,-65,19,0,0,1
3,1.0,2090,4000,1.5,0,2,3,8,1890,200,1931,0,98199,47.6393,-122.392,2090,4000,717500,4,12,2014,0,83,1910,1910,0,1,1
4,3.25,3910,7500,2.0,0,2,4,11,2550,1360,1933,0,98199,47.6448,-122.409,3070,7500,2000000,1,5,2015,0,82,3590,4430,0,1,1
2,1.5,1460,5700,1.5,0,0,3,7,1460,0,1912,0,98115,47.6838,-122.312,1780,3800,580000,28,1,2015,0,103,4240,2020,0,0,1
4,1.5,2700,14760,1.5,0,0,5,9,2700,0,1940,0,98022,47.1996,-122.003,1670,7200,415000,7,11,2014,0,74,12060,5530,0,0,0
2,1.0,670,6300,1.0,0,0,4,6,670,0,1942,0,98126,47.5145,-122.374,740,6300,272000,13,1,2015,0,73,5630,5560,0,0,1
3,1.75,1880,6360,1.0,0,0,4,7,1040,840,1945,0,98115,47.6878,-122.286,1770,6175,600000,5,5,2014,0,69,4480,4405,0,1,1
4,3.0,1980,5352,2.5,0,0,3,8,1980,0,1941,2005,98136,47.532,-122.385,1680,5352,744000,15,5,2014,64,73,3372,3672,1,0,1
3,3.0,2080,10521,1.5,0,0,3,9,2080,0,2004,0,98034,47.6987,-122.228,3730,11840,830000,3,6,2014,0,10,8441,8110,0,0,0
3,3.25,1380,1225,3.0,0,0,3,7,1380,0,2000,0,98133,47.7035,-122.351,1380,1704,322000,29,10,2014,0,14,-155,324,0,0,1
3,1.0,1350,7973,1.5,0,0,3,7,1350,0,1954,0,98188,47.4323,-122.292,1310,7491,272450,6,3,2015,0,61,6623,6181,0,0,1
3,3.0,1760,2114,2.0,0,0,3,7,1400,360,2008,0,98107,47.6666,-122.37,1300,1500,605000,8,4,2015,0,7,354,200,0,1,1
3,1.75,1950,8325,1.0,0,0,4,7,1950,0,1962,0,98011,47.7685,-122.2,1950,8325,510000,11,5,2015,0,53,6375,6375,0,0,0
4,3.5,3170,4000,2.0,0,0,3,10,2340,830,1999,0,98112,47.6265,-122.298,1770,4000,1130000,23,4,2015,0,16,830,2230,0,1,1
4,2.5,3000,7500,2.0,0,0,3,9,3000,0,1937,1994,98105,47.6571,-122.277,2580,5000,1690000,12,6,2014,57,77,4500,2420,1,0,1
3,1.75,1350,5850,1.0,0,0,4,7,1050,300,1973,0,98198,47.4225,-122.328,1710,7757,337500,6,5,2015,0,42,4500,6047,0,1,1
3,2.25,1470,7857,1.0,0,0,4,7,1180,290,1973,0,98055,47.4547,-122.209,1900,7600,312000,31,3,2015,0,42,6387,5700,0,1,0
4,1.0,1360,8136,1.0,0,0,3,7,1360,0,1948,0,98133,47.7366,-122.333,1570,8132,328000,25,9,2014,0,66,6776,6562,0,0,1
3,1.0,1020,7538,1.0,0,0,3,7,1020,0,1981,0,98032,47.3587,-122.288,1650,7201,241000,13,2,2015,0,34,6518,5551,0,0,0
3,2.25,1840,6750,1.0,0,0,4,7,1270,570,1980,0,98031,47.4075,-122.172,1750,7004,265000,31,7,2014,0,34,4910,5254,0,1,0
5,1.75,2030,10200,1.0,0,0,4,7,2030,0,1958,0,98002,47.2867,-122.209,1760,11550,246000,27,3,2015,0,57,8170,9790,0,0,0
4,1.75,1490,9112,1.0,0,0,3,6,970,520,1940,0,98146,47.4991,-122.345,1650,8411,271000,30,9,2014,0,74,7622,6761,0,1,1
2,1.0,2060,8398,1.0,0,0,3,7,1260,800,1962,0,98168,47.509,-122.324,1690,13495,270000,25,6,2014,0,52,6338,11805,0,1,1
4,2.0,2240,7085,1.5,0,0,3,7,2240,0,1944,1992,98125,47.7309,-122.305,1440,7085,395000,17,11,2014,48,70,4845,5645,1,0,1
3,2.0,1460,5715,1.0,0,0,3,7,1460,0,1957,2014,98118,47.54,-122.276,1400,5715,340000,31,7,2014,57,57,4255,4315,1,0,1
3,1.75,2140,13260,1.0,0,0,3,7,1240,900,1948,0,98146,47.5074,-122.353,1640,13260,340000,16,10,2014,0,66,11120,11620,0,1,1
2,2.25,1420,1246,2.0,0,0,3,8,1420,0,2007,0,98106,47.5394,-122.368,1420,1826,335000,6,3,2015,0,8,-174,406,0,0,1
2,1.0,1060,3036,1.5,0,0,4,6,1060,0,1943,0,98105,47.6578,-122.324,1730,5535,435000,25,6,2014,0,71,1976,3805,0,0,1
4,1.75,1760,3600,1.0,0,0,5,7,880,880,1926,0,98103,47.6889,-122.33,1500,5580,527950,9,10,2014,0,88,1840,4080,0,1,1
3,1.75,1770,3880,1.0,0,0,3,8,1300,470,1963,0,98117,47.6846,-122.392,1430,3880,667000,16,7,2014,0,51,2110,2450,0,1,1
10,5.25,4590,10920,1.0,0,2,3,9,2500,2090,2008,0,98004,47.5861,-122.113,2730,10400,1150000,14,8,2014,0,6,6330,7670,0,1,0
3,2.5,2040,11211,2.0,0,0,3,8,2040,0,2000,0,98055,47.4867,-122.223,1830,11964,417000,8,4,2015,0,15,9171,10134,0,0,0
4,1.75,1260,7250,1.0,0,0,3,6,1260,0,1943,0,98027,47.5267,-122.032,1880,7250,451000,10,3,2015,0,72,5990,5370,0,0,0
2,1.0,1650,9780,1.0,0,0,3,7,950,700,1943,0,98199,47.6549,-122.394,1650,5458,580000,18,2,2015,0,72,8130,3808,0,1,1
5,3.25,2750,7500,2.0,0,1,3,7,2150,600,1937,1997,98033,47.6636,-122.203,2750,7500,750000,10,6,2014,60,77,4750,4750,1,1,0
3,2.5,2810,7700,2.0,0,0,3,9,2810,0,2001,0,98006,47.5464,-122.191,2910,8250,685000,27,5,2014,0,13,4890,5340,0,0,0
3,2.0,1340,9764,1.0,0,0,3,7,1340,0,1944,0,98052,47.6786,-122.161,1310,9764,275000,26,12,2014,0,70,8424,8454,0,0,0
2,2.5,2160,5581,1.0,0,0,3,8,2160,0,2002,0,98053,47.7017,-122.023,2315,5652,715000,27,5,2014,0,12,3421,3337,0,0,0
4,2.0,2450,4400,1.0,0,0,3,7,1450,1000,1913,1980,98102,47.6414,-122.327,1890,1386,800000,25,3,2015,67,102,1950,-504,1,1,1
3,1.5,1870,9000,1.0,0,0,3,7,1120,750,1923,0,98108,47.5224,-122.318,1850,6000,350000,24,11,2014,0,91,7130,4150,0,1,1
3,2.5,2240,7791,2.0,0,0,3,7,2240,0,2002,0,98065,47.5361,-121.88,2480,5018,452500,9,10,2014,0,12,5551,2538,0,0,0
4,2.5,2200,5893,2.0,0,0,3,7,2200,0,2008,0,98042,47.3333,-122.055,2200,5757,280000,16,3,2015,0,7,3693,3557,0,0,0
1,1.0,790,12000,1.0,0,0,3,6,790,0,1918,0,98118,47.5146,-122.265,1900,6000,248000,23,10,2014,0,96,11210,4100,0,0,1
2,1.0,890,7200,1.0,0,0,3,7,740,150,1949,0,98115,47.6998,-122.278,1290,7200,305000,17,4,2015,0,66,6310,5910,0,1,1
3,1.0,1270,4000,1.0,0,0,3,7,1120,150,1954,0,98106,47.5293,-122.354,1220,4600,435010,12,3,2015,0,61,2730,3380,0,1,1
3,1.75,1850,2860,1.5,0,0,5,8,1210,640,1931,0,98116,47.5853,-122.39,1660,3120,678100,18,7,2014,0,83,1010,1460,0,1,1
3,2.25,1352,1694,3.0,0,0,3,8,1352,0,2007,0,98125,47.7265,-122.315,1439,1387,325000,9,5,2014,0,7,342,-52,0,0,1
3,2.0,1540,8400,1.0,0,0,3,7,1180,360,1968,0,98052,47.6554,-122.129,1550,8760,529950,14,7,2014,0,46,6860,7210,0,1,0
3,1.75,1640,8529,1.0,0,0,5,7,1640,0,1951,0,98155,47.7751,-122.32,1730,7769,440000,23,12,2014,0,63,6889,6039,0,0,1
3,1.0,1350,4800,1.5,0,0,3,7,1350,0,1928,0,98116,47.5749,-122.412,1360,4800,585000,16,3,2015,0,87,3450,3440,0,0,1
3,2.5,2010,2778,2.0,0,0,3,8,1390,620,2014,0,98029,47.5528,-121.999,1540,1689,462608,20,8,2014,0,0,768,149,0,1,0
3,1.75,2080,5200,1.0,0,0,3,7,1040,1040,1974,0,98166,47.4738,-122.35,1410,6550,350500,7,4,2015,0,41,3120,5140,0,1,1
3,1.0,1040,8125,1.0,0,0,3,7,1040,0,1956,0,98003,47.3171,-122.316,1200,9375,210000,10,11,2014,0,58,7085,8175,0,0,0
3,2.5,1890,5929,2.0,0,0,3,8,1890,0,1993,0,98029,47.5697,-121.994,2060,5775,510000,6,2,2015,0,22,4039,3715,0,0,0
3,2.25,1810,7630,1.0,0,0,4,7,1810,0,1959,0,98056,47.497,-122.18,1830,7594,280000,6,5,2015,0,56,5820,5764,0,0,0
3,1.75,1930,14389,1.0,0,0,3,7,1130,800,1963,1998,98155,47.7733,-122.317,1730,14378,385000,3,3,2015,35,52,12459,12648,1,1,1
3,1.0,1010,8184,1.0,0,0,4,6,1010,0,1947,0,98155,47.7416,-122.319,1010,8184,349000,25,6,2014,0,67,7174,7174,0,0,1
3,2.25,1740,10836,1.0,0,0,3,7,910,830,1981,0,98031,47.3976,-122.166,2090,7500,252000,26,8,2014,0,33,9096,5410,0,1,0
4,2.5,2910,8881,2.0,0,1,3,10,1940,970,1932,0,98199,47.6424,-122.411,2540,5250,1100000,30,10,2014,0,82,5971,2710,0,1,1
3,2.25,1330,8004,2.0,0,0,3,7,1330,0,1985,0,98034,47.7098,-122.217,1300,7971,375000,11,12,2014,0,29,6674,6671,0,0,0
4,2.25,2210,11700,2.0,0,0,4,8,2210,0,1967,0,98032,47.3648,-122.284,2040,9000,336000,14,7,2014,0,47,9490,6960,0,0,0
3,3.75,2670,6517,2.5,0,4,4,8,2020,650,1977,0,98126,47.5702,-122.38,2010,6073,732000,2,7,2014,0,37,3847,4063,0,1,1
2,1.0,1000,6227,1.0,0,0,3,6,1000,0,1949,0,98168,47.513,-122.333,1240,6250,200000,6,8,2014,0,65,5227,5010,0,0,1
4,2.5,3150,7277,2.0,0,0,3,9,3150,0,2006,0,98056,47.5159,-122.202,3030,8643,681716,28,5,2014,0,8,4127,5613,0,0,0
3,1.75,1520,12246,1.0,0,0,4,6,1520,0,1971,0,98010,47.3434,-122.049,1460,12246,235000,25,2,2015,0,44,10726,10786,0,0,0
3,1.0,1690,13825,1.0,0,0,3,7,1210,480,1955,0,98148,47.4256,-122.322,1190,9450,257500,9,10,2014,0,59,12135,8260,0,1,1
3,1.0,1070,9497,1.0,0,0,3,7,1070,0,1955,0,98028,47.7425,-122.23,1710,9561,315000,29,9,2014,0,59,8427,7851,0,0,0
3,1.0,910,8000,1.0,0,0,4,6,740,170,1950,0,98177,47.7746,-122.378,2090,9007,299950,20,5,2014,0,64,7090,6917,0,1,1
4,2.25,2130,8640,1.0,0,0,3,7,1430,700,1969,0,98034,47.7087,-122.198,2120,8826,530000,11,7,2014,0,45,6510,6706,0,1,0
2,1.75,2230,6930,1.0,0,0,4,8,1530,700,1947,0,98105,47.6705,-122.277,1970,6930,766500,15,9,2014,0,67,4700,4960,0,1,1
4,2.5,3560,11119,1.0,0,2,3,10,2290,1270,1986,0,98004,47.6456,-122.19,3290,11385,860000,13,5,2014,0,28,7559,8095,0,1,0
3,2.5,2590,4961,2.0,0,0,3,9,2590,0,1944,2007,98126,47.5271,-122.381,1230,4961,690000,31,1,2015,63,71,2371,3731,1,0,1
4,1.75,2040,6348,1.0,0,0,3,7,1020,1020,1962,0,98103,47.6964,-122.336,1770,5047,551000,18,3,2015,0,53,4308,3277,0,1,1
3,1.0,1340,7260,1.5,0,0,3,7,1340,0,1953,0,98125,47.7016,-122.295,1830,6822,568000,20,4,2015,0,62,5920,4992,0,0,1
3,2.5,2770,10773,2.0,0,2,3,9,2770,0,1992,0,98008,47.5754,-122.12,2530,10423,749950,20,5,2014,0,22,8003,7893,0,0,0
3,2.5,2400,12546,1.0,0,0,3,9,2400,0,1983,0,98074,47.6317,-122.041,2940,12150,535000,6,10,2014,0,31,10146,9210,0,0,0
3,1.0,1140,9779,1.0,0,0,3,7,1140,0,1963,0,98055,47.424,-122.201,1520,9814,234300,9,4,2015,0,52,8639,8294,0,0,0
2,1.0,930,11450,1.0,0,0,3,6,930,0,1946,0,98178,47.4862,-122.264,1150,11450,190000,21,8,2014,0,68,10520,10300,0,0,1
4,1.75,1820,6600,1.0,0,0,5,7,1820,0,1960,0,98007,47.606,-122.135,1430,8800,525000,10,10,2014,0,54,4780,7370,0,0,0
4,1.0,1390,3708,1.5,0,0,4,7,1390,0,1926,0,98117,47.685,-122.363,1430,3708,610000,6,11,2014,0,88,2318,2278,0,0,1
3,2.5,1480,1165,3.0,0,0,3,8,1480,0,2006,0,98144,47.6199,-122.3,1480,1231,520000,3,10,2014,0,8,-315,-249,0,0,1
2,1.0,760,6000,1.0,0,0,3,6,760,0,1942,0,98199,47.646,-122.384,1360,6000,375000,22,4,2015,0,73,5240,4640,0,0,1
3,1.75,1580,7416,1.0,0,0,3,7,1150,430,1967,0,98005,47.6056,-122.173,1730,7416,600000,28,5,2014,0,47,5836,5686,0,1,0
4,2.5,1870,16200,1.0,0,0,5,8,1250,620,1974,0,98033,47.6651,-122.174,2000,11250,664000,23,10,2014,0,40,14330,9250,0,1,0
2,1.0,1510,4080,1.0,0,0,3,7,1010,500,1923,0,98103,47.6742,-122.329,1660,4080,698000,4,5,2015,0,92,2570,2420,0,1,1
3,2.0,1250,1306,3.0,0,0,3,7,1250,0,2001,0,98107,47.6705,-122.39,1320,1250,418000,27,8,2014,0,13,56,-70,0,0,1
3,1.0,1540,9028,1.0,0,0,4,6,1540,0,1968,0,98033,47.6698,-122.177,1450,9028,450000,7,5,2015,0,47,7488,7578,0,0,0
6,3.0,2020,4129,1.0,0,0,3,7,1230,790,1994,0,98105,47.6648,-122.324,2080,4080,599950,15,1,2015,0,21,2109,2000,0,1,1
4,2.75,2820,5000,1.5,0,0,3,8,2170,650,1927,0,98199,47.6376,-122.394,1740,5000,810000,22,1,2015,0,88,2180,3260,0,1,1
3,1.75,1660,10000,1.0,0,0,3,7,1660,0,1972,0,98019,47.741,-121.978,1770,10000,331292,29,7,2014,0,42,8340,8230,0,0,0
3,1.75,1830,2417,1.0,0,0,3,7,930,900,1919,0,98144,47.5723,-122.309,1320,3200,348000,6,4,2015,0,96,587,1880,0,1,1
2,1.0,720,5600,1.0,0,0,4,7,720,0,1920,0,98116,47.5641,-122.391,1330,5600,435000,19,9,2014,0,94,4880,4270,0,0,1
3,2.5,2160,9063,2.0,0,0,3,8,2160,0,1992,0,98133,47.7296,-122.333,2160,9063,530000,19,2,2015,0,23,6903,6903,0,0,1
3,1.75,1510,9837,2.0,0,0,3,7,1510,0,1989,0,98001,47.2576,-122.255,1470,8054,227000,22,9,2014,0,25,8327,6584,0,0,0
3,1.0,990,9145,1.5,0,0,4,6,990,0,1939,0,98146,47.5022,-122.36,1640,8320,246000,11,3,2015,0,76,8155,6680,0,0,1
3,1.0,1910,8710,1.0,0,0,3,7,1080,830,1954,0,98168,47.5038,-122.3,1460,8944,260000,17,2,2015,0,61,6800,7484,0,1,1
3,2.0,1350,10200,1.0,0,0,3,7,1350,0,1977,0,98074,47.6159,-122.05,1820,9600,366000,11,8,2014,0,37,8850,7780,0,0,0
4,3.25,2557,9480,2.0,0,2,3,7,2557,0,1948,1993,98118,47.5449,-122.262,2220,8340,594950,26,10,2014,45,66,6923,6120,1,0,1
3,2.75,2610,5000,2.0,0,0,4,7,1710,900,1946,0,98107,47.6729,-122.373,1500,5000,608000,27,3,2015,0,69,2390,3500,0,1,1
3,2.0,1720,11875,1.0,0,0,5,6,1720,0,1905,0,98056,47.5068,-122.191,1860,7500,313100,8,4,2015,0,110,10155,5640,0,0,0
3,1.75,1170,9085,1.0,0,0,3,7,1170,0,1967,0,98023,47.2808,-122.354,1230,9085,185000,3,10,2014,0,47,7915,7855,0,0,0
2,1.0,1140,11480,1.0,0,0,3,6,1140,0,1907,0,98118,47.5328,-122.274,1550,8150,455000,4,5,2015,0,108,10340,6600,0,0,1
3,2.5,2350,9051,1.0,0,0,4,8,1570,780,1966,0,98023,47.3126,-122.364,2270,8748,235000,11,7,2014,0,48,6701,6478,0,1,0
3,1.0,1020,12289,1.0,0,0,4,7,1020,0,1967,0,98058,47.4235,-122.155,1300,9894,230000,30,10,2014,0,47,11269,8594,0,0,0
4,2.25,2730,5000,1.0,0,0,5,7,1460,1270,1955,0,98116,47.5843,-122.393,2010,5000,770000,20,11,2014,0,59,2270,2990,0,1,1
4,2.25,1830,7614,2.0,0,0,3,7,1830,0,1991,0,98030,47.3682,-122.179,1860,6930,240000,2,10,2014,0,23,5784,5070,0,0,0
3,2.5,1690,3026,2.0,0,0,3,7,1690,0,2002,0,98053,47.6885,-122.043,1650,3161,461000,19,2,2015,0,13,1336,1511,0,0,0
4,2.5,2900,10500,1.0,0,3,5,8,1450,1450,1963,0,98040,47.5838,-122.246,2900,9201,1580000,27,3,2015,0,52,7600,6301,0,1,0
3,2.5,1690,4000,2.0,0,0,3,7,1690,0,2004,0,98053,47.6788,-122.034,1690,4000,452000,23,11,2014,0,10,2310,2310,0,0,0
4,2.5,2660,5043,2.0,0,2,3,9,2660,0,2003,0,98029,47.5445,-121.996,3010,5500,765000,3,10,2014,0,11,2383,2490,0,0,0
3,3.0,1530,9999,1.0,0,0,4,7,1150,380,1983,0,98033,47.6869,-122.186,1530,8556,546000,5,5,2015,0,32,8469,7026,0,1,0
3,2.5,2070,4463,1.5,0,0,5,8,1780,290,1931,0,98115,47.6853,-122.305,2070,5000,781000,22,1,2015,0,84,2393,2930,0,1,1
4,1.75,1880,7953,1.0,0,0,4,7,1880,0,1965,0,98008,47.5838,-122.123,1750,8591,538000,20,1,2015,0,50,6073,6841,0,0,0
4,2.5,2240,8664,1.0,0,0,5,8,1470,770,1975,0,98033,47.6621,-122.189,2210,8860,790000,19,8,2014,0,39,6424,6650,0,1,0
4,2.75,2540,4400,1.5,0,0,5,7,1630,910,1925,0,98103,47.6832,-122.343,1560,3920,696500,21,10,2014,0,89,1860,2360,0,1,1
3,2.0,1370,8137,1.0,0,0,4,7,1370,0,1988,0,98003,47.2802,-122.303,1660,8840,276000,30,4,2015,0,27,6767,7180,0,0,0
2,1.0,770,8612,1.0,0,0,3,6,770,0,1953,0,98155,47.7547,-122.323,1290,8407,269000,2,9,2014,0,61,7842,7117,0,0,1
2,1.0,740,6840,1.0,0,0,3,6,740,0,1942,0,98126,47.5168,-122.373,740,6840,122000,6,3,2015,0,73,6100,6100,0,0,1
3,1.5,1360,7680,1.0,0,0,3,7,1360,0,1955,0,98133,47.7441,-122.337,1630,7679,352500,21,8,2014,0,59,6320,6049,0,0,1
4,2.0,1280,7560,1.0,0,0,5,6,1280,0,1959,0,98058,47.45,-122.175,1250,7690,249000,21,10,2014,0,55,6280,6440,0,0,0
4,2.0,1920,7803,1.0,0,0,3,7,1080,840,1962,0,98155,47.758,-122.325,1940,8147,360000,8,12,2014,0,52,5883,6207,0,1,1
3,2.0,2020,10584,1.0,0,0,3,10,2020,0,1994,0,98075,47.5851,-122.028,3030,9870,629500,4,5,2015,0,21,8564,6840,0,0,0
3,1.5,1320,7695,1.0,0,0,4,7,1320,0,1959,0,98056,47.4908,-122.181,1370,8295,275000,18,7,2014,0,55,6375,6925,0,0,0
4,2.5,3160,6961,2.0,0,0,3,8,3160,0,2005,0,98074,47.6125,-122.01,3110,5058,697000,9,9,2014,0,9,3801,1948,0,0,0
4,2.5,3000,5548,2.0,0,0,3,9,3000,0,2006,0,98059,47.5399,-122.188,2870,5000,675000,13,5,2014,0,8,2548,2130,0,0,0
5,2.5,2810,6000,2.5,0,0,3,9,2810,0,1907,0,98109,47.6367,-122.35,2240,4800,1170000,29,10,2014,0,107,3190,2560,0,0,1
3,2.0,2390,6888,2.0,0,1,5,8,2390,0,1939,0,98115,47.6839,-122.274,2390,7920,1100000,20,5,2014,0,75,4498,5530,0,0,1
4,1.0,2080,3500,1.5,0,0,5,7,1260,820,1926,0,98136,47.5445,-122.383,1380,5900,520000,12,6,2014,0,88,1420,4520,0,1,1
3,1.75,2650,7500,1.5,0,0,4,7,1590,1060,1962,0,98155,47.7716,-122.317,1340,7500,415000,3,10,2014,0,52,4850,6160,0,1,1
3,2.5,1060,1536,2.0,0,0,3,8,1060,0,2000,0,98117,47.6907,-122.395,1220,1316,415000,27,6,2014,0,14,476,96,0,0,1
3,2.25,1940,8312,1.0,0,1,4,7,1220,720,1963,0,98166,47.4556,-122.346,2060,9503,450000,7,4,2015,0,52,6372,7443,0,1,1
2,1.0,1080,4080,1.0,0,0,3,8,1080,0,1948,0,98115,47.6899,-122.32,1890,4080,485000,27,4,2015,0,67,3000,2190,0,0,1
3,2.25,1700,9600,2.0,0,0,3,7,1700,0,1984,0,98042,47.39,-122.158,1930,9600,294000,27,4,2015,0,31,7900,7670,0,0,0
4,3.5,4440,10660,2.0,0,0,3,11,4440,0,2003,0,98059,47.5294,-122.137,4390,9976,1040000,9,7,2014,0,11,6220,5586,0,0,0
3,1.0,1580,4000,2.0,0,0,3,8,1580,0,1905,0,98102,47.6363,-122.32,2190,4000,690000,28,7,2014,0,109,2420,1810,0,0,1
2,2.25,1290,1137,3.0,0,0,3,8,1290,0,2007,0,98107,47.6718,-122.382,1290,1332,481000,3,9,2014,0,7,-153,42,0,0,1
4,2.75,1960,4635,1.0,0,0,4,7,1000,960,1968,0,98118,47.5693,-122.285,1830,6180,575000,19,4,2015,0,47,2675,4350,0,1,1
3,2.0,2090,5015,1.5,0,0,5,7,2090,0,1920,0,98112,47.6378,-122.301,1930,4250,785000,15,8,2014,0,94,2925,2320,0,0,1
3,2.25,2120,9297,2.0,0,0,4,8,2120,0,1981,0,98006,47.5561,-122.154,2620,10352,720000,19,8,2014,0,33,7177,7732,0,0,0
4,2.5,1880,7965,2.0,0,0,3,7,1880,0,2000,0,98038,47.3642,-122.052,1570,7584,324900,13,6,2014,0,14,6085,6014,0,0,0
2,1.0,770,5160,1.0,0,0,3,6,770,0,1943,0,98106,47.5304,-122.356,920,5160,265000,15,8,2014,0,71,4390,4240,0,0,1
3,2.5,1530,3210,1.5,0,0,5,7,1010,520,1928,0,98117,47.6913,-122.393,1330,4410,545000,1,7,2014,0,86,1680,3080,0,1,1
3,2.25,1690,7320,2.0,0,0,3,7,1690,0,1987,0,98198,47.3889,-122.316,1520,7450,292500,9,1,2015,0,28,5630,5930,0,0,1
4,1.75,1880,3720,1.5,0,0,4,7,1880,0,1924,0,98109,47.6431,-122.356,2090,4095,860000,2,7,2014,0,90,1840,2005,0,0,1
4,2.5,2140,7245,2.0,0,0,3,7,2140,0,2003,0,98133,47.729,-122.35,2080,7875,495000,12,6,2014,0,11,5105,5795,0,0,1
2,2.0,1320,1462,3.0,0,0,3,7,1320,0,1997,0,98125,47.7223,-122.29,1430,1650,342000,7,5,2015,0,18,142,220,0,0,1
4,2.5,2000,10051,2.0,0,0,3,7,2000,0,1997,0,98038,47.3625,-122.025,2000,6686,320000,25,6,2014,0,17,8051,4686,0,0,0
3,2.0,1460,2610,2.0,0,0,3,8,1460,0,1987,0,98103,47.6864,-122.345,1320,3000,444000,24,9,2014,0,27,1150,1680,0,0,1
4,2.5,3070,8086,2.0,0,0,3,10,3070,0,2005,0,98059,47.5399,-122.16,3320,10738,804100,25,6,2014,0,9,5016,7418,0,0,0
3,2.5,1660,15000,1.0,0,0,4,7,1660,0,1970,0,98075,47.5803,-122.05,2060,15015,432000,19,9,2014,0,44,13340,12955,0,0,0
6,1.5,1810,4838,1.5,0,0,4,5,1050,760,1905,0,98055,47.4874,-122.202,1300,4838,230000,30,12,2014,0,109,3028,3538,0,1,0
4,3.5,3510,11200,2.0,0,0,3,11,3510,0,2001,0,98059,47.5193,-122.15,3600,12124,935000,27,8,2014,0,13,7690,8524,0,0,0
3,3.0,2180,2650,1.5,0,0,5,8,1410,770,1930,0,98117,47.6891,-122.375,1570,4820,634950,7,8,2014,0,84,470,3250,0,1,1
6,4.0,3300,5720,1.0,0,0,3,8,1960,1340,1963,0,98115,47.676,-122.309,2030,4080,780000,12,1,2015,0,52,2420,2050,0,1,1
4,2.5,2460,4200,2.0,0,0,3,8,2460,0,1998,0,98074,47.6031,-122.021,2330,4200,611000,19,5,2014,0,16,1740,1870,0,0,0
4,1.75,1880,4175,1.5,0,0,3,7,1090,790,1944,0,98107,47.6646,-122.364,1700,3758,475999,21,11,2014,0,70,2295,2058,0,1,1
3,2.0,2290,9450,1.0,0,0,3,9,1670,620,1979,0,98008,47.5692,-122.1,2750,11700,565000,16,12,2014,0,35,7160,8950,0,1,0
4,3.25,3020,4000,1.5,0,0,5,8,1920,1100,1927,0,98112,47.6395,-122.279,2400,4000,1270000,23,12,2014,0,87,980,1600,0,1,1
3,2.0,1510,3760,1.0,0,0,5,7,930,580,1925,0,98136,47.5425,-122.39,1510,3760,520000,22,4,2015,0,90,2250,2250,0,1,1
4,2.0,2410,8712,1.0,0,0,3,7,1260,1150,1958,0,98144,47.5729,-122.302,2220,6038,446800,17,10,2014,0,56,6302,3818,0,1,1
3,1.0,1470,6122,1.0,0,0,3,8,1200,270,1948,0,98199,47.6517,-122.406,2200,6122,652000,29,1,2015,0,67,4652,3922,0,1,1
3,2.75,2890,12130,2.0,0,3,4,10,2830,60,1987,0,98033,47.6505,-122.203,2415,11538,1170000,22,5,2014,0,27,9240,9123,0,1,0
4,3.25,3490,7024,2.0,0,0,3,10,3490,0,2006,0,98075,47.5834,-121.972,3450,6866,745000,10,6,2014,0,8,3534,3416,0,0,0
3,2.25,1270,1406,2.0,0,0,3,8,1060,210,2014,0,98105,47.6647,-122.284,1160,1327,594000,25,6,2014,0,0,136,167,0,1,1
2,1.0,1000,3700,1.0,0,0,3,6,800,200,1929,0,98118,47.552,-122.29,1270,5000,257000,10,3,2015,0,86,2700,3730,0,1,1
4,1.75,1430,4096,2.0,0,0,3,7,1430,0,1900,0,98122,47.604,-122.306,1640,3377,485000,1,7,2014,0,114,2666,1737,0,0,1
3,2.0,1680,8946,1.0,0,0,3,6,940,740,1996,0,98053,47.6379,-121.966,1550,11625,381000,31,7,2014,0,18,7266,10075,0,1,0
4,2.5,2450,4080,1.5,0,0,4,8,1490,960,1930,0,98115,47.6899,-122.319,2000,4080,793000,2,4,2015,0,85,1630,2080,0,1,1
3,2.25,3650,5353,2.0,0,4,4,7,2200,1450,1947,0,98144,47.5949,-122.291,1950,4970,920000,28,7,2014,0,67,1703,3020,0,1,1
2,1.0,830,4000,1.0,0,0,4,6,830,0,1947,0,98117,47.6909,-122.381,1420,4000,455000,22,4,2015,0,68,3170,2580,0,0,1
4,2.5,3490,7494,2.0,0,3,3,11,3490,0,2000,0,98006,47.559,-122.127,3260,8437,975000,13,5,2014,0,14,4004,5177,0,0,0
2,1.5,1050,1046,2.0,0,0,3,8,960,90,2007,0,98122,47.6028,-122.309,1470,1768,375000,3,12,2014,0,7,-4,298,0,1,1
2,2.5,1170,1811,2.0,0,0,3,8,1170,0,2001,0,98122,47.6132,-122.297,1250,3146,400000,11,3,2015,0,14,641,1896,0,0,1
3,1.0,1220,7200,1.0,0,0,4,7,1220,0,1965,0,98008,47.6218,-122.116,1320,7200,447000,11,2,2015,0,50,5980,5880,0,0,0
3,1.75,1310,8600,1.0,0,0,4,7,1310,0,1987,0,98033,47.686,-122.185,2510,8515,470000,31,10,2014,0,27,7290,6005,0,0,0
4,2.5,3130,7582,2.0,0,0,3,8,3130,0,2004,0,98075,47.577,-122.055,2990,6441,665000,15,10,2014,0,10,4452,3451,0,0,0
4,2.5,1720,8638,2.0,0,0,3,8,1720,0,1994,0,98003,47.2704,-122.313,1870,7455,200000,15,1,2015,0,21,6918,5585,0,0,0
3,2.0,1520,11067,1.0,0,0,3,7,1140,380,1983,0,98074,47.6326,-122.033,1280,11371,434900,29,8,2014,0,31,9547,10091,0,1,0
4,2.25,3260,4640,2.0,0,0,5,9,2360,900,1907,0,98112,47.6272,-122.312,3240,5800,1330000,24,3,2015,0,108,1380,2560,0,1,1
4,3.25,3910,7500,2.0,0,0,3,10,3910,0,2006,0,98033,47.6527,-122.198,2600,9235,1650000,9,1,2015,0,9,3590,6635,0,0,0
4,2.5,3480,6315,2.0,0,0,3,9,2360,1120,2000,0,98052,47.6841,-122.161,3620,5233,852500,5,9,2014,0,14,2835,1613,0,1,0
4,1.75,2030,7350,1.0,0,0,3,8,2030,0,1966,0,98008,47.6274,-122.094,2000,7998,565000,13,3,2015,0,49,5320,5998,0,0,0
3,2.5,1870,1436,2.0,0,0,3,7,1870,0,2004,0,98059,47.4899,-122.166,1720,1852,289950,22,12,2014,0,10,-434,132,0,0,0
2,2.0,2640,13939,1.0,0,1,5,8,1640,1000,1963,0,98006,47.5647,-122.165,2880,14810,850000,5,11,2014,0,51,11299,11930,0,1,0
4,1.75,1940,4800,1.0,0,0,5,7,1030,910,1922,0,98122,47.6054,-122.314,1450,4800,505000,12,5,2014,0,92,2860,3350,0,1,1
3,2.5,1710,5633,2.0,0,0,3,7,1710,0,1981,0,98034,47.7232,-122.161,1540,5000,372000,28,10,2014,0,33,3923,3460,0,0,0
4,2.0,1690,7728,1.5,0,0,4,7,1690,0,1967,0,98198,47.3666,-122.318,1480,8009,207000,23,10,2014,0,47,6038,6529,0,0,1
3,1.75,2340,10495,1.0,0,0,4,8,2340,0,1967,0,98040,47.5386,-122.226,3120,11068,780000,13,5,2014,0,47,8155,7948,0,0,0
3,1.5,1850,8124,1.0,0,0,4,7,1850,0,1948,0,98177,47.7275,-122.359,1530,8123,440250,23,2,2015,0,67,6274,6593,0,0,1
2,2.0,1370,7920,1.0,0,0,3,8,950,420,1949,0,98199,47.6589,-122.397,1370,4680,585000,3,3,2015,0,66,6550,3310,0,1,1
4,2.5,2900,9972,2.0,0,0,3,9,2900,0,1993,0,98006,47.5536,-122.121,2901,8567,850000,18,9,2014,0,21,7072,5666,0,0,0
3,3.0,2400,3192,2.0,0,0,3,7,2400,0,1991,0,98103,47.6963,-122.348,1360,3192,570000,25,9,2014,0,23,792,1832,0,0,1
4,2.75,2170,5988,2.0,0,0,3,8,2170,0,2014,0,98155,47.7484,-122.317,1170,8147,551000,24,9,2014,0,0,3818,6977,0,0,1
3,1.0,970,8378,1.0,0,0,4,6,970,0,1962,0,98023,47.3078,-122.365,1050,8563,172380,13,3,2015,0,53,7408,7513,0,0,0
4,2.5,2980,10194,2.0,0,0,3,9,2980,0,1993,0,98006,47.5515,-122.12,2980,10053,728935,25,2,2015,0,22,7214,7073,0,0,0
3,2.5,2340,1919,2.0,0,2,4,9,2340,0,1981,0,98033,47.6512,-122.203,2415,2166,850000,6,3,2015,0,34,-421,-249,0,0,0
2,1.0,1480,5325,1.0,0,0,4,7,1120,360,1925,0,98022,47.2079,-121.993,1670,5800,215000,5,12,2014,0,89,3845,4130,0,1,0
4,2.5,2240,9826,1.0,0,0,4,7,1370,870,1988,0,98023,47.314,-122.364,1980,9826,220000,16,6,2014,0,26,7586,7846,0,1,0
4,2.5,2940,7675,2.0,0,0,3,9,2940,0,2004,0,98052,47.7054,-122.129,3120,6574,845000,24,7,2014,0,10,4735,3454,0,0,0
1,1.0,710,4000,1.0,0,0,4,6,610,100,1928,0,98103,47.6562,-122.354,1440,4500,390000,23,2,2015,0,87,3290,3060,0,1,1
4,1.0,1460,18599,1.5,0,0,3,5,1460,0,1940,0,98146,47.5006,-122.351,1320,8100,135000,13,3,2015,0,75,17139,6780,0,0,1
4,2.5,2630,6185,2.0,0,0,3,9,2630,0,1999,0,98056,47.5229,-122.192,2720,6185,585000,8,7,2014,0,15,3555,3465,0,0,0
3,1.0,960,3600,1.0,0,0,4,7,960,0,1906,0,98117,47.6758,-122.369,1580,5000,477000,2,9,2014,0,108,2640,3420,0,0,1
2,1.5,1180,1722,2.0,0,0,3,8,1180,0,2006,0,98116,47.5626,-122.384,1490,1469,399500,14,10,2014,0,8,542,-21,0,0,1
3,2.5,1340,8867,2.0,0,0,3,8,1340,0,1984,0,98125,47.724,-122.327,1630,7287,432500,9,9,2014,0,30,7527,5657,0,0,1
5,3.5,4330,11979,1.0,0,4,3,12,2090,2240,2008,0,98004,47.6251,-122.218,4320,12000,3170000,28,8,2014,0,6,7649,7680,0,1,0
3,2.5,3720,11610,2.0,0,0,3,11,3720,0,1982,0,98074,47.636,-122.049,3530,11877,1080000,12,5,2014,0,32,7890,8347,0,0,0
4,2.0,1670,5200,1.0,0,0,4,7,1030,640,1977,0,98042,47.3652,-122.09,1500,5200,229999,15,8,2014,0,37,3530,3700,0,1,0
3,1.0,1100,7657,1.0,0,0,3,7,1100,0,1955,0,98188,47.4374,-122.285,1300,8000,233000,11,8,2014,0,59,6557,6700,0,0,1
3,2.5,3240,8016,2.0,0,0,3,8,2910,330,2004,0,98065,47.5382,-121.877,2990,7561,600000,26,6,2014,0,10,4776,4571,0,1,0
4,1.5,1680,7620,1.0,0,0,4,7,1180,500,1965,0,98166,47.4578,-122.351,1460,7620,334000,8,5,2015,0,50,5940,6160,0,1,1
3,1.0,1030,8164,1.0,0,0,4,7,1030,0,1950,0,98133,47.7353,-122.334,1340,8164,332500,16,7,2014,0,64,7134,6824,0,0,1
3,2.5,1630,7700,1.0,0,0,3,7,1120,510,1978,0,98031,47.3876,-122.211,1640,8160,249900,26,6,2014,0,36,6070,6520,0,1,0
3,2.0,2610,12180,1.0,0,0,3,7,1670,940,1918,0,98146,47.5063,-122.346,1520,12180,310000,23,10,2014,0,96,9570,10660,0,1,1
2,1.0,1250,8520,1.0,0,0,3,6,1250,0,1928,0,98126,47.5158,-122.378,1040,8520,200000,5,11,2014,0,86,7270,7480,0,0,1
3,1.0,1390,6000,1.0,0,0,3,5,1390,0,1954,0,98056,47.4977,-122.175,1170,6000,230000,7,7,2014,0,60,4610,4830,0,0,0
4,2.5,1940,5414,2.0,0,0,3,8,1940,0,1997,0,98108,47.5461,-122.299,2050,6307,420000,20,10,2014,0,17,3474,4257,0,0,1
4,2.5,2960,4750,2.0,0,0,3,9,2960,0,2005,0,98029,47.5544,-121.993,2960,4750,785000,12,10,2014,0,9,1790,1790,0,0,0
5,1.5,1500,7112,1.0,0,0,5,6,760,740,1920,0,98166,47.4692,-122.35,1200,7112,265000,7,5,2014,0,94,5612,5912,0,1,1
2,1.0,840,10465,1.0,0,0,3,6,840,0,1951,0,98155,47.755,-122.317,1320,8515,295000,23,9,2014,0,63,9625,7195,0,0,1
4,2.75,2390,9968,1.0,0,0,4,9,1390,1000,1989,0,98038,47.3706,-122.056,2560,12385,415000,12,1,2015,0,26,7578,9825,0,1,0
3,1.75,1200,5478,1.0,0,0,5,6,1200,0,1955,0,98056,47.4959,-122.174,1270,6855,250000,12,2,2015,0,60,4278,5585,0,0,0
3,2.5,2570,5000,2.0,0,0,3,11,2570,0,1984,0,98102,47.6295,-122.32,1570,5000,1480000,21,4,2015,0,31,2430,3430,0,0,1
5,2.25,2180,6000,1.0,0,0,4,8,1430,750,1966,0,98007,47.6235,-122.143,2160,8800,635000,7,4,2015,0,49,3820,6640,0,1,0
3,2.5,2020,5613,2.0,0,0,3,7,2020,0,2003,0,98053,47.6835,-122.035,2020,4609,528000,21,7,2014,0,11,3593,2589,0,0,0
3,2.5,2480,7480,2.0,0,0,3,9,2480,0,1992,0,98072,47.771,-122.166,2480,7480,530000,25,8,2014,0,22,5000,5000,0,0,0
3,1.5,1140,3104,2.0,0,0,3,7,1140,0,1988,0,98029,47.5707,-122.018,1150,2981,310000,7,8,2014,0,26,1964,1831,0,0,0
3,1.0,1530,9465,1.0,0,0,4,7,1530,0,1960,0,98059,47.4915,-122.151,1530,9465,252000,26,1,2015,0,55,7935,7935,0,0,0
3,2.0,1700,8160,1.0,0,0,3,7,1120,580,1961,0,98133,47.74,-122.339,1740,8181,334500,11,8,2014,0,53,6460,6441,0,1,1
3,1.0,2150,8480,1.0,0,0,3,8,1610,540,1951,0,98115,47.6996,-122.308,1620,5203,370000,6,5,2015,0,64,6330,3583,0,1,1
3,2.0,1190,7840,1.5,0,0,4,6,1190,0,1918,0,98108,47.5531,-122.312,1460,3240,311000,19,12,2014,0,96,6650,1780,0,0,1
3,2.75,1730,4131,2.0,0,2,3,7,1480,250,1975,0,98106,47.5327,-122.346,1570,4120,260000,14,4,2015,0,40,2401,2550,0,1,1
3,1.75,1400,9546,1.0,0,0,4,7,1400,0,1984,0,98003,47.3179,-122.331,1660,8550,217500,1,7,2014,0,30,8146,6890,0,0,0
3,2.5,2200,4240,2.0,0,0,3,7,2200,0,2003,0,98042,47.3715,-122.127,2200,4311,290000,18,2,2015,0,12,2040,2111,0,0,0
3,1.5,960,4600,1.0,0,0,3,6,960,0,1944,0,98033,47.6937,-122.213,2230,9350,500000,7,10,2014,0,70,3640,7120,0,0,0
3,2.0,1770,6000,1.0,0,3,3,7,1100,670,1984,0,98118,47.5644,-122.29,1300,3000,423500,20,4,2015,0,31,4230,1700,0,1,1
4,2.5,2970,5722,2.0,0,0,3,9,2970,0,2005,0,98074,47.6134,-122.042,3940,4848,715000,24,12,2014,0,9,2752,908,0,0,0
3,2.5,1590,3121,2.0,0,0,3,7,1590,0,1994,0,98118,47.5515,-122.284,1090,4900,299000,28,7,2014,0,20,1531,3810,0,0,1
3,2.5,3350,4007,2.0,0,0,3,8,2550,800,2005,0,98034,47.7277,-122.207,2340,4167,635000,30,6,2014,0,9,657,1827,0,1,0
4,2.5,3370,9629,2.0,0,0,3,10,3370,0,1999,0,98075,47.5896,-121.978,3360,10335,806000,26,8,2014,0,15,6259,6975,0,0,0
3,2.5,1960,3480,2.0,0,0,3,7,1960,0,2004,0,98056,47.4802,-122.18,2560,3500,289950,31,5,2014,0,10,1520,940,0,0,0
3,1.75,1360,6603,1.0,0,0,4,7,1360,0,1981,0,98058,47.4619,-122.168,1770,7107,280000,10,10,2014,0,33,5243,5337,0,0,0
3,2.5,2780,6000,2.0,0,0,3,9,2780,0,2004,0,98058,47.4569,-122.118,1940,3466,479950,30,3,2015,0,11,3220,1526,0,0,0
4,2.5,3000,9793,2.0,0,0,3,7,3000,0,2002,0,98038,47.3655,-122.028,1890,7557,394000,27,6,2014,0,12,6793,5667,0,0,0
2,1.0,990,3000,1.0,0,0,4,6,990,0,1918,0,98103,47.6839,-122.345,1120,3000,409950,24,7,2014,0,96,2010,1880,0,0,1
4,3.5,2990,4200,2.0,0,4,5,9,2000,990,1925,0,98144,47.593,-122.289,2390,4200,1000000,11,9,2014,0,89,1210,1810,0,1,1
4,1.0,1200,6600,1.5,0,2,3,7,1200,0,1908,0,98136,47.5372,-122.382,1810,6600,436000,20,1,2015,0,107,5400,4790,0,0,1
1,1.75,1440,4920,1.0,0,0,3,7,720,720,1923,0,98126,47.534,-122.376,1440,4920,390000,15,7,2014,0,91,3480,3480,0,1,1
4,2.75,2140,8100,2.0,0,0,4,7,2140,0,1990,0,98023,47.3075,-122.359,1960,7002,304400,18,7,2014,0,24,5960,5042,0,0,0
5,1.75,2330,3800,1.5,0,0,3,7,1360,970,1927,0,98115,47.6835,-122.308,2100,3800,780000,25,3,2015,0,88,1470,1700,0,1,1
3,1.75,1950,10633,1.0,0,0,3,7,1250,700,1978,0,98125,47.7019,-122.313,1290,6380,580000,19,3,2015,0,37,8683,5090,0,1,1
3,1.75,1440,7198,1.0,0,0,3,7,990,450,1981,0,98055,47.4333,-122.194,1550,7156,274000,8,9,2014,0,33,5758,5606,0,1,0
3,2.25,1530,7906,1.0,0,0,3,7,1150,380,1980,0,98058,47.4418,-122.136,1460,7875,315000,9,2,2015,0,35,6376,6415,0,1,0
5,2.0,1750,8220,1.0,0,0,3,7,1750,0,1956,0,98155,47.7694,-122.321,1210,6760,340000,11,9,2014,0,58,6470,5550,0,0,1
3,1.75,1750,11180,1.0,0,0,3,8,1750,0,1968,0,98059,47.4713,-122.117,1730,11180,260000,6,8,2014,0,46,9430,9450,0,0,0
2,1.0,940,4800,1.0,0,0,4,6,940,0,1911,1955,98116,47.5756,-122.414,980,5900,399000,30,5,2014,44,103,3860,4920,1,0,1
2,1.0,880,6345,1.0,0,0,3,7,880,0,1919,0,98106,47.5341,-122.358,1440,6345,312500,15,5,2014,0,95,5465,4905,0,0,1
3,1.75,1650,8254,1.0,0,0,5,7,1060,590,1951,0,98155,47.7596,-122.304,2280,9450,370000,13,5,2014,0,63,6604,7170,0,1,1
4,3.5,3820,13224,2.0,0,0,3,10,3280,540,1990,0,98004,47.6005,-122.199,3340,9700,1240000,19,6,2014,0,24,9404,6360,0,1,0
3,1.5,1900,9630,1.0,0,0,3,8,1900,0,1967,0,98023,47.3352,-122.344,2010,9630,230000,20,2,2015,0,48,7730,7620,0,0,0
4,1.75,3720,8448,1.0,0,3,4,9,1960,1760,1947,0,98199,47.6425,-122.406,2540,7064,1280000,3,10,2014,0,67,4728,4524,0,1,1
3,1.0,1410,5120,1.5,0,0,3,6,1210,200,1925,0,98106,47.5238,-122.355,1330,5120,294350,20,8,2014,0,89,3710,3790,0,1,1
3,1.0,960,5700,1.0,0,0,4,5,960,0,1956,0,98056,47.4983,-122.172,960,5700,208950,13,10,2014,0,58,4740,4740,0,0,0
2,1.75,1930,5570,1.0,0,0,3,8,1930,0,2005,0,98053,47.7173,-122.034,1810,5178,515000,6,11,2014,0,9,3640,3368,0,0,0
4,2.5,3420,9575,2.0,0,0,3,11,3420,0,1994,0,98027,47.5527,-122.095,3310,8192,965000,8,4,2015,0,21,6155,4882,0,0,0
4,2.75,3010,3400,2.0,0,2,3,9,2240,770,1923,2009,98122,47.6142,-122.284,1940,5080,925000,26,3,2015,86,92,390,3140,1,1,1
4,1.0,1780,5000,1.5,0,0,3,8,1780,0,1947,0,98115,47.6761,-122.297,2030,5000,654500,18,3,2015,0,68,3220,2970,0,0,1
4,2.5,2080,11050,1.0,0,0,4,8,2080,0,1969,0,98059,47.472,-122.119,1850,11050,364000,14,8,2014,0,45,8970,9200,0,0,0
2,1.0,1250,5208,1.0,0,0,3,7,1050,200,1951,0,98002,47.3063,-122.219,1030,5354,150000,24,3,2015,0,64,3958,4324,0,1,0
5,3.0,2257,10117,1.0,0,0,3,8,1363,894,2005,0,98188,47.4524,-122.284,1540,10700,349950,14,5,2014,0,9,7860,9160,0,1,1
3,1.5,1670,5000,1.5,0,0,4,7,1670,0,1912,0,98117,47.678,-122.36,1750,5000,585000,25,8,2014,0,102,3330,3250,0,0,1
4,2.25,2250,13500,2.0,0,0,4,9,2250,0,1980,0,98007,47.621,-122.151,2730,13500,801501,17,3,2015,0,35,11250,10770,0,0,0
5,2.25,2880,11965,2.0,0,0,4,8,2880,0,1990,0,98042,47.3734,-122.124,2370,10715,382000,21,5,2014,0,24,9085,8345,0,0,0
3,1.75,1950,6504,1.0,0,0,3,8,1530,420,1953,0,98115,47.6934,-122.328,1660,6552,447500,3,11,2014,0,61,4554,4892,0,1,1
4,2.5,2280,9491,1.0,0,0,4,7,1290,990,1966,0,98008,47.6297,-122.117,1560,8050,575000,20,2,2015,0,49,7211,6490,0,1,0
2,1.75,1740,4736,1.5,0,2,4,7,1040,700,1907,0,98144,47.5994,-122.287,2020,4215,565000,7,10,2014,0,107,2996,2195,0,1,1
3,1.0,1220,7876,1.0,0,0,3,7,1220,0,1966,0,98034,47.7317,-122.201,1340,7876,348580,22,5,2014,0,48,6656,6536,0,0,0
4,1.75,2260,9703,1.0,0,0,2,8,1660,600,1978,0,98052,47.6622,-122.145,2390,8455,459000,16,10,2014,0,36,7443,6065,0,1,0
4,2.5,2440,7093,2.0,0,0,3,7,2440,0,1999,0,98030,47.3817,-122.204,1860,6072,310000,4,9,2014,0,15,4653,4212,0,0,0
3,1.5,1400,9600,1.0,0,0,4,7,1400,0,1964,0,98003,47.2878,-122.297,2210,15000,210000,18,11,2014,0,50,8200,12790,0,0,0
3,2.75,1810,3292,2.0,0,0,3,8,1810,0,2014,0,98065,47.5164,-121.877,1810,2769,384205,11,9,2014,0,0,1482,959,0,0,0
2,1.0,1400,4500,1.0,0,0,3,7,900,500,1922,0,98055,47.4866,-122.219,1400,5500,180000,22,5,2014,0,92,3100,4100,0,1,0
2,1.0,1400,4500,1.0,0,0,3,7,900,500,1922,0,98055,47.4866,-122.219,1400,5500,310000,24,12,2014,0,92,3100,4100,0,1,0
4,2.5,2010,6294,2.0,0,0,3,7,2010,0,2000,0,98028,47.776,-122.24,1870,4394,427500,3,2,2015,0,15,4284,2524,0,0,0
3,3.0,2520,2152,1.5,0,0,3,8,1560,960,1925,2006,98119,47.6363,-122.371,1140,2152,780000,27,5,2014,81,89,-368,1012,1,1,1
3,2.25,3060,16000,2.0,0,0,3,10,3060,0,1988,0,98039,47.6189,-122.23,3510,13162,1760000,21,8,2014,0,26,12940,9652,0,0,0
4,2.5,2150,4000,2.0,0,0,3,7,2150,0,2010,0,98038,47.3655,-122.018,1610,4000,339950,3,3,2015,0,5,1850,2390,0,0,0
3,2.25,2880,9750,2.0,0,0,3,10,2880,0,1989,0,98006,47.5575,-122.119,2920,11090,820000,1,7,2014,0,25,6870,8170,0,0,0
2,2.0,1300,3865,1.0,0,0,3,8,1300,0,2006,0,98053,47.7193,-122.024,1350,4199,398000,24,9,2014,0,8,2565,2849,0,0,0
4,1.5,1780,14810,1.0,0,0,4,8,1180,600,1950,0,98032,47.3581,-122.288,1450,6728,240000,8,1,2015,0,65,13030,5278,0,1,0
4,3.5,3730,15029,2.0,0,2,3,10,2440,1290,1991,0,98042,47.3804,-122.163,3440,14280,599950,9,6,2014,0,23,11299,10840,0,1,0
2,1.0,930,7740,1.0,0,0,1,5,930,0,1932,0,98148,47.4611,-122.324,1620,8584,105500,16,7,2014,0,82,6810,6964,0,0,1
2,1.0,930,7740,1.0,0,0,1,5,930,0,1932,0,98148,47.4611,-122.324,1620,8584,445000,16,3,2015,0,83,6810,6964,0,0,1
3,2.0,1310,8454,1.0,0,0,3,7,1310,0,1994,0,98042,47.3697,-122.075,1310,8454,255000,24,2,2015,0,21,7144,7144,0,0,0
4,2.5,2770,10274,2.0,0,0,3,9,2770,0,1989,0,98029,47.5748,-122.018,2270,7210,675750,26,6,2014,0,25,7504,4940,0,0,0
3,3.25,3140,5445,2.0,0,3,4,10,2240,900,1913,0,98109,47.6406,-122.347,2950,5250,1640000,1,7,2014,0,101,2305,2300,0,1,1
4,2.5,1770,9239,2.0,0,0,3,7,1770,0,2004,0,98038,47.3512,-122.006,2150,5450,353500,30,9,2014,0,10,7469,3300,0,0,0
3,1.0,1220,7585,1.0,0,0,4,7,1220,0,1954,0,98004,47.6094,-122.194,1380,8918,765000,20,10,2014,0,60,6365,7538,0,0,0
4,2.5,2190,4944,2.0,0,0,3,8,2190,0,1999,0,98065,47.5341,-121.866,2190,5108,563500,3,3,2015,0,16,2754,2918,0,0,0
4,2.0,1800,5465,1.0,0,0,3,7,900,900,1942,0,98118,47.561,-122.272,1400,5400,439000,21,1,2015,0,73,3665,4000,0,1,1
5,2.75,3100,10014,1.0,0,2,4,9,1660,1440,1973,0,98040,47.5734,-122.213,3230,10279,975000,13,6,2014,0,41,6914,7049,0,1,0
3,2.5,2270,4399,2.0,0,0,3,7,2270,0,2007,0,98065,47.5415,-121.884,2060,4399,469900,6,4,2015,0,8,2129,2339,0,0,0
3,1.0,1300,8184,2.0,0,0,3,6,1300,0,1947,0,98155,47.7469,-122.319,1120,8184,252000,23,4,2015,0,68,6884,7064,0,0,1
3,2.0,1769,9300,1.0,0,0,4,7,1769,0,1955,2009,98166,47.441,-122.342,1870,10226,495000,12,6,2014,54,59,7531,8356,1,0,1
4,2.5,1630,5361,2.0,0,0,3,7,1630,0,1999,0,98144,47.5704,-122.294,1920,5046,327000,12,8,2014,0,15,3731,3126,0,0,1
2,2.25,2470,7658,1.0,0,0,4,8,1480,990,1954,0,98199,47.653,-122.416,2070,7270,898000,14,10,2014,0,60,5188,5200,0,1,1
4,2.5,2600,8572,2.0,0,0,3,8,2600,0,2003,0,98001,47.3155,-122.266,2170,5288,300000,9,1,2015,0,12,5972,3118,0,0,0
3,2.0,1800,12440,1.0,0,0,3,8,1220,580,1978,0,98074,47.6254,-122.05,2460,12352,418500,13,4,2015,0,37,10640,9892,0,1,0
4,2.5,2240,4616,2.0,0,0,3,7,1840,400,2001,0,98056,47.5118,-122.194,2260,5200,450000,25,3,2015,0,14,2376,2940,0,1,0
3,2.0,1960,13100,1.0,0,2,5,8,1650,310,1957,0,98166,47.4419,-122.34,1960,10518,403000,2,5,2014,0,57,11140,8558,0,1,1
3,1.0,1710,6556,1.5,0,0,4,7,1200,510,1926,0,98133,47.7185,-122.354,1410,6563,440000,12,6,2014,0,88,4846,5153,0,1,1
4,1.75,2140,4959,1.0,0,0,3,7,1080,1060,1965,0,98118,47.5166,-122.266,1590,5250,350000,29,4,2015,0,50,2819,3660,0,1,1
3,2.0,1400,6200,1.0,0,0,3,6,700,700,1948,0,98133,47.7634,-122.34,1410,7564,240000,15,5,2014,0,66,4800,6154,0,1,1
2,1.0,890,2100,1.0,0,0,4,6,760,130,1919,0,98107,47.656,-122.359,1600,4250,460000,16,6,2014,0,95,1210,2650,0,1,1
4,1.0,1820,4000,2.0,0,0,3,8,1820,0,1923,0,98102,47.6259,-122.321,2050,4000,825000,19,9,2014,0,91,2180,1950,0,0,1
3,2.25,1860,12000,1.0,0,0,4,7,1860,0,1976,0,98092,47.2942,-122.19,1815,9604,267500,26,2,2015,0,39,10140,7789,0,0,0
3,2.75,2300,4637,2.0,0,0,3,8,2300,0,2008,0,98065,47.5216,-121.878,2420,5699,479500,17,6,2014,0,6,2337,3279,0,0,0
2,1.0,1520,4700,2.0,0,0,4,7,1520,0,1978,0,98092,47.3187,-122.182,1140,3906,210000,2,4,2015,0,37,3180,2766,0,0,0
2,1.0,1440,3225,1.0,0,0,3,7,960,480,1915,0,98103,47.6653,-122.338,1160,3630,445000,8,6,2014,0,99,1785,2470,0,1,1
3,1.75,1170,8148,1.0,0,0,3,7,1170,0,1952,0,98155,47.7479,-122.318,1200,8147,265000,14,7,2014,0,62,6978,6947,0,0,1
3,1.75,1170,8148,1.0,0,0,3,7,1170,0,1952,0,98155,47.7479,-122.318,1200,8147,399000,11,11,2014,0,62,6978,6947,0,0,1
4,2.5,2570,4557,2.0,0,0,3,7,2570,0,2009,0,98042,47.367,-122.115,2200,4500,360000,3,4,2015,0,6,1987,2300,0,0,0
3,2.5,2370,7916,2.0,0,0,3,9,2370,0,1990,0,98056,47.528,-122.171,2500,8221,655000,23,4,2015,0,25,5546,5721,0,0,0
4,1.5,1800,10150,1.5,0,0,4,7,1800,0,1958,0,98034,47.7325,-122.242,1630,10660,449950,4,5,2015,0,57,8350,9030,0,0,0
5,2.5,2300,7000,1.0,0,0,3,8,1290,1010,1975,0,98052,47.6875,-122.122,2080,7280,612000,29,4,2015,0,40,4700,5200,0,1,0
3,2.5,2280,18241,1.0,0,0,3,9,960,1320,1995,0,98011,47.7453,-122.213,3100,12465,557000,12,2,2015,0,20,15961,9365,0,1,0
4,1.75,1870,12500,1.0,0,1,5,6,1030,840,1943,0,98056,47.511,-122.197,2060,14141,375000,28,1,2015,0,72,10630,12081,0,1,0
5,2.75,2390,6282,1.0,0,0,4,7,1290,1100,1966,0,98118,47.5149,-122.263,1690,5202,330000,20,4,2015,0,49,3892,3512,0,1,1
4,1.75,2110,6708,1.0,0,3,3,8,1410,700,1941,0,98105,47.67,-122.274,2140,7006,1030000,27,4,2015,0,74,4598,4866,0,1,1
2,1.0,980,4800,1.0,0,0,4,7,980,0,1910,0,98103,47.6569,-122.348,1570,2640,550000,26,3,2015,0,105,3820,1070,0,0,1
3,1.75,1250,7710,1.0,0,0,4,7,1250,0,1947,0,98155,47.7623,-122.317,1340,7710,338000,10,11,2014,0,67,6460,6370,0,0,1
4,2.5,3680,13351,2.0,0,2,5,9,3680,0,1946,1982,98004,47.6154,-122.214,3410,11700,1900000,31,7,2014,36,68,9671,8290,1,0,0
3,1.0,2230,8163,1.0,0,0,3,7,1230,1000,1966,0,98118,47.5215,-122.275,2380,6874,235000,20,8,2014,0,48,5933,4494,0,1,1
1,1.0,1230,9300,1.5,0,0,4,6,1230,0,1918,0,98133,47.7055,-122.348,1190,6820,349950,25,11,2014,0,96,8070,5630,0,0,1
5,2.5,2093,10350,1.5,0,0,5,7,2093,0,1963,0,98058,47.4495,-122.17,1520,10350,300000,29,7,2014,0,51,8257,8830,0,0,0
3,1.75,1660,12865,1.0,0,0,5,7,1660,0,1967,0,98056,47.5375,-122.175,1610,12400,431000,3,11,2014,0,47,11205,10790,0,0,0
4,2.5,1677,7209,2.0,0,0,3,7,1677,0,2011,0,98023,47.2957,-122.357,2236,7209,295000,26,3,2015,0,4,5532,4973,0,0,0
4,2.5,2990,6383,2.0,0,0,3,7,2990,0,2003,0,98038,47.3499,-122.027,2640,6454,445000,23,4,2015,0,12,3393,3814,0,0,0
3,2.5,1410,2500,2.0,0,0,3,7,1410,0,2006,0,98146,47.5132,-122.358,1290,5190,265000,8,9,2014,0,8,1090,3900,0,0,1
4,2.5,2280,2432,2.0,0,0,5,8,1520,760,1921,0,98103,47.6605,-122.355,1690,2099,597000,24,9,2014,0,93,152,409,0,1,1
2,1.0,1260,5800,1.0,0,0,4,7,1260,0,1939,0,98199,47.6501,-122.409,1830,5800,661000,15,8,2014,0,75,4540,3970,0,0,1
3,2.0,1460,4350,2.0,0,0,3,7,1460,0,2008,0,98053,47.696,-122.026,1740,4622,362764,15,7,2014,0,6,2890,2882,0,0,0
4,2.5,1600,14000,1.0,0,0,3,8,1310,290,1950,0,98125,47.7258,-122.326,1600,10200,427000,21,8,2014,0,64,12400,8600,0,1,1
3,1.75,2020,8531,1.0,0,0,3,7,2020,0,1965,0,98011,47.7691,-122.199,1950,8449,405000,5,12,2014,0,49,6511,6499,0,0,0
3,1.5,1170,11530,1.0,0,0,3,7,1170,0,1960,0,98198,47.4211,-122.29,1550,8605,157000,24,12,2014,0,54,10360,7055,0,0,1
3,1.5,1170,11530,1.0,0,0,3,7,1170,0,1960,0,98198,47.4211,-122.29,1550,8605,246500,19,3,2015,0,55,10360,7055,0,0,1
2,1.5,1280,11071,1.0,0,0,3,7,850,430,1984,0,98074,47.6351,-122.033,1280,10879,386500,8,1,2015,0,31,9791,9599,0,1,0
3,1.75,1770,8571,1.0,0,0,3,8,1270,500,1978,0,98023,47.3109,-122.339,2120,7711,240000,7,11,2014,0,36,6801,5591,0,1,0
5,3.5,4790,12957,2.0,0,1,3,9,3110,1680,2005,0,98006,47.5469,-122.194,2620,13538,818500,9,9,2014,0,9,8167,10918,0,1,0
3,1.75,1300,8500,1.0,0,0,4,7,1300,0,1964,0,98022,47.209,-122.005,1410,7800,249000,9,8,2014,0,50,7200,6390,0,0,0
4,2.25,2610,7700,1.0,0,0,3,8,1700,910,1977,0,98027,47.5659,-122.089,2260,8266,580000,29,9,2014,0,37,5090,6006,0,1,0
4,2.5,2100,7366,2.0,0,0,3,8,2100,0,1997,0,98042,47.3703,-122.107,2060,7324,333000,26,9,2014,0,17,5266,5264,0,0,0
2,2.0,1340,7605,1.0,0,0,3,7,1340,0,1992,0,98022,47.1936,-121.981,1670,7136,230000,23,8,2014,0,22,6265,5466,0,0,0
3,1.0,970,6180,1.0,0,3,3,6,970,0,1974,0,98118,47.5658,-122.291,1120,4500,360500,13,2,2015,0,41,5210,3380,0,0,1
3,1.75,2200,7200,1.0,0,0,3,8,1270,930,1962,0,98032,47.3745,-122.276,1800,8000,265000,22,7,2014,0,52,5000,6200,0,1,0
2,1.0,990,5000,1.0,0,0,3,7,990,0,1941,0,98116,47.5666,-122.403,2250,6032,490000,25,10,2014,0,73,4010,3782,0,0,1
2,1.75,1180,5000,1.0,0,0,2,7,880,300,1925,0,98107,47.6749,-122.398,1470,5000,600000,6,5,2015,0,90,3820,3530,0,1,1
3,1.0,980,6530,1.0,0,0,3,7,980,0,1969,0,98034,47.7133,-122.213,1220,6723,307500,15,9,2014,0,45,5550,5503,0,0,0
4,2.25,2370,9636,1.0,0,0,3,8,1660,710,1976,0,98033,47.6497,-122.194,2350,9588,670000,17,12,2014,0,38,7266,7238,0,1,0
3,1.5,1910,10583,1.5,0,0,4,7,1910,0,1922,1967,98002,47.2782,-122.212,1770,9068,247200,21,10,2014,45,92,8673,7298,1,0,0
4,4.5,5270,12195,2.0,1,4,3,11,3400,1870,1979,0,98027,47.5696,-122.09,3390,9905,2600000,16,12,2014,0,35,6925,6515,0,1,0
3,1.75,1430,8400,1.0,0,0,4,7,1430,0,1961,0,98008,47.6073,-122.127,1570,7800,440000,20,8,2014,0,53,6970,6230,0,0,0
4,2.5,2490,7694,2.0,0,0,3,8,2490,0,1987,0,98029,47.567,-122.016,2140,8126,700000,6,5,2015,0,28,5204,5986,0,0,0
4,2.0,2000,8317,1.5,0,0,4,8,2000,0,1917,0,98126,47.5394,-122.379,1390,6001,756100,11,3,2015,0,98,6317,4611,0,0,1
5,3.5,2880,3750,2.0,0,2,3,8,2270,610,2001,0,98144,47.5905,-122.292,2060,4000,830000,24,4,2015,0,14,870,1940,0,1,1
3,1.0,1010,8863,1.0,0,0,4,6,1010,0,1990,0,98022,47.1955,-121.999,1090,8410,180000,12,12,2014,0,24,7853,7320,0,0,0
5,3.5,3290,5600,2.0,0,0,3,9,2670,620,2004,0,98052,47.7056,-122.119,3130,5600,775000,6,10,2014,0,10,2310,2470,0,1,0
4,1.75,1530,18400,1.5,0,0,4,6,1530,0,1938,0,98002,47.329,-122.219,1620,13535,220000,5,8,2014,0,76,16870,11915,0,0,0
4,2.75,2020,15810,1.0,0,0,4,9,1620,400,1967,0,98005,47.5921,-122.155,2210,10160,650000,24,7,2014,0,47,13790,7950,0,1,0
3,1.75,1340,9975,1.0,0,0,4,7,1340,0,1961,0,98033,47.7012,-122.169,1340,10050,410000,24,12,2014,0,53,8635,8710,0,0,0
4,2.5,2180,5367,2.0,0,0,3,7,2180,0,2000,0,98038,47.3775,-122.022,2180,5130,339995,21,10,2014,0,14,3187,2950,0,0,0
5,1.75,2870,9680,1.0,0,4,5,9,1440,1430,1966,0,98008,47.6122,-122.111,2940,9729,1160000,19,2,2015,0,49,6810,6789,0,1,0
3,2.75,2070,9697,2.0,0,0,4,7,1330,740,1929,0,98188,47.4327,-122.283,2000,14436,440000,23,7,2014,0,85,7627,12436,0,1,1
2,1.75,930,7080,1.0,0,0,3,6,930,0,1923,2006,98106,47.5224,-122.36,1100,7680,275000,30,7,2014,83,91,6150,6580,1,0,1
3,2.5,2270,9822,2.0,0,0,3,9,2270,0,1988,0,98052,47.6685,-122.137,2790,8089,766000,29,8,2014,0,26,7552,5299,0,0,0
3,2.25,1630,7900,1.0,0,0,4,7,1130,500,1973,0,98023,47.3076,-122.377,1630,8200,231500,10,7,2014,0,41,6270,6570,0,1,0
4,1.75,1970,8390,1.0,0,0,3,7,1140,830,1955,0,98178,47.4861,-122.251,1710,10890,265000,6,3,2015,0,60,6420,9180,0,1,1
2,1.0,790,6000,1.0,0,0,3,7,790,0,1948,0,98118,47.5543,-122.273,960,6000,325000,13,11,2014,0,66,5210,5040,0,0,1
3,1.75,1740,8424,1.0,0,0,5,7,1040,700,1954,0,98133,47.7508,-122.352,1370,8424,364500,29,7,2014,0,60,6684,7054,0,1,1
2,1.0,1130,8184,1.0,0,0,3,6,1130,0,1947,0,98155,47.7473,-122.32,1010,8184,322500,29,1,2015,0,68,7054,7174,0,0,1
3,1.75,1180,4000,1.0,0,0,3,7,1040,140,1929,0,98118,47.5226,-122.284,1430,4000,338900,16,4,2015,0,86,2820,2570,0,1,1
5,2.5,2350,4000,2.0,0,0,3,9,2350,0,1993,0,98112,47.6265,-122.296,1840,4000,910000,13,6,2014,0,21,1650,2160,0,0,1
5,2.5,2350,4000,2.0,0,0,3,9,2350,0,1993,0,98112,47.6265,-122.296,1840,4000,1020000,24,4,2015,0,22,1650,2160,0,0,1
3,1.75,1850,6869,1.0,0,2,5,6,1100,750,1919,1934,98166,47.4648,-122.363,1850,10096,459950,13,6,2014,15,95,5019,8246,1,1,1
4,3.0,3220,6224,1.5,0,0,3,9,3220,0,2009,0,98059,47.4813,-122.129,2950,6224,584950,14,10,2014,0,5,3004,3274,0,0,0
3,1.75,2050,11313,1.0,0,0,3,7,1520,530,1987,0,98023,47.2837,-122.358,1620,8065,252000,23,12,2014,0,27,9263,6445,0,1,0
3,2.5,1430,8470,1.0,0,0,3,7,1190,240,1992,0,98022,47.1943,-121.991,1670,8418,270000,29,4,2015,0,23,7040,6748,0,1,0
4,2.5,3210,8938,2.0,0,0,3,10,3210,0,2005,0,98075,47.582,-121.971,3740,8108,750000,30,10,2014,0,9,5728,4368,0,0,0
3,1.75,3520,12350,1.0,0,4,4,8,1530,1990,1960,0,98116,47.5837,-122.382,2140,7800,775000,1,12,2014,0,54,8830,5660,0,1,1
3,2.5,2260,8120,2.0,0,0,3,8,2260,0,2004,0,98023,47.2924,-122.357,2250,7784,325000,18,2,2015,0,11,5860,5534,0,0,0
5,3.25,3290,6422,2.0,0,0,3,9,3290,0,2012,0,98074,47.5933,-122.061,3210,6891,810000,26,10,2014,0,2,3132,3681,0,0,0
2,2.25,1640,2128,2.0,0,0,4,8,1640,0,1974,0,98028,47.753,-122.252,1640,2128,409000,15,7,2014,0,40,488,488,0,0,0
4,1.75,1580,5340,1.0,0,0,3,7,1130,450,1947,0,98144,47.6003,-122.306,830,980,400000,16,6,2014,0,67,3760,150,0,1,1
4,2.25,1940,8270,2.0,0,0,5,7,1940,0,1962,0,98133,47.7567,-122.333,1800,7743,530000,12,5,2015,0,53,6330,5943,0,0,1
3,2.25,1580,8506,2.0,0,0,3,7,1580,0,1987,0,98033,47.686,-122.185,2253,8515,580000,13,3,2015,0,28,6926,6262,0,0,0
3,1.75,1750,11340,1.0,0,1,4,7,1300,450,1987,0,98074,47.6099,-122.058,2310,11340,491300,9,5,2014,0,27,9590,9030,0,1,0
4,2.75,1810,7350,1.0,0,0,4,7,1200,610,1980,0,98030,47.3703,-122.171,1750,7350,272000,31,12,2014,0,34,5540,5600,0,1,0
3,2.5,1770,5146,2.0,0,0,3,8,1770,0,1992,0,98029,47.5704,-121.999,1870,5146,464000,26,2,2015,0,23,3376,3276,0,0,0
3,1.75,1800,6000,1.0,0,0,5,7,900,900,1905,0,98103,47.6867,-122.349,1800,3000,471001,23,6,2014,0,109,4200,1200,0,1,1
3,1.5,1500,11616,1.0,0,0,3,7,1100,400,1980,0,98031,47.4062,-122.174,1830,8288,230000,17,11,2014,0,34,10116,6458,0,1,0
3,1.0,940,6695,1.0,0,0,4,6,940,0,1959,0,98008,47.6195,-122.12,1230,7400,358000,14,7,2014,0,55,5755,6170,0,0,0
3,2.25,2340,6183,1.0,0,0,3,7,1210,1130,1929,0,98115,47.6979,-122.31,1970,6183,510000,20,8,2014,0,85,3843,4213,0,1,1
3,1.0,840,9480,1.0,0,0,3,6,840,0,1960,0,98023,47.3277,-122.341,840,9420,86500,22,7,2014,0,54,8640,8580,0,0,0
3,1.0,840,9480,1.0,0,0,3,6,840,0,1960,0,98023,47.3277,-122.341,840,9420,199950,3,4,2015,0,55,8640,8580,0,0,0
3,3.25,2940,5432,3.0,0,3,4,10,2440,500,1978,0,98109,47.6299,-122.354,4400,5500,1710000,16,6,2014,0,36,2492,1100,0,1,1
3,2.75,3180,3680,2.0,0,0,4,9,2190,990,1918,0,98126,47.577,-122.38,2000,3680,850000,13,3,2015,0,97,500,1680,0,1,1
4,2.5,2020,3440,1.5,0,0,4,7,1480,540,1928,0,98117,47.6885,-122.376,1520,5080,542000,23,9,2014,0,86,1420,3560,0,1,1
2,1.0,820,4320,1.0,0,0,3,5,820,0,1937,0,98106,47.514,-122.359,780,7424,102500,1,7,2014,0,77,3500,6644,0,0,1
3,1.0,1010,11244,1.0,0,0,4,7,1010,0,1947,0,98155,47.7467,-122.321,1220,11242,350000,23,5,2014,0,67,10234,10022,0,0,1
2,1.0,710,5120,1.0,0,0,3,6,710,0,1918,0,98106,47.5224,-122.357,1150,1252,216000,9,2,2015,0,97,4410,102,0,0,1
3,1.0,980,7228,1.5,0,0,3,7,980,0,1946,0,98133,47.7294,-122.353,1070,7228,340000,5,9,2014,0,68,6248,6158,0,0,1
3,1.0,1100,5400,1.5,0,0,3,7,1100,0,1908,0,98199,47.6604,-122.396,1770,4400,505000,14,11,2014,0,106,4300,2630,0,0,1
5,2.5,2840,6010,2.0,0,0,3,8,2840,0,2003,0,98001,47.3161,-122.27,2740,5509,372000,13,5,2015,0,12,3170,2769,0,0,0
4,2.25,2300,7524,2.0,0,0,4,8,2300,0,1978,0,98023,47.313,-122.388,2270,8025,263850,4,9,2014,0,36,5224,5755,0,0,0
4,2.5,2280,9899,2.0,0,0,3,8,2280,0,1987,0,98058,47.461,-122.148,1970,9451,325000,19,11,2014,0,27,7619,7481,0,0,0
2,1.0,1010,7740,1.0,0,0,3,6,890,120,1924,0,98106,47.5323,-122.355,1030,6000,289000,27,10,2014,0,90,6730,4970,0,1,1
3,2.25,1420,6600,1.0,0,0,3,7,1160,260,1987,0,98028,47.77,-122.265,1920,7902,364000,26,2,2015,0,28,5180,5982,0,1,0
4,2.5,2100,8800,1.0,0,0,5,8,1250,850,1980,0,98033,47.6909,-122.186,2100,9000,610000,22,8,2014,0,34,6700,6900,0,1,0
3,2.25,2160,9540,2.0,0,0,3,8,2160,0,1979,0,98028,47.7668,-122.243,1720,12593,402500,30,4,2015,0,36,7380,10873,0,0,0
2,1.0,820,6250,1.0,0,0,4,5,820,0,1922,0,98136,47.5479,-122.384,1300,6250,375000,4,6,2014,0,92,5430,4950,0,0,1
5,2.5,4340,9108,1.0,0,0,5,8,2170,2170,1979,0,98118,47.5384,-122.276,2030,6812,537500,26,1,2015,0,36,4768,4782,0,1,1
3,1.75,2100,9066,1.0,0,0,3,8,1440,660,1962,0,98188,47.4294,-122.292,2000,9132,375000,31,7,2014,0,52,6966,7132,0,1,1
4,1.75,1250,8840,1.0,0,0,4,7,910,340,1979,0,98198,47.4138,-122.317,1410,8378,293550,20,8,2014,0,35,7590,6968,0,1,1
2,2.5,1360,2693,2.0,0,0,3,6,1360,0,2003,0,98038,47.3492,-122.025,1360,2693,225000,12,8,2014,0,11,1333,1333,0,0,0
4,1.0,1400,8684,1.5,0,0,3,7,1400,0,1957,0,98146,47.4887,-122.344,1520,8712,185000,8,1,2015,0,58,7284,7192,0,0,1
3,1.5,1450,7375,1.0,0,0,3,7,1010,440,1968,0,98034,47.7212,-122.179,1350,7440,402000,17,6,2014,0,46,5925,6090,0,1,0
5,1.75,1880,16617,1.0,0,0,3,7,960,920,1963,0,98007,47.6003,-122.132,1720,8400,585000,9,4,2015,0,52,14737,6680,0,1,0
2,2.5,1380,953,3.0,0,0,3,9,1380,0,2006,0,98103,47.6654,-122.355,1430,3400,549000,17,6,2014,0,8,-427,1970,0,0,1
3,2.25,2910,15626,1.5,0,0,4,9,2510,400,1923,0,98199,47.6534,-122.412,2370,6519,1810000,14,4,2015,0,92,12716,4149,0,1,1
3,1.75,1380,10529,1.0,0,0,3,7,1380,0,1967,0,98034,47.7119,-122.233,1670,5694,345000,6,4,2015,0,48,9149,4024,0,0,0
3,2.25,3100,11985,1.0,0,0,4,7,1790,1310,1963,0,98198,47.3825,-122.31,1770,7954,302500,17,11,2014,0,51,8885,6184,0,1,1
2,2.0,1650,6840,1.5,0,0,5,7,1650,0,1916,0,98103,47.6512,-122.338,1700,4560,705000,1,10,2014,0,98,5190,2860,0,0,1
3,1.0,840,5525,1.0,0,0,5,6,840,0,1969,0,98042,47.3607,-122.085,920,5330,191000,28,4,2015,0,46,4685,4410,0,0,0
2,2.75,2820,11770,2.0,0,0,3,7,1630,1190,1947,0,98168,47.5102,-122.324,1690,12500,350000,2,4,2015,0,68,8950,10810,0,1,1
3,1.75,1710,4080,1.0,0,0,4,7,1130,580,1979,0,98136,47.5563,-122.392,1200,4080,480000,7,8,2014,0,35,2370,2880,0,1,1
3,1.0,820,5200,1.0,0,0,4,6,820,0,1977,0,98042,47.363,-122.094,1120,5200,220000,2,3,2015,0,38,4380,4080,0,0,0
3,1.75,1560,7424,1.0,0,0,5,8,1560,0,1940,0,98117,47.6981,-122.374,1370,7424,592000,25,11,2014,0,74,5864,6054,0,0,1
4,2.5,3060,6826,2.0,0,0,3,9,3060,0,2004,0,98052,47.7006,-122.112,3110,6932,775000,24,11,2014,0,10,3766,3822,0,0,0
3,2.5,1680,4584,2.0,0,0,3,7,1680,0,2003,0,98056,47.4794,-122.182,2160,4621,320000,17,9,2014,0,11,2904,2461,0,0,0
3,3.25,3320,15022,2.0,0,0,3,10,3320,0,1989,0,98166,47.429,-122.341,3430,15018,760000,17,3,2015,0,26,11702,11588,0,0,1
3,2.5,2390,8315,2.0,0,0,4,9,2390,0,1990,0,98074,47.6271,-122.028,2370,7816,640000,22,7,2014,0,24,5925,5446,0,0,0
3,1.0,1360,5840,1.0,0,0,4,5,1360,0,1953,0,98056,47.4945,-122.166,1250,6708,253200,2,5,2015,0,62,4480,5458,0,0,0
2,1.0,1800,9236,1.0,0,0,3,7,1800,0,1954,0,98030,47.3792,-122.198,1730,5701,228000,16,7,2014,0,60,7436,3971,0,0,0
3,1.0,1160,9525,1.0,0,0,4,7,1160,0,1968,0,98077,47.7431,-122.073,1160,10640,325000,4,11,2014,0,46,8365,9480,0,0,0
4,2.25,1660,3200,2.0,0,0,3,7,1660,0,2011,0,98038,47.3666,-122.019,1960,3558,300000,11,2,2015,0,4,1540,1598,0,0,0
3,2.0,1410,6030,1.5,0,0,4,7,1410,0,1930,0,98103,47.6994,-122.347,1410,6300,418000,5,5,2014,0,84,4620,4890,0,0,1
4,1.75,2230,9625,1.0,0,4,3,8,1180,1050,1955,0,98178,47.508,-122.244,2300,8211,415000,17,12,2014,0,59,7395,5911,0,1,1
3,2.5,1700,4000,2.0,0,0,3,7,1700,0,2003,0,98065,47.5327,-121.871,1700,4417,384000,20,5,2014,0,11,2300,2717,0,0,0
3,2.5,2070,8337,2.0,0,0,3,8,2070,0,1997,0,98030,47.3658,-122.176,2030,7248,325000,13,6,2014,0,17,6267,5218,0,0,0
3,1.75,2300,12682,1.0,0,2,3,8,2300,0,1955,0,98028,47.7588,-122.27,2720,14643,600000,22,12,2014,0,59,10382,11923,0,0,0
4,2.25,3040,9690,1.0,0,0,4,9,1940,1100,1978,0,98005,47.5923,-122.169,2430,9690,760000,10,10,2014,0,36,6650,7260,0,1,0
2,1.5,1220,3568,1.5,0,0,4,8,1220,0,1976,0,98198,47.3804,-122.318,1180,3678,168000,30,5,2014,0,38,2348,2498,0,0,1
3,1.0,960,3960,1.0,0,0,3,7,960,0,1943,0,98199,47.6465,-122.404,1550,6050,405000,20,10,2014,0,71,3000,4500,0,0,1
3,1.0,1480,10094,1.0,0,0,4,7,1480,0,1956,0,98007,47.5942,-122.136,1430,10083,479000,4,5,2015,0,59,8614,8653,0,0,0
3,2.0,1560,5130,1.0,0,0,5,7,1150,410,1915,0,98103,47.6913,-122.333,1560,4500,549000,26,8,2014,0,99,3570,2940,0,1,1
2,1.5,900,5750,1.0,0,2,3,7,900,0,1940,0,98116,47.5623,-122.384,1300,1413,550000,29,1,2015,0,75,4850,113,0,0,1
4,1.75,2400,7700,1.5,0,0,4,7,1500,900,1927,0,98133,47.7125,-122.332,1530,7700,389000,2,7,2014,0,87,5300,6170,0,1,1
3,2.5,2320,15024,2.0,0,0,3,8,2320,0,1990,0,98045,47.4829,-121.766,2300,15145,447500,22,7,2014,0,24,12704,12845,0,0,0
5,3.0,2570,5590,1.0,0,0,3,8,1580,990,2009,0,98034,47.7271,-122.228,2020,10500,540000,13,10,2014,0,5,3020,8480,0,1,0
4,2.75,1300,9638,1.0,0,0,2,7,1300,0,1983,0,98042,47.3683,-122.109,1670,9638,273500,28,4,2015,0,32,8338,7968,0,0,0
5,2.75,2930,10148,2.0,0,0,3,9,2930,0,2002,0,98059,47.4887,-122.145,2930,8425,257000,17,10,2014,0,12,7218,5495,0,0,0
2,1.0,720,7200,1.0,0,0,5,6,720,0,1943,0,98058,47.4763,-122.177,970,8027,199000,24,5,2014,0,71,6480,7057,0,0,0
4,2.5,2350,10655,2.0,0,0,3,8,2350,0,1992,0,98092,47.3284,-122.171,2210,7028,339100,4,3,2015,0,23,8305,4818,0,0,0
4,2.5,2940,7590,2.0,0,0,3,9,2940,0,1991,0,98058,47.4341,-122.16,2550,8360,435000,23,12,2014,0,23,4650,5810,0,0,0
3,2.5,2020,3000,1.0,0,0,4,6,1010,1010,1910,0,98118,47.5621,-122.291,1670,3000,400000,11,7,2014,0,104,980,1330,0,1,1
3,1.0,950,6951,1.0,0,0,4,7,950,0,1950,0,98125,47.7263,-122.3,1410,7200,395000,6,4,2015,0,65,6001,5790,0,0,1
2,1.0,1250,4320,1.0,0,0,4,7,850,400,1911,0,98103,47.6549,-122.352,1520,4320,575000,4,3,2015,0,104,3070,2800,0,1,1
3,1.75,1300,5120,1.5,0,0,4,6,1300,0,1925,0,98116,47.5589,-122.394,1090,5124,515000,23,4,2015,0,90,3820,4034,0,0,1
4,3.25,2520,3360,1.5,0,0,4,8,1550,970,1931,0,98115,47.6801,-122.315,1730,3360,618250,19,6,2014,0,83,840,1630,0,1,1
3,1.5,1330,7125,2.0,0,0,3,7,1330,0,1968,0,98034,47.7308,-122.194,1570,7350,245000,19,2,2015,0,47,5795,5780,0,0,0
3,2.75,2480,3240,1.5,0,0,3,9,1890,590,1929,0,98112,47.6399,-122.311,2160,3240,690000,10,10,2014,0,85,760,1080,0,1,1
5,2.25,3020,10010,1.0,0,0,3,7,1510,1510,1959,0,98027,47.5249,-122.044,1760,10878,465000,6,11,2014,0,55,6990,9118,0,1,0
3,1.75,1770,8240,1.0,0,0,4,7,1240,530,1978,0,98023,47.3066,-122.378,2060,8250,280000,20,11,2014,0,36,6470,6190,0,1,0
3,1.75,1930,6533,1.0,0,0,3,7,1230,700,1960,0,98055,47.4883,-122.221,2030,5954,285000,16,3,2015,0,55,4603,3924,0,1,0
3,2.25,1650,7047,2.0,0,0,3,7,1650,0,1994,0,98038,47.3826,-122.027,2010,7763,320000,16,3,2015,0,21,5397,5753,0,0,0
4,3.0,2580,9601,2.0,0,0,4,7,2130,450,1992,0,98070,47.3726,-122.433,1900,10092,355000,13,2,2015,0,23,7021,8192,0,1,0
3,2.0,2570,10078,1.5,0,0,3,8,2570,0,1965,0,98008,47.6275,-122.12,2660,8013,670000,27,4,2015,0,50,7508,5353,0,0,0
1,1.0,2880,7560,1.0,0,0,3,7,1440,1440,1925,2014,98126,47.537,-122.375,1400,5040,550000,24,9,2014,89,89,4680,3640,1,1,1
4,2.75,2660,4500,1.5,0,0,5,8,1860,800,1909,0,98103,47.6864,-122.347,1830,4000,765000,15,10,2014,0,105,1840,2170,0,1,1
3,1.0,1560,5225,1.5,0,0,3,7,1260,300,1927,0,98118,47.5554,-122.279,1560,5322,430000,30,10,2014,0,87,3665,3762,0,1,1
3,2.5,3080,8448,2.0,0,2,3,9,3080,0,2000,0,98199,47.6469,-122.389,2500,6400,950000,27,8,2014,0,14,5368,3900,0,0,1
4,1.75,2540,7200,1.0,0,0,4,7,1270,1270,1947,0,98118,47.5579,-122.271,1650,7200,525000,15,10,2014,0,67,4660,5550,0,1,1
6,2.5,3080,8163,1.0,0,0,3,7,1580,1500,1985,0,98030,47.3859,-122.221,1850,8658,300000,20,10,2014,0,29,5083,6808,0,1,0
3,2.75,2190,7258,2.0,0,0,3,8,2190,0,2000,0,98003,47.3486,-122.301,2190,8645,345000,17,4,2015,0,15,5068,6455,0,0,0
4,2.25,1830,5720,2.0,0,0,3,7,1830,0,2003,0,98030,47.3604,-122.179,1960,5754,295000,23,7,2014,0,11,3890,3794,0,0,0
4,4.0,3180,7650,2.0,0,0,3,8,2530,650,1920,0,98115,47.6887,-122.319,2000,4080,775000,17,10,2014,0,94,4470,2080,0,1,1
3,2.5,1880,6047,2.0,0,0,3,8,1880,0,1993,0,98038,47.3722,-122.044,2120,7188,380000,18,3,2015,0,22,4167,5068,0,0,0
3,1.0,1140,8180,1.0,0,0,3,7,1140,0,1959,0,98005,47.5851,-122.172,1510,8588,550000,27,4,2015,0,56,7040,7078,0,0,0
3,1.75,1670,5209,1.5,0,0,5,7,1670,0,1908,0,98118,47.5362,-122.271,1990,4960,329900,16,9,2014,0,106,3539,2970,0,0,1
3,2.25,2580,11060,1.0,0,0,3,8,2580,0,1964,0,98005,47.6113,-122.164,2580,13868,898000,1,9,2014,0,50,8480,11288,0,0,0
4,2.5,2790,7956,2.0,0,0,3,9,2790,0,2005,0,98198,47.3681,-122.31,1660,8192,375000,16,5,2014,0,9,5166,6532,0,0,1
3,2.5,2190,5091,2.0,0,0,3,8,2190,0,2004,0,98038,47.3506,-122.039,2200,5948,365000,8,8,2014,0,10,2901,3748,0,0,0
4,2.75,2280,2850,1.5,0,0,4,7,1540,740,1930,0,98115,47.6871,-122.307,1680,3800,530000,8,5,2014,0,84,570,2120,0,1,1
3,1.0,1100,5200,1.0,0,0,4,6,1100,0,1969,0,98042,47.3643,-122.081,920,5200,225500,18,3,2015,0,46,4100,4280,0,0,0
4,2.25,2180,7000,1.0,0,0,3,8,1680,500,1969,0,98055,47.4651,-122.192,2000,8000,318000,17,11,2014,0,45,4820,6000,0,1,0
4,2.5,2770,9798,2.0,0,0,4,9,2770,0,1986,0,98027,47.562,-122.081,3040,11100,910000,1,4,2015,0,29,7028,8060,0,0,0
3,1.0,1980,18730,1.0,0,0,4,7,1280,700,1943,0,98001,47.3221,-122.282,1356,9450,207000,8,10,2014,0,71,16750,8094,0,1,0
5,3.5,4180,17935,2.0,0,0,3,11,4180,0,2004,0,98004,47.5873,-122.202,2950,13760,1890000,30,5,2014,0,10,13755,10810,0,0,0
3,2.5,1690,1553,2.5,0,0,3,8,1690,0,2007,0,98199,47.6443,-122.385,1910,1553,640000,4,6,2014,0,7,-137,-357,0,0,1
5,1.75,2250,8970,1.0,0,0,4,7,1500,750,1966,0,98034,47.7217,-122.188,1940,8710,390000,4,3,2015,0,49,6720,6770,0,1,0
3,2.25,2080,2050,1.5,0,0,3,7,1550,530,2003,0,98042,47.4199,-122.157,2080,2275,284000,29,7,2014,0,11,-30,195,0,1,0
3,2.5,2588,5702,2.0,0,0,3,8,2588,0,2008,0,98042,47.3453,-122.151,2403,5703,306000,17,3,2015,0,7,3114,3300,0,0,0
4,1.75,2570,12039,1.0,0,0,3,8,1910,660,1978,0,98074,47.626,-122.048,2200,12384,495000,19,9,2014,0,36,9469,10184,0,1,0
3,1.0,1070,10563,1.0,0,0,3,7,1070,0,1969,0,98072,47.7687,-122.166,1840,9638,330000,10,11,2014,0,45,9493,7798,0,0,0
3,2.0,1940,5820,1.5,0,0,5,7,1150,790,1944,0,98107,47.6638,-122.362,990,3880,665000,13,5,2014,0,70,3880,2890,0,1,1
3,2.5,2650,2387,2.0,0,0,3,8,1830,820,1920,0,98119,47.6315,-122.362,1870,2216,850000,30,6,2014,0,94,-263,346,0,1,1
4,2.5,2290,6318,2.0,0,0,4,8,2290,0,1988,0,98029,47.57,-122.02,2150,7350,599950,11,9,2014,0,26,4028,5200,0,0,0
4,2.5,2050,9143,2.0,0,0,3,8,2050,0,1992,0,98166,47.4597,-122.355,1510,9484,360000,22,10,2014,0,22,7093,7974,0,0,1
3,2.5,2680,5497,2.0,0,0,3,9,2680,0,2001,0,98052,47.7043,-122.128,2780,5497,699000,27,8,2014,0,13,2817,2717,0,0,0
3,1.75,1520,8100,1.0,0,0,5,6,760,760,1945,0,98117,47.6966,-122.375,1040,8100,475000,13,3,2015,0,70,6580,7060,0,1,1
2,1.5,1180,844,2.0,0,0,3,7,990,190,2005,0,98144,47.5998,-122.3,1170,1400,345000,27,5,2014,0,9,-336,230,0,1,1
4,2.5,3030,9500,2.0,0,0,3,8,3030,0,1989,0,98001,47.3511,-122.287,2650,9500,367950,30,4,2015,0,26,6470,6850,0,0,0
3,2.25,1400,11400,2.0,0,0,3,8,1400,0,1984,0,98028,47.7428,-122.231,2180,9248,374500,25,6,2014,0,30,10000,7068,0,0,0
4,2.5,3000,8100,2.0,0,0,3,8,3000,0,1992,0,98125,47.7151,-122.305,1550,8100,607500,4,8,2014,0,22,5100,6550,0,0,1
3,1.0,1200,9800,1.0,0,0,4,7,1200,0,1971,0,98072,47.7412,-122.109,1220,10220,374000,30,5,2014,0,43,8600,9000,0,0,0
3,1.0,1000,6947,1.0,0,0,3,7,1000,0,1947,0,98125,47.7142,-122.319,1000,6947,390000,3,9,2014,0,67,5947,5947,0,0,1
4,3.25,2740,5339,2.5,0,0,3,9,2740,0,2004,0,98103,47.6706,-122.356,1770,4820,705000,7,4,2015,0,11,2599,3050,0,0,1
3,2.5,1990,4978,2.0,0,0,3,8,1990,0,2004,0,98065,47.5323,-121.856,2650,6816,467000,29,10,2014,0,10,2988,4166,0,0,0
3,3.0,2110,7794,1.0,0,0,3,6,2110,0,1981,0,98198,47.4005,-122.293,1330,10044,243500,14,8,2014,0,33,5684,8714,0,0,1
3,2.75,1830,1850,2.0,0,0,3,10,1690,140,2011,0,98027,47.5307,-122.074,2310,2680,593000,7,7,2014,0,3,20,370,0,1,0
3,1.0,940,7980,1.0,0,0,3,6,940,0,1961,0,98146,47.5107,-122.345,1050,7980,223000,14,11,2014,0,53,7040,6930,0,0,1
4,2.5,2980,10179,2.0,0,2,3,9,2980,0,2003,0,98038,47.3895,-122.033,2980,8828,574000,20,4,2015,0,12,7199,5848,0,0,0
3,2.0,2260,11305,1.0,0,0,3,7,1130,1130,1986,0,98055,47.4544,-122.204,2080,10248,400000,4,6,2014,0,28,9045,8168,0,1,0
3,1.75,1510,10450,1.0,0,0,4,7,1510,0,1964,0,98052,47.684,-122.113,1310,9450,593777,1,5,2015,0,51,8940,8140,0,0,0
4,3.5,2710,5722,2.0,0,0,4,8,2040,670,1997,0,98108,47.5591,-122.302,2500,5722,539500,23,12,2014,0,17,3012,3222,0,1,1
3,2.5,2080,2625,2.0,0,0,3,8,2080,0,2006,0,98029,47.5469,-121.997,1760,2772,550000,1,4,2015,0,9,545,1012,0,0,0
2,2.0,1860,10856,1.0,0,0,3,8,1260,600,1952,0,98178,47.4989,-122.265,1250,10008,265000,30,6,2014,0,62,8996,8758,0,1,1
3,1.75,2120,9350,1.0,0,0,3,7,1280,840,1979,0,98072,47.7562,-122.145,2200,9000,428000,2,10,2014,0,35,7230,6800,0,1,0
3,2.0,1110,8375,1.0,0,0,5,7,1110,0,1951,0,98115,47.6978,-122.297,1410,7734,505000,28,4,2015,0,64,7265,6324,0,0,1
5,5.5,5190,12637,2.0,0,2,3,11,5190,0,2001,0,98065,47.5424,-121.872,3840,12637,925000,1,7,2014,0,13,7447,8797,0,0,0
3,1.75,1520,15344,1.0,0,0,3,8,1520,0,1968,0,98023,47.3308,-122.365,2270,14981,230000,2,1,2015,0,47,13824,12711,0,0,0
4,2.5,2650,9990,2.0,0,0,3,10,2650,0,1990,0,98029,47.5605,-122.016,2710,8012,695000,20,8,2014,0,24,7340,5302,0,0,0
4,2.75,3350,7857,2.0,0,2,3,9,3350,0,2004,0,98065,47.5398,-121.859,3870,7886,700000,14,4,2015,0,11,4507,4016,0,0,0
3,1.75,1770,2800,1.5,0,0,3,7,1770,0,1914,0,98103,47.6631,-122.357,1630,3254,712500,25,4,2015,0,101,1030,1624,0,0,1
3,2.5,2200,4692,2.0,0,0,3,8,2200,0,2005,0,98011,47.7761,-122.169,2440,3833,480000,3,4,2015,0,10,2492,1393,0,0,0
3,2.5,2000,8424,1.0,0,0,4,7,1300,700,1968,0,98034,47.7089,-122.201,2110,8400,470000,22,9,2014,0,46,6424,6290,0,1,0
3,1.5,1300,7907,1.0,0,0,3,7,900,400,1970,0,98030,47.3737,-122.224,1630,7600,270000,17,4,2015,0,45,6607,5970,0,1,0
3,3.0,1720,954,3.0,0,0,3,8,1460,260,2006,0,98119,47.648,-122.358,1720,1294,589000,12,8,2014,0,8,-766,-426,0,1,1
2,1.0,880,4558,1.0,0,0,3,7,880,0,1951,0,98115,47.6803,-122.287,1370,5243,415000,26,9,2014,0,63,3678,3873,0,0,1
4,2.25,1790,13200,1.0,0,0,3,7,1220,570,1979,0,98058,47.4672,-122.185,1740,8950,197000,11,3,2015,0,36,11410,7210,0,1,0
3,1.5,1380,7600,1.0,0,0,4,7,790,590,1971,0,98003,47.3489,-122.306,1570,7904,235500,25,8,2014,0,43,6220,6334,0,1,0
3,2.25,1530,1840,2.0,0,0,3,8,1240,290,2008,0,98144,47.587,-122.301,1800,3431,460000,7,4,2015,0,7,310,1631,0,1,1
5,1.75,2330,4947,1.0,0,0,4,8,1380,950,1955,0,98136,47.5352,-122.392,2120,5605,572500,29,10,2014,0,59,2617,3485,0,1,1
5,2.0,1540,9629,1.0,0,0,4,7,1540,0,1960,0,98059,47.4915,-122.143,2260,9600,302000,24,9,2014,0,54,8089,7340,0,0,0
3,2.5,3210,8630,2.0,0,0,4,10,2530,680,1990,0,98033,47.6939,-122.189,2630,8630,870000,13,8,2014,0,24,5420,6000,0,1,0
3,1.0,1130,5758,1.0,0,0,3,7,960,170,1939,0,98199,47.6413,-122.401,1510,6000,485000,7,10,2014,0,75,4628,4490,0,1,1
3,2.0,1460,7526,1.0,0,0,3,7,1460,0,1968,0,98003,47.3463,-122.304,1580,7526,240000,5,2,2015,0,47,6066,5946,0,0,0
3,1.75,1410,7215,1.0,0,0,3,7,1410,0,1967,0,98034,47.7343,-122.193,1550,7600,383000,22,10,2014,0,47,5805,6050,0,0,0
4,2.75,1750,5080,1.5,0,0,3,8,1750,0,1903,0,98122,47.6143,-122.305,1700,4572,750000,26,6,2014,0,111,3330,2872,0,0,1
2,1.75,1370,5125,1.0,0,0,5,6,1370,0,1944,0,98103,47.6926,-122.346,1200,5100,409950,3,6,2014,0,70,3755,3900,0,0,1
4,1.75,1890,4500,2.0,0,0,5,7,1490,400,1937,0,98115,47.6751,-122.289,1890,5000,860000,3,4,2015,0,78,2610,3110,0,1,1
3,2.25,1630,12295,2.0,0,0,4,7,1630,0,1985,0,98058,47.4279,-122.161,1730,9948,339950,7,5,2014,0,29,10665,8218,0,0,0
5,1.75,2320,8100,1.0,0,0,4,7,1160,1160,1956,0,98166,47.4631,-122.341,1410,7271,315000,9,5,2014,0,58,5780,5861,0,1,1
3,2.5,2580,4636,2.0,0,0,3,9,2580,0,2006,0,98074,47.6201,-122.025,2480,4500,698000,13,8,2014,0,8,2056,2020,0,0,0
2,2.5,1470,2034,2.0,0,0,4,8,1470,0,1985,0,98007,47.6213,-122.153,1510,2055,419000,22,8,2014,0,29,564,545,0,0,0
3,2.5,1960,4709,2.0,0,0,3,7,1960,0,2003,0,98065,47.5322,-121.871,1700,4444,425000,11,9,2014,0,11,2749,2744,0,0,0
3,2.25,2950,8036,1.5,0,0,3,8,1950,1000,1963,0,98125,47.7239,-122.313,2060,7200,386500,24,7,2014,0,51,5086,5140,0,1,1
2,1.0,670,7312,1.0,0,0,3,5,670,0,1942,0,98125,47.7145,-122.285,860,8242,348000,17,11,2014,0,72,6642,7382,0,0,1
5,3.5,3020,15305,2.0,0,0,3,10,2230,790,1978,0,98040,47.5627,-122.216,3680,14486,754000,24,4,2015,0,37,12285,10806,0,1,0
4,3.0,2390,7309,2.0,0,0,4,7,2390,0,1944,1981,98002,47.294,-122.218,930,7308,269950,15,12,2014,37,70,4919,6378,1,0,0
4,1.75,1780,5000,1.0,0,0,5,7,890,890,1903,0,98108,47.5329,-122.292,1860,5000,349950,9,10,2014,0,111,3220,3140,0,1,1
4,2.25,2420,15482,2.0,0,0,4,8,2420,0,1925,1997,98004,47.5907,-122.196,2870,13905,975000,9,12,2014,72,89,13062,11035,1,0,0
4,2.0,1480,3844,1.5,0,0,5,7,1480,0,1928,0,98133,47.7042,-122.352,1480,3844,449250,5,5,2014,0,86,2364,2364,0,0,1
4,2.25,2190,3850,2.0,0,0,3,7,2190,0,2006,0,98059,47.4854,-122.16,1900,3850,350000,1,12,2014,0,8,1660,1950,0,0,0
4,1.75,1820,6137,1.5,0,3,4,7,1690,130,1911,0,98107,47.6681,-122.36,2130,5100,790000,1,4,2015,0,104,4317,2970,0,1,1
3,2.25,2550,4089,2.0,0,0,3,9,2550,0,1983,0,98112,47.6272,-122.297,1680,4089,834000,1,12,2014,0,31,1539,2409,0,0,1
3,1.0,1360,3880,1.0,0,0,3,7,1060,300,1963,0,98117,47.6837,-122.391,1110,3880,466950,14,8,2014,0,51,2520,2770,0,1,1
4,2.5,3880,14550,2.0,0,0,3,10,3880,0,1987,0,98074,47.6378,-122.04,3240,14045,762300,6,5,2014,0,27,10670,10805,0,0,0
6,2.75,2730,5000,1.0,0,0,3,8,1780,950,1962,0,98107,47.6751,-122.38,2090,5000,733000,26,1,2015,0,53,2270,2910,0,1,1
4,2.5,2800,17279,1.0,0,2,3,7,1560,1240,1957,0,98028,47.7596,-122.269,3060,13423,439000,14,4,2015,0,58,14479,10363,0,1,0
5,3.25,4290,7019,2.5,0,0,4,10,3590,700,1927,0,98112,47.6439,-122.302,1920,4000,1160000,12,11,2014,0,87,2729,2080,0,1,1
3,2.5,1770,3993,2.0,0,0,3,8,1770,0,1999,0,98074,47.6027,-122.02,1820,4046,420000,8,10,2014,0,15,2223,2226,0,0,0
3,2.25,1920,10961,2.0,0,0,3,8,1920,0,1981,0,98074,47.6432,-122.057,2000,10706,549000,18,7,2014,0,33,9041,8706,0,0,0
4,2.5,2320,4000,1.5,0,0,5,8,1510,810,1905,0,98122,47.6048,-122.298,1490,4500,518000,26,8,2014,0,109,1680,3010,0,1,1
3,2.5,1680,7385,2.0,0,0,3,8,1680,0,1988,0,98074,47.6194,-122.041,1970,7470,485000,5,1,2015,0,27,5705,5500,0,0,0
2,1.0,1370,9460,1.0,0,0,3,6,1370,0,1950,0,98004,47.6238,-122.191,1690,9930,720000,21,3,2015,0,65,8090,8240,0,0,0
3,2.5,2620,4558,2.0,0,3,3,7,2620,0,2010,0,98022,47.1944,-121.974,1670,4558,277500,18,11,2014,0,4,1938,2888,0,0,0
2,1.0,700,6000,1.0,0,0,4,6,700,0,1949,0,98155,47.7515,-122.316,920,6000,267800,14,5,2014,0,65,5300,5080,0,0,1
4,2.75,2390,6979,2.0,0,0,3,8,2390,0,1993,0,98029,47.5703,-121.996,2090,6321,625000,25,3,2015,0,22,4589,4231,0,0,0
4,2.5,2070,8127,1.5,0,0,3,9,1590,480,1924,2003,98125,47.7316,-122.289,2050,8131,600000,17,9,2014,79,90,6057,6081,1,1,1
4,2.0,1780,8149,1.5,0,0,4,7,1780,0,1948,0,98155,47.745,-122.302,1180,8149,395000,17,10,2014,0,66,6369,6969,0,0,1
2,1.0,1040,4040,1.0,0,0,3,7,940,100,1928,0,98117,47.6829,-122.393,1420,4040,425000,12,12,2014,0,86,3000,2620,0,1,1
4,1.75,2370,5000,1.5,0,2,3,8,1770,600,1919,0,98103,47.6779,-122.357,2100,4550,870000,11,5,2015,0,96,2630,2450,0,1,1
3,2.5,1970,3667,2.0,0,0,3,7,1970,0,2004,0,98065,47.5321,-121.851,1970,3739,420000,25,3,2015,0,11,1697,1769,0,0,0
4,2.25,2120,9921,2.0,0,0,3,8,2120,0,1981,0,98027,47.5593,-122.082,1890,7845,800000,3,4,2015,0,34,7801,5955,0,0,0
3,2.5,1960,9535,2.0,0,0,3,8,1960,0,1989,0,98011,47.7371,-122.215,2520,9206,575000,6,5,2015,0,26,7575,6686,0,0,0
3,3.25,2660,4000,2.0,0,0,3,9,2170,490,2003,0,98122,47.6186,-122.288,2660,4000,915000,20,6,2014,0,11,1340,1340,0,1,1
3,2.25,1180,14258,2.0,0,0,3,7,1180,0,1987,0,98034,47.7112,-122.238,1860,10390,400000,3,9,2014,0,27,13078,8530,0,0,0
3,2.5,2390,6550,1.0,0,2,4,8,1440,950,1955,0,98116,47.5714,-122.408,2010,6550,750000,2,5,2014,0,59,4160,4540,0,1,1
3,1.0,1250,7592,1.0,0,0,5,7,1250,0,1961,0,98042,47.3604,-122.111,1250,7592,235000,3,11,2014,0,53,6342,6342,0,0,0
5,3.0,2600,13674,1.0,0,0,5,8,1300,1300,1967,0,98125,47.7176,-122.302,2150,7800,599950,12,11,2014,0,47,11074,5650,0,1,1
2,1.0,940,3800,1.0,0,0,3,7,940,0,1929,0,98115,47.6798,-122.292,1680,3800,481203,27,3,2015,0,86,2860,2120,0,0,1
5,3.0,3880,13000,2.0,0,0,3,10,3880,0,1972,2003,98040,47.5467,-122.234,3470,13701,1820000,19,6,2014,31,42,9120,10231,1,0,0
3,2.5,1530,2913,2.0,0,0,4,7,1530,0,1986,0,98033,47.6939,-122.184,1370,3783,379000,9,7,2014,0,28,1383,2413,0,0,0
3,1.75,2430,5000,2.0,0,0,4,7,1760,670,1945,0,98117,47.6785,-122.372,1320,4062,626000,26,6,2014,0,69,2570,2742,0,1,1
2,1.0,1030,4841,1.0,0,0,3,7,920,110,1939,0,98103,47.686,-122.341,1530,4944,535000,21,5,2014,0,75,3811,3414,0,1,1
2,1.5,1180,1034,2.0,0,0,3,7,1120,60,2001,0,98115,47.678,-122.322,1137,1034,410000,24,7,2014,0,13,-146,-103,0,1,1
4,2.5,3090,9238,1.0,0,3,4,8,1680,1410,1967,0,98006,47.5654,-122.163,2690,8500,940000,10,2,2015,0,48,6148,5810,0,1,0
3,1.0,1060,9663,1.0,0,0,3,7,1060,0,1967,0,98034,47.7244,-122.226,1320,10162,326250,21,7,2014,0,47,8603,8842,0,0,0
2,1.0,790,5985,1.0,0,0,3,6,790,0,1944,0,98178,47.4941,-122.24,1030,5985,200000,5,9,2014,0,70,5195,4955,0,0,1
4,2.5,3070,8250,1.0,0,0,5,8,2100,970,1958,0,98005,47.5935,-122.172,2270,8800,880000,13,8,2014,0,56,5180,6530,0,1,0
2,2.5,1100,1737,2.0,0,0,3,8,1100,0,2006,0,98055,47.4499,-122.189,1610,2563,190000,1,8,2014,0,8,637,953,0,0,0
2,1.0,1070,4200,1.0,0,0,4,6,1070,0,1983,0,98002,47.3336,-122.215,1150,4200,160000,29,1,2015,0,32,3130,3050,0,0,0
4,3.0,2190,12825,1.0,0,0,3,9,1520,670,1989,0,98034,47.7107,-122.229,3050,4673,625000,23,8,2014,0,25,10635,1623,0,1,0
4,3.5,3450,6873,2.0,0,0,3,10,2750,700,2004,0,98058,47.459,-122.118,3450,6873,590000,7,5,2015,0,11,3423,3423,0,1,0
3,2.5,2070,3599,2.0,0,0,3,8,2070,0,1999,0,98033,47.6679,-122.165,2070,6844,575000,5,8,2014,0,15,1529,4774,0,0,0
2,1.0,1190,5200,1.0,0,0,5,7,1190,0,1912,0,98103,47.6939,-122.348,1550,5100,470000,13,10,2014,0,102,4010,3550,0,0,1
2,1.0,600,1500,1.0,0,0,4,4,600,0,1900,0,98027,47.5289,-122.033,1130,6000,130000,11,3,2015,0,115,900,4870,0,0,0
3,1.0,940,8400,1.0,0,0,3,7,940,0,1958,0,98056,47.5108,-122.165,1190,8400,229000,21,4,2015,0,57,7460,7210,0,0,0
3,1.0,1370,7500,1.0,0,0,3,7,1370,0,1960,0,98014,47.6499,-121.915,1160,7500,307000,19,5,2014,0,54,6130,6340,0,0,0
4,2.25,1970,15743,1.0,0,0,3,7,1370,600,1962,0,98011,47.7673,-122.202,2390,11336,405000,1,8,2014,0,52,13773,8946,0,1,0
4,2.75,2910,9000,1.0,0,0,4,8,2130,780,1966,0,98006,47.544,-122.176,1970,9000,539950,7,10,2014,0,48,6090,7030,0,1,0
2,1.0,760,5240,1.0,0,0,3,6,760,0,1949,0,98032,47.388,-122.234,980,5080,129000,7,11,2014,0,65,4480,4100,0,0,0
3,1.75,1270,8422,1.0,0,0,3,7,1270,0,1967,0,98011,47.7601,-122.197,1470,8500,340000,17,9,2014,0,47,7152,7030,0,0,0
3,1.75,1570,4875,1.0,0,0,4,7,1310,260,1977,0,98042,47.3621,-122.094,1380,5200,214950,11,6,2014,0,37,3305,3820,0,1,0
4,2.75,2310,5650,1.0,0,2,3,8,1330,980,1952,2012,98118,47.513,-122.252,2300,5650,450000,25,6,2014,60,62,3340,3350,1,1,1
3,1.75,1900,5000,1.0,0,0,4,7,950,950,1925,0,98106,47.5677,-122.363,1420,5000,515000,4,3,2015,0,90,3100,3580,0,1,1
4,2.25,3780,5160,2.0,0,0,4,9,2510,1270,1907,0,98112,47.6275,-122.308,2740,5160,1400000,22,8,2014,0,107,1380,2420,0,1,1
3,1.0,1060,9946,1.0,0,0,4,7,1060,0,1956,0,98188,47.4432,-122.282,1310,10619,230000,26,6,2014,0,58,8886,9309,0,0,1
3,1.75,1880,10032,1.0,0,0,4,8,1880,0,1984,0,98006,47.5527,-122.16,2430,9732,681000,7,7,2014,0,30,8152,7302,0,0,0
3,1.0,1160,8636,1.0,0,0,3,6,1160,0,1923,0,98146,47.5097,-122.357,1300,8636,255000,29,9,2014,0,91,7476,7336,0,0,1
2,1.0,860,4013,1.0,0,0,3,7,860,0,1925,0,98103,47.6652,-122.338,1490,4013,580000,13,3,2015,0,90,3153,2523,0,0,1
2,2.0,1590,8000,1.0,0,0,3,7,910,680,1984,0,98055,47.459,-122.205,1590,8364,295000,17,3,2015,0,31,6410,6774,0,1,0
2,1.0,1170,6543,1.0,0,0,3,7,1170,0,1913,0,98136,47.537,-122.385,1550,7225,286000,30,7,2014,0,101,5373,5675,0,0,1
3,1.5,1190,8100,1.0,0,0,3,7,830,360,1947,0,98125,47.7146,-122.311,1256,8100,425000,8,1,2015,0,68,6910,6844,0,1,1
2,1.0,1300,11400,1.0,0,0,3,7,1300,0,1961,0,98003,47.3459,-122.299,1360,9750,170000,12,12,2014,0,53,10100,8390,0,0,0
3,2.0,1660,8281,1.0,0,0,3,7,1660,0,1949,0,98136,47.5568,-122.382,1660,7559,380000,28,5,2014,0,65,6621,5899,0,0,1
3,2.0,1160,6120,1.0,0,0,3,7,1160,0,1947,0,98115,47.6853,-122.293,1150,5100,506000,6,5,2015,0,68,4960,3950,0,0,1
3,2.5,1950,9618,2.0,0,0,3,7,1950,0,1992,0,98031,47.4068,-122.18,1890,7133,315000,22,9,2014,0,22,7668,5243,0,0,0
4,2.5,2470,3811,2.0,0,0,3,8,2470,0,1999,0,98065,47.5362,-121.877,2400,4266,449950,17,6,2014,0,15,1341,1866,0,0,0
3,1.0,1430,12420,1.0,0,0,3,7,1430,0,1964,0,98056,47.5116,-122.191,1900,10350,255000,31,3,2015,0,51,10990,8450,0,0,0
3,2.5,1970,9607,2.0,0,0,3,7,1090,880,1988,0,98001,47.3462,-122.286,2020,9608,289000,24,6,2014,0,26,7637,7588,0,1,0
3,1.75,1400,10018,1.0,0,0,4,7,1400,0,1962,0,98027,47.5327,-122.032,1350,9300,389000,28,8,2014,0,52,8618,7950,0,0,0
7,3.0,5350,14400,2.5,0,0,4,10,5020,330,1910,0,98112,47.6295,-122.285,3050,7469,2890000,26,9,2014,0,104,9050,4419,0,1,1
3,1.0,920,6612,1.0,0,0,3,6,920,0,1948,0,98118,47.548,-122.284,1860,8424,210000,14,7,2014,0,66,5692,6564,0,0,1
4,2.5,2490,4751,2.0,0,0,3,7,2490,0,2001,0,98056,47.4813,-122.188,2510,5233,360000,29,12,2014,0,13,2261,2723,0,0,0
4,2.25,1650,7200,1.0,0,0,3,8,1650,0,1967,0,98008,47.6384,-122.116,2180,7950,550000,4,11,2014,0,47,5550,5770,0,0,0
3,1.5,1210,12500,1.0,0,0,3,7,1210,0,1962,0,98146,47.503,-122.351,1210,12500,257500,17,7,2014,0,52,11290,11290,0,0,1
4,2.75,2990,7389,1.5,0,0,4,8,2090,900,1923,0,98144,47.5711,-122.284,2510,6157,1080000,10,12,2014,0,91,4399,3647,0,1,1
2,1.0,1060,5144,1.0,0,0,5,6,1060,0,1969,0,98042,47.3613,-122.088,1130,5200,202950,28,10,2014,0,45,4084,4070,0,0,0
4,1.75,2680,6120,1.0,0,0,5,8,1340,1340,1959,0,98117,47.6965,-122.393,2320,6840,622000,30,10,2014,0,55,3440,4520,0,1,1
2,1.0,770,9497,1.0,0,0,3,6,770,0,1950,0,98133,47.7407,-122.351,1550,7532,257000,8,9,2014,0,64,8727,5982,0,0,1
5,2.5,2700,16570,1.0,0,0,4,8,1750,950,1967,0,98005,47.6144,-122.167,2570,11840,744500,25,6,2014,0,47,13870,9270,0,1,0
4,2.5,2620,9157,2.0,0,0,3,8,2620,0,1996,0,98033,47.6916,-122.203,2240,7405,885000,13,4,2015,0,19,6537,5165,0,0,0
2,2.25,930,747,2.0,0,0,3,8,630,300,2007,0,98144,47.5844,-122.316,940,6000,355000,24,6,2014,0,7,-183,5060,0,1,1
3,1.0,1340,7000,1.0,0,0,4,7,1340,0,1978,0,98042,47.3742,-122.149,1850,7904,240000,20,8,2014,0,36,5660,6054,0,0,0
3,2.5,2330,4160,2.0,0,0,4,8,2330,0,1992,0,98052,47.6367,-122.109,2940,4500,639900,28,3,2015,0,23,1830,1560,0,0,0
4,2.5,2780,7838,2.0,0,3,3,9,2780,0,2004,0,98065,47.5312,-121.861,3160,7848,563500,22,9,2014,0,10,5058,4688,0,0,0
2,2.0,1200,7131,1.0,0,0,3,8,1200,0,2006,0,98053,47.7199,-122.022,1670,4601,389000,26,1,2015,0,9,5931,2931,0,0,0
3,2.0,1820,4418,2.0,0,0,4,8,1820,0,1994,0,98033,47.6947,-122.19,1920,13402,661000,21,8,2014,0,20,2598,11482,0,0,0
2,2.0,1300,4659,1.0,0,0,3,8,1300,0,2005,0,98053,47.7132,-122.033,1640,4780,344000,12,9,2014,0,9,3359,3140,0,0,0
1,1.0,680,6600,1.0,0,0,3,5,480,200,1916,0,98199,47.6567,-122.392,1170,5500,510000,22,4,2015,0,99,5920,4330,0,1,1
2,1.0,780,4132,1.0,0,0,3,7,780,0,1942,0,98136,47.5324,-122.387,1100,5100,289000,16,9,2014,0,72,3352,4000,0,0,1
3,2.25,2430,7614,1.5,0,0,3,8,1900,530,1979,0,98056,47.5065,-122.191,1720,11250,365000,27,8,2014,0,35,5184,9530,0,1,0
3,1.0,1610,5100,1.5,0,0,5,7,1010,600,1901,0,98117,47.6765,-122.386,1270,5100,535610,24,7,2014,0,113,3490,3830,0,1,1
4,1.75,2120,7620,2.0,0,0,3,8,2120,0,1971,2002,98166,47.457,-122.346,1820,7620,397950,13,11,2014,31,43,5500,5800,1,0,1
3,1.75,1430,4850,1.0,0,0,3,7,930,500,1978,0,98108,47.5472,-122.303,1430,4850,284000,27,8,2014,0,36,3420,3420,0,1,1
4,1.5,1360,8100,1.5,0,0,3,7,1360,0,1962,0,98168,47.4931,-122.305,1300,8100,201000,17,12,2014,0,52,6740,6800,0,0,1
4,2.25,2530,5000,1.5,0,0,4,7,1690,840,1925,0,98117,47.6806,-122.36,1530,5000,734000,15,12,2014,0,89,2470,3470,0,1,1
5,3.0,3270,9146,2.0,0,0,3,7,3270,0,2002,0,98092,47.3342,-122.169,3200,6300,357500,8,1,2015,0,13,5876,3100,0,0,0
5,2.5,2620,8050,1.0,0,0,3,8,1520,1100,1975,0,98052,47.6919,-122.115,2030,7676,550120,15,10,2014,0,39,5430,5646,0,1,0
3,1.5,1810,8232,1.0,0,0,3,8,1810,0,1988,0,98001,47.3195,-122.273,2260,8491,300000,10,3,2015,0,27,6422,6231,0,0,0
3,2.5,2120,9653,2.0,0,0,3,8,2120,0,1992,0,98030,47.3843,-122.213,1780,9801,374950,19,8,2014,0,22,7533,8021,0,0,0
3,1.0,980,7606,1.0,0,0,3,7,980,0,1954,0,98188,47.4356,-122.29,980,8125,221000,22,12,2014,0,60,6626,7145,0,0,1
5,3.0,2230,4400,2.0,0,0,3,7,1730,500,1913,0,98102,47.6404,-122.325,1280,1800,920000,10,4,2015,0,102,2170,520,0,1,1
4,2.0,1540,9279,1.0,0,0,3,7,1540,0,1955,0,98118,47.5163,-122.268,1540,5110,235000,6,3,2015,0,60,7739,3570,0,0,1
3,1.0,980,7296,1.0,0,0,3,7,980,0,1967,0,98034,47.7292,-122.231,1280,7296,375000,4,8,2014,0,47,6316,6016,0,0,0
4,2.5,2120,3640,2.0,0,0,3,8,2120,0,2005,0,98029,47.5521,-121.996,2190,3640,599000,27,8,2014,0,9,1520,1450,0,0,0
3,2.25,2090,12112,2.0,0,0,3,8,2090,0,1983,0,98052,47.7015,-122.13,1760,12112,562100,3,6,2014,0,31,10022,10352,0,0,0
3,2.5,1620,1377,2.0,0,0,3,8,1100,520,2009,0,98112,47.6195,-122.299,1620,1251,640000,16,3,2015,0,6,-243,-369,0,1,1
3,2.0,1650,11256,1.0,0,0,4,7,1250,400,1957,0,98168,47.4707,-122.26,1860,11256,294000,20,11,2014,0,57,9606,9396,0,1,1
4,2.5,3230,7766,2.0,0,0,3,9,3230,0,2005,0,98052,47.7069,-122.131,3740,8344,714000,29,12,2014,0,9,4536,4604,0,0,0
4,3.25,2790,5420,1.0,0,3,3,9,1130,1660,1963,2013,98177,47.7698,-122.386,2530,7200,970000,21,5,2014,50,51,2630,4670,1,1,1
4,2.25,1600,7916,2.0,0,0,3,7,1600,0,1991,0,98022,47.194,-121.981,1540,7242,280000,28,4,2015,0,24,6316,5702,0,0,0
4,2.5,1790,4358,2.0,0,0,3,7,1790,0,1993,0,98031,47.3994,-122.204,1790,4305,260000,12,11,2014,0,21,2568,2515,0,0,0
5,4.75,6200,13873,2.0,1,4,4,11,4440,1760,1989,0,98008,47.605,-122.112,2940,13525,3300000,4,9,2014,0,25,7673,10585,0,1,0
3,1.0,1280,9898,1.0,0,0,3,7,1280,0,1968,0,98072,47.7677,-122.163,1290,9625,368000,12,5,2014,0,46,8618,8335,0,0,0
4,2.25,2180,11056,1.0,0,0,3,8,1370,810,1963,0,98004,47.6042,-122.193,2090,8747,830000,10,11,2014,0,51,8876,6657,0,1,0
2,1.75,1440,11210,1.0,0,0,4,6,1130,310,1935,0,98146,47.498,-122.35,1250,9381,282500,15,7,2014,0,79,9770,8131,0,1,1
2,2.0,1580,5750,1.0,0,0,5,6,790,790,1910,0,98116,47.5668,-122.384,1580,5750,558000,7,7,2014,0,104,4170,4170,0,1,1
4,1.5,1730,8505,1.5,0,0,4,7,1730,0,1961,0,98146,47.4905,-122.347,1510,8505,270000,24,2,2015,0,54,6775,6995,0,0,1
2,1.0,700,13500,1.0,0,0,3,4,700,0,1920,0,98031,47.3882,-122.208,1600,10124,152000,25,7,2014,0,94,12800,8524,0,0,0
4,1.75,2030,18295,1.5,0,0,4,7,2030,0,1975,0,98034,47.7326,-122.179,1970,7307,493000,17,6,2014,0,39,16265,5337,0,0,0
4,2.5,2500,10330,2.0,0,0,3,10,2500,0,1992,0,98006,47.5595,-122.114,2710,8375,740000,15,8,2014,0,22,7830,5665,0,0,0
3,2.5,2605,2216,2.0,0,2,3,9,2090,515,1979,0,98033,47.6536,-122.203,2605,2300,789800,13,3,2015,0,36,-389,-305,0,1,0
2,1.0,910,4191,1.0,0,0,3,6,910,0,1910,0,98117,47.6929,-122.36,1480,6050,275000,8,5,2015,0,105,3281,4570,0,0,1
6,2.5,3560,6480,2.5,0,0,4,11,3560,0,1914,0,98112,47.627,-122.304,2780,6480,1500000,7,5,2014,0,100,2920,3700,0,0,1
3,1.75,1140,3395,1.0,0,0,5,7,620,520,1925,0,98107,47.6712,-122.393,1480,3500,424000,29,9,2014,0,89,2255,2020,0,1,1
2,1.0,1000,3513,1.0,0,4,4,5,1000,0,1914,0,98116,47.5935,-122.39,1930,4920,715000,27,3,2015,0,101,2513,2990,0,0,1
4,2.5,3010,7953,2.0,0,0,3,9,3010,0,2000,0,98056,47.522,-122.19,2670,6202,600000,30,7,2014,0,14,4943,3532,0,0,0
2,1.75,2110,8700,1.0,0,4,4,9,1760,350,1960,0,98146,47.4912,-122.365,2120,9500,802000,13,8,2014,0,54,6590,7380,0,1,1
3,1.0,910,8700,1.0,0,0,4,6,910,0,1943,0,98188,47.449,-122.29,1090,8700,165000,26,7,2014,0,71,7790,7610,0,0,1
4,3.25,2050,5000,2.0,0,0,4,8,1370,680,1987,0,98112,47.6235,-122.298,1720,5000,750000,9,6,2014,0,27,2950,3280,0,1,1
2,1.0,1090,10481,1.0,0,0,2,7,780,310,1981,0,98074,47.632,-122.03,1160,10533,405000,12,8,2014,0,33,9391,9373,0,1,0
3,2.5,2100,12338,2.0,0,0,3,9,2100,0,1997,0,98072,47.7412,-122.168,2320,6257,521900,3,12,2014,0,17,10238,3937,0,0,0
3,1.0,1000,8018,1.0,0,0,3,7,1000,0,1969,0,98034,47.7285,-122.198,1270,8000,275000,22,7,2014,0,45,7018,6730,0,0,0
3,1.75,1800,10200,1.0,0,0,3,8,1800,0,1967,0,98058,47.4496,-122.146,2140,10128,442500,19,5,2014,0,47,8400,7988,0,0,0
2,1.0,920,7716,1.0,0,0,3,6,920,0,1944,0,98178,47.5028,-122.243,1410,7128,229950,9,9,2014,0,70,6796,5718,0,0,1
3,2.0,1410,7265,1.0,0,0,4,7,1410,0,1983,0,98042,47.3654,-122.076,1390,8060,274950,20,1,2015,0,32,5855,6670,0,0,0
4,2.5,2100,8400,1.0,0,0,4,7,1240,860,1976,0,98072,47.735,-122.17,1980,8610,468000,9,7,2014,0,38,6300,6630,0,1,0
2,1.0,1030,4365,1.0,0,0,3,7,1030,0,1942,0,98117,47.6875,-122.387,1420,4268,450000,30,9,2014,0,72,3335,2848,0,0,1
2,1.0,940,8997,1.0,0,0,5,7,940,0,1955,0,98022,47.2005,-121.999,1110,9126,219950,23,10,2014,0,59,8057,8016,0,0,0
2,2.5,1340,5995,2.0,0,0,3,7,1340,0,1989,0,98028,47.7366,-122.233,1540,6616,275000,22,1,2015,0,26,4655,5076,0,0,0
2,1.0,850,6000,1.0,0,0,3,6,850,0,1924,0,98178,47.4972,-122.224,1100,6000,229950,10,4,2015,0,91,5150,4900,0,0,1
3,1.75,2130,4400,1.0,0,0,3,7,1430,700,1922,0,98102,47.6417,-122.325,1710,3300,675000,25,11,2014,0,92,2270,1590,0,1,1
4,2.5,2430,6796,2.0,0,0,3,8,2430,0,1993,0,98058,47.4499,-122.127,2450,8400,412950,23,3,2015,0,22,4366,5950,0,0,0
3,1.75,1230,10005,1.0,0,0,4,7,1230,0,1963,0,98008,47.621,-122.114,1530,8560,420000,23,9,2014,0,51,8775,7030,0,0,0
3,2.5,2120,3600,2.0,0,0,3,9,2120,0,2005,0,98052,47.6649,-122.082,2540,4592,680000,24,4,2015,0,10,1480,2052,0,0,0
2,1.0,980,3400,1.0,0,0,3,7,980,0,1923,0,98105,47.6688,-122.323,1200,3420,380000,4,11,2014,0,91,2420,2220,0,0,1
2,1.0,1050,4800,1.0,0,0,4,7,1050,0,1969,0,98146,47.5128,-122.388,1230,4800,325000,19,8,2014,0,45,3750,3570,0,0,1
3,2.5,1820,6848,1.0,0,0,4,7,1820,0,1953,0,98004,47.6287,-122.207,2080,11700,875000,4,12,2014,0,61,5028,9620,0,0,0
3,2.5,2210,5750,2.0,0,0,3,7,1710,500,1914,2000,98106,47.5525,-122.366,1350,5750,426000,20,4,2015,86,101,3540,4400,1,1,1
5,2.5,2490,9639,1.0,0,0,4,8,1610,880,1959,0,98040,47.551,-122.22,2290,9958,868500,15,9,2014,0,55,7149,7668,0,1,0
2,1.0,1210,3090,1.0,0,0,3,6,860,350,1926,0,98118,47.5532,-122.277,1210,3348,366000,18,9,2014,0,88,1880,2138,0,1,1
2,1.0,1010,4000,1.0,0,0,3,6,1010,0,1911,0,98118,47.5536,-122.267,1040,4000,385000,16,9,2014,0,103,2990,2960,0,0,1
4,2.0,2050,8750,1.0,0,0,3,7,1300,750,1967,0,98058,47.4324,-122.171,2050,8750,300000,8,9,2014,0,47,6700,6700,0,1,0
3,1.75,2060,3300,2.0,0,0,4,9,1500,560,1918,0,98102,47.6498,-122.32,1830,3712,810000,20,3,2015,0,97,1240,1882,0,1,1
4,1.75,1560,7200,1.0,0,0,3,6,860,700,1943,0,98115,47.7001,-122.279,1420,7200,460000,17,4,2015,0,72,5640,5780,0,1,1
3,2.5,1780,4000,2.0,0,0,4,8,1780,0,1995,0,98029,47.5677,-122.003,1730,4000,459000,21,10,2014,0,19,2220,2270,0,0,0
3,1.75,1460,10000,1.0,0,0,4,8,1460,0,1967,0,98092,47.342,-122.195,1930,14175,260000,19,3,2015,0,48,8540,12245,0,0,0
4,2.5,3030,6813,2.0,0,0,3,9,3030,0,1987,0,98074,47.6296,-122.029,2310,8682,557865,12,11,2014,0,27,3783,6372,0,0,0
4,1.0,980,3000,1.5,0,0,4,7,980,0,1914,0,98144,47.5892,-122.312,1525,3000,295000,20,4,2015,0,101,2020,1475,0,0,1
4,2.25,1450,7245,1.0,0,0,5,7,1450,0,1950,1983,98133,47.7643,-122.343,1660,7800,375000,5,9,2014,33,64,5795,6140,1,0,1
2,2.0,1520,1020,3.0,0,0,3,7,1520,0,1999,0,98133,47.7292,-122.343,1500,1245,307300,19,8,2014,0,15,-500,-255,0,0,1
4,1.0,1410,7000,1.5,0,0,3,7,1410,0,1963,0,98032,47.3767,-122.287,1540,7000,225000,27,8,2014,0,51,5590,5460,0,0,0
3,1.75,1390,13200,2.0,0,0,3,7,1390,0,1979,0,98045,47.4429,-121.771,1430,10725,290000,7,11,2014,0,35,11810,9295,0,0,0
4,2.0,2230,5000,1.5,0,0,4,7,1510,720,1922,0,98144,47.5772,-122.292,2140,5000,690000,20,11,2014,0,92,2770,2860,0,1,1
4,2.25,2110,12653,2.0,0,0,4,8,2110,0,1972,0,98040,47.536,-122.225,2350,10980,825000,5,7,2014,0,42,10543,8630,0,0,0
3,1.75,2270,11472,1.0,0,0,4,7,1370,900,1956,0,98177,47.7057,-122.374,2270,8340,645000,2,7,2014,0,58,9202,6070,0,1,1
4,2.25,2530,10611,1.0,0,0,5,8,1320,1210,1977,0,98006,47.5698,-122.132,2530,10125,590000,17,2,2015,0,38,8081,7595,0,1,0
5,2.0,1900,5470,1.0,0,0,3,7,1180,720,1930,1965,98105,47.6666,-122.303,1300,3250,667000,25,7,2014,35,84,3570,1950,1,1,1
4,2.5,2390,8432,2.0,0,0,3,9,2390,0,1998,0,98074,47.6027,-122.024,2710,7417,664000,25,9,2014,0,16,6042,4707,0,0,0
4,2.5,3160,6540,1.0,0,3,3,8,1580,1580,1959,0,98178,47.5037,-122.24,1990,7090,452100,28,4,2015,0,56,3380,5100,0,1,1
2,1.0,900,2728,2.0,0,0,3,7,900,0,1998,0,98144,47.5877,-122.298,900,2728,290000,2,12,2014,0,16,1828,1828,0,0,1
3,3.0,3610,17483,2.0,0,2,4,8,3610,0,1954,0,98146,47.4852,-122.357,2230,12600,950000,22,4,2015,0,61,13873,10370,0,0,1
3,2.0,2070,4200,1.5,0,0,4,7,1670,400,1906,0,98103,47.6624,-122.333,1490,4560,662500,30,1,2015,0,109,2130,3070,0,1,1
4,2.5,1850,5444,2.0,0,0,5,7,1850,0,1981,0,98034,47.7227,-122.16,1540,5000,475000,2,7,2014,0,33,3594,3460,0,0,0
3,1.5,1440,9711,1.0,0,0,3,7,1140,300,1956,0,98028,47.7394,-122.252,1590,9711,450000,15,9,2014,0,58,8271,8121,0,1,0
3,2.25,2590,15229,2.0,0,3,3,8,2590,0,1984,0,98198,47.3948,-122.325,2590,15229,538250,7,7,2014,0,30,12639,12639,0,0,1
2,1.0,1140,5250,1.5,0,0,4,6,1140,0,1949,0,98133,47.731,-122.341,1450,5250,329950,5,5,2014,0,65,4110,3800,0,0,1
4,3.5,2760,5040,2.0,0,2,3,9,2760,0,1955,2005,98117,47.6756,-122.401,2370,5760,1100000,22,1,2015,50,60,2280,3390,1,0,1
5,1.5,1310,4800,1.5,0,0,3,6,1110,200,1929,0,98106,47.5545,-122.365,960,4800,307000,20,10,2014,0,85,3490,3840,0,1,1
3,1.75,1870,7189,1.0,0,0,3,7,1270,600,1959,0,98118,47.5412,-122.27,1780,6200,433000,10,6,2014,0,55,5319,4420,0,1,1
3,2.25,1900,18000,1.0,0,0,4,7,1280,620,1968,0,98023,47.3251,-122.354,1920,15000,212000,14,1,2015,0,47,16100,13080,0,1,0
5,2.75,2860,6000,2.5,0,0,4,8,2380,480,1902,0,98144,47.5906,-122.316,2240,6000,750000,8,9,2014,0,112,3140,3760,0,1,1
3,2.0,1640,5650,1.0,0,0,3,7,1640,0,2003,0,98042,47.3736,-122.13,2250,5488,279000,25,11,2014,0,11,4010,3238,0,0,0
3,1.0,1140,5500,1.5,0,0,4,6,1140,0,1908,0,98199,47.6606,-122.395,1690,4400,476000,11,6,2014,0,106,4360,2710,0,0,1
5,1.75,2590,9394,1.0,0,0,4,7,1390,1200,1963,0,98198,47.3941,-122.307,2580,9049,368000,26,3,2015,0,52,6804,6469,0,1,1
4,3.0,2160,5200,1.0,0,0,3,7,1320,840,1978,0,98042,47.3627,-122.091,1460,5144,228950,15,10,2014,0,36,3040,3684,0,1,0
4,1.75,1660,3800,1.5,0,0,3,7,1660,0,1926,0,98115,47.6883,-122.314,1660,3767,619000,5,6,2014,0,88,2140,2107,0,0,1
3,2.25,1640,6044,2.0,0,0,3,7,1640,0,1996,0,98002,47.2844,-122.205,1600,7418,275000,29,7,2014,0,18,4404,5818,0,0,0
4,2.5,2620,5457,2.0,0,0,3,8,2620,0,2003,0,98001,47.3148,-122.27,2740,5816,321500,27,10,2014,0,11,2837,3076,0,0,0
3,1.75,950,6000,1.0,0,0,3,6,790,160,1939,0,98108,47.5271,-122.316,1360,6000,230000,8,5,2014,0,75,5050,4640,0,1,1
3,1.0,900,8100,1.0,0,0,4,6,900,0,1959,0,98002,47.2866,-122.221,1000,7830,179500,28,1,2015,0,56,7200,6830,0,0,0
3,2.25,1650,7313,1.0,0,0,3,7,1220,430,1975,0,98011,47.7375,-122.194,1690,7252,460000,18,8,2014,0,39,5663,5562,0,1,0
3,2.5,1800,3980,2.0,0,0,3,7,1800,0,2006,0,98042,47.4006,-122.162,2580,4307,286000,26,2,2015,0,9,2180,1727,0,0,0
3,1.0,1480,4200,1.5,0,0,3,7,1480,0,1925,0,98122,47.6147,-122.298,1460,3600,427500,31,10,2014,0,89,2720,2140,0,0,1
3,1.0,1040,6250,1.0,0,0,3,7,1040,0,1942,0,98136,47.5526,-122.385,1770,6250,400000,22,5,2014,0,72,5210,4480,0,0,1
3,3.5,2300,5611,1.0,0,0,3,8,2300,0,2004,0,98053,47.7122,-122.026,2170,5926,675000,24,6,2014,0,10,3311,3756,0,0,0
3,1.0,2480,8906,1.0,0,0,3,7,1240,1240,1969,0,98118,47.5366,-122.289,1800,8906,350000,26,2,2015,0,46,6426,7106,0,1,1
4,1.75,1970,10358,1.0,0,0,3,8,1540,430,1977,0,98028,47.7719,-122.255,1900,10358,385000,22,11,2014,0,37,8388,8458,0,1,0
2,1.75,1530,3503,1.0,0,1,4,7,830,700,1916,0,98119,47.6368,-122.371,1280,1531,525000,2,7,2014,0,98,1973,251,0,1,1
2,1.0,970,18557,1.0,0,0,3,6,970,0,1939,0,98146,47.5116,-122.37,1150,7200,315000,21,1,2015,0,76,17587,6050,0,0,1
3,1.0,970,7700,1.0,0,0,4,7,970,0,1959,0,98032,47.3793,-122.304,1160,8250,205000,15,4,2015,0,56,6730,7090,0,0,0
2,1.0,680,5250,1.0,0,0,4,6,680,0,1922,0,98177,47.7013,-122.359,1620,5461,500000,5,12,2014,0,92,4570,3841,0,0,1
4,2.5,2640,6738,2.0,0,0,4,8,2640,0,1989,0,98029,47.5787,-122.0,2180,5782,599000,22,8,2014,0,25,4098,3602,0,0,0
1,2.5,1980,7521,1.0,0,0,4,7,1180,800,1979,0,98055,47.4343,-122.192,1980,8000,299000,21,4,2015,0,36,5541,6020,0,1,0
3,3.25,1630,1677,3.0,0,0,3,8,1630,0,2007,0,98133,47.7048,-122.353,1220,1677,385000,23,6,2014,0,7,47,457,0,0,1
2,1.75,1780,4520,1.0,0,0,5,7,890,890,1925,0,98116,47.5798,-122.404,1560,4520,639950,11,8,2014,0,89,2740,2960,0,1,1
2,1.0,1210,8400,1.0,0,0,3,8,780,430,2000,0,98199,47.6503,-122.393,1860,6000,824000,10,11,2014,0,14,7190,4140,0,1,1
3,1.0,1010,7245,1.0,0,0,3,7,1010,0,1969,0,98003,47.3338,-122.306,1300,8236,199950,2,6,2014,0,45,6235,6936,0,0,0
3,2.5,2570,5000,1.0,0,0,4,8,1480,1090,1940,0,98105,47.6578,-122.285,2420,5484,1010000,8,4,2015,0,75,2430,3064,0,1,1
4,2.25,2770,5320,2.0,0,1,3,9,2440,330,2013,0,98136,47.5283,-122.385,2100,6011,950000,3,4,2015,0,2,2550,3911,0,1,1
3,2.5,2290,9158,2.0,0,0,4,8,2290,0,1984,0,98006,47.5476,-122.14,2210,9588,822000,23,9,2014,0,30,6868,7378,0,0,0
4,1.5,1780,8400,1.0,0,0,3,7,1080,700,1969,0,98136,47.5173,-122.385,1660,8400,473600,6,11,2014,0,45,6620,6740,0,1,1
5,2.0,2150,4500,1.5,0,0,3,8,2150,0,1938,0,98116,47.5582,-122.388,1300,4500,490000,2,2,2015,0,77,2350,3200,0,0,1
3,1.75,1920,9306,1.0,0,0,3,7,1000,920,1984,0,98001,47.3319,-122.267,1860,8458,245000,5,5,2014,0,30,7386,6598,0,1,0
4,1.0,1220,11730,1.0,0,0,4,7,1220,0,1960,0,98001,47.3229,-122.283,1270,9520,199000,28,8,2014,0,54,10510,8250,0,0,0
3,3.0,2960,5500,2.0,0,2,3,10,2440,520,1937,1990,98199,47.6356,-122.402,2960,5876,1340000,7,5,2014,53,77,2540,2916,1,1,1
7,3.5,2830,8625,1.0,0,0,4,8,1830,1000,1957,0,98133,47.7493,-122.355,1570,8400,450000,11,3,2015,0,58,5795,6830,0,1,1
3,2.5,1580,7000,2.0,0,0,3,8,1580,0,1992,0,98030,47.3659,-122.17,2110,7062,280000,18,7,2014,0,22,5420,4952,0,0,0
3,2.25,1230,11601,1.0,0,0,4,7,910,320,1992,0,98022,47.1955,-121.991,1820,8465,273000,3,3,2015,0,23,10371,6645,0,1,0
4,2.5,2910,6338,2.0,0,0,3,8,2910,0,2008,0,98059,47.4804,-122.126,2500,5877,549000,5,5,2014,0,6,3428,3377,0,0,0
5,2.25,2370,15512,2.0,0,0,4,9,2370,0,1981,0,98006,47.5555,-122.15,2380,15100,913888,25,6,2014,0,33,13142,12720,0,0,0
4,2.25,1930,3500,1.5,0,0,5,8,1540,390,1916,0,98122,47.6167,-122.29,1800,5000,689888,18,7,2014,0,98,1570,3200,0,1,1
4,2.0,1780,5043,1.0,0,0,3,7,870,910,1993,0,98133,47.7045,-122.342,1350,5044,305000,12,12,2014,0,21,3263,3694,0,1,1
4,2.5,2760,6850,2.0,0,0,3,9,2760,0,1999,0,98056,47.5346,-122.185,2640,9803,602500,29,5,2014,0,15,4090,7163,0,0,0
2,1.75,1620,3640,1.0,0,0,3,7,900,720,1929,0,98108,47.543,-122.299,1590,5538,355000,24,4,2015,0,86,2020,3948,0,1,1
3,2.5,2160,7525,2.0,0,0,3,9,2160,0,1986,0,98052,47.6608,-122.145,2470,7941,756000,21,8,2014,0,28,5365,5471,0,0,0
4,2.25,2190,6906,1.0,0,0,4,7,1040,1150,1977,0,98023,47.319,-122.373,1250,6440,289950,23,4,2015,0,38,4716,5190,0,1,0
3,2.5,3240,7857,2.0,0,0,3,10,3240,0,1994,0,98075,47.5857,-122.038,2970,7857,800000,5,5,2014,0,20,4617,4887,0,0,0
2,1.0,720,3255,1.0,0,0,4,6,720,0,1905,0,98103,47.6823,-122.348,1430,3170,403000,2,12,2014,0,109,2535,1740,0,0,1
3,2.25,1410,1340,2.0,0,0,3,8,1370,40,1967,0,98008,47.6108,-122.113,1730,2748,350000,13,4,2015,0,48,-70,1018,0,1,0
5,3.5,2980,5100,2.0,0,0,3,10,2370,610,2015,0,98115,47.6782,-122.299,1780,5100,1290000,26,3,2015,0,0,2120,3320,0,1,1
5,2.25,1950,8025,1.0,0,2,3,7,1150,800,1960,0,98008,47.6159,-122.114,1780,8560,525126,18,9,2014,0,54,6075,6780,0,1,0
3,1.0,1100,8138,1.0,0,0,3,7,1100,0,1949,0,98155,47.7393,-122.325,1440,8131,241450,12,8,2014,0,65,7038,6691,0,0,1
3,1.5,1400,9087,1.0,0,0,3,7,1400,0,1954,0,98133,47.7711,-122.34,1490,8380,320000,22,1,2015,0,61,7687,6890,0,0,1
4,2.0,1710,7455,1.0,0,0,3,7,1030,680,1975,0,98031,47.3965,-122.173,1710,7350,234000,23,10,2014,0,39,5745,5640,0,1,0
5,2.5,2000,3600,1.0,0,0,3,6,1150,850,1987,0,98144,47.5971,-122.295,1410,3600,441000,21,11,2014,0,27,1600,2190,0,1,1
5,2.5,2000,3600,1.0,0,0,3,6,1150,850,1987,0,98144,47.5971,-122.295,1410,3600,474500,17,3,2015,0,28,1600,2190,0,1,1
3,1.0,1440,2618,1.5,0,0,4,7,1440,0,1906,0,98103,47.6582,-122.336,1850,3990,705000,22,4,2015,0,109,1178,2140,0,0,1
4,2.5,1520,3370,2.0,0,0,3,8,1520,0,1994,0,98029,47.5696,-122.004,1860,4486,517500,9,4,2015,0,21,1850,2626,0,0,0
4,0.75,1440,13300,1.0,0,0,3,6,1440,0,1948,0,98166,47.4761,-122.337,1460,11100,142500,17,6,2014,0,66,11860,9640,0,0,1
2,1.5,1010,10005,2.0,0,0,3,7,1010,0,1981,0,98056,47.5118,-122.189,1210,7794,310000,6,11,2014,0,33,8995,6584,0,0,0
4,2.5,2440,9727,2.0,0,0,3,9,2440,0,1987,0,98052,47.6613,-122.132,2370,11503,749500,28,10,2014,0,27,7287,9133,0,0,0
5,3.0,2480,7200,1.0,0,0,3,7,1560,920,1999,0,98188,47.4586,-122.283,1910,9432,360000,29,4,2015,0,16,4720,7522,0,1,1
5,2.5,2800,11325,1.0,0,0,4,8,1400,1400,1970,0,98005,47.6166,-122.172,2510,13700,850000,5,11,2014,0,44,8525,11190,0,1,0
4,1.75,1820,4500,1.5,0,0,3,8,1820,0,1921,0,98119,47.6429,-122.36,1870,3600,815000,29,10,2014,0,93,2680,1730,0,0,1
5,4.0,5840,11652,2.0,0,1,3,11,4410,1430,1988,0,98004,47.5835,-122.202,3120,13639,2200000,8,1,2015,0,27,5812,10519,0,1,0
4,3.25,2980,3600,2.0,0,0,3,9,2150,830,1999,0,98112,47.6352,-122.284,2980,4800,1630000,3,7,2014,0,15,620,1820,0,1,1
3,1.5,1220,7300,1.0,0,0,3,7,1220,0,1973,0,98001,47.3341,-122.279,1260,7347,175000,16,6,2014,0,41,6080,6087,0,0,0
3,1.75,1830,9758,1.0,0,0,3,8,1300,530,1977,0,98034,47.7107,-122.23,1850,8000,429950,2,10,2014,0,37,7928,6150,0,1,0
4,2.5,2900,5505,2.0,0,0,3,8,2900,0,2002,0,98074,47.6063,-122.02,2970,5251,675000,14,7,2014,0,12,2605,2281,0,0,0
3,2.25,1940,5980,1.0,0,0,3,7,1520,420,1987,0,98027,47.5476,-122.075,1910,6309,580000,8,7,2014,0,27,4040,4399,0,1,0
4,2.0,1750,7800,1.0,0,0,4,6,1750,0,1944,0,98166,47.4791,-122.347,1270,7800,240000,24,2,2015,0,71,6050,6530,0,0,1
4,2.5,3220,4400,2.0,0,2,3,9,2180,1040,1937,0,98199,47.6325,-122.394,3000,5000,862500,12,12,2014,0,77,1180,2000,0,1,1
2,1.0,1080,6052,1.0,0,0,5,6,1080,0,1908,0,98030,47.3857,-122.215,1810,7830,140000,21,1,2015,0,107,4972,6020,0,0,0
5,3.75,3990,18897,2.0,0,0,3,8,3090,900,1937,2010,98125,47.7228,-122.31,2080,9793,740000,30,5,2014,73,77,14907,7713,1,1,1
3,1.75,920,3600,1.0,0,0,4,6,820,100,1904,0,98119,47.6386,-122.365,1620,3600,589000,24,2,2015,0,111,2680,1980,0,1,1
3,1.75,1290,9760,1.0,0,0,3,7,1290,0,1979,0,98058,47.4265,-122.148,1410,8034,275000,23,2,2015,0,36,8470,6624,0,0,0
4,2.5,2090,4196,2.0,0,0,3,8,2090,0,2006,0,98011,47.7453,-122.192,2640,4503,489900,11,7,2014,0,8,2106,1863,0,0,0
3,2.5,1900,3366,2.0,0,0,3,9,1900,0,1996,0,98033,47.6679,-122.184,2500,3954,545000,13,8,2014,0,18,1466,1454,0,0,0
4,1.0,1360,7132,1.5,0,0,3,6,1360,0,1941,0,98168,47.5054,-122.301,1280,7175,235000,25,3,2015,0,74,5772,5895,0,0,1
3,1.0,1000,4000,1.5,0,0,4,6,1000,0,1915,0,98118,47.5523,-122.286,1040,4240,230000,17,2,2015,0,100,3000,3200,0,0,1
4,2.25,2170,4080,2.0,0,0,3,7,1920,250,1980,0,98122,47.6124,-122.293,1890,4400,655000,10,7,2014,0,34,1910,2510,0,1,1
2,1.0,820,16030,1.0,0,0,4,5,820,0,1923,0,98022,47.2039,-122.003,1880,14046,185000,22,8,2014,0,91,15210,12166,0,0,0
3,1.0,1090,7400,1.0,0,0,4,7,1090,0,1962,0,98092,47.2923,-122.19,1140,8165,196000,26,3,2015,0,53,6310,7025,0,0,0
3,2.25,1830,7897,1.0,0,0,4,8,1290,540,1986,0,98052,47.6914,-122.103,1990,8306,572000,4,6,2014,0,28,6067,6316,0,1,0
4,2.5,3010,6903,2.0,0,0,3,9,3010,0,2001,0,98056,47.5213,-122.193,2860,6435,615000,30,4,2015,0,14,3893,3575,0,0,0
6,2.25,2930,4320,2.0,0,0,3,9,2130,800,1913,0,98112,47.6295,-122.306,2860,4320,1230000,20,3,2015,0,102,1390,1460,0,1,1
3,2.5,1520,5649,2.0,0,0,4,7,1520,0,1989,0,98034,47.7221,-122.162,1540,5000,375000,19,8,2014,0,25,4129,3460,0,0,0
3,1.75,1250,9486,1.0,0,0,4,6,1250,0,1971,0,98070,47.4341,-122.446,1270,9600,295000,5,9,2014,0,43,8236,8330,0,0,0
4,2.5,2760,6000,2.0,0,0,5,7,2230,530,1942,0,98115,47.6877,-122.295,1600,6000,760000,25,6,2014,0,72,3240,4400,0,1,1
3,1.75,1330,7848,1.0,0,0,3,8,1330,0,1978,0,98058,47.4463,-122.127,2110,8497,347000,7,4,2015,0,37,6518,6387,0,0,0
3,2.0,1700,5100,1.5,0,0,4,7,1500,200,1924,0,98117,47.679,-122.39,1700,5100,712000,4,5,2015,0,91,3400,3400,0,1,1
4,2.0,2050,4000,1.5,0,0,5,7,1210,840,1941,0,98144,47.5799,-122.306,1310,4000,495000,15,5,2014,0,73,1950,2690,0,1,1
4,2.0,3140,10437,1.0,0,0,4,8,2040,1100,1959,0,98040,47.5786,-122.229,2010,10437,925000,20,6,2014,0,55,7297,8427,0,1,0
3,1.0,2030,4080,1.5,0,0,4,7,1840,190,1908,0,98115,47.6765,-122.308,2030,4080,775000,2,4,2015,0,107,2050,2050,0,1,1
4,2.5,2100,7920,1.5,0,0,4,6,1400,700,1916,0,98126,47.5293,-122.371,1230,7920,429000,1,8,2014,0,98,5820,6690,0,1,1
3,1.0,1010,12705,1.0,0,0,4,7,1010,0,1959,0,98003,47.3348,-122.303,1490,10200,229000,18,12,2014,0,55,11695,8710,0,0,0
4,2.25,2100,8290,2.0,0,0,4,8,2100,0,1978,0,98006,47.5595,-122.129,2100,8290,625000,29,7,2014,0,36,6190,6190,0,0,0
2,1.0,840,6654,1.0,0,0,3,7,840,0,1951,0,98133,47.7319,-122.335,1350,5831,130000,21,10,2014,0,63,5814,4481,0,0,1
3,1.75,1690,5080,1.0,0,0,3,7,1190,500,1976,0,98106,47.5312,-122.348,1300,5080,349000,4,11,2014,0,38,3390,3780,0,1,1
3,2.5,1810,1988,2.0,0,0,3,7,1350,460,1997,0,98199,47.6513,-122.385,1600,1525,487500,17,3,2015,0,18,178,-75,0,1,1
3,2.5,2600,7210,2.0,0,0,3,8,2600,0,1989,0,98059,47.5123,-122.151,2350,7225,475000,3,6,2014,0,25,4610,4875,0,0,0
3,1.75,1650,8400,1.0,0,0,3,8,1470,180,1959,0,98040,47.5766,-122.236,2020,7777,685000,24,9,2014,0,55,6750,5757,0,1,0
3,1.75,2460,4800,1.0,0,0,4,7,1230,1230,1938,0,98112,47.6343,-122.282,2860,4800,960000,11,8,2014,0,76,2340,1940,0,1,1
5,2.25,4320,7620,2.0,0,0,3,7,2880,1440,1973,2014,98115,47.6824,-122.287,1880,7620,1100000,13,11,2014,41,41,3300,5740,1,1,1
3,2.25,2600,15000,2.0,0,0,3,9,2600,0,1978,0,98038,47.3719,-122.056,2380,15000,428000,20,3,2015,0,37,12400,12620,0,0,0
3,2.5,1930,5790,2.0,0,0,4,7,1930,0,1988,0,98011,47.7733,-122.17,1790,4901,435000,10,5,2015,0,27,3860,3111,0,0,0
3,2.0,2190,5400,1.0,0,2,5,7,1260,930,1952,0,98107,47.6737,-122.4,2160,5400,769950,28,10,2014,0,62,3210,3240,0,1,1
3,1.0,1420,10980,1.0,0,0,4,7,1200,220,1954,0,98006,47.574,-122.138,1630,9763,385000,29,9,2014,0,60,9560,8133,0,1,0
3,2.5,2090,3002,2.0,0,0,3,7,1670,420,2005,0,98019,47.745,-121.984,2090,3163,352000,18,11,2014,0,9,912,1073,0,1,0
3,3.0,2470,11900,2.0,0,0,3,9,2290,180,1976,0,98074,47.641,-122.057,2590,11900,660000,12,2,2015,0,39,9430,9310,0,1,0
3,1.0,840,8400,1.0,0,0,3,6,840,0,1959,0,98023,47.3277,-122.343,840,9450,105000,2,9,2014,0,55,7560,8610,0,0,0
2,1.0,2100,4480,1.0,0,0,5,7,1400,700,1908,0,98126,47.574,-122.372,1570,4400,420000,2,12,2014,0,106,2380,2830,0,1,1
3,1.5,1360,11250,1.0,0,0,4,7,1360,0,1955,0,98006,47.5697,-122.177,1440,11250,499950,3,9,2014,0,59,9890,9810,0,0,0
3,2.75,1930,2960,1.5,0,0,5,7,1490,440,1929,0,98105,47.6659,-122.287,2080,3760,665000,1,10,2014,0,85,1030,1680,0,1,1
4,2.5,2180,10140,1.0,0,0,4,7,1180,1000,1968,0,98052,47.6822,-122.111,1840,9375,540000,1,7,2014,0,46,7960,7535,0,1,0
4,2.0,1670,12056,1.0,0,0,3,7,1670,0,1955,0,98028,47.7418,-122.244,1860,12056,400000,29,5,2014,0,59,10386,10196,0,0,0
4,2.75,2720,6427,1.0,0,0,3,8,1650,1070,2008,0,98146,47.4931,-122.354,2720,8484,469950,15,12,2014,0,6,3707,5764,0,1,1
4,2.5,3170,9900,2.0,0,0,4,8,3170,0,1979,0,98007,47.6181,-122.147,2540,12400,777000,16,10,2014,0,35,6730,9860,0,0,0
2,1.75,1610,6300,1.0,0,0,3,7,1010,600,1941,0,98108,47.554,-122.304,1370,5225,346500,25,6,2014,0,73,4690,3855,0,1,1
3,2.5,2370,4950,2.0,0,0,3,8,2370,0,2003,0,98029,47.5465,-122.013,2230,4950,685000,11,3,2015,0,12,2580,2720,0,0,0
3,2.5,2590,18980,1.0,0,0,4,10,2590,0,1976,0,98042,47.3839,-122.153,3110,14652,396500,24,6,2014,0,38,16390,11542,0,0,0
3,2.5,2850,7130,2.0,0,0,3,10,1990,860,1980,0,98122,47.603,-122.289,2280,6459,783500,4,5,2014,0,34,4280,4179,0,1,1
4,2.0,1660,4800,1.5,0,0,3,7,1660,0,1922,0,98103,47.6556,-122.345,1660,4800,575000,2,7,2014,0,92,3140,3140,0,0,1
4,4.25,5550,12968,2.0,0,0,3,11,5550,0,2005,0,98059,47.5305,-122.135,4750,13001,1500000,6,11,2014,0,9,7418,8251,0,0,0
3,1.5,2200,7620,1.0,0,0,4,7,1130,1070,1942,0,98177,47.7263,-122.363,2170,7672,515000,8,4,2015,0,73,5420,5502,0,1,1
3,2.5,2020,6628,1.0,0,0,4,7,1250,770,1963,0,98168,47.4934,-122.332,1540,9995,300000,5,8,2014,0,51,4608,8455,0,1,1
3,1.5,1760,9600,1.0,0,0,4,7,1760,0,1966,0,98031,47.4085,-122.195,1450,9600,272000,14,1,2015,0,49,7840,8150,0,0,0
4,2.25,1810,4970,2.0,0,0,3,7,1810,0,2003,0,98059,47.5003,-122.156,1810,4858,355000,27,5,2014,0,11,3160,3048,0,0,0
3,2.0,1310,8440,1.0,0,0,5,6,1310,0,1951,0,98178,47.5003,-122.269,1790,10775,223000,31,7,2014,0,63,7130,8985,0,0,1
4,2.5,3000,8584,2.0,0,0,3,7,3000,0,2003,0,98038,47.369,-122.032,2610,7570,397000,20,8,2014,0,11,5584,4960,0,0,0
2,2.0,1080,5000,1.0,0,0,5,6,1080,0,1923,0,98117,47.6826,-122.394,1530,5000,460000,18,3,2015,0,92,3920,3470,0,0,1
3,2.75,2170,2738,1.5,0,0,4,9,1550,620,1930,0,98109,47.6389,-122.349,1170,1062,848000,6,2,2015,0,85,568,-108,0,1,1
2,1.0,740,4275,1.0,0,0,5,6,740,0,1924,0,98115,47.688,-122.308,1900,4275,392800,7,10,2014,0,90,3535,2375,0,0,1
3,2.25,2370,7878,2.0,0,0,3,8,2370,0,1985,0,98034,47.7281,-122.168,1870,7766,577000,22,1,2015,0,30,5508,5896,0,0,0
3,1.0,1890,3330,1.5,0,0,4,7,1390,500,1901,0,98103,47.6597,-122.352,1530,3330,570000,7,7,2014,0,113,1440,1800,0,1,1
3,1.75,1160,6134,1.0,0,0,3,7,1160,0,1998,0,98002,47.3414,-122.218,1330,6301,250000,17,6,2014,0,16,4974,4971,0,0,0
4,1.75,1550,7350,1.5,0,0,4,8,1550,0,1958,0,98040,47.5795,-122.235,1860,7350,645000,4,9,2014,0,56,5800,5490,0,0,0
4,2.5,2610,5240,2.0,0,0,3,8,2610,0,2004,0,98038,47.345,-122.042,2480,5240,337000,22,7,2014,0,10,2630,2760,0,0,0
3,1.75,1230,8250,1.0,0,0,3,7,1230,0,1966,0,98058,47.4526,-122.176,1250,8250,280000,25,6,2014,0,48,7020,7000,0,0,0
3,1.5,1280,5547,2.0,0,0,4,6,1280,0,1985,0,98002,47.3344,-122.215,1150,4500,167000,28,7,2014,0,29,4267,3350,0,0,0
2,1.0,1880,7560,1.0,0,0,3,6,940,940,1919,0,98126,47.5261,-122.374,1280,7560,280000,30,5,2014,0,95,5680,6280,0,1,1
2,1.5,1220,8409,1.0,0,0,4,6,1220,0,1948,0,98155,47.7534,-122.324,1130,8409,317500,22,12,2014,0,66,7189,7279,0,0,1
2,2.75,1350,1252,2.0,0,0,3,8,1120,230,2006,0,98136,47.522,-122.39,1410,1265,405500,3,7,2014,0,8,-98,-145,0,1,1
4,3.0,3040,11651,2.0,0,0,3,10,3040,0,1987,0,98074,47.6348,-122.038,2540,11815,691000,28,1,2015,0,28,8611,9275,0,0,0
2,1.75,1560,4141,1.0,0,0,4,7,880,680,1942,0,98117,47.6863,-122.382,1210,4141,549010,11,2,2015,0,73,2581,2931,0,1,1
5,3.5,2980,5809,2.0,0,2,3,8,2980,0,2005,0,98029,47.5537,-121.996,2120,3416,750000,22,4,2015,0,10,2829,1296,0,0,0
2,1.0,870,5689,1.0,0,0,4,7,870,0,1948,0,98103,47.6988,-122.351,1100,5711,365000,24,2,2015,0,67,4819,4611,0,0,1
3,1.75,1660,10716,1.0,0,0,3,7,1100,560,1988,0,98034,47.7326,-122.234,1630,7626,412500,5,3,2015,0,27,9056,5996,0,1,0
3,2.25,1870,9000,1.0,0,0,3,7,1440,430,1978,0,98011,47.7373,-122.198,1870,8640,425000,3,6,2014,0,36,7130,6770,0,1,0
3,1.0,1410,9656,1.0,0,0,3,7,960,450,1953,0,98004,47.6354,-122.208,2410,9384,920000,31,3,2015,0,62,8246,6974,0,1,0
4,2.25,2180,8000,1.0,0,0,4,9,1630,550,1975,0,98023,47.317,-122.378,2310,8000,340000,22,12,2014,0,39,5820,5690,0,1,0
4,2.5,2620,8960,1.0,0,0,5,7,1520,1100,1955,0,98133,47.7642,-122.335,1880,8960,405000,5,11,2014,0,59,6340,7080,0,1,1
3,2.5,2450,7051,1.0,0,0,3,8,1870,580,1990,0,98056,47.5308,-122.171,2450,8788,537100,24,3,2015,0,25,4601,6338,0,1,0
4,2.5,3250,4650,2.0,0,0,3,8,3250,0,2007,0,98031,47.4004,-122.203,2960,4650,353500,18,3,2015,0,8,1400,1690,0,0,0
3,1.0,1150,7080,1.0,0,0,3,7,1150,0,1952,0,98125,47.7106,-122.288,1490,7921,522000,12,9,2014,0,62,5930,6431,0,0,1
4,2.75,2780,6978,2.0,0,0,3,8,2780,0,2001,0,98053,47.6881,-122.04,2760,5460,710000,10,10,2014,0,13,4198,2700,0,0,0
3,1.75,1360,13320,1.0,0,0,4,7,1360,0,1985,0,98059,47.4625,-122.069,1580,13625,329950,12,3,2015,0,30,11960,12045,0,0,0
5,2.5,2810,14207,1.0,0,3,3,9,1540,1270,1979,0,98008,47.5742,-122.11,3190,14000,830000,20,4,2015,0,36,11397,10810,0,1,0
4,2.5,1780,11130,1.0,0,0,5,8,1780,0,1962,0,98005,47.5931,-122.178,2610,11130,800500,19,2,2015,0,53,9350,8520,0,0,0
3,1.0,1100,10125,1.0,0,0,3,7,1100,0,1969,0,98042,47.367,-122.107,1570,10650,168500,28,5,2014,0,45,9025,9080,0,0,0
3,2.5,2230,5348,2.0,0,0,3,8,2230,0,2000,0,98065,47.5347,-121.866,2190,5205,490000,27,6,2014,0,14,3118,3015,0,0,0
3,2.5,1710,1904,2.0,0,0,3,8,1140,570,2003,0,98116,47.5827,-122.387,1260,1316,579000,6,10,2014,0,11,194,56,0,1,1
4,2.5,2620,9873,2.0,0,0,3,8,2620,0,1987,0,98075,47.5822,-122.051,2520,9935,600000,3,6,2014,0,27,7253,7415,0,0,0
4,1.75,1990,4725,1.5,0,0,4,7,1190,800,1944,0,98126,47.5275,-122.38,1240,4961,445000,29,5,2014,0,70,2735,3721,0,1,1
4,1.75,1450,8450,1.0,0,0,3,7,1450,0,1960,0,98027,47.5289,-122.028,1540,8450,362500,24,6,2014,0,54,7000,6910,0,0,0
4,2.0,1630,9010,1.0,0,0,4,7,1050,580,1975,0,98092,47.317,-122.196,1670,7820,234000,14,5,2014,0,39,7380,6150,0,1,0
1,1.0,730,1942,1.0,0,0,3,7,730,0,2008,0,98144,47.5939,-122.299,1020,2183,321500,9,7,2014,0,6,1212,1163,0,0,1
3,1.75,1980,3300,1.5,0,0,4,7,1140,840,1926,0,98115,47.6733,-122.298,1590,5000,660000,6,6,2014,0,88,1320,3410,0,1,1
3,2.0,1410,5000,1.0,0,0,5,7,740,670,1908,0,98107,47.6752,-122.361,1830,4000,517950,6,10,2014,0,106,3590,2170,0,1,1
5,2.5,2360,10081,1.0,0,0,4,7,1180,1180,1961,0,98006,47.5552,-122.178,2200,10461,525000,14,7,2014,0,53,7721,8261,0,1,0
3,1.0,1190,8450,1.0,0,0,5,6,1190,0,1961,0,98059,47.4807,-122.157,1660,8450,319500,11,2,2015,0,54,7260,6790,0,0,0
4,3.25,3760,10920,1.5,0,0,5,9,2400,1360,1950,0,98105,47.6687,-122.264,3430,11050,1580000,6,5,2014,0,64,7160,7620,0,1,1
2,1.75,1590,5136,1.5,0,3,3,9,1320,270,1927,0,98199,47.6424,-122.411,2520,5243,850000,19,6,2014,0,87,3546,2723,0,1,1
5,3.25,3510,10930,2.0,0,0,3,9,3510,0,2013,0,98033,47.6914,-122.21,1970,7488,1010000,8,12,2014,0,1,7420,5518,0,0,0
3,2.5,1320,1310,3.0,0,0,3,8,1320,0,2006,0,98107,47.6719,-122.38,1350,1250,475000,4,8,2014,0,8,-10,-100,0,0,1
3,1.0,1610,11250,1.0,0,0,3,7,1090,520,1975,0,98028,47.7391,-122.256,2040,10692,375000,24,7,2014,0,39,9640,8652,0,1,0
3,1.0,1410,8053,1.0,0,0,4,7,1410,0,1951,0,98177,47.704,-122.367,1170,8042,405000,24,6,2014,0,63,6643,6872,0,0,1
4,2.5,2170,10500,1.0,0,0,3,7,1570,600,1962,0,98155,47.7512,-122.295,1850,11127,420000,15,10,2014,0,52,8330,9277,0,1,1
4,1.75,1890,4800,1.5,0,0,3,7,1390,500,1906,0,98119,47.6405,-122.367,1890,4800,775000,16,10,2014,0,108,2910,2910,0,1,1
4,2.75,3260,5000,2.0,0,0,3,9,3260,0,2007,0,98027,47.5395,-121.997,3450,6218,800000,7,4,2015,0,8,1740,2768,0,0,0
3,1.75,2080,12714,2.0,0,0,4,8,1540,540,1984,0,98052,47.7056,-122.162,2080,12107,436800,1,4,2015,0,31,10634,10027,0,1,0
3,1.75,2040,4005,1.5,0,0,4,8,1740,300,1930,0,98117,47.6885,-122.38,1380,4005,620000,3,12,2014,0,84,1965,2625,0,1,1
3,1.0,1250,9035,1.0,0,0,4,7,1250,0,1970,0,98003,47.275,-122.302,1350,10425,230000,25,3,2015,0,45,7785,9075,0,0,0
1,1.0,850,8050,1.0,0,0,2,6,850,0,1906,0,98118,47.5427,-122.288,1590,5180,165000,8,7,2014,0,108,7200,3590,0,0,1
1,1.0,850,8050,1.0,0,0,2,6,850,0,1906,0,98118,47.5427,-122.288,1590,5180,490000,22,1,2015,0,109,7200,3590,0,0,1
3,1.75,1600,8400,1.0,0,0,5,8,1600,0,1963,0,98006,47.5479,-122.179,2210,8400,480000,6,8,2014,0,51,6800,6190,0,0,0
3,2.5,2400,6975,2.0,0,0,3,9,2400,0,1993,0,98056,47.534,-122.179,2640,11172,570000,6,6,2014,0,21,4575,8532,0,0,0
3,2.25,1870,4894,2.0,0,0,4,8,1750,120,1992,0,98033,47.6943,-122.19,1920,5988,615000,24,1,2015,0,23,3024,4068,0,1,0
3,1.0,1720,9605,1.0,0,0,3,7,860,860,1969,0,98028,47.7439,-122.242,1720,9998,280000,24,9,2014,0,45,7885,8278,0,1,0
3,1.0,1030,9834,1.0,0,0,3,7,1030,0,1969,0,98072,47.7676,-122.164,1210,9875,326000,23,6,2014,0,45,8804,8665,0,0,0
2,2.25,1190,1499,2.0,0,0,3,9,1100,90,2004,0,98105,47.6666,-122.285,1430,1332,550700,16,2,2015,0,11,309,-98,0,1,1
2,1.0,910,2002,1.5,0,0,3,6,910,0,1900,0,98112,47.6188,-122.306,1190,1208,600000,1,7,2014,0,114,1092,18,0,0,1
2,2.25,1530,1324,2.0,0,0,3,8,1280,250,2010,0,98122,47.6032,-122.311,1410,1689,546000,9,3,2015,0,5,-206,279,0,1,1
3,1.75,2090,7667,1.0,0,2,3,7,1200,890,1952,0,98115,47.7007,-122.312,1480,7666,489000,17,11,2014,0,62,5577,6186,0,1,1
3,2.0,1570,7000,2.0,0,2,4,8,1050,520,1971,0,98122,47.6061,-122.286,1990,6675,765000,17,6,2014,0,43,5430,4685,0,1,1
2,1.0,1500,4120,1.5,0,0,3,5,880,620,1928,0,98055,47.4857,-122.2,1300,4120,262000,29,5,2014,0,86,2620,2820,0,1,0
4,2.75,2160,5005,1.0,0,0,3,7,1430,730,1987,0,98115,47.6971,-122.302,1770,5326,550000,2,7,2014,0,27,2845,3556,0,1,1
2,1.0,780,5000,1.0,0,0,4,6,780,0,1943,0,98146,47.5112,-122.357,1030,5000,285000,6,6,2014,0,71,4220,3970,0,0,1
4,1.75,2340,17541,1.0,0,0,4,7,1360,980,1956,0,98028,47.745,-122.229,2250,9212,476000,4,2,2015,0,59,15201,6962,0,1,0
1,1.0,720,5100,1.0,0,0,3,6,720,0,1907,0,98117,47.6821,-122.38,1320,5100,335000,23,6,2014,0,107,4380,3780,0,0,1
3,2.25,1860,13939,1.0,0,0,4,7,1860,0,1961,0,98030,47.3746,-122.217,1530,10018,291000,18,9,2014,0,53,12079,8488,0,0,0
4,1.75,1950,13440,1.5,0,0,4,6,1950,0,1931,0,98065,47.5232,-121.821,1300,7432,335000,21,8,2014,0,83,11490,6132,0,0,0
3,1.5,1860,9003,1.0,0,0,3,7,1490,370,1955,0,98028,47.7624,-122.26,2090,11574,415000,29,8,2014,0,59,7143,9484,0,1,0
3,2.0,1550,6039,1.0,0,0,5,7,830,720,1942,0,98126,47.5436,-122.378,1330,6042,430000,8,7,2014,0,72,4489,4712,0,1,1
3,1.75,1610,6205,1.0,0,0,4,7,1210,400,1979,0,98023,47.3004,-122.383,1780,8056,270000,7,4,2015,0,36,4595,6276,0,1,0
3,2.0,1810,4500,1.0,0,0,4,7,980,830,1906,0,98117,47.681,-122.359,1800,4500,760000,7,4,2015,0,109,2690,2700,0,1,1
2,2.0,1730,4248,2.0,0,0,3,7,1730,0,1905,0,98144,47.5933,-122.308,1380,4000,450000,8,5,2015,0,110,2518,2620,0,0,1
4,2.5,2130,3420,1.5,0,0,4,7,1730,400,1916,0,98103,47.649,-122.336,1520,3420,725000,21,11,2014,0,98,1290,1900,0,1,1
3,2.75,2190,11060,1.0,0,0,4,7,1610,580,1973,0,98033,47.6893,-122.208,2020,8588,700000,21,7,2014,0,41,8870,6568,0,1,0
5,4.5,4130,10404,2.0,0,0,3,10,4130,0,2004,0,98029,47.5556,-122.03,3890,11531,998000,26,8,2014,0,10,6274,7641,0,0,0
3,2.25,1680,9766,2.0,0,0,3,7,1680,0,1989,0,98019,47.7341,-121.981,1590,9757,396000,8,5,2015,0,26,8086,8167,0,0,0
3,2.5,1480,8381,1.0,0,0,4,7,1480,0,1968,0,98125,47.7078,-122.288,1710,8050,547000,5,6,2014,0,46,6901,6340,0,0,1
4,1.5,1790,10200,1.0,0,0,4,8,1210,580,1963,0,98030,47.3774,-122.225,1540,6600,302000,15,4,2015,0,52,8410,5060,0,1,0
5,3.5,2810,2700,2.0,0,0,5,9,1900,910,1910,0,98117,47.6799,-122.363,1510,3800,999000,21,10,2014,0,104,-110,2290,0,1,1
4,2.5,2360,10000,1.0,0,3,3,8,1980,380,1977,0,98126,47.573,-122.374,2480,5000,633000,3,7,2014,0,37,7640,2520,0,1,1
3,1.75,1460,7361,1.0,0,0,3,6,1460,0,1982,0,98019,47.7436,-121.979,1460,7505,265800,11,12,2014,0,32,5901,6045,0,0,0
3,2.25,2160,8114,1.0,0,0,3,8,1460,700,1960,0,98133,47.7176,-122.35,2160,8000,530000,16,10,2014,0,54,5954,5840,0,1,1
6,2.0,2610,9132,1.0,0,0,4,8,1320,1290,1965,0,98007,47.622,-122.14,2170,8000,605000,1,5,2015,0,50,6522,5830,0,1,0
4,2.5,2170,4587,2.0,0,0,3,7,2170,0,2006,0,98065,47.5396,-121.889,2170,5211,489000,21,4,2015,0,9,2417,3041,0,0,0
2,1.0,2160,12960,1.0,0,0,3,7,1360,800,1968,0,98168,47.4702,-122.261,2070,12960,305000,2,7,2014,0,46,10800,10890,0,1,1
4,2.75,2020,7070,1.0,0,0,5,7,1010,1010,1958,0,98126,47.5202,-122.378,1390,6000,513000,13,6,2014,0,56,5050,4610,0,1,1
4,2.5,2980,5000,2.0,0,0,3,10,2980,0,2006,0,98027,47.5431,-121.997,3140,5500,765000,16,7,2014,0,8,2020,2360,0,0,0
2,1.5,1300,2970,1.0,0,0,3,7,990,310,1903,0,98102,47.6233,-122.319,1700,3000,550000,16,9,2014,0,111,1670,1300,0,1,1
4,2.5,3090,10730,2.0,0,0,5,8,2420,670,1985,0,98006,47.5458,-122.141,2220,7875,974350,24,7,2014,0,29,7640,5655,0,1,0
4,2.25,2280,7229,2.0,0,0,4,8,2280,0,1984,0,98027,47.5609,-122.081,2320,7735,653675,27,3,2015,0,31,4949,5415,0,0,0
3,1.75,1260,8614,1.0,0,0,4,7,1260,0,1985,0,98038,47.3586,-122.056,1600,8614,245000,15,10,2014,0,29,7354,7014,0,0,0
2,1.75,1530,4387,1.0,0,0,3,8,1020,510,1952,0,98115,47.6726,-122.264,1870,5029,700180,5,5,2015,0,63,2857,3159,0,1,1
3,2.5,1830,8133,1.0,0,0,3,8,1390,440,1996,0,98028,47.7478,-122.247,2310,11522,510000,30,4,2015,0,19,6303,9212,0,1,0
3,2.5,1610,10292,1.0,0,0,4,7,1190,420,1969,0,98056,47.5349,-122.174,1940,8700,390000,25,10,2014,0,45,8682,6760,0,1,0
3,2.5,2170,5500,2.0,0,0,3,8,2170,0,2000,0,98075,47.5975,-122.018,2170,5862,606500,4,5,2015,0,15,3330,3692,0,0,0
3,2.25,1620,7772,2.0,0,0,4,8,1620,0,1988,0,98003,47.3521,-122.302,1710,6455,290000,7,5,2015,0,27,6152,4745,0,0,0
3,1.75,1080,7942,1.0,0,0,3,7,1080,0,1981,0,98023,47.3141,-122.355,1380,8244,115000,24,2,2015,0,34,6862,6864,0,0,0
3,2.5,2360,4638,2.0,0,3,3,9,2360,0,1996,0,98115,47.6837,-122.321,1620,4638,580050,15,5,2014,0,18,2278,3018,0,0,1
3,2.5,2010,2261,2.0,0,0,3,8,1390,620,2014,0,98029,47.5514,-121.998,1690,1899,550000,6,3,2015,0,1,251,209,0,1,0
3,1.0,800,3060,1.5,0,0,4,6,800,0,1903,0,98117,47.6769,-122.389,1180,3060,465000,9,4,2015,0,112,2260,1880,0,0,1
3,1.0,970,5922,1.5,0,0,3,7,970,0,1949,0,98125,47.719,-122.321,1730,6128,354950,24,3,2015,0,66,4952,4398,0,0,1
4,3.25,3720,7150,2.0,0,2,3,11,3720,0,2007,0,98027,47.5359,-122.069,4040,7442,980000,7,11,2014,0,7,3430,3402,0,0,0
3,2.25,2010,7447,2.0,0,0,3,8,2010,0,1985,0,98028,47.747,-122.248,2230,7846,500000,5,9,2014,0,29,5437,5616,0,0,0
4,1.0,1430,4080,1.5,0,0,3,7,1430,0,1924,0,98105,47.6696,-122.324,1760,4080,667750,29,3,2015,0,91,2650,2320,0,0,1
3,1.75,2250,11520,1.0,0,1,3,8,2250,0,1956,0,98028,47.7619,-122.268,2730,12445,735000,28,4,2015,0,59,9270,9715,0,0,0
3,1.75,2130,8742,1.0,0,3,3,7,1330,800,1955,0,98178,47.5057,-122.231,2380,7448,361000,17,9,2014,0,59,6612,5068,0,1,1
3,2.0,1620,12482,1.0,0,0,4,7,1290,330,1989,0,98042,47.3584,-122.086,1560,8499,276750,5,1,2015,0,26,10862,6939,0,1,0
4,3.25,3140,3680,2.0,0,0,3,10,2310,830,2009,0,98027,47.5319,-122.076,2620,2664,760000,22,8,2014,0,5,540,44,0,1,0
2,1.0,870,7975,1.0,0,2,3,7,870,0,1946,0,98107,47.6698,-122.361,1080,5722,475000,29,8,2014,0,68,7105,4642,0,0,1
4,2.5,1820,8217,1.0,0,0,3,7,1120,700,1987,0,98001,47.263,-122.242,1310,8217,234000,27,8,2014,0,27,6397,6907,0,1,0
3,2.0,1510,9153,1.0,0,0,4,7,1510,0,1974,0,98001,47.3412,-122.273,1780,9286,234950,17,11,2014,0,40,7643,7506,0,0,0
2,1.75,1320,7540,1.0,0,0,3,7,1320,0,1968,0,98038,47.3634,-122.052,1570,7540,269950,22,2,2015,0,47,6220,5970,0,0,0
3,2.5,1800,7318,2.0,0,0,3,8,1800,0,1989,0,98029,47.5747,-122.008,1800,5414,495000,12,1,2015,0,26,5518,3614,0,0,0
2,1.0,1120,6380,1.0,0,0,3,7,1120,0,1942,1994,98115,47.6951,-122.316,1230,6380,438000,18,3,2015,52,73,5260,5150,1,0,1
4,2.5,3220,6399,2.0,0,0,3,9,3220,0,2004,0,98075,47.5883,-121.991,2850,6399,697000,8,12,2014,0,10,3179,3549,0,0,0
2,1.0,960,5000,1.0,0,0,3,6,960,0,1951,0,98126,47.5188,-122.372,930,5000,212625,10,3,2015,0,64,4040,4070,0,0,1
5,2.5,2640,4400,1.5,0,0,5,7,1840,800,1925,0,98122,47.605,-122.3,1720,4400,593000,10,11,2014,0,89,1760,2680,0,1,1
4,3.0,2430,7243,2.0,0,0,3,8,2430,0,2003,0,98038,47.3533,-122.016,2430,7084,410000,12,12,2014,0,11,4813,4654,0,0,0
2,1.0,1470,7137,1.0,0,0,3,7,1020,450,1941,0,98103,47.7008,-122.352,1470,7067,445434,10,6,2014,0,73,5667,5597,0,1,1
3,2.5,2040,15463,1.0,0,0,3,8,1340,700,1968,0,98003,47.3334,-122.322,2370,12672,200126,11,9,2014,0,46,13423,10302,0,1,0
3,2.5,1670,6666,2.0,0,0,4,7,1670,0,1992,0,98038,47.3488,-122.033,1370,6170,290700,11,8,2014,0,22,4996,4800,0,0,0
4,1.0,1010,7515,1.0,0,0,4,6,1010,0,1955,0,98198,47.4174,-122.316,1330,7515,248000,29,1,2015,0,60,6505,6185,0,0,1
1,1.0,540,10125,1.0,0,0,3,5,540,0,1961,0,98177,47.7739,-122.358,1840,10125,345000,13,10,2014,0,53,9585,8285,0,0,1
3,1.0,1240,4800,1.0,0,0,3,7,800,440,1951,0,98103,47.6563,-122.353,1440,4800,525000,20,8,2014,0,63,3560,3360,0,1,1
3,1.75,1510,8385,1.0,0,0,3,7,1510,0,1968,0,98034,47.7279,-122.195,1570,7480,400000,12,12,2014,0,46,6875,5910,0,0,0
3,1.0,1820,5750,1.0,0,0,3,7,1120,700,1918,0,98116,47.5773,-122.383,1500,5750,532000,8,4,2015,0,97,3930,4250,0,1,1
2,1.0,1000,5026,1.0,0,0,5,5,760,240,1915,0,98002,47.297,-122.225,990,5026,159995,28,10,2014,0,99,4026,4036,0,1,0
5,1.5,2040,11772,1.0,0,0,4,7,1030,1010,1963,0,98056,47.5015,-122.166,1560,9435,287000,16,10,2014,0,51,9732,7875,0,1,0
4,2.5,3690,11191,1.0,0,3,4,10,2190,1500,1951,0,98199,47.6434,-122.412,3460,8160,1120000,20,4,2015,0,64,7501,4700,0,1,1
3,2.5,2310,11993,2.0,0,0,3,9,2310,0,1988,0,98006,47.5438,-122.139,2830,10031,765000,23,4,2015,0,27,9683,7201,0,0,0
3,1.5,1090,9605,1.0,0,0,4,6,1090,0,1969,0,98038,47.3609,-122.028,1160,10487,185000,14,11,2014,0,45,8515,9327,0,0,0
3,1.0,1150,3000,1.0,0,0,5,6,1150,0,1906,0,98103,47.6867,-122.345,1460,3200,430000,21,5,2014,0,108,1850,1740,0,0,1
4,2.5,2100,3916,2.0,0,0,3,8,2100,0,2009,0,98058,47.4324,-122.185,2100,3916,346000,26,5,2014,0,5,1816,1816,0,0,0
4,2.75,2150,16728,1.0,0,0,4,8,1240,910,1982,0,98033,47.6915,-122.183,2200,9257,607000,15,7,2014,0,32,14578,7057,0,1,0
3,1.5,2500,6000,1.5,0,0,5,7,1730,770,1941,1984,98106,47.5297,-122.354,1340,5000,417000,4,8,2014,43,73,3500,3660,1,1,1
5,2.0,3530,9385,1.5,0,0,3,9,3530,0,1925,0,98144,47.5774,-122.285,4100,9203,930000,19,6,2014,0,89,5855,5103,0,0,1
2,1.75,1290,6600,1.0,0,2,3,7,870,420,1951,0,98136,47.531,-122.39,2380,7370,573300,23,4,2015,0,64,5310,4990,0,1,1
4,1.75,2010,10816,1.0,0,0,3,7,1410,600,1955,0,98178,47.5048,-122.251,1610,9360,260000,6,4,2015,0,60,8806,7750,0,1,1
1,0.75,420,6720,1.0,0,0,3,5,420,0,1922,0,98108,47.552,-122.311,1420,6720,280000,12,6,2014,0,92,6300,5300,0,0,1
4,2.5,2180,4000,2.0,0,0,3,8,2180,0,1920,2005,98122,47.6186,-122.288,2660,4000,825000,18,12,2014,85,94,1820,1340,1,0,1
4,1.0,1150,8184,1.5,0,0,3,6,1150,0,1947,0,98155,47.7431,-122.319,990,8184,307000,10,6,2014,0,67,7034,7194,0,0,1
4,1.75,2000,5100,1.0,0,0,4,7,1130,870,1949,0,98117,47.6798,-122.391,1540,5100,595000,13,8,2014,0,65,3100,3560,0,1,1
5,1.75,2780,7786,1.0,0,0,3,8,1390,1390,1966,0,98052,47.6694,-122.157,2130,7918,528000,15,4,2015,0,49,5006,5788,0,1,0
2,1.75,1550,7764,1.0,1,4,4,8,1550,0,1965,1986,98070,47.358,-122.446,1690,11620,600000,22,8,2014,21,49,6214,9930,1,0,0
2,1.0,2180,12875,1.0,0,0,3,7,1480,700,1959,0,98198,47.3757,-122.303,1800,7447,275000,2,3,2015,0,56,10695,5647,0,1,1
2,1.5,1570,3600,1.5,0,2,4,7,1320,250,1906,0,98119,47.6366,-122.363,2140,3600,782000,2,7,2014,0,108,2030,1460,0,1,1
3,1.0,1600,3200,1.5,0,0,3,7,1600,0,1909,0,98103,47.653,-122.331,1860,3420,488000,25,11,2014,0,105,1600,1560,0,0,1
3,1.0,1630,5000,1.0,0,0,3,7,930,700,1954,0,98108,47.5497,-122.295,1630,5480,320000,3,4,2015,0,61,3370,3850,0,1,1
3,1.0,890,4810,1.0,0,0,3,6,890,0,1910,0,98118,47.5153,-122.266,1230,6057,153500,18,3,2015,0,105,3920,4827,0,0,1
3,1.0,1350,9450,1.0,0,0,3,7,1350,0,1979,0,98034,47.7186,-122.236,1460,9461,414500,19,3,2015,0,36,8100,8001,0,0,0
5,1.75,2850,11860,1.0,0,0,3,9,2850,0,1951,0,98155,47.7503,-122.28,2640,11604,750000,4,8,2014,0,63,9010,8964,0,0,1
2,1.0,1090,6000,1.0,0,0,3,7,1090,0,1922,0,98144,47.5886,-122.292,1960,5000,425000,6,4,2015,0,93,4910,3040,0,0,1
4,2.5,2990,9374,2.0,0,0,3,9,2990,0,2003,0,98074,47.6287,-122.024,2440,8711,785000,5,8,2014,0,11,6384,6271,0,0,0
2,1.0,720,5160,1.0,0,0,3,6,720,0,1949,0,98106,47.5274,-122.357,990,5160,248500,14,8,2014,0,65,4440,4170,0,0,1
3,2.5,2330,8627,1.0,0,0,4,7,1480,850,1980,0,98055,47.4543,-122.21,1940,9607,325000,23,7,2014,0,34,6297,7667,0,1,0
2,1.0,1280,5728,1.5,0,0,5,6,1280,0,1941,0,98028,47.7477,-122.232,2480,9775,272925,23,7,2014,0,73,4448,7295,0,0,0
2,2.25,1570,1269,2.0,0,0,3,9,1280,290,2015,0,98199,47.6514,-122.385,1570,6000,500000,26,8,2014,0,-1,-301,4430,0,1,1
4,1.75,1510,5500,1.5,0,0,3,7,1510,0,1920,0,98106,47.535,-122.359,1320,6431,250000,20,10,2014,0,94,3990,5111,0,0,1
4,2.5,2470,8536,2.0,0,0,3,8,2470,0,2002,0,98155,47.7699,-122.292,1690,8840,470000,22,9,2014,0,12,6066,7150,0,0,1
2,1.0,1190,3400,1.0,0,0,4,7,990,200,1917,0,98118,47.5539,-122.268,1180,4000,440000,1,10,2014,0,97,2210,2820,0,1,1
4,2.5,1981,4828,2.0,0,0,3,8,1981,0,2013,0,98092,47.3252,-122.167,1981,3783,299999,5,1,2015,0,2,2847,1802,0,0,0
3,1.75,1590,7810,1.0,0,0,4,7,1590,0,1959,0,98002,47.2932,-122.22,1470,7810,255000,27,3,2015,0,56,6220,6340,0,0,0
3,1.75,1150,7700,1.0,0,0,3,7,1150,0,1957,0,98008,47.6048,-122.121,1650,8000,415950,13,8,2014,0,57,6550,6350,0,0,0
5,2.75,2160,7200,1.5,0,0,3,7,1220,940,1955,0,98118,47.5576,-122.273,1900,7200,402000,5,8,2014,0,59,5040,5300,0,1,1
2,2.5,2470,8840,2.0,0,0,4,8,1780,690,2001,0,98108,47.5693,-122.301,1940,8840,635000,17,9,2014,0,13,6370,6900,0,1,1
3,2.5,1710,8998,2.0,0,0,3,8,1710,0,1982,0,98052,47.7236,-122.11,1710,9859,479000,8,10,2014,0,32,7288,8149,0,0,0
2,2.25,1860,2670,2.0,0,0,4,8,1860,0,1986,0,98006,47.5436,-122.187,1860,2531,462370,22,12,2014,0,28,810,671,0,0,0
3,1.0,1150,6480,1.5,0,0,4,5,1150,0,1946,0,98001,47.2642,-122.258,1100,7300,171500,1,5,2015,0,69,5330,6200,0,0,0
5,3.0,3850,9457,2.0,0,0,4,9,2910,940,1963,0,98177,47.727,-122.362,2830,9608,925000,15,7,2014,0,51,5607,6778,0,1,1
5,3.0,3410,9600,1.0,0,0,4,8,1870,1540,1968,0,98052,47.6358,-122.103,2390,9679,675000,13,5,2014,0,46,6190,7289,0,1,0
4,2.5,2390,6426,2.0,0,0,3,9,2390,0,1999,0,98092,47.2586,-122.221,2520,6700,359800,5,6,2014,0,15,4036,4180,0,0,0
3,2.0,1410,7566,1.0,0,0,3,7,1410,0,1985,0,98030,47.3674,-122.182,1570,7210,239900,7,5,2014,0,29,6156,5640,0,0,0
2,1.0,740,4459,1.0,0,2,3,5,740,0,1915,0,98116,47.5704,-122.409,1490,4700,295000,10,7,2014,0,99,3719,3210,0,0,1
4,2.5,2180,6500,2.0,0,0,3,7,1410,770,1945,0,98126,47.5365,-122.37,920,6500,435000,21,4,2015,0,70,4320,5580,0,1,1
2,1.0,820,5040,1.0,0,0,3,7,820,0,1953,0,98199,47.6498,-122.388,1730,5760,508000,20,8,2014,0,61,4220,4030,0,0,1
6,4.5,5480,10800,2.0,0,3,4,9,4430,1050,1999,0,98119,47.6307,-122.367,2970,7200,2400000,20,6,2014,0,15,5320,4230,0,1,1
4,2.5,1960,7875,1.0,0,0,3,7,1220,740,1978,0,98001,47.3427,-122.274,2030,7650,234500,16,9,2014,0,36,5915,5620,0,1,0
2,1.0,1270,3200,1.0,0,0,4,7,960,310,1920,0,98103,47.6565,-122.348,1410,1320,355000,28,5,2014,0,94,1930,-90,0,1,1
3,2.0,1710,5200,1.0,0,0,5,7,1030,680,1977,0,98042,47.3651,-122.094,1390,5200,230000,1,8,2014,0,37,3490,3810,0,1,0
3,1.75,1930,9000,1.0,0,1,4,7,1150,780,1951,0,98166,47.4539,-122.348,1590,9000,345000,11,2,2015,0,64,7070,7410,0,1,1
3,1.75,1200,4500,1.0,0,0,5,7,1200,0,1906,0,98108,47.5553,-122.316,1340,4500,430000,20,5,2014,0,108,3300,3160,0,0,1
3,1.5,1680,17409,1.0,0,0,3,7,1680,0,1962,0,98033,47.6766,-122.176,1680,9101,500000,15,12,2014,0,52,15729,7421,0,0,0
4,1.0,1300,6075,1.0,0,0,5,7,1300,0,1954,0,98133,47.773,-122.349,1450,7320,378000,5,5,2015,0,61,4775,5870,0,0,1
3,2.5,1540,3237,2.0,0,0,3,7,1540,0,1999,0,98065,47.5299,-121.878,1780,3411,345000,8,8,2014,0,15,1697,1631,0,0,0
2,1.75,870,4000,1.0,0,0,3,6,870,0,1941,0,98126,47.5657,-122.376,1420,4000,410000,29,3,2015,0,74,3130,2580,0,0,1
2,2.25,1890,5400,2.0,0,0,5,8,1610,280,1905,0,98105,47.6688,-122.31,2820,4860,750000,22,8,2014,0,109,3510,2040,0,1,1
4,1.75,2050,8913,1.0,0,0,3,7,1330,720,1968,0,98052,47.6735,-122.151,1290,8550,485000,22,1,2015,0,47,6863,7260,0,1,0
3,1.0,880,18109,1.0,0,0,4,6,880,0,1970,0,98042,47.3634,-122.101,940,11193,105000,17,3,2015,0,45,17229,10253,0,0,0
3,2.75,2780,4000,2.0,0,2,5,8,1960,820,1904,0,98103,47.6565,-122.355,1490,4800,1030000,23,4,2015,0,111,1220,3310,0,1,1
5,2.75,2300,7600,1.0,0,0,4,7,1400,900,1969,0,98023,47.3084,-122.372,1750,8500,294000,30,10,2014,0,45,5300,6750,0,1,0
4,2.5,3140,12792,2.0,0,0,4,9,3140,0,1977,0,98042,47.3863,-122.156,2510,12792,400000,9,10,2014,0,37,9652,10282,0,0,0
3,1.75,2300,6200,1.0,0,0,4,7,1150,1150,1970,0,98198,47.4176,-122.323,1740,6600,325000,2,1,2015,0,45,3900,4860,0,1,1
3,2.25,1920,8223,2.0,0,0,4,7,1920,0,1989,0,98011,47.735,-122.201,1940,7274,443000,9,7,2014,0,25,6303,5334,0,0,0
3,1.0,1150,7486,1.0,0,0,3,7,1150,0,1970,0,98034,47.7261,-122.219,1510,7486,325000,17,9,2014,0,44,6336,5976,0,0,0
4,2.5,3120,8792,2.0,0,0,4,9,3120,0,1992,0,98029,47.5699,-121.993,2150,7688,760000,23,1,2015,0,23,5672,5538,0,0,0
4,2.0,2560,7798,1.0,0,0,4,7,1890,670,1947,0,98115,47.6914,-122.296,1330,7798,640000,15,5,2014,0,67,5238,6468,0,1,1
3,2.0,1410,4303,1.5,0,0,4,7,1410,0,1900,0,98108,47.5541,-122.317,1660,4326,415000,6,4,2015,0,115,2893,2666,0,0,1
3,1.0,970,8580,1.0,0,0,3,7,970,0,1959,0,98003,47.3363,-122.311,1430,11907,156000,12,5,2014,0,55,7610,10477,0,0,0
3,3.25,3620,8131,2.0,0,0,4,10,2730,890,1988,0,98040,47.5776,-122.214,2040,3776,996000,22,9,2014,0,26,4511,1736,0,1,0
2,1.0,880,5100,1.0,0,0,4,7,880,0,1941,0,98103,47.694,-122.346,980,5100,415000,27,3,2015,0,74,4220,4120,0,0,1
3,1.75,1900,3783,1.5,0,0,5,7,1110,790,1927,0,98144,47.5742,-122.315,1530,5098,615000,26,9,2014,0,87,1883,3568,0,1,1
4,2.5,2540,4241,2.0,0,0,3,8,2540,0,2009,0,98052,47.7073,-122.112,3010,4929,717000,7,10,2014,0,5,1701,1919,0,0,0
4,1.75,1690,7794,1.0,0,0,3,7,1090,600,1968,0,98033,47.6888,-122.203,1380,7325,548000,31,3,2015,0,47,6104,5945,0,1,0
3,1.5,1120,6653,1.0,0,0,4,7,1120,0,1937,0,98133,47.7321,-122.334,1580,7355,425000,1,4,2015,0,78,5533,5775,0,0,1
4,2.75,2130,9339,1.0,0,0,3,7,1330,800,1991,0,98198,47.3788,-122.316,2090,7628,325250,27,10,2014,0,23,7209,5538,0,1,1
3,1.75,1900,11165,1.0,0,0,4,7,1900,0,1959,0,98008,47.5789,-122.118,2030,11165,557500,25,6,2014,0,55,9265,9135,0,0,0
3,3.0,1790,2003,2.0,0,0,3,7,1480,310,2006,0,98108,47.5421,-122.321,1220,4000,249950,10,9,2014,0,8,213,2780,0,1,1
4,2.75,2250,7345,1.0,0,0,4,8,1320,930,1984,0,98023,47.2895,-122.37,1800,6950,260000,16,9,2014,0,30,5095,5150,0,1,0
4,1.75,1780,2788,1.0,0,0,4,6,890,890,1943,0,98199,47.6511,-122.4,1760,5664,442900,21,6,2014,0,71,1008,3904,0,1,1
3,2.25,1580,12177,1.0,0,0,3,7,1200,380,1981,0,98074,47.6254,-122.045,1660,11374,475000,13,6,2014,0,33,10597,9714,0,1,0
5,2.75,3260,9253,2.0,0,0,3,8,3260,0,2004,0,98042,47.3674,-122.07,2770,8067,365000,13,8,2014,0,10,5993,5297,0,0,0
3,1.75,2460,4240,1.0,0,0,4,7,1230,1230,1925,0,98103,47.6593,-122.337,1700,4240,930000,27,2,2015,0,90,1780,2540,0,1,1
3,1.0,1020,4980,1.0,0,0,4,7,850,170,1941,0,98133,47.7039,-122.34,970,4980,350000,18,8,2014,0,73,3960,4010,0,1,1
3,1.75,1630,9403,1.0,0,0,3,7,1630,0,1983,0,98155,47.757,-122.316,1430,8461,357500,18,12,2014,0,31,7773,7031,0,0,1
4,2.5,3290,11446,2.0,0,0,3,8,3290,0,1992,0,98028,47.7399,-122.234,2050,11933,520000,21,5,2014,0,22,8156,9883,0,0,0
4,2.5,1940,3784,2.0,0,0,3,8,1940,0,2003,0,98058,47.4513,-122.119,1940,4499,330000,9,5,2014,0,11,1844,2559,0,0,0
3,2.0,1350,11150,1.0,0,0,3,7,1110,240,1995,0,98045,47.446,-121.776,1290,10043,310000,4,6,2014,0,19,9800,8753,0,1,0
3,1.0,1110,6060,1.0,0,0,3,6,1110,0,1949,0,98166,47.4705,-122.352,1480,8100,279000,13,2,2015,0,66,4950,6620,0,0,1
4,2.5,2280,7200,2.0,0,0,3,8,2280,0,1994,0,98030,47.3829,-122.207,2250,7200,322000,30,5,2014,0,20,4920,4950,0,0,0
5,3.25,3800,15500,1.0,0,0,3,7,2490,1310,1965,0,98032,47.3862,-122.28,2000,13980,380000,12,3,2015,0,50,11700,11980,0,1,0
2,1.0,850,8400,1.0,0,0,4,6,850,0,1941,0,98166,47.4696,-122.359,1280,8400,320000,28,4,2015,0,74,7550,7120,0,0,1
3,1.75,1560,8456,1.0,0,0,5,7,1560,0,1970,0,98028,47.7769,-122.25,2230,13109,400000,22,9,2014,0,44,6896,10879,0,0,0
3,1.0,1000,3844,1.0,0,0,5,7,900,100,1928,0,98133,47.7031,-122.349,1000,3920,412000,22,8,2014,0,86,2844,2920,0,1,1
3,1.0,1400,5100,1.5,0,0,3,7,1400,0,1900,0,98103,47.6677,-122.333,1740,3060,887200,7,4,2015,0,115,3700,1320,0,0,1
4,1.75,1540,5120,1.0,0,0,5,6,770,770,1943,0,98126,47.5359,-122.372,1080,5120,395000,24,6,2014,0,71,3580,4040,0,1,1
2,1.0,800,5280,1.0,0,0,5,6,800,0,1918,0,98022,47.205,-121.995,1240,7670,195000,19,11,2014,0,96,4480,6430,0,0,0
3,1.0,1160,3750,1.5,0,0,3,7,1160,0,1910,0,98106,47.5652,-122.359,1530,3750,390000,20,6,2014,0,104,2590,2220,0,0,1
3,1.0,1010,7690,1.0,0,0,4,6,1010,0,1958,0,98058,47.4501,-122.176,1010,7619,165000,11,11,2014,0,56,6680,6609,0,0,0
3,1.0,1010,7690,1.0,0,0,4,6,1010,0,1958,0,98058,47.4501,-122.176,1010,7619,255000,8,5,2015,0,57,6680,6609,0,0,0
3,2.5,1610,4611,2.0,0,0,3,8,1610,0,1996,0,98029,47.5678,-122.004,1730,4461,505000,19,6,2014,0,18,3001,2731,0,0,0
3,3.0,2400,7260,1.0,0,0,3,7,1440,960,1955,0,98178,47.5045,-122.251,1060,7200,335750,23,2,2015,0,60,4860,6140,0,1,1
3,1.75,1800,5816,1.0,0,0,5,7,900,900,1947,0,98199,47.6529,-122.407,1650,5816,719000,15,1,2015,0,68,4016,4166,0,1,1
4,3.25,2110,3000,2.0,0,0,3,8,2110,0,2001,0,98115,47.6769,-122.328,1780,4000,796000,9,9,2014,0,13,890,2220,0,0,1
2,1.0,960,7000,1.0,0,0,3,4,960,0,1918,0,98198,47.3864,-122.307,1850,8120,95000,8,4,2015,0,97,6040,6270,0,0,1
3,3.0,2600,5238,1.5,0,3,3,9,1890,710,1989,0,98198,47.3448,-122.327,2220,4853,525000,29,5,2014,0,25,2638,2633,0,1,1
3,1.5,1340,10224,1.0,0,0,4,7,1340,0,1956,0,98006,47.5752,-122.157,1340,10440,417000,15,5,2014,0,58,8884,9100,0,0,0
3,1.0,1410,5000,1.0,0,0,3,6,980,430,1925,0,98116,47.5769,-122.397,1410,5000,410000,20,4,2015,0,90,3590,3590,0,1,1
4,2.25,2390,12292,1.0,0,0,5,9,2390,0,1962,0,98040,47.5528,-122.221,2870,12337,984000,12,1,2015,0,53,9902,9467,0,0,0
2,1.5,1180,834,3.0,0,0,3,8,1180,0,2009,0,98133,47.7074,-122.356,1180,1207,325000,3,4,2015,0,6,-346,27,0,0,1
3,2.25,1840,9929,1.0,0,0,3,7,1200,640,1987,0,98028,47.7408,-122.236,1710,9929,350000,23,9,2014,0,27,8089,8219,0,1,0
4,2.25,2630,4000,2.0,0,0,5,9,1810,820,1909,0,98102,47.6393,-122.317,2370,4700,1050000,27,10,2014,0,105,1370,2330,0,1,1
2,2.5,1720,3132,2.0,0,0,3,8,1720,0,1999,0,98042,47.3728,-122.157,1740,4220,234950,8,4,2015,0,16,1412,2480,0,0,0
4,1.75,2320,7500,1.0,0,0,3,7,1220,1100,1955,0,98133,47.7574,-122.343,2230,7500,410000,20,3,2015,0,60,5180,5270,0,1,1
3,1.75,1840,5664,2.0,0,0,3,7,1270,570,1948,0,98115,47.6899,-122.283,1480,5664,625000,17,4,2015,0,67,3824,4184,0,1,1
5,2.5,2890,15891,2.0,0,0,3,9,2890,0,1990,0,98059,47.5286,-122.16,2590,10556,706000,23,4,2015,0,25,13001,7966,0,0,0
4,2.75,1660,5150,1.5,0,0,5,7,1280,380,1928,0,98117,47.6835,-122.362,1490,4017,685000,2,10,2014,0,86,3490,2527,0,1,1
3,2.5,2170,9900,1.0,0,0,3,7,1690,480,1980,0,98038,47.3634,-122.031,1420,10614,242050,16,10,2014,0,34,7730,9194,0,1,0
3,3.25,3310,5000,2.0,0,0,3,9,3310,0,2006,0,98029,47.5558,-122.001,2670,4907,770000,22,9,2014,0,8,1690,2237,0,0,0
2,1.5,1450,3840,1.0,0,0,3,7,950,500,1947,0,98117,47.684,-122.381,1450,3840,557000,28,4,2015,0,68,2390,2390,0,1,1
4,2.0,1760,7700,1.0,0,0,4,7,1760,0,1962,0,98003,47.3299,-122.318,1870,7316,194000,10,3,2015,0,53,5940,5446,0,0,0
3,2.5,3170,7187,2.0,0,0,3,9,3170,0,2005,0,98033,47.6934,-122.166,2790,7336,720000,24,11,2014,0,9,4017,4546,0,0,0
2,1.0,1250,4576,1.0,0,0,3,6,1040,210,1925,0,98118,47.5387,-122.266,1550,5000,449000,25,3,2015,0,90,3326,3450,0,1,1
4,3.0,2460,10401,1.0,0,0,5,7,1700,760,1947,0,98125,47.7106,-122.285,1470,7727,570000,26,3,2015,0,68,7941,6257,0,1,1
3,2.0,1470,10125,1.0,0,0,4,7,1470,0,1962,0,98011,47.7751,-122.222,1440,10125,395000,12,11,2014,0,52,8655,8685,0,0,0
4,2.0,1780,15648,1.5,0,0,5,8,1780,0,1918,0,98004,47.5849,-122.198,2320,14963,1000000,29,7,2014,0,96,13868,12643,0,0,0
4,1.0,1580,8475,1.5,0,2,4,7,1580,0,1928,0,98178,47.5104,-122.254,1700,5650,406000,1,7,2014,0,86,6895,3950,0,0,1
3,1.5,1630,2946,1.5,0,0,4,8,1630,0,1932,0,98115,47.6865,-122.31,1550,3800,574800,23,10,2014,0,82,1316,2250,0,0,1
4,2.0,2240,9240,1.0,0,0,3,7,1120,1120,1968,0,98032,47.3666,-122.288,2040,8250,309000,20,4,2015,0,47,7000,6210,0,1,0
3,1.5,1940,5625,1.0,0,0,4,7,1440,500,1941,0,98117,47.6818,-122.388,1460,5500,525000,17,3,2015,0,74,3685,4040,0,1,1
3,2.5,1970,4058,2.0,0,0,3,7,1970,0,2004,0,98065,47.5308,-121.853,2340,4067,419000,18,7,2014,0,10,2088,1727,0,0,0
4,2.5,2050,6705,1.0,0,0,4,7,1230,820,1973,0,98034,47.7242,-122.217,1610,7292,479000,11,4,2015,0,42,4655,5682,0,1,0
3,1.0,1340,18552,1.5,0,0,4,5,1340,0,1935,0,98014,47.7129,-121.325,960,15141,160000,13,1,2015,0,80,17212,14181,0,0,0
4,1.75,1880,9880,1.0,0,0,4,8,1880,0,1967,0,98058,47.4551,-122.151,1880,9600,333000,16,9,2014,0,47,8000,7720,0,0,0
2,1.0,860,12160,1.0,0,0,4,6,860,0,1921,0,98106,47.5267,-122.361,1010,7611,310000,30,9,2014,0,93,11300,6601,0,0,1
3,2.5,2140,2868,2.0,0,0,3,8,1770,370,2007,0,98052,47.6668,-122.132,2140,2527,666000,5,2,2015,0,8,728,387,0,1,0
4,2.75,2370,7320,2.0,0,0,3,7,2370,0,1989,0,98023,47.3071,-122.36,1960,7320,310000,17,9,2014,0,25,4950,5360,0,0,0
4,3.0,2110,5000,1.5,0,2,4,7,1640,470,1930,0,98136,47.5195,-122.391,1380,5000,610000,12,5,2014,0,84,2890,3620,0,1,1
3,2.25,1990,8501,2.0,0,0,3,8,1990,0,1991,0,98029,47.5707,-121.996,2090,6459,564800,8,10,2014,0,23,6511,4369,0,0,0
3,2.25,1820,9150,1.0,0,0,3,7,1320,500,1961,0,98133,47.737,-122.334,1780,8055,438000,21,4,2015,0,54,7330,6275,0,1,1
3,2.0,3120,9400,1.0,0,0,5,9,1820,1300,1978,0,98006,47.5612,-122.15,2770,9500,855000,13,8,2014,0,36,6280,6730,0,1,0
3,2.5,1190,3000,2.0,0,0,3,7,1190,0,2002,0,98178,47.4933,-122.275,1190,3000,229000,8,5,2014,0,12,1810,1810,0,0,1
3,2.0,1170,5450,1.0,0,0,5,6,1170,0,1902,0,98118,47.5276,-122.273,1340,6384,260000,25,7,2014,0,112,4280,5044,0,0,1
3,2.5,2630,10131,2.0,0,0,3,9,2630,0,1989,0,98028,47.7695,-122.259,2800,10123,609000,18,9,2014,0,25,7501,7323,0,0,0
4,1.0,1450,6250,1.0,0,0,3,6,990,460,1964,0,98146,47.5131,-122.357,1440,4000,277000,28,5,2014,0,50,4800,2560,0,1,1
4,2.0,2100,8160,1.0,0,0,3,7,1200,900,1959,0,98106,47.5145,-122.365,1140,8160,283000,9,12,2014,0,55,6060,7020,0,1,1
2,1.75,1680,8367,1.0,0,0,3,6,840,840,1914,0,98115,47.6976,-122.288,1830,6720,334000,18,3,2015,0,101,6687,4890,0,1,1
4,1.75,2000,7350,1.0,0,0,3,7,1100,900,1963,0,98003,47.3428,-122.303,1720,7350,267000,26,2,2015,0,52,5350,5630,0,1,0
3,1.0,1030,3000,1.0,0,0,3,7,830,200,1924,0,98115,47.6813,-122.317,1830,3000,385000,14,7,2014,0,90,1970,1170,0,1,1
5,1.75,2020,6565,1.0,0,0,3,8,1120,900,1956,0,98115,47.6821,-122.283,2020,6552,640000,24,10,2014,0,58,4545,4532,0,1,1
4,2.5,1750,8476,1.0,0,0,4,7,1240,510,1983,0,98058,47.4447,-122.137,1660,7875,335000,23,5,2014,0,31,6726,6215,0,1,0
3,2.5,1710,4920,2.0,0,0,3,7,1710,0,1990,0,98126,47.5347,-122.376,1500,4920,415000,30,10,2014,0,24,3210,3420,0,0,1
2,2.5,2720,16637,1.0,0,3,3,10,2160,560,1953,0,98118,47.5499,-122.264,2880,7320,1440000,28,8,2014,0,61,13917,4440,0,1,1
3,1.0,1010,10215,1.0,0,0,3,6,1010,0,1955,0,98146,47.4872,-122.345,1320,10245,180000,7,8,2014,0,59,9205,8925,0,0,1
4,2.5,1830,4500,2.0,0,0,3,7,1830,0,2004,0,98038,47.3504,-122.005,2080,5100,335000,14,7,2014,0,10,2670,3020,0,0,0
4,1.5,2080,4400,1.5,0,0,3,7,2080,0,1925,0,98122,47.606,-122.299,1680,4400,592500,3,10,2014,0,89,2320,2720,0,0,1
3,1.5,1470,11112,1.0,0,0,3,7,1470,0,1954,0,98155,47.7462,-122.294,1460,11407,418900,8,8,2014,0,60,9642,9947,0,0,1
3,1.0,1600,7324,1.0,0,0,4,7,1600,0,1958,0,98056,47.5054,-122.19,1430,7249,340000,9,7,2014,0,56,5724,5819,0,0,0
3,2.0,1340,7200,1.5,0,0,4,7,1340,0,1923,0,98118,47.5601,-122.265,1630,5760,545000,2,7,2014,0,91,5860,4130,0,0,1
5,3.5,3680,8680,2.0,0,0,3,9,3680,0,2003,0,98033,47.6575,-122.197,2020,8847,1380000,3,4,2015,0,12,5000,6827,0,0,0
3,2.5,1770,3451,2.0,0,0,3,7,1770,0,2004,0,98055,47.4325,-122.197,1490,2138,183750,26,3,2015,0,11,1681,648,0,0,0
4,2.0,980,10640,1.0,0,0,5,7,980,0,1978,0,98045,47.4462,-121.773,1230,9750,295000,22,5,2014,0,36,9660,8520,0,0,0
4,3.0,2530,5625,1.0,0,0,3,8,1470,1060,1976,0,98034,47.7094,-122.233,1840,7070,625000,11,7,2014,0,38,3095,5230,0,1,0
4,3.0,2390,4500,2.0,0,0,3,7,2390,0,1974,0,98055,47.4872,-122.204,1320,4500,290000,9,6,2014,0,40,2110,3180,0,0,0
3,1.0,1710,4050,1.5,0,0,3,7,1710,0,1909,0,98103,47.6732,-122.331,1790,4896,620000,13,5,2014,0,105,2340,3106,0,0,1
4,2.0,1170,4000,1.0,0,0,3,7,1170,0,1955,0,98144,47.5797,-122.305,1720,4000,330000,8,5,2015,0,60,2830,2280,0,0,1
3,2.25,1990,6256,1.0,0,0,3,7,1390,600,1960,0,98033,47.6903,-122.206,2080,9300,620000,8,4,2015,0,55,4266,7220,0,1,0
4,1.75,1710,10480,1.5,0,0,4,6,1710,0,1969,0,98059,47.4743,-122.143,1750,10480,320000,7,1,2015,0,46,8770,8730,0,0,0
3,2.5,1740,2350,2.0,0,0,3,8,1120,620,1996,0,98112,47.6206,-122.297,1750,3802,525000,15,9,2014,0,18,610,2052,0,1,1
4,3.75,3320,8030,2.0,0,0,3,10,3320,0,2005,0,98075,47.5818,-121.972,3740,8030,802500,21,7,2014,0,9,4710,4290,0,0,0
4,1.0,1960,3194,2.0,0,0,3,7,1960,0,1907,0,98144,47.6005,-122.296,1870,4200,569500,26,9,2014,0,107,1234,2330,0,0,1
6,3.5,2820,5400,1.0,0,0,3,8,1620,1200,1958,0,98117,47.6791,-122.374,1560,2276,850000,16,12,2014,0,56,2580,716,0,1,1
3,1.0,1590,4080,1.5,0,0,3,7,1590,0,1922,0,98105,47.662,-122.326,1570,4080,630000,5,4,2015,0,93,2490,2510,0,0,1
4,2.25,2490,10720,1.0,0,1,4,7,1400,1090,1979,0,98074,47.6137,-122.06,3080,10720,454800,5,8,2014,0,35,8230,7640,0,1,0
3,1.0,870,5200,1.0,0,0,5,6,870,0,1969,0,98042,47.3695,-122.081,870,5200,177000,3,3,2015,0,46,4330,4330,0,0,0
3,1.0,1580,3840,2.0,0,0,3,8,1580,0,1908,0,98102,47.6192,-122.319,1680,2624,729000,17,6,2014,0,106,2260,944,0,0,1
4,3.25,4110,15488,2.0,0,2,3,11,4110,0,1995,0,98006,47.5493,-122.117,4190,14973,935000,21,10,2014,0,19,11378,10783,0,0,0
3,2.0,1410,4800,1.0,0,0,3,7,1410,0,1940,0,98117,47.6852,-122.378,1190,3840,481450,9,5,2014,0,74,3390,2650,0,0,1
3,2.0,2090,4190,1.5,0,0,4,8,1490,600,1930,0,98122,47.6178,-122.284,2090,6270,860000,17,3,2015,0,85,2100,4180,0,1,1
3,1.75,1400,8364,1.0,0,0,4,7,1400,0,1958,0,98056,47.4918,-122.178,1210,8160,274000,6,11,2014,0,56,6964,6950,0,0,0
3,3.5,1690,1432,2.0,0,0,3,7,1360,330,2008,0,98199,47.6513,-122.4,1650,2788,499000,5,6,2014,0,6,-258,1138,0,1,1
3,1.0,960,9748,1.0,0,0,3,5,960,0,1922,0,98065,47.5259,-121.815,1600,9958,265000,16,12,2014,0,92,8788,8358,0,0,0
4,2.25,2380,17199,2.0,0,0,3,8,1530,850,1979,0,98028,47.7668,-122.27,2280,11529,470000,9,7,2014,0,35,14819,9249,0,1,0
2,1.0,1020,7742,1.0,0,0,4,6,1020,0,1935,1978,98168,47.499,-122.301,1510,7742,168500,29,1,2015,43,80,6722,6232,1,0,1
3,1.75,1290,8250,1.0,0,0,3,7,1290,0,1983,0,98001,47.3353,-122.27,1410,7823,220000,11,11,2014,0,31,6960,6413,0,0,0
3,2.0,1830,17321,1.0,0,0,4,7,1100,730,1948,0,98178,47.5072,-122.272,1450,10706,295000,20,10,2014,0,66,15491,9256,0,1,1
3,1.0,950,10723,1.0,0,0,4,6,950,0,1959,0,98059,47.4899,-122.133,1520,10723,285000,8,4,2015,0,56,9773,9203,0,0,0
3,1.0,1160,8950,1.0,0,0,3,7,1160,0,1968,0,98133,47.7499,-122.338,1210,8193,294950,22,10,2014,0,46,7790,6983,0,0,1
3,1.75,1780,5850,1.0,0,0,5,7,980,800,1944,0,98116,47.5589,-122.392,1550,5850,565500,3,4,2015,0,71,4070,4300,0,1,1
3,2.0,1410,10625,1.0,0,0,3,7,1410,0,1980,0,98042,47.3649,-122.117,1410,9744,230000,13,10,2014,0,34,9215,8334,0,0,0
2,1.5,1790,4250,1.0,0,0,3,7,920,870,1915,2014,98112,47.6367,-122.301,1910,4250,721000,24,9,2014,99,99,2460,2340,1,1,1
3,2.5,4040,8653,2.0,0,0,3,9,2900,1140,2006,0,98019,47.7378,-121.975,3360,8653,565000,18,12,2014,0,8,4613,5293,0,1,0
3,1.75,1990,9885,1.0,0,0,4,7,1030,960,1978,0,98052,47.6722,-122.162,1560,10000,438000,17,9,2014,0,36,7895,8440,0,1,0
3,1.75,2150,19127,1.0,0,0,3,7,1650,500,1978,0,98168,47.5061,-122.324,1550,15000,369900,2,4,2015,0,37,16977,13450,0,1,1
4,2.5,1850,9136,2.0,0,0,3,8,1850,0,1997,0,98059,47.4943,-122.157,1930,7873,405000,5,9,2014,0,17,7286,5943,0,0,0
3,2.5,1680,15711,1.0,0,0,3,7,1240,440,1994,0,98031,47.423,-122.171,1420,8588,282000,27,5,2014,0,20,14031,7168,0,1,0
2,1.0,1430,7819,1.0,0,0,3,7,1110,320,1944,0,98125,47.7307,-122.302,1380,7473,380950,4,11,2014,0,70,6389,6093,0,1,1
3,1.0,960,8855,1.0,0,0,4,7,960,0,1958,0,98155,47.7689,-122.328,1250,8855,349810,30,6,2014,0,56,7895,7605,0,0,1
4,2.5,2700,8810,2.0,0,0,3,9,2700,0,2004,0,98052,47.7041,-122.116,2730,5100,690000,26,5,2014,0,10,6110,2370,0,0,0
2,1.5,1290,5141,1.0,0,0,4,7,1050,240,1947,0,98115,47.6878,-122.29,1290,5406,653000,5,5,2015,0,68,3851,4116,0,1,1
4,3.5,4320,8490,2.0,0,0,3,10,3280,1040,2005,0,98029,47.5568,-122.029,4030,11008,1040000,17,10,2014,0,9,4170,6978,0,1,0
3,1.0,2130,3825,1.5,0,0,3,7,2130,0,1917,0,98118,47.5506,-122.281,1780,5150,335000,23,9,2014,0,97,1695,3370,0,0,1
5,3.5,3740,11340,2.0,0,0,3,10,3740,0,2013,0,98052,47.6628,-122.143,2040,8715,1080000,10,3,2015,0,2,7600,6675,0,0,0
3,2.5,2130,8022,2.0,0,0,3,8,2130,0,1985,0,98052,47.7252,-122.106,2130,7605,475000,22,9,2014,0,29,5892,5475,0,0,0
4,2.0,1210,4250,1.0,0,0,4,7,1210,0,1941,0,98108,47.5275,-122.321,1210,6000,315000,12,2,2015,0,74,3040,4790,0,0,1
5,2.25,3040,8111,2.0,0,0,3,8,3040,0,1984,0,98052,47.7157,-122.103,2020,8304,562000,6,5,2014,0,30,5071,6284,0,0,0
3,2.5,1570,6932,2.0,0,0,3,7,1570,0,1993,0,98038,47.3902,-122.049,1570,6271,295000,24,4,2015,0,22,5362,4701,0,0,0
3,2.25,2090,15000,1.0,0,0,3,7,2090,0,1961,0,98045,47.4885,-121.783,1690,14400,383000,8,7,2014,0,53,12910,12710,0,0,0
3,2.25,1690,7292,1.0,0,0,3,7,1250,440,1985,0,98003,47.2639,-122.303,1670,7747,242000,13,4,2015,0,30,5602,6077,0,1,0
3,1.5,1470,17577,1.0,0,0,5,7,1470,0,1967,0,98059,47.4695,-122.116,2300,13832,352500,3,4,2015,0,48,16107,11532,0,0,0
4,1.0,1460,6000,1.0,0,0,4,7,730,730,1941,0,98178,47.4952,-122.224,1190,6000,239950,23,7,2014,0,73,4540,4810,0,1,1
4,2.5,3030,6820,2.0,0,0,3,9,2530,500,1947,2000,98105,47.6695,-122.266,2070,6820,998000,3,9,2014,53,67,3790,4750,1,1,1
3,1.75,1190,4500,1.0,0,0,3,6,1190,0,1922,2012,98116,47.5576,-122.388,1820,4500,515000,17,4,2015,90,93,3310,2680,1,0,1
5,1.0,1840,6710,1.5,0,0,3,7,1840,0,1920,0,98126,47.5686,-122.378,1410,4880,590000,6,4,2015,0,95,4870,3470,0,0,1
4,3.75,3560,13959,2.0,0,0,4,9,3560,0,1972,0,98040,47.5575,-122.211,3320,11834,1160000,2,4,2015,0,43,10399,8514,0,0,0
3,1.75,1580,9750,1.0,0,0,5,7,1580,0,1954,0,98148,47.427,-122.331,1460,9750,289000,4,11,2014,0,60,8170,8290,0,0,1
3,1.5,1230,7200,1.0,0,0,3,7,1230,0,1953,0,98125,47.7281,-122.311,1400,6240,424000,23,3,2015,0,62,5970,4840,0,0,1
4,2.0,1440,9477,1.0,0,0,3,5,1440,0,1943,0,98056,47.5093,-122.182,1440,9546,199000,16,10,2014,0,71,8037,8106,0,0,0
4,3.5,4420,7902,2.0,0,0,3,10,3350,1070,2004,0,98065,47.5327,-121.86,3440,7851,730000,6,10,2014,0,10,3482,4411,0,1,0
3,1.0,910,5250,1.0,0,0,4,6,910,0,1971,0,98166,47.4729,-122.352,1650,10442,244000,27,5,2014,0,43,4340,8792,0,0,1
2,1.0,670,10920,1.0,0,0,3,6,670,0,1942,0,98146,47.5128,-122.372,900,7425,240000,18,6,2014,0,72,10250,6525,0,0,1
4,2.75,2650,8610,2.0,0,0,3,8,2650,0,1959,2007,98008,47.6155,-122.121,1680,8316,797000,22,4,2015,48,56,5960,6636,1,0,0
4,2.25,2220,6953,2.0,0,0,4,8,2220,0,1999,0,98038,47.3509,-122.041,2240,6716,350000,20,5,2014,0,15,4733,4476,0,0,0
3,1.75,1640,6435,1.0,0,0,3,7,1190,450,1972,0,98034,47.7197,-122.217,1770,6930,415000,19,11,2014,0,42,4795,5160,0,1,0
2,1.0,770,5185,1.0,0,0,3,7,770,0,1947,0,98126,47.5459,-122.379,1260,6550,378510,14,4,2015,0,68,4415,5290,0,0,1
4,3.5,3960,6654,2.0,0,0,3,10,2850,1110,2006,0,98199,47.6461,-122.389,2840,6400,1200000,8,7,2014,0,8,2694,3560,0,1,1
2,1.5,1140,7620,1.0,0,0,4,6,1140,0,1925,0,98106,47.5277,-122.351,1300,7620,379900,6,10,2014,0,89,6480,6320,0,0,1
3,2.5,2480,9041,2.0,0,0,3,7,2480,0,2004,0,98053,47.6797,-122.035,2480,6500,620000,20,5,2014,0,10,6561,4020,0,0,0
3,1.5,1580,3172,1.0,0,0,4,8,900,680,1946,0,98117,47.6796,-122.393,1580,5000,524500,29,8,2014,0,68,1592,3420,0,1,1
4,2.75,1990,7252,1.0,0,0,3,7,1270,720,1999,0,98002,47.2839,-122.202,2100,7535,270000,9,6,2014,0,15,5262,5435,0,1,0
4,2.25,1830,9485,1.0,0,0,4,7,1200,630,1989,0,98023,47.2995,-122.387,1730,10109,236000,28,5,2014,0,25,7655,8379,0,1,0
2,2.0,840,14564,1.5,0,0,5,6,840,0,1942,0,98106,47.5499,-122.36,1430,7920,308500,5,11,2014,0,72,13724,6490,0,0,1
5,2.25,3320,11350,1.0,0,0,5,8,1660,1660,1963,0,98040,47.5749,-122.213,3320,11085,989900,8,12,2014,0,51,8030,7765,0,1,0
2,1.0,800,15000,1.0,0,0,3,6,800,0,1927,0,98168,47.4932,-122.316,1170,15000,110000,11,6,2014,0,87,14200,13830,0,0,1
2,1.0,1190,6200,1.0,0,0,3,7,1190,0,1948,0,98133,47.7634,-122.34,1470,7800,295950,3,7,2014,0,66,5010,6330,0,0,1
3,1.75,1300,4127,1.0,0,0,4,6,650,650,1918,1953,98106,47.5353,-122.352,1420,4000,270000,28,5,2014,35,96,2827,2580,1,1,1
2,1.5,1170,1250,3.0,0,0,3,8,1170,0,2000,0,98107,47.6719,-122.38,1310,1308,475000,6,5,2015,0,15,80,-2,0,0,1
4,2.5,2510,5258,2.0,0,0,3,7,2510,0,2001,0,98056,47.4818,-122.188,2570,5119,410000,17,3,2015,0,14,2748,2549,0,0,0
3,2.5,2390,3903,2.0,0,0,3,8,1970,420,2006,0,98072,47.7515,-122.174,2390,3431,420000,12,12,2014,0,8,1513,1041,0,1,0
4,2.25,2200,3404,2.0,0,0,3,8,2200,0,2005,0,98038,47.3895,-122.034,2200,3449,355000,19,1,2015,0,10,1204,1249,0,0,0
4,2.25,2560,12100,1.0,0,0,4,8,1760,800,1976,0,98052,47.631,-122.108,2240,12100,765000,20,5,2014,0,38,9540,9860,0,1,0
3,3.75,3250,5797,2.0,0,2,4,8,2370,880,1951,0,98199,47.6481,-122.405,1840,5797,967500,27,5,2014,0,63,2547,3957,0,1,1
2,2.0,1340,4447,1.0,0,0,3,8,1340,0,2004,0,98053,47.7175,-122.033,1350,4458,381000,5,9,2014,0,10,3107,3108,0,0,0
4,2.25,2480,9780,1.0,0,0,4,8,1900,580,1975,0,98052,47.6388,-122.099,2640,9780,716000,27,8,2014,0,39,7300,7140,0,1,0
5,3.5,3060,8862,2.0,0,0,3,8,3060,0,1989,0,98056,47.5322,-122.185,2680,8398,605000,14,4,2015,0,26,5802,5718,0,0,0
4,2.5,2910,8596,2.0,0,0,3,8,2910,0,2004,0,98003,47.2596,-122.304,2770,8602,312200,19,9,2014,0,10,5686,5832,0,0,0
4,1.0,1900,9000,1.0,0,0,4,7,1290,610,1948,0,98166,47.4629,-122.361,1950,10800,327000,18,7,2014,0,66,7100,8850,0,1,1
3,1.5,1480,7000,1.0,0,0,3,7,1000,480,1980,0,98023,47.2866,-122.368,1470,7022,160000,11,7,2014,0,34,5520,5552,0,1,0
3,1.0,1250,9472,1.0,0,0,4,6,1250,0,1972,0,98059,47.495,-122.154,1590,9600,255000,12,8,2014,0,42,8222,8010,0,0,0
4,2.5,2000,4700,1.5,0,0,4,7,1220,780,1944,0,98117,47.6902,-122.368,1560,4700,530000,25,11,2014,0,70,2700,3140,0,1,1
3,1.5,1330,6540,1.0,0,0,3,7,900,430,1971,0,98188,47.4239,-122.292,1400,11500,239000,24,10,2014,0,43,5210,10100,0,1,1
3,2.25,1840,6214,1.0,0,0,4,7,1270,570,1983,0,98031,47.4043,-122.185,1840,6214,285000,28,2,2015,0,32,4374,4374,0,1,0
4,2.0,1560,7104,1.5,0,0,3,7,1140,420,1945,0,98105,47.6714,-122.28,1850,7105,537000,27,8,2014,0,69,5544,5255,0,1,1
3,2.25,1560,6013,2.0,0,0,3,7,1560,0,1990,0,98023,47.2862,-122.352,1640,6290,213675,25,7,2014,0,24,4453,4650,0,0,0
5,2.5,2910,9636,1.0,0,0,4,7,1690,1220,1964,0,98008,47.5803,-122.119,2830,10385,530000,6,5,2014,0,50,6726,7555,0,1,0
3,1.0,950,3621,1.0,0,0,4,6,950,0,1947,0,98144,47.575,-122.289,1540,4080,390000,13,11,2014,0,67,2671,2540,0,0,1
2,1.0,1200,4000,1.0,0,0,3,7,1070,130,1940,0,98126,47.5766,-122.378,1770,4000,450000,21,5,2014,0,74,2800,2230,0,1,1
2,1.0,1000,5375,1.0,0,0,3,7,1000,0,1953,0,98118,47.5404,-122.268,1380,5000,420000,11,3,2015,0,62,4375,3620,0,0,1
3,2.0,1490,3880,1.0,0,0,3,7,1490,0,1959,0,98107,47.662,-122.363,1490,3880,550000,27,1,2015,0,56,2390,2390,0,0,1
2,1.0,600,6120,1.0,0,0,3,5,600,0,1943,0,98168,47.4997,-122.317,1060,6120,110000,19,2,2015,0,72,5520,5060,0,0,1
2,1.75,2320,5500,1.5,0,2,3,8,1720,600,1925,2000,98144,47.586,-122.292,2380,5000,700000,28,5,2014,75,89,3180,2620,1,1,1
2,1.0,990,8760,1.0,0,0,3,7,990,0,1977,0,98003,47.3302,-122.305,1560,11880,179000,2,10,2014,0,37,7770,10320,0,0,0
4,2.75,5470,18200,2.0,1,4,3,11,3730,1740,1992,0,98118,47.5316,-122.263,3620,15100,1610000,10,7,2014,0,22,12730,11480,0,1,1
3,2.0,1790,6800,1.0,0,0,4,7,1240,550,1964,0,98133,47.728,-122.339,1470,6800,472500,16,3,2015,0,51,5010,5330,0,1,1
4,2.5,2350,6958,2.0,0,0,3,9,2350,0,1998,0,98092,47.3321,-122.172,2480,6395,299000,27,10,2014,0,16,4608,3915,0,0,0
4,2.5,3430,10157,2.0,0,0,3,10,3430,0,2000,0,98034,47.723,-122.158,3480,10157,740000,14,5,2014,0,14,6727,6677,0,0,0
3,1.75,2600,15064,1.0,0,0,4,8,1700,900,1967,0,98004,47.64,-122.204,2940,14984,860000,10,10,2014,0,47,12464,12044,0,1,0
4,3.0,2130,6325,1.0,0,0,5,7,1440,690,1948,0,98116,47.5683,-122.396,1240,6325,620000,1,7,2014,0,66,4195,5085,0,1,1
3,1.75,1660,5987,1.0,0,0,3,7,960,700,1982,0,98146,47.5107,-122.381,1510,6000,410000,10,10,2014,0,32,4327,4490,0,1,1
5,3.5,2473,9282,2.0,0,1,5,7,2473,0,1963,0,98198,47.3966,-122.308,2040,10920,343000,4,3,2015,0,52,6809,8880,0,0,1
2,2.75,1430,1425,2.0,0,0,3,7,995,435,2006,0,98112,47.621,-122.298,1500,1749,465000,17,6,2014,0,8,-5,249,0,1,1
3,2.25,1570,3109,2.0,0,0,3,8,1570,0,2002,0,98092,47.3258,-122.186,1680,3590,273950,4,3,2015,0,13,1539,1910,0,0,0
3,2.5,1720,6200,2.0,0,0,3,7,1720,0,2014,0,98022,47.2137,-121.989,1710,9520,255000,30,3,2015,0,1,4480,7810,0,0,0
3,2.0,1140,11161,1.0,0,0,4,7,1140,0,1998,0,98022,47.209,-122.012,1720,8587,250000,8,9,2014,0,16,10021,6867,0,0,0
4,3.25,2690,7200,2.0,0,3,3,9,1720,970,1978,0,98155,47.7341,-122.288,2400,8845,635000,22,8,2014,0,36,4510,6445,0,1,1
3,1.75,1520,9600,1.0,0,0,3,8,1520,0,1966,0,98023,47.3263,-122.365,2060,9600,240000,26,8,2014,0,48,8080,7540,0,0,0
4,2.25,2040,7031,2.0,0,0,3,8,2040,0,2012,0,98033,47.7016,-122.17,1670,7031,670000,7,5,2015,0,3,4991,5361,0,0,0
3,2.5,2830,6000,1.0,0,3,3,9,1730,1100,1954,0,98126,47.5751,-122.378,2040,5300,713414,24,10,2014,0,60,3170,3260,0,1,1
3,1.5,1340,7391,1.0,0,0,4,7,1340,0,1966,0,98198,47.3837,-122.317,1300,7391,245000,13,5,2015,0,49,6051,6091,0,0,1
4,2.5,2520,10850,1.0,0,0,4,8,1680,840,1968,0,98155,47.7751,-122.284,2590,10800,600000,9,12,2014,0,46,8330,8210,0,1,1
3,2.5,1660,5550,2.0,0,0,3,7,1660,0,2002,0,98198,47.375,-122.304,1810,5550,270000,15,10,2014,0,12,3890,3740,0,0,1
2,1.0,880,6900,1.0,0,0,3,6,880,0,1943,0,98056,47.4903,-122.191,1060,8000,190000,20,11,2014,0,71,6020,6940,0,0,0
3,2.0,980,5000,1.0,0,0,3,6,980,0,1940,0,98144,47.595,-122.308,1970,3025,435000,6,6,2014,0,74,4020,1055,0,0,1
4,1.0,1360,5814,1.5,0,0,2,6,1360,0,1900,0,98122,47.6038,-122.314,1010,5814,560000,23,10,2014,0,114,4454,4804,0,0,1
3,1.0,940,8377,1.0,0,0,4,7,940,0,1952,0,98004,47.5974,-122.2,1710,6900,725000,2,12,2014,0,62,7437,5190,0,0,0
2,1.0,970,8874,1.0,0,0,3,7,970,0,1968,0,98056,47.4943,-122.178,1340,8175,210000,24,11,2014,0,46,7904,6835,0,0,0
3,2.25,1500,1312,3.0,0,0,3,8,1500,0,2007,0,98103,47.6534,-122.346,1500,1282,513000,25,8,2014,0,7,-188,-218,0,0,1
5,2.5,2780,9652,1.0,0,0,4,8,1390,1390,1967,0,98001,47.3444,-122.271,1790,9652,290000,5,11,2014,0,47,6872,7862,0,1,0
3,2.5,3110,9930,1.0,0,1,3,8,1640,1470,1954,0,98039,47.6112,-122.226,3650,14399,1260000,25,9,2014,0,60,6820,10749,0,1,0
3,2.25,1860,11227,2.0,0,0,3,7,1860,0,1995,0,98038,47.3879,-122.031,1820,8800,330000,20,6,2014,0,19,9367,6980,0,0,0
3,1.0,1010,7560,1.0,0,0,3,6,1010,0,1958,0,98058,47.4497,-122.176,1170,7560,189000,5,6,2014,0,56,6550,6390,0,0,0
3,2.25,2850,6281,2.0,0,2,4,7,1900,950,1947,0,98115,47.6911,-122.326,1680,7006,907500,4,5,2015,0,68,3431,5326,0,1,1
4,3.0,3080,10757,2.0,0,3,5,8,3080,0,1961,0,98006,47.5671,-122.159,2810,10757,1050000,20,2,2015,0,54,7677,7947,0,0,0
4,2.5,2280,14290,1.5,0,0,4,7,1510,770,1942,0,98125,47.7054,-122.297,2140,9890,622100,4,12,2014,0,72,12010,7750,0,1,1
3,1.5,2030,14400,1.0,0,0,4,7,1310,720,1969,0,98001,47.2639,-122.285,1330,14400,250000,23,7,2014,0,45,12370,13070,0,1,0
4,3.0,2570,4000,2.0,0,0,3,8,1750,820,1909,2014,98115,47.6743,-122.313,1970,4000,1180000,18,8,2014,105,105,1430,2030,1,1,1
3,2.75,3640,10300,1.0,0,0,4,9,2060,1580,1979,0,98006,47.5612,-122.146,3110,10625,925000,9,2,2015,0,36,6660,7515,0,1,0
3,2.0,1760,4046,1.0,0,0,3,7,960,800,1931,0,98117,47.6876,-122.381,1500,4046,554000,18,2,2015,0,84,2286,2546,0,1,1
3,2.5,2760,17377,2.0,0,0,3,9,2760,0,2002,0,98056,47.4929,-122.188,1940,8504,545000,9,7,2014,0,12,14617,6564,0,0,0
3,2.5,2650,11250,2.0,0,0,3,9,2650,0,2005,0,98155,47.7644,-122.29,2200,10013,660000,9,9,2014,0,9,8600,7813,0,0,1
4,2.0,1480,8625,1.0,0,0,4,7,1480,0,1974,0,98055,47.462,-122.193,2130,8502,260000,2,5,2014,0,40,7145,6372,0,0,0
3,1.0,860,6664,1.0,0,0,3,6,860,0,1944,0,98178,47.4931,-122.247,1150,6857,219900,30,10,2014,0,70,5804,5707,0,0,1
4,2.5,2610,4978,2.0,0,0,3,8,2610,0,2004,0,98038,47.3438,-122.04,2470,5024,373500,25,3,2015,0,11,2368,2554,0,0,0
3,2.25,1760,10013,2.0,0,0,4,8,1760,0,1983,0,98056,47.5336,-122.189,1810,9768,450000,23,7,2014,0,31,8253,7958,0,0,0
3,1.75,2040,12065,1.0,0,0,3,8,2040,0,1987,0,98038,47.3756,-122.044,2010,11717,379950,16,7,2014,0,27,10025,9707,0,0,0
3,3.5,3470,4171,3.0,0,0,3,9,3470,0,2008,0,98034,47.711,-122.229,3430,4268,834800,20,8,2014,0,6,701,838,0,0,0
2,1.0,680,4800,1.0,0,0,3,6,680,0,1917,0,98122,47.6084,-122.304,1610,4800,365000,16,9,2014,0,97,4120,3190,0,0,1
3,1.5,1250,4000,1.0,0,0,3,7,1250,0,1955,0,98117,47.6916,-122.379,1030,4000,452000,30,7,2014,0,59,2750,2970,0,0,1
3,3.0,3570,6250,2.0,0,2,3,10,2710,860,1985,0,98116,47.5624,-122.399,2550,7596,840000,4,3,2015,0,30,2680,5046,0,1,1
4,2.0,2000,6250,1.5,0,0,3,7,1480,520,1930,0,98136,47.5532,-122.389,1110,6250,465000,3,11,2014,0,84,4250,5140,0,1,1
3,2.5,2030,4867,2.0,0,0,3,7,2030,0,2003,0,98042,47.3747,-122.128,2030,5000,295000,7,5,2015,0,12,2837,2970,0,0,0
3,1.0,1390,6160,1.0,0,0,4,7,1390,0,1949,0,98133,47.7289,-122.338,1230,6160,396000,24,2,2015,0,66,4770,4930,0,0,1
2,1.0,1030,12350,1.5,0,0,3,7,1030,0,1942,0,98115,47.6984,-122.324,1790,6900,397000,24,2,2015,0,73,11320,5110,0,0,1
3,1.0,1280,9000,1.5,0,0,4,6,1280,0,1954,0,98146,47.4915,-122.338,1430,4500,240000,19,8,2014,0,60,7720,3070,0,0,1
3,2.5,2370,6840,2.0,0,0,3,9,2370,0,1987,0,98119,47.6503,-122.366,1590,4400,300523,5,1,2015,0,28,4470,2810,0,0,1
3,2.0,1380,9000,2.0,0,0,2,7,1380,0,1946,1982,98001,47.2613,-122.248,1460,9732,215500,6,11,2014,36,68,7620,8272,1,0,0
5,3.0,2320,7229,1.0,0,0,4,8,1370,950,1986,0,98052,47.697,-122.097,2090,7554,552500,5,8,2014,0,28,4909,5464,0,1,0
5,1.5,2050,9360,1.0,0,0,3,7,1520,530,1968,0,98055,47.436,-122.195,1840,9383,375000,28,8,2014,0,46,7310,7543,0,1,0
3,2.5,2450,4400,2.0,0,0,4,9,1800,650,1922,0,98102,47.6439,-122.319,2220,5500,952000,4,11,2014,0,92,1950,3280,0,1,1
5,1.75,1890,5000,1.5,0,0,3,7,1090,800,1906,0,98107,47.6711,-122.372,1610,5000,523460,27,6,2014,0,108,3110,3390,0,1,1
4,2.5,2007,4968,2.0,0,0,3,9,2007,0,2009,0,98092,47.3301,-122.191,2189,5852,305950,12,8,2014,0,5,2961,3663,0,0,0
3,2.5,1430,9044,2.0,0,0,3,7,1430,0,1991,0,98022,47.1956,-121.986,1580,8624,220000,9,2,2015,0,24,7614,7044,0,0,0
5,2.5,2210,10772,1.0,0,2,3,9,1430,780,1964,0,98155,47.7383,-122.288,2720,9858,648000,9,2,2015,0,51,8562,7138,0,1,1
5,1.75,2330,6000,1.5,0,0,3,8,2080,250,1937,0,98199,47.6461,-122.392,2150,6000,825000,10,4,2015,0,78,3670,3850,0,1,1
4,2.0,2070,10800,2.0,0,0,3,7,2070,0,1982,0,98011,47.7264,-122.237,1880,10800,400000,4,12,2014,0,32,8730,8920,0,0,0
2,2.5,1480,1369,3.0,0,0,3,7,1480,0,2009,0,98052,47.676,-122.121,1390,1337,420000,12,5,2014,0,5,-111,-53,0,0,0
2,1.75,1160,4848,2.0,0,1,4,7,1160,0,1949,0,98118,47.542,-122.265,1990,7440,389000,20,1,2015,0,66,3688,5450,0,0,1
4,2.5,2520,4950,2.0,0,0,3,8,2520,0,1906,2002,98117,47.6814,-122.359,1810,3500,865000,8,9,2014,96,108,2430,1690,1,0,1
3,2.5,1680,10455,2.0,0,0,3,8,1680,0,1982,0,98052,47.7229,-122.11,1860,10063,550000,16,4,2015,0,33,8775,8203,0,0,0
3,1.0,1320,5000,1.5,0,0,3,7,1320,0,1912,0,98116,47.5711,-122.386,1320,4179,201500,8,7,2014,0,102,3680,2859,0,0,1
3,1.0,1320,5000,1.5,0,0,3,7,1320,0,1912,0,98116,47.5711,-122.386,1320,4179,459000,23,3,2015,0,103,3680,2859,0,0,1
3,2.5,1810,7350,1.0,0,0,3,8,1310,500,1984,0,98058,47.4434,-122.125,2240,7350,327000,18,12,2014,0,30,5540,5110,0,1,0
1,1.0,1140,6700,1.5,0,0,3,7,1140,0,1920,0,98103,47.6958,-122.357,1350,6700,540000,16,5,2014,0,94,5560,5350,0,0,1
3,2.0,1840,6000,1.0,0,0,4,6,1840,0,1908,1944,98136,47.5508,-122.392,2010,6000,521000,23,10,2014,36,106,4160,3990,1,0,1
3,1.5,2000,7294,1.0,0,0,3,7,1520,480,1965,0,98118,47.5297,-122.267,2000,6000,375000,27,5,2014,0,49,5294,4000,0,1,1
3,1.75,1480,6592,1.0,0,0,4,7,1080,400,1978,0,98023,47.2982,-122.378,1660,7150,235000,17,1,2015,0,37,5112,5490,0,1,0
4,2.5,2040,11841,2.0,0,0,3,7,2040,0,1994,0,98042,47.3691,-122.074,1730,8808,240000,29,9,2014,0,20,9801,7078,0,0,0
4,2.25,2060,12155,1.0,0,0,4,8,2060,0,1968,0,98008,47.6378,-122.117,2360,8625,575000,15,9,2014,0,46,10095,6265,0,0,0
6,3.5,3720,11690,2.0,0,0,3,10,3720,0,2003,0,98040,47.5699,-122.226,3030,11686,1520000,1,12,2014,0,11,7970,8656,0,0,0
4,2.5,3002,6042,2.0,0,0,3,8,3002,0,2004,0,98055,47.4231,-122.186,2566,6390,394500,2,7,2014,0,10,3040,3824,0,0,0
3,1.0,1060,5200,1.0,0,0,5,6,1060,0,1970,0,98042,47.3636,-122.093,1380,5200,174950,15,5,2014,0,44,4140,3820,0,0,0
3,2.5,1690,2752,2.0,0,0,3,8,1690,0,1979,0,98052,47.6332,-122.108,1690,2855,431000,18,3,2015,0,36,1062,1165,0,0,0
5,2.5,2510,8050,1.0,0,0,4,7,1490,1020,1977,0,98034,47.7212,-122.172,1840,8471,475000,7,7,2014,0,37,5540,6631,0,1,0
3,2.25,1290,2500,2.0,0,0,4,8,1290,0,1987,0,98112,47.6229,-122.298,1700,3750,605000,16,5,2014,0,27,1210,2050,0,0,1
4,2.0,1450,7560,1.0,0,0,3,7,1450,0,1967,0,98001,47.3375,-122.276,1430,7560,234950,18,2,2015,0,48,6110,6130,0,0,0
4,2.5,2690,7947,2.0,0,0,3,8,2690,0,1993,0,98058,47.4248,-122.153,2160,8328,419000,13,6,2014,0,21,5257,6168,0,0,0
4,3.25,3340,10890,1.5,0,0,3,9,2240,1100,1963,2000,98052,47.6677,-122.136,2880,9794,910000,22,5,2014,37,51,7550,6914,1,1,0
4,2.5,2600,8921,2.0,0,0,3,8,2600,0,1991,0,98058,47.4423,-122.178,2550,8683,392000,3,12,2014,0,23,6321,6133,0,0,0
3,2.5,3140,9808,2.0,0,0,3,9,2500,640,2001,0,98052,47.6383,-122.097,2370,10014,915000,25,8,2014,0,13,6668,7644,0,1,0
3,3.25,3800,13995,2.0,0,3,3,9,3800,0,1983,0,98011,47.7741,-122.203,2480,8434,630000,14,11,2014,0,31,10195,5954,0,0,0
4,1.75,2320,5490,1.0,0,3,3,8,1160,1160,1956,0,98178,47.5091,-122.241,2240,7200,416100,10,7,2014,0,58,3170,4960,0,1,1
4,2.5,2360,7350,1.0,0,0,4,7,1440,920,1965,0,98001,47.3417,-122.277,1450,7305,285000,21,8,2014,0,49,4990,5855,0,1,0
4,1.5,1100,9600,1.0,0,0,4,6,1100,0,1960,0,98033,47.7,-122.175,1100,9630,353000,6,5,2015,0,55,8500,8530,0,0,0
3,2.0,1390,5127,1.0,0,0,3,8,1390,0,1990,0,98055,47.4504,-122.206,1960,5019,297950,26,8,2014,0,24,3737,3059,0,0,0
3,3.0,1730,1074,3.5,0,0,3,8,1730,0,2006,0,98107,47.6692,-122.392,1370,1185,525000,2,4,2015,0,9,-656,-185,0,0,1
5,1.75,2760,18112,1.0,0,0,3,8,1510,1250,1968,0,98155,47.7363,-122.298,1720,8482,495000,15,7,2014,0,46,15352,6762,0,1,1
3,1.75,2430,11448,1.0,0,1,5,7,1620,810,1949,0,98117,47.6971,-122.391,2140,8144,710000,25,8,2014,0,65,9018,6004,0,1,1
3,2.0,2010,12950,1.0,0,0,3,8,2010,0,1953,0,98034,47.7222,-122.229,1490,10181,310000,30,7,2014,0,61,10940,8691,0,0,0
5,1.75,1730,5200,1.0,0,0,4,7,1050,680,1978,0,98042,47.3628,-122.089,1350,5200,205000,16,5,2014,0,36,3470,3850,0,1,0
2,1.0,720,9520,1.0,0,0,4,6,720,0,1947,0,98155,47.7678,-122.316,1450,8612,195000,25,11,2014,0,67,8800,7162,0,0,1
3,2.0,1240,11172,1.0,0,0,3,7,1000,240,1984,0,98074,47.6364,-122.037,1330,14102,401000,1,7,2014,0,30,9932,12772,0,1,0
5,2.5,3050,8200,1.0,0,4,4,8,1650,1400,1962,0,98006,47.5647,-122.155,2970,8792,1030000,22,9,2014,0,52,5150,5822,0,1,0
3,2.0,2040,4841,1.0,0,0,4,7,1020,1020,1949,0,98115,47.6778,-122.302,1600,4841,667500,27,10,2014,0,65,2801,3241,0,1,1
4,2.5,1840,5550,2.0,0,0,3,8,1840,0,2004,0,98031,47.3937,-122.183,2030,5500,300000,23,6,2014,0,10,3710,3470,0,0,0
4,2.25,1960,9021,2.0,0,0,4,8,1960,0,1973,0,98052,47.6349,-122.096,1960,9975,610000,14,8,2014,0,41,7061,8015,0,0,0
5,2.0,2190,9072,1.0,0,0,5,7,1110,1080,1965,0,98052,47.6696,-122.149,1660,8327,600000,2,7,2014,0,49,6882,6667,0,1,0
3,3.25,1720,1587,2.5,0,2,3,9,1410,310,2004,0,98122,47.6187,-122.299,1490,1620,638000,19,2,2015,0,11,-133,130,0,1,1
3,1.75,1710,5000,1.0,0,0,4,7,1360,350,1918,0,98136,47.5492,-122.389,1490,6250,561000,14,10,2014,0,96,3290,4760,0,1,1
3,2.5,2180,5000,1.0,0,0,4,8,1240,940,1977,0,98116,47.5828,-122.396,2000,5000,625000,16,12,2014,0,37,2820,3000,0,1,1
3,1.75,1700,11613,1.0,0,0,5,7,1180,520,1977,0,98092,47.2874,-122.187,1500,12377,263950,24,3,2015,0,38,9913,10877,0,1,0
3,2.5,2960,9350,2.0,0,2,4,9,2960,0,1978,0,98008,47.6218,-122.094,2960,11745,740000,28,10,2014,0,36,6390,8785,0,0,0
3,1.0,1330,8912,1.0,0,0,3,6,1330,0,1948,0,98188,47.4493,-122.274,1200,8913,234999,9,6,2014,0,66,7582,7713,0,0,1
4,2.5,1940,3200,2.0,0,0,3,8,1940,0,2004,0,98058,47.4583,-122.118,1900,3200,380000,14,4,2015,0,11,1260,1300,0,0,0
3,2.25,1500,9656,1.0,0,0,3,7,1170,330,1989,0,98019,47.7327,-121.982,1690,9656,329500,12,8,2014,0,25,8156,7966,0,1,0
3,2.25,1700,9008,1.0,0,0,3,8,1340,360,1985,0,98125,47.7161,-122.317,2340,8003,500000,2,4,2015,0,30,7308,5663,0,1,1
4,1.5,1840,11367,1.5,0,0,4,7,1840,0,1950,0,98177,47.7656,-122.358,1690,9800,415000,9,7,2014,0,64,9527,8110,0,0,1
7,2.5,2580,5750,1.0,0,0,4,7,1880,700,1901,0,98122,47.6025,-122.294,2280,5750,599000,9,7,2014,0,113,3170,3470,0,1,1
4,2.5,2350,8182,2.0,0,0,3,8,2350,0,1997,0,98042,47.3697,-122.106,2330,7000,367000,14,10,2014,0,17,5832,4670,0,0,0
2,1.0,760,3000,1.0,0,0,3,6,760,0,1922,0,98107,47.6633,-122.357,1630,3600,530000,25,4,2015,0,93,2240,1970,0,0,1
5,3.5,3280,4000,2.0,0,0,3,9,2440,840,2003,0,98117,47.689,-122.396,1980,4000,989000,4,6,2014,0,11,720,2020,0,1,1
3,2.0,1320,4000,1.0,0,0,4,6,1020,300,1940,0,98118,47.5515,-122.262,2410,6212,462600,22,8,2014,0,74,2680,3802,0,1,1
3,2.5,1690,10592,1.0,0,0,3,8,1690,0,1973,2009,98040,47.58,-122.231,2260,9945,875000,24,4,2015,36,42,8902,7685,1,0,0
4,2.0,1450,5456,1.0,0,0,5,7,1450,0,1951,0,98108,47.5442,-122.297,980,6100,393000,31,7,2014,0,63,4006,5120,0,0,1
4,3.0,2760,4905,2.0,0,1,4,9,1840,920,1938,0,98105,47.6591,-122.27,3200,5424,1340000,21,7,2014,0,76,2145,2224,0,1,1
3,2.5,2830,5788,2.0,0,0,3,9,2830,0,2001,0,98028,47.7604,-122.235,2500,5802,590000,23,3,2015,0,14,2958,3302,0,0,0
4,2.75,1890,1475,2.0,0,0,3,9,1200,690,2015,0,98199,47.6472,-122.383,1650,1682,671000,21,4,2015,0,0,-415,32,0,1,1
3,3.25,2610,4500,1.5,0,0,4,9,1660,950,1909,0,98103,47.6701,-122.339,2110,4500,925000,28,7,2014,0,105,1890,2390,0,1,1
3,2.25,1900,7250,1.0,0,0,3,7,1250,650,1967,0,98146,47.4869,-122.344,1560,9420,245000,6,10,2014,0,47,5350,7860,0,1,1
3,1.0,930,6572,1.0,0,0,3,7,930,0,1952,0,98115,47.6889,-122.301,960,5840,392500,2,4,2015,0,63,5642,4880,0,0,1
4,2.0,2730,12000,1.0,0,0,4,8,1410,1320,1998,0,98155,47.7733,-122.271,2730,9039,505000,28,8,2014,0,16,9270,6309,0,1,1
4,2.5,2650,6240,2.0,0,0,3,8,2650,0,2013,0,98053,47.6885,-122.021,2640,6524,702000,19,8,2014,0,1,3590,3884,0,0,0
2,1.0,1010,4000,1.0,0,0,3,7,1010,0,1947,0,98136,47.5311,-122.382,1480,4366,337000,18,7,2014,0,67,2990,2886,0,0,1
4,2.5,3550,10233,2.0,0,0,3,9,3550,0,1996,0,98027,47.5499,-122.1,3310,9157,920000,29,12,2014,0,18,6683,5847,0,0,0
3,1.75,2130,6360,1.0,0,0,3,7,1720,410,1959,0,98125,47.7059,-122.301,1540,6361,495500,27,8,2014,0,55,4230,4821,0,1,1
2,1.75,1840,7230,1.0,0,0,3,7,1570,270,1938,0,98030,47.3815,-122.228,1282,6769,245000,24,9,2014,0,76,5390,5487,0,1,0
2,1.0,1320,1824,1.5,0,0,4,6,1320,0,1909,0,98144,47.585,-122.294,1320,4000,395000,29,5,2014,0,105,504,2680,0,0,1
3,1.0,990,6315,1.0,0,0,3,7,990,0,1970,0,98034,47.7116,-122.214,1450,6702,335000,17,2,2015,0,45,5325,5252,0,0,0
2,1.75,1020,10346,1.0,0,0,4,6,1020,0,1983,0,98022,47.1958,-122.002,1160,8610,187000,10,11,2014,0,31,9326,7450,0,0,0
4,2.0,1570,7320,1.0,0,0,4,7,1570,0,1960,0,98007,47.5967,-122.14,1530,8800,450000,21,11,2014,0,54,5750,7270,0,0,0
4,2.25,1930,7207,1.0,0,0,4,7,1360,570,1988,0,98030,47.3783,-122.182,1760,7207,280000,17,6,2014,0,26,5277,5447,0,1,0
3,1.75,1930,9600,1.0,0,0,3,8,1930,0,1958,0,98040,47.5747,-122.237,2350,9840,795000,23,4,2015,0,57,7670,7490,0,0,0
3,1.5,2240,3800,2.0,0,0,3,8,1370,870,1929,0,98115,47.6887,-122.307,1690,4275,510000,29,5,2014,0,85,1560,2585,0,1,1
4,2.5,2190,11500,1.0,0,0,4,8,1430,760,1972,0,98006,47.5668,-122.147,2580,9700,699900,28,6,2014,0,42,9310,7120,0,1,0
4,2.75,2400,12469,1.0,0,2,4,8,1760,640,1958,0,98008,47.5861,-122.112,2400,10400,839000,12,8,2014,0,56,10069,8000,0,1,0
4,1.75,1970,12409,1.0,0,0,4,7,1220,750,1968,0,98028,47.7489,-122.236,1690,10720,396000,15,7,2014,0,46,10439,9030,0,1,0
3,2.25,2860,8458,2.0,0,0,3,7,2860,0,1983,0,98058,47.4269,-122.148,1760,8458,365000,7,5,2015,0,32,5598,6698,0,0,0
3,2.25,1900,7225,1.0,0,0,3,8,1220,680,1970,0,98008,47.6394,-122.113,1900,7399,440000,11,7,2014,0,44,5325,5499,0,1,0
4,2.5,2090,6667,2.0,0,0,3,8,2090,0,1997,0,98058,47.4648,-122.15,2250,6165,405000,4,11,2014,0,17,4577,3915,0,0,0
3,1.5,850,2500,1.0,0,0,3,7,850,0,1986,0,98106,47.5677,-122.36,850,5000,295000,15,5,2014,0,28,1650,4150,0,0,1
4,2.5,1840,1562,2.0,0,0,3,7,1400,440,2004,0,98106,47.5345,-122.364,1840,1766,275000,15,5,2014,0,10,-278,-74,0,1,1
5,3.5,4370,12240,2.0,0,0,3,11,3270,1100,1990,0,98004,47.582,-122.199,2980,12800,1500000,15,8,2014,0,24,7870,9820,0,1,0
3,3.5,3190,10223,2.0,0,0,3,10,2560,630,1994,0,98052,47.6968,-122.102,3120,9735,795000,2,9,2014,0,20,7033,6615,0,1,0
3,1.0,1690,13184,1.0,0,0,4,7,1690,0,1959,0,98166,47.476,-122.343,1130,13451,260000,10,9,2014,0,55,11494,12321,0,0,1
2,2.5,1650,2710,2.0,0,2,3,8,1650,0,2008,0,98065,47.5173,-121.878,1760,2992,382000,6,8,2014,0,6,1060,1232,0,0,0
4,2.5,2590,9341,2.0,0,0,3,8,2590,0,1985,0,98052,47.6496,-122.114,2280,9510,790100,21,4,2015,0,30,6751,7230,0,0,0
4,2.5,2160,8005,2.0,0,0,3,7,2160,0,1993,0,98001,47.2668,-122.231,1790,8016,220000,21,5,2014,0,21,5845,6226,0,0,0
4,3.5,3500,8547,2.0,0,0,3,9,2500,1000,1994,0,98006,47.5613,-122.126,2350,10270,799000,5,6,2014,0,20,5047,7920,0,1,0
4,2.25,3920,7200,2.0,0,0,3,10,3120,800,1928,0,98144,47.5731,-122.284,3400,7200,1480000,23,7,2014,0,86,3280,3800,0,1,1
4,2.75,2190,14937,2.0,0,0,3,8,2190,0,1993,0,98001,47.3535,-122.273,1920,11360,367300,9,6,2014,0,21,12747,9440,0,0,0
4,2.0,1890,4500,1.5,0,0,3,7,1490,400,1907,1993,98103,47.6684,-122.356,1640,4010,805000,9,4,2015,86,108,2610,2370,1,1,1
2,1.0,1860,3400,1.0,0,0,3,7,1010,850,1920,0,98105,47.6714,-122.329,1540,3997,730000,15,12,2014,0,94,1540,2457,0,1,1
3,2.0,1720,7704,1.0,0,0,4,7,1160,560,1969,0,98011,47.7368,-122.195,1620,7600,402000,23,11,2014,0,45,5984,5980,0,1,0
4,2.75,2600,4674,1.0,0,0,3,8,1560,1040,1976,0,98115,47.6782,-122.286,2600,6099,750000,30,5,2014,0,38,2074,3499,0,1,1
3,1.5,1570,12196,1.0,0,0,4,7,1570,0,1972,0,98045,47.4866,-121.786,1740,12196,458000,30,7,2014,0,42,10626,10456,0,0,0
3,2.5,3530,9753,2.0,0,0,3,10,3530,0,1997,0,98006,47.5539,-122.103,3220,9234,898000,28,8,2014,0,17,6223,6014,0,0,0
4,2.5,1960,5642,2.0,0,0,3,7,1960,0,1998,0,98092,47.3167,-122.187,1870,5250,308000,23,3,2015,0,17,3682,3380,0,0,0
3,2.5,2230,8296,2.0,0,0,3,7,2230,0,2004,0,98058,47.4386,-122.116,2480,5940,385000,6,5,2015,0,11,6066,3460,0,0,0
4,3.0,2720,4800,1.5,0,0,5,8,1790,930,1928,0,98105,47.6595,-122.283,2260,4800,1020000,6,10,2014,0,86,2080,2540,0,1,1
5,3.0,2840,6240,2.0,0,0,5,9,2440,400,1905,0,98112,47.6285,-122.309,2940,6000,1430000,29,12,2014,0,109,3400,3060,0,1,1
3,1.75,1260,7362,1.0,0,0,3,7,1260,0,1984,0,98038,47.3602,-122.052,1530,7232,240000,23,7,2014,0,30,6102,5702,0,0,0
3,1.5,1860,8505,1.0,0,0,4,7,1860,0,1967,0,98023,47.3106,-122.365,1810,8262,217000,1,10,2014,0,47,6645,6452,0,0,0
4,1.75,2010,6300,1.0,0,2,5,8,1610,400,1937,0,98199,47.6457,-122.412,3290,6300,972000,30,6,2014,0,77,4290,3010,0,1,1
2,1.0,820,6400,1.0,0,0,4,7,820,0,1944,0,98126,47.55,-122.379,1490,6400,361280,7,5,2014,0,70,5580,4910,0,0,1
3,1.75,1220,1450,1.0,0,0,3,6,620,600,1905,0,98119,47.6361,-122.368,1660,2960,385000,4,8,2014,0,109,230,1300,0,1,1
4,2.5,2860,3638,1.5,0,2,5,7,1720,1140,1924,0,98107,47.6631,-122.361,1760,3880,724950,2,4,2015,0,91,778,2120,0,1,1
5,4.5,4230,9701,2.0,0,0,3,10,4230,0,1999,0,98006,47.5444,-122.131,4130,12253,935000,27,10,2014,0,15,5471,8123,0,0,0
3,1.0,840,8470,1.0,0,0,4,6,840,0,1961,0,98023,47.3275,-122.338,840,8450,169950,8,9,2014,0,53,7630,7610,0,0,0
3,2.5,2290,5089,2.0,0,0,3,9,2290,0,2001,0,98006,47.5443,-122.172,2290,7984,585000,8,12,2014,0,13,2799,5694,0,0,0
3,2.5,2290,5089,2.0,0,0,3,9,2290,0,2001,0,98006,47.5443,-122.172,2290,7984,585000,23,4,2015,0,14,2799,5694,0,0,0
5,3.5,3480,12821,2.0,0,2,3,10,2890,590,2004,0,98092,47.2641,-122.215,3400,9870,480000,27,3,2015,0,11,9341,6470,0,1,0
3,2.5,2230,5717,2.0,0,0,3,7,2230,0,2004,0,98058,47.4388,-122.117,2230,5194,368750,4,2,2015,0,11,3487,2964,0,0,0
6,2.0,3080,5500,2.0,0,0,1,7,3080,0,1900,0,98122,47.6031,-122.296,1830,5000,432500,2,12,2014,0,114,2420,3170,0,0,1
3,2.5,2250,4337,2.0,0,0,3,8,2250,0,2004,0,98075,47.5908,-122.017,2250,4721,589000,3,9,2014,0,10,2087,2471,0,0,0
4,3.25,3160,6327,2.0,0,0,3,9,2280,880,2004,0,98027,47.536,-122.066,3160,5946,840000,14,4,2015,0,11,3167,2786,0,1,0
3,2.5,1770,3873,2.0,0,0,3,7,1770,0,2005,0,98058,47.4648,-122.144,2280,4330,316500,5,3,2015,0,10,2103,2050,0,0,0
4,2.5,2880,8833,2.0,0,0,3,7,2880,0,2006,0,98065,47.5388,-121.89,2570,5234,536000,13,2,2015,0,9,5953,2664,0,0,0
4,1.0,1730,7350,1.5,0,0,4,6,1730,0,1970,0,98003,47.3467,-122.307,1440,7752,152500,26,12,2014,0,44,5620,6312,0,0,0
4,1.0,1730,7350,1.5,0,0,4,6,1730,0,1970,0,98003,47.3467,-122.307,1440,7752,267950,20,4,2015,0,45,5620,6312,0,0,0
4,2.5,2540,8400,2.0,0,0,5,7,2540,0,1977,0,98032,47.3754,-122.277,1600,8050,269950,23,6,2014,0,37,5860,6450,0,0,0
4,3.0,2630,5772,2.0,0,0,3,9,2630,0,2006,0,98052,47.6952,-122.133,3460,6158,731688,21,7,2014,0,8,3142,2698,0,0,0
3,1.5,1890,9000,1.0,0,0,3,7,1190,700,1959,0,98188,47.4425,-122.272,2060,9000,240000,3,12,2014,0,55,7110,6940,0,1,1
2,1.0,1220,5040,1.0,0,0,3,7,1220,0,1961,0,98117,47.6957,-122.364,1420,5040,555950,3,9,2014,0,53,3820,3620,0,0,1
2,1.0,710,6300,1.0,0,0,3,6,710,0,1942,0,98126,47.5155,-122.374,740,6300,289000,27,4,2015,0,73,5590,5560,0,0,1
3,2.5,2970,11985,1.0,0,0,3,9,1770,1200,1995,0,98074,47.6359,-122.052,2990,12049,525000,6,5,2014,0,19,9015,9059,0,1,0
3,2.5,2970,11985,1.0,0,0,3,9,1770,1200,1995,0,98074,47.6359,-122.052,2990,12049,745000,4,12,2014,0,19,9015,9059,0,1,0
2,1.0,1000,7664,1.0,0,2,3,7,1000,0,1939,0,98115,47.7001,-122.311,1570,6350,397000,17,11,2014,0,75,6664,4780,0,0,1
3,1.0,1980,8505,1.0,0,0,3,7,1030,950,1965,0,98106,47.538,-122.353,1830,8505,233000,22,4,2015,0,50,6525,6675,0,1,1
4,2.25,1920,8259,2.0,0,0,4,8,1920,0,1979,0,98027,47.5616,-122.088,2030,8910,625000,16,10,2014,0,35,6339,6880,0,0,0
3,2.25,1740,7345,1.0,0,0,3,7,1380,360,1973,0,98032,47.3663,-122.285,1770,8250,270000,4,5,2015,0,42,5605,6480,0,1,0
3,1.75,1300,7770,1.0,0,0,3,7,1300,0,1967,0,98034,47.7347,-122.192,1520,7600,360000,22,7,2014,0,47,6470,6080,0,0,0
4,1.5,2740,4000,2.0,0,0,5,9,1930,810,1905,0,98109,47.6343,-122.352,1680,4000,1110000,13,5,2014,0,109,1260,2320,0,1,1
4,1.75,4060,4000,2.0,0,3,3,10,2890,1170,1953,1995,98199,47.6375,-122.389,1860,4000,970000,11,11,2014,42,61,-60,2140,1,1,1
5,2.5,3490,18850,1.0,0,4,4,9,1840,1650,1958,0,98005,47.5955,-122.176,2690,11625,915000,10,10,2014,0,56,15360,8935,0,1,0
4,1.75,1430,10500,1.0,0,0,4,7,1130,300,1960,0,98007,47.6083,-122.132,2070,8640,412000,11,7,2014,0,54,9070,6570,0,1,0
4,1.75,1860,9112,1.0,0,0,4,7,1110,750,1963,0,98032,47.3792,-122.282,1570,9112,265000,12,2,2015,0,52,7252,7542,0,1,0
4,2.25,2120,7700,1.0,0,0,4,7,1490,630,1976,0,98034,47.7207,-122.165,1890,8203,426000,16,9,2014,0,38,5580,6313,0,1,0
4,2.25,1860,12693,1.0,0,0,3,8,1140,720,1978,0,98023,47.3114,-122.395,1950,8740,266000,10,12,2014,0,36,10833,6790,0,1,0
3,2.0,2330,4950,1.5,0,0,3,6,1430,900,1900,0,98118,47.5585,-122.29,1160,5115,325000,15,12,2014,0,114,2620,3955,0,1,1
3,1.75,1670,5100,1.0,0,2,5,7,990,680,1954,0,98144,47.5898,-122.291,2140,4452,615000,20,1,2015,0,61,3430,2312,0,1,1
3,1.75,2130,7140,1.0,0,0,3,8,1580,550,1979,0,98023,47.3074,-122.341,2180,7906,310000,23,4,2015,0,36,5010,5726,0,1,0
4,1.75,1900,7313,1.0,0,0,3,7,1900,0,1973,0,98034,47.7311,-122.232,1420,7384,340000,14,9,2014,0,41,5413,5964,0,0,0
2,1.0,1170,2800,1.5,0,0,4,5,1170,0,1905,0,98103,47.6574,-122.345,1660,4996,562500,1,5,2015,0,110,1630,3336,0,0,1
2,1.0,980,1600,2.0,0,0,3,8,980,0,2010,0,98119,47.638,-122.375,1180,1600,447000,21,7,2014,0,4,620,420,0,0,1
4,1.5,2500,6300,1.0,0,0,4,7,1500,1000,1961,0,98032,47.3781,-122.284,1720,8925,250000,20,5,2014,0,53,3800,7205,0,1,0
4,2.5,2020,8044,2.0,0,0,3,8,2020,0,1990,0,98074,47.6247,-122.043,2320,7328,633000,2,1,2015,0,25,6024,5008,0,0,0
3,2.0,1290,886,3.0,0,0,3,7,1290,0,2004,0,98125,47.7161,-122.295,1270,1152,310000,23,4,2015,0,11,-404,-118,0,0,1
3,3.25,1710,2381,2.0,0,0,3,8,1360,350,2003,0,98029,47.5477,-122.004,1420,1163,470000,20,8,2014,0,11,671,-257,0,1,0
3,2.5,1720,8550,1.0,0,0,4,7,1720,0,1968,0,98002,47.2837,-122.207,1460,8550,270000,14,4,2015,0,47,6830,7090,0,0,0
3,1.75,1820,8813,2.0,0,0,3,7,1820,0,1994,0,98003,47.2622,-122.303,1780,7349,299500,19,12,2014,0,20,6993,5569,0,0,0
3,1.0,1130,10018,1.0,0,0,4,6,1130,0,1954,0,98032,47.3733,-122.275,1770,7700,227000,18,9,2014,0,60,8888,5930,0,0,0
4,2.75,3040,2415,2.0,1,4,3,8,3040,0,1966,0,98118,47.5188,-122.256,2620,2433,735000,20,8,2014,0,48,-625,-187,0,0,1
3,3.0,2410,7479,2.0,0,2,3,7,2410,0,1942,1988,98155,47.7394,-122.288,2610,7479,537000,26,6,2014,46,72,5069,4869,1,0,1
2,1.0,800,4533,1.0,0,0,3,6,600,200,1929,0,98115,47.6979,-122.325,1720,6800,330000,2,9,2014,0,85,3733,5080,0,1,1
3,1.0,1030,7800,1.0,0,0,3,7,1030,0,1954,0,98168,47.473,-122.324,1630,12664,229000,29,8,2014,0,60,6770,11034,0,0,1
3,1.0,1480,5600,1.0,0,0,4,6,940,540,1947,0,98178,47.5045,-122.27,1350,11100,200000,21,11,2014,0,67,4120,9750,0,1,1
3,1.75,1710,9707,1.0,0,0,4,8,1710,0,1966,0,98008,47.623,-122.105,1820,8700,522500,12,8,2014,0,48,7997,6880,0,0,0
3,2.75,3450,5350,1.5,0,3,4,9,2590,860,1925,0,98199,47.6389,-122.407,2910,5350,1300000,24,3,2015,0,90,1900,2440,0,1,1
3,3.25,2610,16387,2.0,1,4,3,9,2610,0,2006,0,98125,47.7175,-122.278,2590,12958,2000000,10,11,2014,0,8,13777,10368,0,0,1
3,1.75,1260,7200,1.0,0,0,3,7,1260,0,1971,0,98034,47.7189,-122.178,1460,7200,352000,8,4,2015,0,44,5940,5740,0,0,0
4,3.0,2590,6250,2.0,0,2,3,9,2240,350,1964,0,98115,47.6774,-122.267,2260,6780,855000,25,3,2015,0,51,3660,4520,0,1,1
3,2.5,1580,12250,2.0,0,0,3,8,1580,0,1993,0,98198,47.3771,-122.315,1560,9900,267000,20,8,2014,0,21,10670,8340,0,0,1
2,1.75,1660,6000,1.0,0,0,3,7,1160,500,1942,0,98105,47.6624,-122.291,1660,4000,484000,6,5,2014,0,72,4340,2340,0,1,1
4,2.25,2240,5000,2.0,0,0,3,8,1770,470,1900,2014,98122,47.6027,-122.295,2120,5000,905000,20,4,2015,114,115,2760,2880,1,1,1
4,1.75,1940,7500,1.0,0,0,4,7,1720,220,1966,0,98030,47.3736,-122.215,2000,9000,274000,8,8,2014,0,48,5560,7000,0,1,0
4,4.5,5770,10050,1.0,0,3,5,9,3160,2610,1949,0,98115,47.677,-122.275,2950,6700,1540000,14,11,2014,0,65,4280,3750,0,1,1
4,2.0,2280,6010,1.0,0,0,3,7,1140,1140,1900,0,98122,47.6034,-122.289,2240,6200,628000,4,5,2014,0,114,3730,3960,0,1,1
6,1.75,2740,6360,1.0,0,3,3,8,1370,1370,1953,0,98146,47.5062,-122.385,2150,6600,675000,17,6,2014,0,61,3620,4450,0,1,1
4,3.25,3760,4675,2.0,0,0,3,8,2740,1020,2007,0,98038,47.3862,-122.048,3280,4033,429900,4,11,2014,0,7,915,753,0,1,0
3,1.5,1580,8184,1.0,0,0,3,7,1140,440,1954,0,98148,47.4294,-122.331,1540,9476,260000,25,6,2014,0,60,6604,7936,0,1,1
3,1.75,1600,4400,1.0,0,0,3,7,1030,570,1941,0,98112,47.6348,-122.281,2150,4000,690000,3,9,2014,0,73,2800,1850,0,1,1
4,2.25,2100,12172,1.0,0,0,5,9,2100,0,1961,0,98040,47.5458,-122.227,2400,10713,1080000,23,3,2015,0,54,10072,8313,0,0,0
4,2.5,2610,7333,2.0,0,0,3,8,2610,0,1988,0,98003,47.2721,-122.293,2280,9033,360000,9,4,2015,0,27,4723,6753,0,0,0
3,1.75,1840,5000,1.0,0,0,4,7,920,920,1910,0,98117,47.6808,-122.376,1220,5000,499000,19,6,2014,0,104,3160,3780,0,1,1
3,1.0,1320,6534,1.0,0,0,3,7,1320,0,1952,0,98055,47.4806,-122.223,2140,7405,159000,18,8,2014,0,62,5214,5265,0,0,0
3,1.75,1540,8100,1.0,0,0,4,7,940,600,1947,0,98133,47.749,-122.351,1840,8100,430000,27,3,2015,0,68,6560,6260,0,1,1
3,1.0,1200,9527,1.0,0,0,3,7,1200,0,1959,0,98168,47.5112,-122.316,1510,9457,150000,10,7,2014,0,55,8327,7947,0,0,1
4,2.25,2720,8712,2.0,0,0,4,9,2720,0,1976,0,98006,47.5616,-122.153,2470,8714,840000,21,7,2014,0,38,5992,6244,0,0,0
4,2.5,3100,5700,2.0,0,0,3,9,3100,0,2011,0,98038,47.3696,-122.058,3060,6000,499000,15,4,2015,0,4,2600,2940,0,0,0
3,1.75,1630,4000,1.0,0,0,3,7,1100,530,1968,0,98106,47.5351,-122.353,1300,4000,285000,14,10,2014,0,46,2370,2700,0,1,1
4,2.5,1910,7201,1.0,0,0,3,7,1210,700,1987,0,98198,47.3908,-122.316,1690,7554,340000,8,3,2015,0,28,5291,5864,0,1,1
4,2.0,1580,7300,1.0,0,0,4,7,1580,0,1955,0,98155,47.7598,-122.328,1180,9450,405100,5,5,2015,0,60,5720,8270,0,0,1
3,2.5,1690,4898,2.0,0,0,3,7,1690,0,2003,0,98053,47.6834,-122.038,2220,4933,464000,7,8,2014,0,11,3208,2713,0,0,0
4,2.25,1960,8680,1.0,0,0,4,8,1290,670,1959,0,98004,47.6076,-122.192,2160,8680,723000,29,5,2014,0,55,6720,6520,0,1,0
8,3.25,4300,10441,2.0,0,0,4,8,2800,1500,1979,0,98059,47.4786,-122.131,1780,10457,430000,11,12,2014,0,35,6141,8677,0,1,0
3,1.75,1840,4255,1.0,0,0,3,7,940,900,1907,2005,98116,47.58,-122.392,1600,4255,645000,30,4,2015,98,108,2415,2655,1,1,1
5,3.0,2710,4200,2.0,0,0,3,7,1890,820,1919,2014,98115,47.6754,-122.307,2150,4200,925000,11,8,2014,95,95,1490,2050,1,1,1
4,1.75,2100,4750,1.0,0,0,3,7,1340,760,1975,0,98103,47.6695,-122.333,1700,4125,759000,9,7,2014,0,39,2650,2425,0,1,1
4,2.0,1760,7800,1.0,0,0,3,8,1760,0,1954,0,98117,47.6945,-122.38,1950,7800,690000,5,8,2014,0,60,6040,5850,0,0,1
4,2.5,2155,8140,2.0,0,0,3,8,2155,0,1996,0,98031,47.4204,-122.201,2155,7245,358800,26,3,2015,0,19,5985,5090,0,0,0
5,1.5,1720,4000,1.5,0,0,3,7,1520,200,1925,0,98112,47.6197,-122.287,2280,4000,683000,13,4,2015,0,90,2280,1720,0,1,1
3,1.0,1430,4240,1.5,0,0,3,7,1430,0,1924,0,98103,47.6595,-122.337,1660,4240,650000,8,12,2014,0,90,2810,2580,0,0,1
5,2.75,2790,4807,1.5,0,0,4,7,2140,650,1949,0,98002,47.3098,-122.223,1056,4807,288000,9,12,2014,0,65,2017,3751,0,1,0
3,1.5,1180,7300,1.0,0,0,4,7,1180,0,1968,0,98002,47.2857,-122.197,2030,8424,209950,7,7,2014,0,46,6120,6394,0,0,0
3,3.5,2450,9248,2.0,0,4,3,8,1960,490,1933,1993,98136,47.5476,-122.397,2620,10207,939000,8,10,2014,60,81,6798,7587,1,1,1
3,1.0,1330,5850,1.0,0,0,3,7,930,400,1954,0,98108,47.5498,-122.298,1440,5850,320000,16,8,2014,0,60,4520,4410,0,1,1
3,2.25,1940,9560,2.0,0,0,3,7,1940,0,1989,0,98023,47.2998,-122.387,1800,9560,283748,22,8,2014,0,25,7620,7760,0,0,0
3,2.25,1600,7620,1.0,0,0,3,7,1280,320,1987,0,98011,47.774,-122.208,1600,8215,370000,31,7,2014,0,27,6020,6615,0,1,0
5,2.5,2880,6902,1.0,0,0,3,8,1680,1200,1976,2007,98058,47.4332,-122.144,2080,5586,360000,12,12,2014,31,38,4022,3506,1,1,0
2,1.5,1160,8060,1.0,0,0,4,7,1160,0,1950,0,98136,47.5146,-122.386,1500,8060,365000,12,11,2014,0,64,6900,6560,0,0,1
3,2.0,1360,3120,2.0,0,0,3,7,1360,0,1989,0,98115,47.6943,-122.307,1360,3120,396900,19,12,2014,0,25,1760,1760,0,0,1
3,2.5,2014,4500,2.0,0,0,3,7,2014,0,2005,0,98001,47.3371,-122.256,2014,4500,321000,22,4,2015,0,10,2486,2486,0,0,0
3,2.0,1440,7008,1.0,0,0,3,7,1440,0,1985,0,98030,47.3702,-122.182,1680,7200,245000,6,1,2015,0,30,5568,5520,0,0,0
2,1.0,1570,4704,1.5,0,1,3,8,1570,0,1931,0,98136,47.5256,-122.392,1820,4704,502000,7,10,2014,0,83,3134,2884,0,0,1
4,2.75,2330,7642,1.0,0,0,3,8,1800,530,1990,0,98023,47.2946,-122.37,2320,7933,257000,5,6,2014,0,24,5312,5613,0,1,0
4,1.75,1880,7303,1.0,0,0,3,7,1010,870,1976,0,98034,47.7129,-122.203,1710,7200,423000,15,5,2014,0,38,5423,5490,0,1,0
4,2.25,1850,9911,1.0,0,0,4,7,1850,0,1957,0,98008,47.6019,-122.116,1650,8670,485000,27,3,2015,0,58,8061,7020,0,0,0
4,2.5,2230,8560,2.0,0,0,3,8,2230,0,2002,0,98059,47.4877,-122.143,2400,7756,500000,17,12,2014,0,12,6330,5356,0,0,0
2,1.0,990,4313,1.5,0,2,4,6,990,0,1917,0,98126,47.5677,-122.38,1480,5750,442000,21,10,2014,0,97,3323,4270,0,0,1
3,1.75,1720,3825,1.5,0,0,3,7,1720,0,1925,0,98105,47.666,-122.327,2000,3825,475000,12,5,2015,0,90,2105,1825,0,0,1
4,2.25,3230,9935,2.0,0,0,3,8,3230,0,1986,0,98028,47.7685,-122.257,2820,9722,625000,6,4,2015,0,29,6705,6902,0,0,0
3,1.0,1180,6050,1.0,0,0,3,6,820,360,1944,0,98178,47.4945,-122.249,1070,6050,194000,15,10,2014,0,70,4870,4980,0,1,1
4,2.5,2570,6157,2.0,0,0,3,7,2570,0,2006,0,98065,47.5389,-121.89,2060,5292,490000,24,3,2015,0,9,3587,3232,0,0,0
4,1.75,1870,7575,1.0,0,0,3,7,1480,390,1972,0,98034,47.7205,-122.218,1670,7575,348500,9,12,2014,0,42,5705,5905,0,1,0
3,1.0,1220,3000,1.5,0,0,3,6,1220,0,1901,0,98103,47.6506,-122.346,1350,3000,380000,27,4,2015,0,114,1780,1650,0,0,1
3,2.0,1770,2150,3.0,0,0,3,8,1770,0,1999,0,98122,47.6102,-122.314,2010,3200,660000,11,12,2014,0,15,380,1190,0,0,1
3,1.0,1500,6800,1.0,0,0,3,7,1500,0,1943,0,98105,47.6706,-122.268,1500,6800,525000,1,4,2015,0,72,5300,5300,0,0,1
3,2.0,1110,8724,1.0,0,0,4,7,1110,0,1990,0,98002,47.3056,-122.206,1390,7750,235000,17,7,2014,0,24,7614,6360,0,0,0
4,3.75,4980,18069,2.0,0,3,3,11,4980,0,2006,0,98065,47.5348,-121.856,4080,14577,1210000,22,4,2015,0,9,13089,10497,0,0,0
4,1.75,2360,8116,1.0,0,0,4,7,1180,1180,1916,1970,98133,47.7635,-122.335,1670,8160,397950,24,3,2015,54,99,5756,6490,1,1,1
3,1.75,1600,7711,1.0,0,0,3,7,1600,0,1999,0,98002,47.284,-122.202,2100,7711,268000,18,11,2014,0,15,6111,5611,0,0,0
3,1.0,1450,4000,1.0,0,1,4,8,950,500,1948,0,98118,47.5554,-122.266,1880,4000,525000,21,5,2014,0,66,2550,2120,0,1,1
3,2.5,2680,5860,2.0,0,0,3,8,2680,0,2001,0,98011,47.7557,-122.223,2680,5860,549950,6,10,2014,0,13,3180,3180,0,0,0
3,1.75,1150,6600,1.5,0,0,4,6,1150,0,1970,0,98033,47.6709,-122.185,1530,6600,370000,27,8,2014,0,44,5450,5070,0,0,0
4,2.25,1870,6693,2.0,0,0,3,7,1870,0,1996,0,98003,47.2774,-122.299,1650,6518,299000,26,9,2014,0,18,4823,4868,0,0,0
6,2.75,3400,5000,2.0,0,2,3,8,2860,540,1977,0,98107,47.6728,-122.362,1800,5000,715000,15,1,2015,0,38,1600,3200,0,1,1
4,1.5,1810,7200,1.0,0,0,3,7,1810,0,1966,0,98034,47.7207,-122.186,2060,7200,430000,24,4,2015,0,49,5390,5140,0,0,0
3,1.75,1860,7191,1.0,0,0,4,7,1260,600,1975,0,98058,47.4338,-122.168,1850,7490,345000,10,2,2015,0,40,5331,5640,0,1,0
3,2.5,2130,3500,1.0,0,0,4,8,1210,920,1994,0,98072,47.736,-122.159,2030,3710,534640,18,5,2014,0,20,1370,1680,0,1,0
3,2.5,2860,4500,2.0,0,2,3,8,1980,880,1915,0,98119,47.6463,-122.371,2310,4500,1230000,7,10,2014,0,99,1640,2190,0,1,1
4,2.5,2370,7274,2.0,0,0,3,7,2370,0,1997,0,98031,47.3982,-122.171,2090,7656,351000,13,4,2015,0,18,4904,5566,0,0,0
4,2.25,2290,10409,2.0,0,0,3,8,2290,0,1972,0,98005,47.6351,-122.168,2040,10409,745000,15,7,2014,0,42,8119,8369,0,0,0
2,1.0,1120,5329,1.0,0,1,3,6,750,370,1929,0,98126,47.5421,-122.378,1530,5330,320000,5,11,2014,0,85,4209,3800,0,1,1
3,2.0,1810,12420,1.0,0,0,4,7,1810,0,1957,0,98008,47.5888,-122.127,2230,12330,555700,31,7,2014,0,57,10610,10100,0,0,0
2,1.0,850,6174,1.0,0,0,4,7,850,0,1950,0,98155,47.7352,-122.328,1100,6174,308500,2,5,2014,0,64,5324,5074,0,0,1
4,2.5,2665,5868,2.0,0,0,3,9,2665,0,2006,0,98030,47.3831,-122.185,2665,6092,340000,5,3,2015,0,9,3203,3427,0,0,0
4,2.75,2580,3560,1.5,0,0,5,7,1710,870,1917,0,98115,47.6753,-122.304,1980,3800,937750,27,3,2015,0,98,980,1820,0,1,1
4,2.5,3200,12369,2.0,0,0,3,10,3200,0,1998,0,98059,47.5273,-122.143,3770,12960,725126,6,5,2014,0,16,9169,9190,0,0,0
3,1.0,840,3000,1.0,0,0,3,5,840,0,1943,0,98178,47.494,-122.275,1010,6000,135000,5,1,2015,0,72,2160,4990,0,0,1
4,2.5,2970,7961,1.0,0,0,3,8,2020,950,1969,0,98125,47.7118,-122.29,1410,7959,635000,3,4,2015,0,46,4991,6549,0,1,1
2,1.0,790,7500,1.0,0,0,3,6,790,0,1950,0,98011,47.7644,-122.198,1970,8970,245500,6,8,2014,0,64,6710,7000,0,0,0
3,2.5,2580,14603,1.0,0,2,4,9,2580,0,1951,0,98004,47.6199,-122.212,2410,14347,1770000,4,3,2015,0,64,12023,11937,0,0,0
5,2.5,2180,7875,1.0,0,0,4,7,1200,980,1955,0,98133,47.7543,-122.341,1840,5105,425000,10,11,2014,0,59,5695,3265,0,1,1
2,1.0,1060,10423,1.5,0,0,3,7,1060,0,1965,0,98125,47.705,-122.313,2240,10200,220000,20,4,2015,0,50,9363,7960,0,0,1
3,2.0,1860,9100,1.5,0,0,3,8,1860,0,1939,2006,98155,47.7522,-122.304,1620,9519,370000,29,8,2014,67,75,7240,7899,1,0,1
3,1.75,1340,16480,1.0,0,0,4,7,1340,0,1968,0,98042,47.364,-122.162,1520,10451,239000,3,6,2014,0,46,15140,8931,0,0,0
4,2.25,2320,7350,2.0,0,0,3,8,2320,0,1973,0,98058,47.4512,-122.131,2170,7350,345000,2,1,2015,0,42,5030,5180,0,0,0
3,2.5,2110,8304,1.0,0,0,4,7,2110,0,1985,0,98030,47.3558,-122.173,1680,7508,289000,26,8,2014,0,29,6194,5828,0,0,0
5,1.5,1840,8050,1.5,0,0,4,7,1840,0,1962,0,98198,47.3668,-122.312,1690,8151,285000,8,5,2015,0,53,6210,6461,0,0,1
3,2.0,1080,9225,1.0,0,0,2,7,1080,0,1955,0,98146,47.4842,-122.346,1410,9840,147400,15,9,2014,0,59,8145,8430,0,0,1
2,1.0,1290,4636,1.0,0,0,3,7,1290,0,1924,0,98112,47.6393,-122.301,1940,4635,600000,27,1,2015,0,91,3346,2695,0,0,1
3,2.25,2210,10794,1.0,0,0,3,7,1540,670,1967,0,98178,47.4911,-122.224,2230,10753,245000,6,8,2014,0,47,8584,8523,0,1,1
3,2.25,2210,10794,1.0,0,0,3,7,1540,670,1967,0,98178,47.4911,-122.224,2230,10753,520000,4,3,2015,0,48,8584,8523,0,1,1
4,2.75,2440,7150,1.0,0,0,3,7,1200,1240,1963,1985,98032,47.3662,-122.282,1790,7150,270000,29,9,2014,22,51,4710,5360,1,1,0
3,2.5,2040,6000,1.0,0,0,3,8,1840,200,1951,0,98109,47.6334,-122.35,1820,4920,872500,26,8,2014,0,63,3960,3100,0,1,1
4,3.25,3840,6214,1.5,0,3,4,10,2590,1250,1939,0,98199,47.6388,-122.406,3280,5915,2150000,18,3,2015,0,76,2374,2635,0,1,1
3,1.5,1660,7221,1.0,0,0,3,7,980,680,1962,0,98168,47.4962,-122.32,1770,8083,225000,12,8,2014,0,52,5561,6313,0,1,1
4,2.0,1640,6000,1.5,0,0,4,9,1640,0,1911,0,98119,47.6505,-122.375,1900,6000,735000,21,11,2014,0,103,4360,4100,0,0,1
3,1.0,1310,8400,1.0,0,0,3,7,1310,0,1972,1989,98034,47.7253,-122.197,1680,8000,375000,1,4,2015,17,43,7090,6320,1,0,0
3,1.75,1720,9775,1.0,0,0,3,8,1720,0,1978,0,98032,47.3731,-122.286,1970,8400,169000,23,10,2014,0,36,8055,6430,0,0,0
3,1.75,1720,9775,1.0,0,0,3,8,1720,0,1978,0,98032,47.3731,-122.286,1970,8400,279950,4,3,2015,0,37,8055,6430,0,0,0
3,2.25,1960,2345,2.0,0,0,3,7,1750,210,2003,0,98118,47.5419,-122.288,1760,1958,310000,5,8,2014,0,11,385,198,0,1,1
10,2.0,3610,11914,2.0,0,0,4,7,3010,600,1958,0,98006,47.5705,-122.175,2040,11914,650000,29,10,2014,0,56,8304,9874,0,1,0
2,1.5,1800,4500,1.0,0,2,3,7,1000,800,1942,0,98109,47.6305,-122.347,2270,3840,930000,16,12,2014,0,72,2700,1570,0,1,1
4,1.5,1960,5000,1.0,0,0,3,7,980,980,1912,0,98106,47.5688,-122.363,1300,5000,412000,2,4,2015,0,103,3040,3700,0,1,1
3,1.0,1250,10200,1.0,0,0,3,6,1250,0,1965,0,98178,47.4902,-122.256,1800,8283,225000,17,4,2015,0,50,8950,6483,0,0,1
3,2.5,2120,7201,2.0,0,0,3,8,2120,0,2003,0,98133,47.7174,-122.337,1930,7206,507000,19,6,2014,0,11,5081,5276,0,0,1
3,2.5,1340,3011,2.0,0,0,3,7,1340,0,1995,0,98038,47.3839,-122.038,1060,3232,230000,17,11,2014,0,19,1671,2172,0,0,0
5,3.25,3920,4832,2.0,0,0,3,9,3030,890,2014,0,98065,47.5202,-121.885,2660,4832,616200,10,9,2014,0,0,912,2172,0,1,0
4,2.5,2570,7753,2.0,0,0,3,8,2570,0,1987,0,98058,47.4237,-122.162,2140,7615,370000,16,3,2015,0,28,5183,5475,0,0,0
3,1.75,1870,7030,1.0,0,0,3,7,1870,0,1977,0,98033,47.6999,-122.17,1820,7500,619100,6,3,2015,0,38,5160,5680,0,0,0
3,2.25,2860,11250,1.0,0,1,5,8,2290,570,1956,0,98166,47.4534,-122.372,2030,11250,805000,21,8,2014,0,58,8390,9220,0,1,1
2,1.5,1670,6000,1.0,0,0,3,7,1090,580,1950,0,98119,47.6517,-122.374,1670,6000,612125,2,2,2015,0,65,4330,4330,0,1,1
2,1.5,1070,937,3.0,0,0,3,8,1070,0,2003,0,98115,47.6761,-122.3,1100,3200,350000,12,9,2014,0,11,-133,2100,0,0,1
2,1.0,940,15000,1.0,0,0,3,7,940,0,1960,0,98055,47.4312,-122.195,1450,15000,225000,4,11,2014,0,54,14060,13550,0,0,0
3,2.5,2588,5701,2.0,0,0,3,8,2588,0,2008,0,98042,47.3449,-122.151,2389,5702,335000,22,10,2014,0,6,3113,3313,0,0,0
5,3.25,3500,10457,2.0,0,0,3,11,3500,0,2001,0,98059,47.5198,-122.157,3500,11734,972800,31,3,2015,0,14,6957,8234,0,0,0
4,3.75,3790,7200,2.0,0,0,3,10,2530,1260,1931,0,98112,47.6264,-122.289,3250,7200,2200000,23,12,2014,0,83,3410,3950,0,1,1
3,1.5,1090,8400,1.0,0,0,4,7,1090,0,1966,0,98008,47.6219,-122.115,1320,8400,415000,19,11,2014,0,48,7310,7080,0,0,0
3,3.0,2240,10479,2.0,0,0,4,7,1710,530,1950,0,98106,47.5529,-122.356,1530,5244,399000,26,8,2014,0,64,8239,3714,0,1,1
2,1.0,1150,4000,1.0,0,0,3,7,1150,0,1947,0,98199,47.6575,-122.394,1150,4288,376000,20,5,2014,0,67,2850,3138,0,0,1
3,2.0,1870,3378,1.0,0,0,3,7,1120,750,1913,0,98136,47.5371,-122.393,1870,1872,340000,17,12,2014,0,101,1508,2,0,1,1
5,2.75,2990,7200,2.0,0,0,3,8,2990,0,1997,0,98059,47.4955,-122.16,2710,7620,490000,14,11,2014,0,17,4210,4910,0,0,0
4,2.5,2580,6260,2.0,0,0,3,7,2580,0,2004,0,98056,47.4858,-122.185,2160,3600,374000,22,6,2014,0,10,3680,1440,0,0,0
4,1.0,2220,3588,1.5,0,0,4,7,1470,750,1927,0,98115,47.6854,-122.308,1740,3588,852000,26,3,2015,0,88,1368,1848,0,1,1
3,2.25,1620,12309,2.0,0,0,3,7,1620,0,1987,0,98074,47.6188,-122.029,2030,13963,473000,25,11,2014,0,27,10689,11933,0,0,0
2,2.0,1390,12530,1.0,0,0,3,8,970,420,1959,0,98155,47.7499,-122.29,1940,12530,431000,26,8,2014,0,55,11140,10590,0,1,1
4,3.0,2270,7245,1.0,0,0,3,7,1410,860,1979,0,98155,47.7722,-122.315,1740,7571,435000,6,5,2015,0,36,4975,5831,0,1,1
3,2.75,1250,892,2.0,0,0,3,8,1040,210,2010,0,98116,47.5826,-122.387,1250,1296,450000,13,5,2014,0,4,-358,46,0,1,1
3,1.75,1500,7475,1.0,0,0,4,8,1500,0,1976,0,98023,47.3155,-122.365,1940,7475,244000,17,12,2014,0,38,5975,5535,0,0,0
3,2.5,2800,10603,2.0,0,0,3,9,2800,0,2001,0,98011,47.7528,-122.195,2580,10603,550000,11,2,2015,0,14,7803,8023,0,0,0
3,1.0,1790,3876,1.5,0,0,5,7,1090,700,1904,0,98144,47.575,-122.288,1360,4080,350000,16,7,2014,0,110,2086,2720,0,1,1
3,1.0,1790,3876,1.5,0,0,5,7,1090,700,1904,0,98144,47.575,-122.288,1360,4080,615000,10,2,2015,0,111,2086,2720,0,1,1
3,2.25,2220,12056,2.0,0,0,3,8,2220,0,1985,0,98052,47.7148,-122.101,2320,12025,542000,23,2,2015,0,30,9836,9705,0,0,0
4,1.75,2000,6000,1.0,0,3,5,7,1000,1000,1956,0,98109,47.6428,-122.348,2610,4377,710000,19,11,2014,0,58,4000,1767,0,1,1
3,2.5,1770,9450,1.0,0,0,3,8,1770,0,1988,0,98001,47.3196,-122.272,2200,8582,289950,1,5,2015,0,27,7680,6382,0,0,0
4,2.75,4280,12668,2.0,0,0,3,9,3900,380,1947,2008,98004,47.6185,-122.219,3590,12670,1900000,16,10,2014,61,67,8388,9080,1,1,0
2,1.0,1260,5100,1.5,0,0,4,7,1120,140,1925,0,98117,47.6805,-122.384,1260,5100,528000,19,11,2014,0,89,3840,3840,0,1,1
2,1.0,840,5100,1.0,0,0,4,7,840,0,1949,0,98117,47.6779,-122.384,1550,5100,471000,25,3,2015,0,66,4260,3550,0,0,1
4,2.75,1830,6643,2.0,0,0,3,8,1830,0,2001,0,98001,47.2601,-122.286,2400,6472,250000,3,12,2014,0,13,4813,4072,0,0,0
3,1.5,970,8400,1.0,0,0,3,7,970,0,1966,0,98003,47.3284,-122.331,1230,8400,155000,27,10,2014,0,48,7430,7170,0,0,0
4,1.5,1740,8160,1.5,0,0,4,7,1400,340,1946,0,98177,47.7243,-122.363,1600,8160,515000,18,8,2014,0,68,6420,6560,0,1,1
3,2.25,1654,8464,2.0,0,0,3,7,1654,0,1995,0,98038,47.3618,-122.033,1975,8515,336600,5,3,2015,0,20,6810,6540,0,0,0
3,2.25,2390,2750,2.0,0,0,5,8,1580,810,1925,0,98109,47.6339,-122.354,2200,5160,915000,10,3,2015,0,90,360,2960,0,1,1
2,1.75,1080,7242,2.0,0,0,4,7,1080,0,1984,0,98034,47.7065,-122.235,1800,7321,350000,15,7,2014,0,30,6162,5521,0,0,0
3,1.0,1070,6164,1.0,0,0,3,7,1070,0,1967,0,98001,47.3377,-122.291,1320,7920,175000,5,3,2015,0,48,5094,6600,0,0,0
2,2.0,1430,3880,1.0,0,0,4,7,1430,0,1949,0,98117,47.6844,-122.392,1430,3880,545000,30,3,2015,0,66,2450,2450,0,0,1
4,3.0,2400,5400,2.0,0,2,4,7,1600,800,1965,0,98178,47.5099,-122.26,2400,5400,475000,27,12,2014,0,49,3000,3000,0,1,1
2,1.0,670,11505,1.0,0,0,3,5,670,0,2003,0,98059,47.499,-122.157,2180,11505,390000,30,4,2015,0,12,10835,9325,0,0,0
4,2.5,2860,14000,2.0,0,0,3,8,2860,0,1995,0,98019,47.7306,-121.973,2650,14564,645000,17,7,2014,0,19,11140,11914,0,0,0
3,1.5,2270,8187,1.0,0,0,4,8,1420,850,1954,0,98155,47.7573,-122.278,2020,14092,410000,2,12,2014,0,60,5917,12072,0,1,1
4,2.5,2180,9861,2.0,0,2,3,8,2180,0,1997,0,98045,47.4817,-121.802,2390,9761,480000,31,3,2015,0,18,7681,7371,0,0,0
3,1.75,1860,6000,2.0,0,2,4,8,1860,0,1959,0,98144,47.5981,-122.288,3030,7119,725000,1,7,2014,0,55,4140,4089,0,0,1
2,1.0,1010,11919,1.0,0,0,3,6,1010,0,1947,0,98155,47.7461,-122.322,1220,11240,300000,2,7,2014,0,67,10909,10020,0,0,1
4,2.5,2570,8178,1.0,0,2,3,8,1710,860,1961,0,98118,47.5483,-122.261,2050,7500,752000,9,3,2015,0,54,5608,5450,0,1,1
4,2.5,1950,3720,2.0,0,0,3,8,1950,0,2004,0,98029,47.5503,-121.997,1720,3720,585000,23,9,2014,0,10,1770,2000,0,0,0
3,1.75,1970,10548,1.0,0,0,4,8,1300,670,1973,0,98033,47.6669,-122.179,2500,8548,678700,13,2,2015,0,42,8578,6048,0,1,0
4,2.25,2110,11155,2.0,0,0,3,9,2110,0,1975,0,98074,47.6386,-122.058,2660,11900,603000,17,4,2015,0,40,9045,9240,0,0,0
3,1.75,1650,7276,1.5,0,4,4,7,1150,500,1928,0,98117,47.6989,-122.399,2300,8088,715000,20,3,2015,0,87,5626,5788,0,1,1
3,2.5,2840,7500,2.0,0,3,3,11,2840,0,1997,0,98034,47.7049,-122.224,2580,5918,1090000,29,4,2015,0,18,4660,3338,0,0,0
2,1.75,1490,4800,1.0,0,0,4,7,750,740,1918,0,98136,47.5496,-122.391,1400,6000,467500,22,2,2015,0,97,3310,4600,0,1,1
3,2.25,1650,7218,1.0,0,0,3,7,1230,420,1985,0,98133,47.7237,-122.335,1690,7459,359000,13,10,2014,0,29,5568,5769,0,1,1
4,2.0,1960,4520,1.0,0,0,3,8,960,1000,1922,2001,98116,47.58,-122.405,1680,4520,745000,26,8,2014,79,92,2560,2840,1,1,1
3,2.0,1720,2000,1.5,0,0,3,8,1060,660,1910,2000,98109,47.6384,-122.35,1590,4000,935000,8,4,2015,90,105,280,2410,1,1,1
3,2.5,1980,3128,2.0,0,0,3,8,1890,90,2009,0,98027,47.5456,-122.016,2160,2240,615000,3,9,2014,0,5,1148,80,0,1,0
4,2.5,1990,5577,2.0,0,0,3,7,1990,0,1999,0,98092,47.3191,-122.191,2020,6400,283500,6,1,2015,0,16,3587,4380,0,0,0
2,1.0,860,7102,1.0,0,0,3,6,860,0,1947,0,98177,47.7042,-122.369,1450,7102,340000,2,12,2014,0,67,6242,5652,0,0,1
4,2.5,2320,9264,2.0,0,0,3,8,2320,0,1994,0,98188,47.4449,-122.274,2320,9129,370000,25,2,2015,0,21,6944,6809,0,0,1
3,2.5,4190,9624,2.0,0,0,3,10,4190,0,1999,0,98006,47.5642,-122.127,3650,8321,1150000,20,8,2014,0,15,5434,4671,0,0,0
4,1.0,1940,9533,1.0,0,0,3,7,1080,860,1962,0,98031,47.4139,-122.208,1940,8839,265000,10,5,2014,0,52,7593,6899,0,1,0
4,2.25,2520,2370,2.0,0,0,3,8,1690,830,1908,0,98122,47.6109,-122.303,1530,2370,480000,26,8,2014,0,106,-150,840,0,1,1
3,2.0,1880,3800,1.0,0,0,5,7,1030,850,1927,0,98115,47.6841,-122.309,1700,3800,667500,17,6,2014,0,87,1920,2100,0,1,1
3,2.5,2910,10044,2.0,0,0,4,10,2910,0,1989,0,98004,47.5845,-122.199,2420,12287,1400000,27,2,2015,0,26,7134,9867,0,0,0
7,4.75,5310,8816,2.0,0,0,3,10,3650,1660,2013,0,98004,47.6221,-122.208,2920,10610,2300000,8,8,2014,0,1,3506,7690,0,1,0
3,2.25,2670,7500,1.0,0,0,4,7,1640,1030,1966,0,98166,47.4608,-122.354,1970,9598,465000,16,6,2014,0,48,4830,7628,0,1,1
3,1.0,1060,5600,1.0,0,0,4,6,760,300,1943,0,98146,47.5116,-122.379,1310,5600,345000,23,3,2015,0,72,4540,4290,0,1,1
3,1.5,1120,6900,1.0,0,0,5,7,1120,0,1956,0,98007,47.6023,-122.132,1300,7000,439800,2,6,2014,0,58,5780,5700,0,0,0
4,1.75,2250,8580,1.0,0,0,4,7,1330,920,1958,0,98011,47.7633,-122.199,2250,10032,468000,25,7,2014,0,56,6330,7782,0,1,0
4,2.5,2070,8473,1.0,0,0,4,8,1250,820,1976,0,98033,47.6608,-122.19,2070,9499,775000,24,7,2014,0,38,6403,7429,0,1,0
4,2.25,2370,9360,2.0,0,0,4,8,2370,0,1979,0,98052,47.6518,-122.123,2370,9720,684680,8,6,2014,0,35,6990,7350,0,0,0
3,2.5,1610,6600,2.0,0,0,3,7,1610,0,1994,0,98003,47.2827,-122.302,1660,7689,250000,11,9,2014,0,20,4990,6029,0,0,0
5,3.0,4150,7500,2.5,0,4,5,11,3510,640,1909,0,98119,47.6303,-122.362,2250,4050,3070000,12,2,2015,0,106,3350,1800,0,1,1
4,2.25,1840,7575,1.0,0,0,4,7,1390,450,1973,0,98034,47.7328,-122.198,1820,7500,442500,25,11,2014,0,41,5735,5680,0,1,0
3,2.0,1820,4080,2.0,0,2,3,8,1820,0,1937,1987,98107,47.6735,-122.401,2160,5400,699000,19,9,2014,50,77,2260,3240,1,0,1
2,1.0,1130,8081,1.0,0,0,4,7,1130,0,1921,0,98133,47.7064,-122.355,1220,7800,345000,18,9,2014,0,93,6951,6580,0,0,1
4,1.0,1320,5000,1.5,0,0,3,7,1320,0,1928,0,98106,47.5457,-122.363,1640,5164,229000,8,4,2015,0,87,3680,3524,0,0,1
3,1.0,1290,12415,1.5,0,0,3,6,1290,0,1908,0,98070,47.3719,-122.461,1620,12415,300000,26,3,2015,0,107,11125,10795,0,0,0
3,3.25,1600,1289,3.0,0,0,3,8,1600,0,1998,0,98117,47.6957,-122.375,1600,1376,392500,20,8,2014,0,16,-311,-224,0,0,1
3,1.0,1120,2300,1.0,0,0,4,7,820,300,1912,0,98117,47.6797,-122.384,1430,5100,552000,16,6,2014,0,102,1180,3670,0,1,1
2,1.75,2060,7192,1.0,0,0,3,7,1420,640,1940,0,98125,47.7038,-122.317,1860,7140,457000,20,11,2014,0,74,5132,5280,0,1,1
4,2.5,2830,13760,2.0,0,0,3,8,2830,0,1993,0,98019,47.7334,-121.97,2350,14029,518000,7,10,2014,0,21,10930,11679,0,0,0
3,2.0,1210,6634,1.0,0,0,4,7,1210,0,1985,0,98031,47.4097,-122.193,1560,7200,237000,12,8,2014,0,29,5424,5640,0,0,0
3,2.25,2260,17114,2.0,0,0,3,7,2260,0,1990,0,98155,47.7537,-122.296,2360,14893,605000,6,5,2015,0,25,14854,12533,0,0,1
4,2.5,1850,8198,2.0,0,0,3,7,1850,0,1993,0,98031,47.4079,-122.186,1850,7924,295000,22,7,2014,0,21,6348,6074,0,0,0
4,2.5,1930,8040,1.0,0,0,3,7,1380,550,1978,0,98034,47.7283,-122.218,2080,7200,513000,28,4,2015,0,37,6110,5120,0,1,0
4,2.5,3230,4290,2.0,0,0,3,9,3230,0,2004,0,98033,47.6874,-122.161,3220,5083,772500,1,10,2014,0,10,1060,1863,0,0,0
4,2.5,3230,4290,2.0,0,0,3,9,3230,0,2004,0,98033,47.6874,-122.161,3220,5083,765000,19,12,2014,0,10,1060,1863,0,0,0
4,2.75,2450,5376,1.5,0,0,4,7,1550,900,1920,0,98117,47.6865,-122.396,1920,5264,696950,10,10,2014,0,94,2926,3344,0,1,1
3,1.0,1200,5650,1.5,0,0,3,7,1200,0,1928,0,98178,47.5065,-122.249,1610,5650,329000,13,2,2015,0,87,4450,4040,0,0,1
3,2.5,2360,8093,2.0,0,0,3,8,2360,0,1995,0,98092,47.3257,-122.17,1860,6762,339999,18,12,2014,0,19,5733,4902,0,0,0
3,1.0,1060,9506,1.0,0,0,3,7,1060,0,1959,0,98125,47.7317,-122.31,1520,8469,364500,14,7,2014,0,55,8446,6949,0,0,1
5,1.75,2220,6000,1.5,0,0,3,7,1420,800,1923,0,98199,47.648,-122.384,1550,1715,607500,14,5,2014,0,91,3780,165,0,1,1
3,1.0,880,6664,1.0,0,0,3,6,880,0,1961,0,98033,47.6855,-122.199,1690,6564,550000,8,4,2015,0,54,5784,4874,0,0,0
4,2.0,2510,9750,1.0,0,0,3,8,1630,880,1960,0,98028,47.7438,-122.229,1980,9750,479900,21,4,2015,0,55,7240,7770,0,1,0
4,4.0,2530,1774,3.0,0,2,3,9,2100,430,2013,0,98119,47.6362,-122.369,2160,2400,1120000,12,2,2015,0,2,-756,240,0,1,1
2,1.0,700,10540,1.0,0,0,3,6,700,0,1953,0,98166,47.438,-122.336,890,10540,192000,12,5,2014,0,61,9840,9650,0,0,1
3,2.0,1500,5200,1.0,0,0,3,7,1060,440,1977,0,98042,47.3653,-122.09,1640,5200,250000,13,4,2015,0,38,3700,3560,0,1,0
3,2.0,1130,9879,2.0,0,0,3,6,1130,0,1996,0,98053,47.635,-121.964,1900,14907,340000,15,7,2014,0,18,8749,13007,0,0,0
3,2.0,1420,6060,1.0,0,0,5,7,830,590,1942,0,98146,47.5102,-122.372,1420,6360,340000,28,10,2014,0,72,4640,4940,0,1,1
2,1.0,1170,5043,1.0,0,0,3,6,880,290,1949,0,98108,47.5492,-122.302,1430,5692,324800,7,4,2015,0,66,3873,4262,0,1,1
2,1.0,780,16344,1.0,0,0,1,5,780,0,1942,0,98168,47.4739,-122.28,1700,10387,78000,6,5,2014,0,72,15564,8687,0,0,1
4,1.75,1770,12875,1.0,0,0,3,8,1770,0,1988,0,98028,47.7438,-122.247,2150,12875,400000,9,4,2015,0,27,11105,10725,0,0,0
3,1.0,1070,4505,1.0,0,2,4,7,1070,0,1919,0,98136,47.5305,-122.384,1380,4505,640500,6,5,2015,0,96,3435,3125,0,0,1
3,2.0,1930,10929,1.0,0,0,3,8,1260,670,1964,0,98155,47.7657,-122.272,2030,8750,570000,30,4,2015,0,51,8999,6720,0,1,1
3,1.5,1940,2885,1.5,0,2,3,8,1940,0,1900,0,98119,47.6308,-122.369,2550,3600,1330000,25,6,2014,0,114,945,1050,0,0,1
3,2.75,1440,7350,1.0,0,0,4,7,1040,400,1980,0,98058,47.4431,-122.138,1510,7350,330490,3,4,2015,0,35,5910,5840,0,1,0
3,2.5,1740,5267,2.0,0,0,3,7,1740,0,1999,0,98038,47.3777,-122.023,2180,5000,325000,19,8,2014,0,15,3527,2820,0,0,0
3,2.5,1740,5267,2.0,0,0,3,7,1740,0,1999,0,98038,47.3777,-122.023,2180,5000,335000,21,4,2015,0,16,3527,2820,0,0,0
5,2.75,2210,13500,1.0,0,0,5,7,1460,750,1963,0,98188,47.4468,-122.282,1590,10850,314000,13,11,2014,0,51,11290,9260,0,1,1
4,2.0,2190,3622,1.5,0,0,5,8,1990,200,1925,0,98115,47.6887,-122.312,1450,3082,625000,23,9,2014,0,89,1432,1632,0,1,1
3,2.5,2590,7720,2.0,0,0,3,9,2590,0,1988,0,98007,47.659,-122.146,2600,9490,809000,17,6,2014,0,26,5130,6890,0,0,0
5,1.75,2180,9178,1.0,0,0,3,7,1140,1040,1963,0,98188,47.4364,-122.28,2140,9261,275000,21,8,2014,0,51,6998,7121,0,1,1
4,2.75,2580,11900,1.0,0,0,4,7,1620,960,1967,0,98058,47.4475,-122.159,1570,9375,358000,17,4,2015,0,48,9320,7805,0,1,0
3,2.25,2820,8100,1.0,0,0,4,7,1720,1100,1947,0,98168,47.4944,-122.304,1040,8100,297975,13,3,2015,0,68,5280,7060,0,1,1
2,1.0,720,8040,1.0,0,0,3,6,720,0,1943,0,98166,47.4662,-122.359,2300,9500,210000,26,6,2014,0,71,7320,7200,0,0,1
3,2.5,2260,4550,1.5,0,0,4,7,1380,880,1928,0,98126,47.5714,-122.376,1870,4582,622500,27,8,2014,0,86,2290,2712,0,1,1
3,2.5,1550,1092,3.0,0,0,3,8,1390,160,2004,0,98102,47.6355,-122.324,1550,1079,550000,22,10,2014,0,10,-458,-471,0,1,1
3,1.75,1390,7700,1.0,0,0,5,7,1390,0,1965,0,98058,47.4559,-122.183,1260,7700,190000,26,2,2015,0,50,6310,6440,0,0,0
4,2.5,2380,9362,2.0,0,0,3,8,2380,0,2000,0,98023,47.3148,-122.349,2190,9840,340000,28,7,2014,0,14,6982,7650,0,0,0
3,2.5,2640,5964,2.0,0,0,3,9,2640,0,2003,0,98052,47.7043,-122.128,2680,5211,678000,25,7,2014,0,11,3324,2531,0,0,0
5,2.0,2260,11970,1.0,0,0,4,7,1250,1010,1962,0,98031,47.3896,-122.218,1950,11970,275000,28,4,2015,0,53,9710,10020,0,1,0
3,2.75,1720,6720,1.0,0,0,4,7,1270,450,1947,0,98122,47.6138,-122.298,1690,3248,493000,15,9,2014,0,67,5000,1558,0,1,1
3,1.0,1070,14000,1.0,0,0,3,7,1070,0,1960,0,98178,47.4971,-122.279,920,12500,147000,16,12,2014,0,54,12930,11580,0,0,1
3,2.25,2000,7225,2.0,0,0,4,7,2000,0,1985,0,98030,47.349,-122.167,1950,7464,334000,4,2,2015,0,30,5225,5514,0,0,0
4,2.5,2800,10786,1.0,0,0,3,8,1420,1380,1970,0,98008,47.5959,-122.116,2140,10788,605000,3,7,2014,0,44,7986,8648,0,1,0
3,1.0,1620,10610,1.0,0,0,4,6,1620,0,1958,0,98059,47.474,-122.125,1680,10795,345000,25,11,2014,0,56,8990,9115,0,0,0
2,1.75,1520,4220,1.0,0,0,4,7,840,680,1910,0,98117,47.6876,-122.366,1120,5700,470000,2,4,2015,0,105,2700,4580,0,1,1
3,2.25,1740,10378,1.0,0,0,5,7,1740,0,1977,0,98042,47.3815,-122.09,1420,10167,255000,17,9,2014,0,37,8638,8747,0,0,0
4,3.5,4150,16197,2.0,0,0,3,10,4150,0,2006,0,98003,47.3423,-122.183,3618,15210,550000,27,6,2014,0,8,12047,11592,0,0,0
5,3.5,3270,4080,2.0,0,0,3,9,2180,1090,2011,0,98115,47.6754,-122.327,1410,4080,1310000,31,7,2014,0,3,810,2670,0,1,1
2,1.0,1070,6000,1.0,0,0,4,5,1070,0,1922,0,98178,47.495,-122.227,1910,6000,225000,5,5,2015,0,93,4930,4090,0,0,1
4,0.75,1960,8277,1.0,1,4,4,7,1320,640,1923,1986,98198,47.3648,-122.325,1940,8402,520000,23,12,2014,63,91,6317,6462,1,1,1
3,3.25,1600,1882,2.0,0,0,3,8,1360,240,2000,0,98133,47.7151,-122.355,1390,1379,345000,26,8,2014,0,14,282,-11,0,1,1
4,1.75,1650,7775,1.0,0,0,4,7,1150,500,1950,0,98133,47.715,-122.354,1390,7200,475000,20,5,2014,0,64,6125,5810,0,1,1
5,1.5,2170,8610,1.0,0,0,4,7,1230,940,1959,0,98008,47.6111,-122.126,1670,8610,497500,8,10,2014,0,55,6440,6940,0,1,0
4,2.75,3280,6845,2.0,0,0,3,10,3280,0,2003,0,98052,47.7042,-122.107,3280,7467,734500,25,8,2014,0,11,3565,4187,0,0,0
3,1.0,870,8040,1.0,0,0,3,7,870,0,1953,0,98177,47.7048,-122.368,1440,8040,276000,18,12,2014,0,61,7170,6600,0,0,1
2,1.0,1400,10800,1.0,0,0,4,7,1400,0,1974,0,98011,47.7726,-122.21,1560,11280,325000,12,8,2014,0,40,9400,9720,0,0,0
4,2.75,1680,9545,1.0,0,0,4,7,1080,600,1979,0,98028,47.739,-122.243,1890,9545,425000,28,5,2014,0,35,7865,7655,0,1,0
3,2.5,2300,5500,1.5,0,0,4,8,2000,300,1921,0,98144,47.5785,-122.293,2100,5000,635000,28,5,2014,0,93,3200,2900,0,1,1
3,1.75,1340,7473,1.0,0,0,4,7,1340,0,1973,0,98002,47.3087,-122.206,1510,8240,223000,14,5,2014,0,41,6133,6730,0,0,0
3,2.75,2600,10874,2.0,0,0,3,9,2600,0,1994,0,98042,47.3815,-122.146,2800,11504,425000,13,4,2015,0,21,8274,8704,0,0,0
3,2.25,1640,7730,1.0,0,0,4,7,1220,420,1989,0,98038,47.3576,-122.039,1560,7566,190000,6,5,2015,0,26,6090,6006,0,1,0
4,1.75,1960,6177,1.0,0,0,4,8,1960,0,1967,0,98023,47.3131,-122.383,2010,8162,275000,18,9,2014,0,47,4217,6152,0,0,0
3,2.5,1480,1961,2.0,0,0,3,8,1480,0,2005,0,98029,47.5478,-122.0,1400,1138,450000,6,6,2014,0,9,481,-262,0,0,0
4,2.0,1540,5000,1.5,0,0,4,7,1540,0,1913,0,98105,47.6713,-122.3,1790,4000,550000,22,12,2014,0,101,3460,2210,0,0,1
4,2.75,4030,10240,2.0,0,2,3,8,3310,720,1943,1994,98177,47.7168,-122.365,2490,7680,835000,4,12,2014,51,71,6210,5190,1,1,1
6,3.0,3020,13783,2.0,0,0,3,8,3020,0,1952,2002,98040,47.5722,-122.226,1720,13500,900000,18,6,2014,50,62,10763,11780,1,0,0
2,2.0,1590,9375,1.0,0,0,3,7,910,680,1983,0,98055,47.4585,-122.205,1560,8524,290000,24,11,2014,0,31,7785,6964,0,1,0
4,2.5,2910,9131,2.0,0,0,3,10,2910,0,2014,0,98033,47.6826,-122.186,1880,11212,1040000,8,8,2014,0,0,6221,9332,0,0,0
4,2.5,3020,15164,1.0,0,0,4,8,1730,1290,1976,0,98004,47.5882,-122.192,2600,11556,780000,5,1,2015,0,39,12144,8956,0,1,0
3,2.0,2290,11200,2.0,0,0,3,9,2290,0,1979,0,98052,47.6517,-122.124,2250,10000,572500,18,12,2014,0,35,8910,7750,0,0,0
4,1.75,2740,10086,1.0,0,0,3,7,1440,1300,1972,0,98168,47.5112,-122.329,1710,9840,350000,21,8,2014,0,42,7346,8130,0,1,1
2,3.0,2330,3600,2.0,0,0,5,10,1870,460,1927,1979,98112,47.6316,-122.282,2950,7200,1050000,4,9,2014,52,87,1270,4250,1,1,1
3,2.25,2300,7200,1.0,0,0,4,8,1550,750,1978,0,98003,47.324,-122.328,2000,7350,287000,17,12,2014,0,36,4900,5350,0,1,0
4,4.0,1550,6596,1.5,0,0,5,7,1550,0,1907,0,98107,47.6711,-122.398,1830,4850,707500,7,11,2014,0,107,5046,3020,0,0,1
4,2.5,1750,11381,1.0,0,0,4,7,1610,140,1947,0,98155,47.7425,-122.321,1080,11375,464500,1,8,2014,0,67,9631,10295,0,1,1
3,1.5,2180,5000,1.0,0,3,4,8,1090,1090,1941,0,98116,47.5787,-122.402,2070,5000,720000,3,12,2014,0,73,2820,2930,0,1,1
3,2.5,1610,8544,2.0,0,0,5,7,1610,0,1994,0,98038,47.3714,-122.054,1840,8190,319000,24,12,2014,0,20,6934,6350,0,0,0
3,1.0,1570,9136,1.0,0,0,3,7,1570,0,1953,0,98133,47.7688,-122.337,1380,9127,330000,16,9,2014,0,61,7566,7747,0,0,1
3,1.75,1140,9628,1.0,0,0,4,7,1140,0,1969,0,98023,47.2933,-122.372,1510,9633,120750,20,5,2014,0,45,8488,8123,0,0,0
3,1.75,1140,9628,1.0,0,0,4,7,1140,0,1969,0,98023,47.2933,-122.372,1510,9633,195000,21,10,2014,0,45,8488,8123,0,0,0
4,1.5,2480,6383,1.0,0,0,3,7,1380,1100,1946,0,98119,47.6445,-122.374,1440,6000,650000,26,1,2015,0,69,3903,4560,0,1,1
3,1.75,1690,8190,1.0,0,0,4,8,1690,0,1958,0,98005,47.5857,-122.172,1840,8705,530000,13,5,2014,0,56,6500,6865,0,0,0
4,3.0,2910,8027,1.0,0,0,5,8,1800,1110,1970,0,98117,47.6939,-122.391,2390,7660,825000,7,4,2015,0,45,5117,5270,0,1,1
4,2.0,1600,15044,1.0,0,0,3,7,1600,0,1972,0,98034,47.72,-122.216,1660,8102,436000,22,8,2014,0,42,13444,6442,0,0,0
3,2.0,1850,9570,1.0,0,0,4,7,950,900,1940,0,98115,47.697,-122.322,1430,6380,547500,13,8,2014,0,74,7720,4950,0,1,1
3,1.75,2150,2527,2.0,0,0,4,8,1400,750,1906,0,98103,47.6629,-122.329,1610,3663,762000,3,12,2014,0,108,377,2053,0,1,1
3,1.75,2650,7378,1.0,0,0,3,7,1460,1190,1952,0,98155,47.7525,-122.315,1600,7616,340000,26,1,2015,0,63,4728,6016,0,1,1
4,1.75,2510,5800,1.0,0,2,4,9,1830,680,1953,0,98199,47.648,-122.41,2190,5800,880000,21,11,2014,0,61,3290,3610,0,1,1
4,2.5,3240,3600,2.0,0,0,3,9,2060,1180,2008,0,98109,47.6405,-122.356,1820,3600,1220000,21,5,2014,0,6,360,1780,0,1,1
4,2.5,3440,14554,2.0,1,4,3,8,2170,1270,2012,0,98155,47.7364,-122.286,3170,11810,1950000,8,4,2015,0,3,11114,8640,0,1,1
3,2.0,1150,6249,1.0,0,0,3,7,1150,0,1952,2006,98155,47.7489,-122.284,2470,7751,382500,23,9,2014,54,62,5099,5281,1,0,1
3,1.75,1890,9535,1.0,0,0,3,7,1210,680,1976,0,98055,47.4872,-122.223,2040,11108,344500,5,1,2015,0,39,7645,9068,0,1,0
4,2.75,1430,7403,1.0,0,0,3,7,1030,400,1982,0,98106,47.5346,-122.344,1480,7663,375000,12,4,2015,0,33,5973,6183,0,1,1
1,0.75,370,1801,1.0,0,0,5,5,370,0,1923,0,98117,47.6778,-122.389,1340,5000,276000,1,7,2014,0,91,1431,3660,0,0,1
5,3.25,3130,12087,2.0,0,0,3,8,2180,950,1975,0,98027,47.5336,-122.052,2410,10350,500000,1,7,2014,0,39,8957,7940,0,1,0
4,2.5,2105,6093,2.0,0,0,3,8,2105,0,2003,0,98042,47.3531,-122.147,1930,8022,330000,2,7,2014,0,11,3988,6092,0,0,0
3,1.0,890,5965,1.0,0,0,3,7,890,0,1950,0,98155,47.7518,-122.279,1930,7500,328000,22,8,2014,0,64,5075,5570,0,0,1
3,1.5,1340,7200,1.0,0,0,3,7,1340,0,1972,0,98034,47.718,-122.193,1730,8820,450000,25,2,2015,0,43,5860,7090,0,0,0
4,2.25,2290,12174,1.0,1,4,3,7,1490,800,1948,0,98178,47.5114,-122.245,2290,9379,840500,15,7,2014,0,66,9884,7089,0,1,1
3,2.5,2770,9350,2.0,0,3,3,8,2770,0,1957,2000,98056,47.5253,-122.201,2660,9695,679000,14,8,2014,43,57,6580,7035,1,0,0
3,1.5,1890,9450,1.0,0,0,3,7,1090,800,1957,0,98146,47.4829,-122.341,1470,8100,270000,5,6,2014,0,57,7560,6630,0,1,1
5,2.25,3160,8065,2.0,0,0,3,8,3160,0,1977,0,98027,47.5678,-122.089,2540,7917,757500,14,1,2015,0,38,4905,5377,0,0,0
2,2.5,1830,2856,2.0,0,0,3,7,1830,0,2005,0,98029,47.5524,-121.996,1850,2667,524950,12,11,2014,0,9,1026,817,0,0,0
3,1.0,1430,8640,1.0,0,0,5,7,1430,0,1954,0,98006,47.572,-122.147,1430,9840,551100,7,1,2015,0,61,7210,8410,0,0,0
3,2.0,1420,12655,1.0,0,0,5,7,1420,0,1968,0,98056,47.5309,-122.186,2020,9655,421000,7,11,2014,0,46,11235,7635,0,0,0
4,1.75,2460,7560,2.0,0,0,4,8,2460,0,1952,0,98177,47.7256,-122.367,2760,8918,635000,1,8,2014,0,62,5100,6158,0,0,1
3,1.0,1340,6120,1.5,0,0,4,7,1340,0,1920,0,98108,47.5272,-122.322,1260,6000,255000,9,12,2014,0,94,4780,4740,0,0,1
4,1.0,1530,7920,1.0,0,0,3,7,1030,500,1955,0,98166,47.4544,-122.36,1690,7920,419950,10,3,2015,0,60,6390,6230,0,1,1
6,3.0,2650,12870,1.0,0,0,4,7,2650,0,1977,0,98022,47.2069,-121.989,1450,8668,325000,10,12,2014,0,37,10220,7218,0,0,0
4,2.25,1677,3600,2.0,0,0,3,7,1677,0,2012,0,98092,47.32,-122.178,1677,3600,281000,21,4,2015,0,3,1923,1923,0,0,0
3,1.75,2050,11856,1.0,0,0,3,7,1460,590,1962,0,98006,47.5735,-122.162,2670,11856,655275,10,6,2014,0,52,9806,9186,0,1,0
3,2.0,2520,3959,1.0,0,0,5,8,1270,1250,1931,0,98105,47.6693,-122.289,1660,3959,861000,25,8,2014,0,83,1439,2299,0,1,1
3,3.5,2620,11148,2.0,0,4,4,9,2060,560,1977,0,98008,47.5845,-122.115,2590,10796,850000,16,10,2014,0,37,8528,8206,0,1,0
3,2.5,1650,6675,1.0,0,0,3,8,1290,360,1990,0,98023,47.2899,-122.372,1880,6675,246000,19,11,2014,0,24,5025,4795,0,1,0
2,1.0,700,4836,1.0,0,0,4,6,700,0,1926,0,98125,47.7139,-122.288,1190,7050,380000,16,12,2014,0,88,4136,5860,0,0,1
4,2.5,3430,7508,2.0,0,0,3,10,3430,0,1998,0,98052,47.6866,-122.11,3110,8741,813000,20,10,2014,0,16,4078,5631,0,0,0
4,2.5,3140,11049,2.0,0,0,3,10,3140,0,1988,0,98004,47.5817,-122.192,2750,11049,990000,20,11,2014,0,26,7909,8299,0,0,0
3,2.5,2350,3750,2.0,0,0,3,7,1740,610,2003,0,98117,47.6767,-122.365,1590,4700,650000,5,11,2014,0,11,1400,3110,0,1,1
4,3.0,1990,6180,2.0,0,0,3,7,1990,0,1990,0,98023,47.3083,-122.36,1910,6180,273000,22,5,2014,0,24,4190,4270,0,0,0
4,2.5,2050,14724,2.0,0,0,3,7,2050,0,1989,0,98019,47.73,-121.969,1920,12841,398000,24,7,2014,0,25,12674,10921,0,0,0
2,1.0,930,8665,1.0,0,0,4,6,930,0,1938,0,98168,47.4822,-122.318,1630,12375,200000,22,8,2014,0,76,7735,10745,0,0,1
3,1.0,1230,12305,1.0,0,0,3,7,1230,0,1955,1990,98004,47.6095,-122.195,2100,7960,839000,15,5,2014,35,59,11075,5860,1,0,0
3,2.5,1870,9135,1.0,0,0,3,7,1250,620,1984,0,98074,47.6269,-122.06,1550,9100,502000,4,11,2014,0,30,7265,7550,0,1,0
3,2.25,2110,7665,1.0,0,0,4,7,1360,750,1973,0,98023,47.3082,-122.372,1660,8436,305000,17,6,2014,0,41,5555,6776,0,1,0
5,3.25,3160,10000,2.0,0,0,4,8,3160,0,1980,0,98027,47.52,-122.047,2130,10000,574950,18,6,2014,0,34,6840,7870,0,0,0
3,1.0,1120,8631,1.0,0,0,3,7,1120,0,1942,0,98125,47.7077,-122.314,1350,7714,311000,18,8,2014,0,72,7511,6364,0,0,1
3,2.25,2750,6203,1.0,1,4,5,7,1620,1130,1959,0,98074,47.6163,-122.068,2570,7009,1650000,22,11,2014,0,55,3453,4439,0,1,0
3,1.0,1230,9568,1.0,0,0,5,7,1230,0,1962,0,98056,47.539,-122.179,1270,9575,387000,6,5,2014,0,52,8338,8305,0,0,0
2,1.0,740,3434,1.0,0,0,5,6,740,0,1920,0,98022,47.2088,-121.992,1160,6000,175000,25,9,2014,0,94,2694,4840,0,0,0
4,2.5,1770,5855,2.0,0,0,3,7,1770,0,2003,0,98038,47.3483,-122.053,1790,5679,248000,12,6,2014,0,11,4085,3889,0,0,0
4,2.25,1720,7803,1.0,0,0,3,8,1350,370,1955,0,98146,47.5119,-122.337,1720,7803,336750,3,4,2015,0,60,6083,6083,0,1,1
4,2.75,2330,3917,2.0,0,0,3,9,2330,0,2004,0,98029,47.5527,-121.99,2620,4400,645000,15,7,2014,0,10,1587,1780,0,0,0
3,2.5,1660,7388,2.0,0,0,3,7,1660,0,2003,0,98038,47.3865,-122.027,2240,6228,279000,18,12,2014,0,11,5728,3988,0,0,0
2,2.5,1730,1037,3.5,0,0,3,8,1730,0,2008,0,98118,47.5594,-122.285,1280,1026,479000,16,4,2015,0,7,-693,-254,0,0,1
3,2.25,1880,7279,1.0,0,0,3,7,1280,600,1962,0,98155,47.7574,-122.322,2020,8274,466000,28,1,2015,0,53,5399,6254,0,1,1
4,2.75,2190,6740,2.0,0,0,3,7,2190,0,1995,0,98038,47.3804,-122.027,1950,7150,361500,20,4,2015,0,20,4550,5200,0,0,0
3,1.75,1720,7202,1.0,0,0,3,7,1720,0,1995,0,98056,47.5044,-122.19,1720,7625,404000,2,12,2014,0,19,5482,5905,0,0,0
4,3.25,2360,8344,2.0,0,0,3,8,2360,0,1990,0,98058,47.4403,-122.126,1860,8410,319000,16,3,2015,0,25,5984,6550,0,0,0
3,1.5,1490,10132,1.0,0,0,4,6,1490,0,1969,0,98059,47.4779,-122.145,1720,9915,320000,16,3,2015,0,46,8642,8195,0,0,0
4,3.75,3490,5625,2.0,0,0,3,9,2610,880,2014,0,98103,47.6685,-122.332,1940,5000,1310000,17,11,2014,0,0,2135,3060,0,1,1
3,2.75,2370,8900,1.0,0,4,4,9,1670,700,1971,0,98006,47.5648,-122.156,2840,8956,1000000,23,9,2014,0,43,6530,6116,0,1,0
4,2.5,2290,9120,2.0,0,0,4,8,2290,0,1977,0,98006,47.5613,-122.128,2290,9120,660000,7,11,2014,0,37,6830,6830,0,0,0
4,3.0,1790,3600,1.5,0,0,3,8,1790,0,1901,0,98122,47.6117,-122.313,1770,3119,546000,21,4,2015,0,114,1810,1349,0,0,1
4,1.75,1820,5015,1.0,0,0,4,6,1190,630,1926,0,98108,47.5569,-122.31,1530,9130,300000,9,7,2014,0,88,3195,7600,0,1,1
2,1.5,1760,12000,1.0,0,0,4,7,1760,0,1964,0,98052,47.6288,-122.109,2200,12088,500000,16,10,2014,0,50,10240,9888,0,0,0
4,2.5,2430,5556,2.0,0,0,4,8,2430,0,2003,0,98042,47.3762,-122.126,2430,5556,381500,10,9,2014,0,11,3126,3126,0,0,0
4,2.5,2390,4639,2.0,0,0,3,8,2390,0,2006,0,98038,47.3527,-121.999,2390,4521,278226,16,1,2015,0,9,2249,2131,0,0,0
2,1.75,1500,4158,1.0,0,0,4,7,1220,280,1947,0,98103,47.7006,-122.35,1270,4081,340000,27,1,2015,0,68,2658,2811,0,1,1
4,2.5,2510,12000,1.0,0,0,3,8,1520,990,1977,0,98023,47.3086,-122.384,2210,8320,305000,13,8,2014,0,37,9490,6110,0,1,0
4,2.5,2420,10285,1.0,0,4,3,8,1700,720,1958,0,98146,47.4871,-122.36,2540,9900,760000,13,6,2014,0,56,7865,7360,0,1,1
4,1.5,2170,9948,2.0,0,0,3,7,2170,0,1952,0,98148,47.4263,-122.331,1500,9750,195000,29,10,2014,0,62,7778,8250,0,0,1
4,1.75,1960,6138,1.0,0,0,4,7,1260,700,1960,0,98115,47.6968,-122.299,2000,7057,564000,15,4,2015,0,55,4178,5057,0,1,1
4,2.25,2280,8550,1.0,0,0,3,8,1660,620,1977,0,98034,47.701,-122.231,2590,9500,539500,24,12,2014,0,37,6270,6910,0,1,0
4,1.5,1580,10230,1.0,0,0,3,6,790,790,1945,2008,98178,47.5002,-122.246,1130,6955,299980,18,9,2014,63,69,8650,5825,1,1,1
4,2.5,1850,5674,2.0,0,0,3,7,1850,0,1993,0,98042,47.3536,-122.142,1750,6875,290000,13,10,2014,0,21,3824,5125,0,0,0
2,1.0,770,11084,1.0,0,0,4,6,770,0,1947,0,98155,47.7482,-122.321,1010,11084,257000,3,2,2015,0,68,10314,10074,0,0,1
4,3.0,2120,5520,1.5,0,0,3,8,1420,700,1985,0,98125,47.7085,-122.286,2020,8700,518500,21,8,2014,0,29,3400,6680,0,1,1
4,1.75,2220,6350,1.0,0,0,3,7,1110,1110,1959,0,98125,47.7136,-122.29,1950,8100,526000,18,7,2014,0,55,4130,6150,0,1,1
2,1.0,1150,11250,1.0,0,0,3,6,1150,0,1920,0,98178,47.486,-122.264,1100,11400,254500,23,3,2015,0,95,10100,10300,0,0,1
2,1.0,980,3663,1.0,0,0,5,7,980,0,1909,0,98105,47.6645,-122.288,1620,3706,575000,14,4,2015,0,106,2683,2086,0,0,1
3,1.5,1690,10500,1.0,0,0,4,7,1690,0,1967,0,98033,47.7018,-122.165,1570,10500,464550,21,1,2015,0,48,8810,8930,0,0,0
3,1.75,1320,6030,1.0,0,0,4,7,1320,0,1969,0,98052,47.6993,-122.13,1840,6565,409950,15,7,2014,0,45,4710,4725,0,0,0
2,1.5,820,1270,2.0,0,0,3,7,820,0,2009,0,98144,47.5925,-122.295,1130,1201,365000,2,3,2015,0,6,450,71,0,0,1
3,1.0,1300,7420,1.0,0,0,4,6,1300,0,1960,0,98002,47.2899,-122.219,1250,7420,208000,9,2,2015,0,55,6120,6170,0,0,0
4,2.5,1950,3000,2.0,0,0,3,7,1550,400,1998,0,98118,47.565,-122.281,1540,4300,497950,10,11,2014,0,16,1050,2760,0,1,1
5,3.5,3672,9742,2.0,0,0,3,9,3006,666,2006,0,98092,47.3255,-122.192,2140,9118,405000,10,9,2014,0,8,6070,6978,0,1,0
2,1.0,890,6000,1.0,0,0,3,6,890,0,1941,0,98118,47.5437,-122.281,1090,5900,334000,11,5,2015,0,74,5110,4810,0,0,1
3,2.0,1090,8400,1.0,0,0,4,6,1090,0,1961,0,98168,47.4942,-122.322,1100,10850,235000,15,1,2015,0,54,7310,9750,0,0,1
2,1.0,1170,10621,1.0,0,0,3,7,1170,0,1963,0,98045,47.497,-121.78,1340,9832,295000,3,6,2014,0,51,9451,8492,0,0,0
4,1.75,2000,6032,1.0,0,2,3,7,1300,700,1959,0,98146,47.5132,-122.389,1930,6032,453500,5,6,2014,0,55,4032,4102,0,1,1
4,3.75,3520,3944,1.5,0,0,5,8,2200,1320,1913,0,98109,47.6424,-122.348,2310,4725,1220000,23,6,2014,0,101,424,2415,0,1,1
2,1.0,1410,7000,1.0,0,0,3,7,1410,0,1968,0,98055,47.4908,-122.223,1540,6000,175000,28,1,2015,0,47,5590,4460,0,0,0
2,1.0,1410,7000,1.0,0,0,3,7,1410,0,1968,0,98055,47.4908,-122.223,1540,6000,335000,28,4,2015,0,47,5590,4460,0,0,0
3,1.5,1950,7620,1.0,0,0,4,7,1010,940,1956,0,98166,47.4594,-122.346,1850,7620,275000,4,9,2014,0,58,5670,5770,0,1,1
2,1.0,980,2130,1.0,0,0,4,6,860,120,1918,0,98117,47.6769,-122.366,980,2800,400000,14,5,2014,0,96,1150,1820,0,1,1
3,2.75,3390,7000,1.0,0,3,4,8,1740,1650,1979,0,98116,47.5701,-122.408,1770,6500,915000,18,7,2014,0,35,3610,4730,0,1,1
4,2.5,2270,9247,1.0,0,0,5,8,1500,770,1972,0,98006,47.5602,-122.176,2270,9163,619850,19,6,2014,0,42,6977,6893,0,1,0
3,1.0,1510,8800,1.0,0,0,4,7,1010,500,1963,0,98003,47.329,-122.33,1290,8470,225900,2,2,2015,0,52,7290,7180,0,1,0
2,1.5,960,7200,1.0,0,0,3,7,960,0,1910,1987,98199,47.649,-122.403,1550,6000,525000,18,9,2014,77,104,6240,4450,1,0,1
4,2.25,1900,9600,1.0,0,0,4,7,1900,0,1967,0,98031,47.4208,-122.2,2040,9600,215000,26,12,2014,0,47,7700,7560,0,0,0
3,2.5,2580,13096,2.0,0,0,3,9,2580,0,1986,0,98052,47.6616,-122.144,2580,7988,802000,14,5,2014,0,28,10516,5408,0,0,0
4,2.5,2340,11784,2.0,0,0,3,9,2340,0,1997,0,98042,47.384,-122.149,2250,10760,330000,30,6,2014,0,17,9444,8510,0,0,0
3,2.25,1580,11680,1.0,0,0,4,7,1580,0,1958,0,98005,47.5872,-122.17,2270,10948,549800,1,8,2014,0,56,10100,8678,0,0,0
4,1.0,1230,8636,1.5,0,0,4,6,1230,0,1954,0,98002,47.3231,-122.219,1168,8316,195500,24,10,2014,0,60,7406,7148,0,0,0
3,2.5,1590,7819,2.0,0,0,3,7,1590,0,1992,0,98055,47.4367,-122.199,1790,7733,338000,18,8,2014,0,22,6229,5943,0,0,0
4,2.25,1770,7000,1.0,0,0,5,7,1770,0,1972,0,98034,47.7193,-122.218,1780,6500,480000,20,8,2014,0,42,5230,4720,0,0,0
4,2.5,1850,8310,1.0,0,0,3,7,1200,650,1962,0,98155,47.7717,-122.29,1840,10080,383000,6,4,2015,0,53,6460,8240,0,1,1
3,1.75,1430,7210,1.0,0,0,3,7,1430,0,1975,0,98031,47.4189,-122.168,1220,7777,257000,31,3,2015,0,40,5780,6557,0,0,0
4,2.75,2190,9209,2.0,0,0,4,8,2190,0,1996,0,98092,47.3341,-122.188,2430,6687,335000,23,2,2015,0,19,7019,4257,0,0,0
4,2.5,2310,6650,2.0,0,2,3,8,2310,0,2012,0,98166,47.4513,-122.267,1800,9819,422000,8,5,2015,0,3,4340,8019,0,0,1
3,1.75,2000,10182,1.0,0,0,5,7,1400,600,1963,0,98033,47.6616,-122.175,2050,10182,560000,3,6,2014,0,51,8182,8132,0,1,0
2,1.0,1210,7040,1.0,0,0,3,7,1210,0,1952,0,98155,47.745,-122.297,1210,7205,320000,28,10,2014,0,62,5830,5995,0,0,1
3,2.5,2840,6854,2.0,0,0,3,9,2840,0,2002,0,98075,47.6006,-121.978,2840,7398,751000,26,3,2015,0,13,4014,4558,0,0,0
6,2.75,2410,10763,1.0,0,0,5,7,1310,1100,1957,0,98188,47.4429,-122.282,1310,10746,320000,13,11,2014,0,57,8353,9436,0,1,1
4,2.0,1470,7412,1.0,0,0,3,7,1470,0,1967,0,98198,47.3702,-122.318,1390,7825,250000,30,10,2014,0,47,5942,6435,0,0,1
3,1.75,1100,10005,1.0,0,0,5,7,1100,0,1964,0,98056,47.5374,-122.173,1340,9709,423000,15,4,2015,0,51,8905,8369,0,0,0
4,2.5,2050,8094,1.0,0,0,3,8,1050,1000,1976,0,98052,47.6614,-122.138,1990,9020,601002,6,5,2015,0,39,6044,7030,0,1,0
2,1.5,1240,1892,2.0,0,0,3,7,1240,0,2002,0,98144,47.5915,-122.295,1220,1740,352900,5,2,2015,0,13,652,520,0,0,1
2,1.75,1340,1050,3.0,0,0,3,8,1340,0,2009,0,98133,47.7053,-122.343,1340,1090,360000,5,2,2015,0,6,-290,-250,0,0,1
4,2.75,2580,8100,2.0,0,1,4,8,1780,800,1964,0,98040,47.5387,-122.215,2840,10006,1080000,10,11,2014,0,50,5520,7166,0,1,0
3,2.5,2390,6441,2.0,0,0,3,7,2390,0,2002,0,98038,47.3659,-122.029,2180,7346,349950,31,7,2014,0,12,4051,5166,0,0,0
4,2.5,2250,6840,2.0,0,0,3,9,2250,0,1987,0,98058,47.4398,-122.151,2480,7386,395000,26,11,2014,0,27,4590,4906,0,0,0
4,1.75,1870,6000,1.0,0,0,5,8,1670,200,1949,0,98199,47.6435,-122.399,1710,6000,700000,14,4,2015,0,66,4130,4290,0,1,1
3,2.5,2370,10968,2.0,0,0,4,9,2370,0,1985,0,98033,47.6679,-122.172,2380,8144,699000,17,4,2015,0,30,8598,5764,0,0,0
4,2.25,2640,8800,1.0,0,0,3,8,1620,1020,1980,0,98072,47.7552,-122.148,2500,11700,537000,16,4,2015,0,35,6160,9200,0,1,0
3,1.5,1240,9975,1.0,0,0,3,6,1240,0,1977,0,98024,47.5667,-121.905,1390,10735,405000,29,4,2015,0,38,8735,9345,0,0,0
2,1.0,800,1200,2.0,0,0,3,7,800,0,1999,0,98103,47.6969,-122.347,806,1200,269500,4,8,2014,0,15,400,394,0,0,1
4,2.5,2050,12500,1.0,0,0,3,7,1300,750,1965,0,98198,47.42,-122.319,1790,7900,260000,25,9,2014,0,49,10450,6110,0,1,1
3,2.25,1650,10000,2.0,0,0,3,7,1650,0,1988,0,98198,47.3862,-122.315,1420,10000,266750,4,9,2014,0,26,8350,8580,0,0,1
2,2.25,2130,5920,1.0,0,0,3,8,1830,300,1950,0,98115,47.6792,-122.275,2130,7192,779000,21,8,2014,0,64,3790,5062,0,1,1
2,1.0,1560,5000,1.5,0,1,4,7,1560,0,1942,0,98117,47.7006,-122.386,2620,5400,724000,6,9,2014,0,72,3440,2780,0,0,1
4,2.5,1450,3600,1.5,0,0,3,7,1250,200,1902,0,98144,47.5985,-122.298,1680,3600,431000,24,7,2014,0,112,2150,1920,0,1,1
4,2.5,2670,8279,2.0,0,0,3,7,2670,0,1999,0,98148,47.4292,-122.328,2290,7504,415000,16,4,2015,0,16,5609,5214,0,0,1
7,3.75,2310,5000,2.0,0,0,3,8,2310,0,1984,0,98117,47.6781,-122.376,1360,1552,727160,14,8,2014,0,30,2690,192,0,0,1
2,1.75,1090,3272,1.0,0,0,5,8,1090,0,1970,0,98198,47.3794,-122.32,1160,5475,265000,14,1,2015,0,45,2182,4315,0,0,1
3,1.75,2000,5680,1.0,0,0,4,7,1080,920,1903,0,98117,47.6805,-122.366,1230,4535,519000,2,2,2015,0,112,3680,3305,0,1,1
4,1.5,1840,9009,2.0,0,0,3,7,1840,0,1965,0,98198,47.406,-122.318,1390,8025,262000,12,1,2015,0,50,7169,6635,0,0,1
4,2.5,3160,13194,2.0,0,0,5,10,3160,0,1965,0,98040,47.5472,-122.233,3490,13194,1190000,23,6,2014,0,49,10034,9704,0,0,0
3,1.75,1520,6559,1.0,0,0,4,7,1170,350,1992,0,98038,47.35,-122.037,1520,6095,295000,7,5,2015,0,23,5039,4575,0,1,0
4,2.75,3410,7750,1.0,0,4,5,8,1710,1700,1958,0,98116,47.5718,-122.406,3080,8525,1100000,5,9,2014,0,56,4340,5445,0,1,1
4,2.5,2630,6247,2.0,0,0,3,8,2630,0,1992,0,98029,47.5662,-122.0,2130,4668,575000,26,9,2014,0,22,3617,2538,0,0,0
3,1.75,1350,2325,3.0,0,0,3,7,1350,0,1999,0,98103,47.6965,-122.35,1520,1652,388000,7,4,2015,0,16,975,132,0,0,1
4,2.5,2860,9159,1.0,0,0,4,8,1530,1330,1989,0,98033,47.6923,-122.2,2070,8680,750500,3,11,2014,0,25,6299,6610,0,1,0
4,3.5,3500,4000,2.0,0,0,3,10,2560,940,2000,0,98112,47.628,-122.299,1910,4000,1050000,4,11,2014,0,14,500,2090,0,1,1
2,1.0,800,7260,1.0,0,0,3,7,800,0,1953,0,98126,47.5359,-122.367,1010,7440,325000,8,7,2014,0,61,6460,6430,0,0,1
3,1.75,1580,6127,1.5,0,0,5,7,1580,0,1947,0,98125,47.7192,-122.32,1500,6128,402000,25,8,2014,0,67,4547,4628,0,0,1
3,1.5,1560,6774,1.0,0,0,4,6,1060,500,1927,0,98133,47.7024,-122.35,1320,3844,370000,24,9,2014,0,87,5214,2524,0,1,1
3,1.0,1750,7800,1.0,0,0,4,7,1150,600,1956,0,98166,47.4596,-122.343,1750,7560,329950,26,6,2014,0,58,6050,5810,0,1,1
2,1.0,600,6120,1.0,0,0,3,5,600,0,1943,1989,98168,47.5,-122.317,1090,6120,135000,12,5,2015,46,72,5520,5030,1,0,1
4,3.0,1630,7626,1.0,0,0,5,7,1110,520,1990,0,98125,47.7168,-122.308,1630,8082,482500,20,6,2014,0,24,5996,6452,0,1,1
4,1.5,1260,7248,1.5,0,0,5,7,1260,0,1955,0,98188,47.433,-122.292,1300,7732,259000,23,9,2014,0,59,5988,6432,0,0,1
3,2.25,2140,9775,1.0,0,0,4,7,1470,670,1978,0,98023,47.306,-122.379,2050,8625,210000,27,10,2014,0,36,7635,6575,0,1,0
4,2.75,2790,6600,2.0,0,0,3,9,2790,0,2000,0,98058,47.4362,-122.109,2900,6752,459000,9,10,2014,0,14,3810,3852,0,0,0
3,2.25,1330,7200,1.0,0,0,3,7,900,430,1974,0,98146,47.5102,-122.364,1380,9570,295000,22,10,2014,0,40,5870,8190,0,1,1
3,2.0,2700,6120,1.0,0,0,4,8,1350,1350,1962,0,98115,47.6731,-122.327,1700,4590,910000,12,5,2014,0,52,3420,2890,0,1,1
4,2.0,2070,7980,1.5,0,0,4,7,2070,0,1940,0,98146,47.5092,-122.386,1600,7980,565000,20,2,2015,0,75,5910,6380,0,0,1
4,2.25,2670,9040,1.0,0,0,3,8,2170,500,1955,0,98148,47.4666,-122.326,1880,2648,339950,7,11,2014,0,59,6370,768,0,1,1
2,1.0,810,8382,1.0,0,0,4,5,810,0,1942,0,98146,47.5033,-122.358,1040,8382,125000,24,9,2014,0,72,7572,7342,0,0,1
4,4.75,3970,9778,2.0,0,2,4,11,3390,580,1928,0,98119,47.6312,-122.366,3970,8460,2300000,1,7,2014,0,86,5808,4490,0,1,1
3,2.5,2370,7500,1.0,0,3,3,8,1620,750,1979,0,98198,47.4091,-122.331,1960,8062,348000,30,4,2015,0,36,5130,6102,0,1,1
3,1.0,1460,11880,1.0,0,0,2,7,1460,0,1961,0,98030,47.3762,-122.219,1310,9315,175000,14,4,2015,0,54,10420,8005,0,0,0
3,2.5,1770,2875,2.0,0,0,3,8,1770,0,1990,0,98116,47.5631,-122.397,1770,3833,439950,2,5,2014,0,24,1105,2063,0,0,1
3,2.5,1520,2550,2.0,0,0,3,7,1520,0,2005,0,98108,47.5245,-122.33,1460,2550,207000,2,9,2014,0,9,1030,1090,0,0,1
4,1.5,1320,14250,1.0,0,0,4,7,1320,0,1954,0,98033,47.7016,-122.199,1720,14250,510000,6,6,2014,0,60,12930,12530,0,0,0
4,1.0,1870,4992,1.5,0,0,4,7,1670,200,1940,0,98199,47.6437,-122.396,2160,5239,730000,31,10,2014,0,74,3122,3079,0,1,1
3,3.75,2460,7630,1.0,0,0,5,8,1940,520,1976,0,98177,47.7147,-122.373,2000,7326,750000,13,8,2014,0,38,5170,5326,0,1,1
3,1.5,960,7400,1.0,0,0,3,7,960,0,1962,0,98198,47.3798,-122.306,1640,8060,237000,10,4,2015,0,53,6440,6420,0,0,1
3,2.75,3010,12432,1.0,0,0,4,8,1890,1120,1970,0,98052,47.6392,-122.108,2500,12432,745000,14,7,2014,0,44,9422,9932,0,1,0
3,2.25,1990,6350,2.0,0,0,3,7,1990,0,1967,0,98198,47.3822,-122.316,1220,6250,180000,18,6,2014,0,47,4360,5030,0,0,1
3,2.25,1990,6350,2.0,0,0,3,7,1990,0,1967,0,98198,47.3822,-122.316,1220,6250,309950,13,11,2014,0,47,4360,5030,0,0,1
4,1.0,1710,6050,1.5,0,0,3,7,1410,300,1913,0,98118,47.5569,-122.288,1560,4950,715000,6,5,2015,0,102,4340,3390,0,1,1
4,2.25,1890,4300,1.5,0,0,3,7,1350,540,1918,0,98103,47.6649,-122.337,1830,3800,620000,27,4,2015,0,97,2410,1970,0,1,1
3,2.5,1990,9995,2.0,0,0,3,7,1990,0,1996,0,98198,47.383,-122.305,1680,7511,330000,31,12,2014,0,18,8005,5831,0,0,1
4,1.75,1600,7400,1.0,0,0,3,7,1210,390,1973,0,98125,47.7111,-122.309,1640,7500,525000,1,4,2015,0,42,5800,5860,0,1,1
4,2.5,2210,8465,1.0,0,0,3,8,1490,720,1990,0,98092,47.2647,-122.221,2210,7917,294000,12,6,2014,0,24,6255,5707,0,1,0
3,1.75,2020,11095,1.0,0,0,4,7,1480,540,1975,0,98034,47.7351,-122.183,2030,10710,463000,21,4,2015,0,40,9075,8680,0,1,0
3,2.0,1770,7251,1.0,0,0,4,8,1770,0,1990,0,98031,47.4087,-122.17,2560,7210,320900,14,7,2014,0,24,5481,4650,0,0,0
4,2.5,2050,4502,2.0,0,0,3,7,2050,0,2005,0,98059,47.5002,-122.15,2480,4504,369950,28,10,2014,0,9,2452,2024,0,0,0
4,1.5,3520,4933,1.5,0,0,4,8,2270,1250,1929,0,98108,47.5655,-122.315,1710,5400,589500,11,3,2015,0,86,1413,3690,0,1,1
4,1.75,1810,9750,2.0,0,0,4,7,1810,0,1977,0,98155,47.7681,-122.311,1570,10000,400000,12,8,2014,0,37,7940,8430,0,0,1
3,2.25,2150,9900,1.0,0,0,3,8,1450,700,1977,0,98052,47.6647,-122.149,2170,9500,458000,22,10,2014,0,37,7750,7330,0,1,0
4,2.5,2495,5751,2.0,0,0,3,7,2495,0,2002,0,98019,47.7243,-121.957,2490,6300,436000,2,12,2014,0,12,3256,3810,0,0,0
3,2.0,1290,6150,1.0,0,1,5,6,1290,0,1950,0,98118,47.5181,-122.257,1960,6150,310000,2,10,2014,0,64,4860,4190,0,0,1
5,2.5,3004,5700,2.0,0,0,3,9,3004,0,2006,0,98030,47.3801,-122.185,2665,5700,398000,23,10,2014,0,8,2696,3035,0,0,0
4,2.25,2070,7200,1.0,0,0,5,8,1390,680,1977,0,98033,47.697,-122.169,2110,8400,625000,15,8,2014,0,37,5130,6290,0,1,0
2,1.0,960,6250,1.0,0,0,4,6,740,220,1940,0,98126,47.5378,-122.375,1090,6000,435000,13,4,2015,0,75,5290,4910,0,1,1
3,2.25,1900,9990,1.0,0,0,3,7,1300,600,1961,0,98003,47.3478,-122.298,1900,9990,250000,13,3,2015,0,54,8090,8090,0,1,0
3,1.5,1450,7316,1.0,0,0,3,7,1450,0,1961,0,98133,47.7725,-122.349,1440,7316,430000,17,3,2015,0,54,5866,5876,0,0,1
4,3.5,2720,3000,2.0,0,0,3,9,2250,470,2014,0,98136,47.5371,-122.388,1600,4600,790000,12,8,2014,0,0,280,3000,0,1,1
5,5.25,4830,18707,2.0,0,1,5,9,3930,900,1952,1998,98040,47.5858,-122.247,2880,10520,1680000,9,7,2014,46,62,13877,7640,1,1,0
4,2.75,1920,7102,1.0,0,0,3,7,1130,790,1992,0,98106,47.539,-122.356,1830,6440,250000,7,4,2015,0,23,5182,4610,0,1,1
5,1.5,2540,6660,2.0,0,3,4,8,2340,200,1954,0,98136,47.5144,-122.393,2460,9000,1120000,13,6,2014,0,60,4120,6540,0,1,1
3,1.5,1600,8040,1.0,0,0,4,7,1050,550,1965,0,98133,47.7471,-122.337,1810,7819,383900,27,4,2015,0,50,6440,6009,0,1,1
4,2.5,2210,5929,2.0,0,0,3,8,2210,0,2004,0,98042,47.35,-122.139,2200,5901,330000,26,3,2015,0,11,3719,3701,0,0,0
5,2.0,2280,5750,1.0,0,0,4,8,1140,1140,1951,0,98116,47.5672,-122.39,1780,5750,383000,11,2,2015,0,64,3470,3970,0,1,1
4,3.25,3160,8876,2.0,0,0,3,9,2460,700,1997,0,98056,47.5153,-122.178,2900,10000,558000,9,3,2015,0,18,5716,7100,0,1,0
3,2.0,1380,3500,2.0,0,0,3,7,1380,0,1971,0,98118,47.5558,-122.27,1620,3900,275000,5,9,2014,0,43,2120,2280,0,0,1
5,2.75,3320,10500,1.0,0,0,4,7,2020,1300,1963,0,98033,47.692,-122.166,1840,10425,687500,28,7,2014,0,51,7180,8585,0,1,0
3,2.5,1870,6821,2.0,0,0,3,7,1870,0,1989,0,98023,47.3065,-122.358,1970,6821,275000,28,7,2014,0,25,4951,4851,0,0,0
3,3.5,3030,11550,2.0,0,2,3,8,3030,0,1971,2011,98146,47.5051,-122.381,2340,10560,700000,11,12,2014,40,43,8520,8220,1,0,1
2,1.75,1210,7507,1.0,0,0,3,7,1210,0,1982,0,98034,47.7078,-122.234,1840,7500,342500,24,6,2014,0,32,6297,5660,0,0,0
3,1.75,1350,7370,1.0,0,0,4,6,1350,0,1912,0,98118,47.5336,-122.278,1440,6000,190000,1,8,2014,0,102,6020,4560,0,0,1
3,1.75,1350,7370,1.0,0,0,4,6,1350,0,1912,0,98118,47.5336,-122.278,1440,6000,300000,18,3,2015,0,103,6020,4560,0,0,1
3,2.0,1470,1691,2.0,0,0,3,8,1000,470,2007,0,98115,47.6743,-122.316,1660,4000,540000,21,5,2014,0,7,221,2340,0,1,1
3,1.75,1270,8991,2.0,0,0,3,7,1270,0,1981,0,98042,47.3563,-122.149,1270,8993,140000,11,2,2015,0,34,7721,7723,0,0,0
3,2.75,2120,7650,1.0,0,0,4,7,2120,0,1958,0,98056,47.4923,-122.178,1180,7650,370000,25,8,2014,0,56,5530,6470,0,0,0
2,1.0,1040,9100,1.0,0,0,4,7,1040,0,1937,0,98133,47.7407,-122.347,1950,13228,227000,25,3,2015,0,78,8060,11278,0,0,1
4,1.0,1730,8706,1.0,0,0,4,7,1010,720,1962,0,98058,47.4586,-122.175,1369,8418,312000,28,1,2015,0,53,6976,7049,0,1,0
2,1.0,1410,5650,1.5,0,0,3,6,1410,0,1918,0,98118,47.5159,-122.258,1430,5650,260000,3,10,2014,0,96,4240,4220,0,0,1
3,2.5,1370,1911,2.0,0,0,3,9,1370,0,1907,2011,98109,47.6375,-122.354,1630,2090,797000,10,7,2014,104,107,541,460,1,0,1
3,2.25,2070,7995,1.0,0,0,3,7,1350,720,1987,0,98031,47.403,-122.175,1620,6799,329950,2,3,2015,0,28,5925,5179,0,1,0
3,2.25,1470,7518,1.0,0,0,3,7,1160,310,1985,0,98003,47.2725,-122.3,1720,8300,220000,13,8,2014,0,29,6048,6580,0,1,0
4,2.25,2430,4748,1.5,0,0,3,8,1630,800,1928,0,98116,47.5904,-122.389,2430,4748,723000,2,7,2014,0,86,2318,2318,0,1,1
3,1.75,1430,8412,1.0,0,0,4,7,1070,360,1928,0,98125,47.7218,-122.299,1490,8410,375000,16,1,2015,0,87,6982,6920,0,1,1
3,1.75,1760,9277,1.0,0,0,4,7,1760,0,1962,0,98146,47.4977,-122.358,1760,7650,388000,26,1,2015,0,53,7517,5890,0,0,1
5,2.0,1730,7375,1.0,0,0,4,6,1730,0,1944,0,98178,47.4953,-122.238,1550,7125,249950,31,10,2014,0,70,5645,5575,0,0,1
5,1.75,2290,7900,1.0,0,0,4,7,1190,1100,1965,0,98133,47.7577,-122.358,1870,8250,390000,6,11,2014,0,49,5610,6380,0,1,1
4,1.75,1690,11739,1.0,0,0,4,8,1690,0,1959,0,98040,47.552,-122.219,2300,11600,705000,17,9,2014,0,55,10049,9300,0,0,0
4,2.5,3220,7875,1.5,0,0,4,8,3220,0,1966,0,98008,47.626,-122.12,1600,7875,590000,23,6,2014,0,48,4655,6275,0,0,0
4,1.75,2130,11097,1.0,0,0,3,7,1370,760,1952,0,98166,47.4629,-122.356,1850,11097,292000,10,10,2014,0,62,8967,9247,0,1,1
4,2.5,2770,8642,2.0,0,0,4,9,2770,0,1987,0,98007,47.6599,-122.146,2670,9000,907500,4,6,2014,0,27,5872,6330,0,0,0
4,2.75,2500,5100,1.5,0,0,4,7,1420,1080,1907,0,98108,47.523,-122.332,1430,5100,319500,14,10,2014,0,107,2600,3670,0,1,1
5,1.75,1580,5292,1.0,0,0,3,6,980,600,1913,0,98118,47.5677,-122.29,1600,2976,265000,23,2,2015,0,102,3712,1376,0,1,1
3,1.0,1130,10650,1.0,0,0,3,7,1130,0,1954,0,98188,47.4363,-122.286,1320,10650,237000,5,6,2014,0,60,9520,9330,0,0,1
5,1.0,1500,9282,1.5,0,0,5,6,1500,0,1966,0,98168,47.4702,-122.281,1520,9639,235000,10,9,2014,0,48,7782,8119,0,0,1
4,2.25,2230,6000,1.5,0,2,3,8,1810,420,1928,0,98199,47.6464,-122.391,2840,6000,740000,30,3,2015,0,87,3770,3160,0,1,1
3,1.5,1550,4980,1.0,0,0,3,7,1080,470,1978,0,98133,47.7035,-122.34,940,4980,359000,9,7,2014,0,36,3430,4040,0,1,1
4,2.5,2230,5500,2.0,0,0,3,7,2230,0,1999,0,98038,47.3533,-122.023,1910,5500,334950,13,2,2015,0,16,3270,3590,0,0,0
2,1.0,790,8100,1.0,0,0,3,6,790,0,1947,0,98125,47.7159,-122.305,1420,8100,259950,29,9,2014,0,67,7310,6680,0,0,1
4,2.5,2230,4541,2.0,0,0,3,7,2230,0,2006,0,98042,47.3848,-122.1,2800,4860,253000,14,5,2014,0,8,2311,2060,0,0,0
3,2.25,1710,4140,2.0,0,0,3,8,1710,0,2004,0,98029,47.5498,-121.997,1730,3680,561000,12,6,2014,0,10,2430,1950,0,0,0
2,1.5,1260,5100,1.0,0,0,3,7,1260,0,1941,0,98115,47.6914,-122.288,1640,5100,455000,25,3,2015,0,74,3840,3460,0,0,1
4,2.5,2420,18470,1.0,0,0,3,8,920,1500,1968,0,98005,47.6001,-122.176,2690,13800,675000,6,4,2015,0,47,16050,11110,0,1,0
3,1.5,1090,8160,1.0,0,0,3,7,1090,0,1967,2014,98058,47.4551,-122.175,1260,7560,267000,26,6,2014,47,47,7070,6300,1,0,0
4,2.5,2689,5724,2.0,0,0,3,9,2689,0,2006,0,98030,47.3799,-122.184,2665,5700,368000,6,11,2014,0,8,3035,3035,0,0,0
3,1.0,1620,3000,1.5,0,0,5,7,1620,0,1928,0,98103,47.6888,-122.347,1420,3060,599995,23,11,2014,0,86,1380,1640,0,0,1
3,1.0,940,10500,1.0,0,0,4,7,940,0,1966,0,98034,47.7268,-122.229,1660,10500,342500,17,9,2014,0,48,9560,8840,0,0,0
4,1.75,1940,13370,1.0,0,0,4,8,1940,0,1974,0,98023,47.3215,-122.369,2405,11769,252000,18,11,2014,0,40,11430,9364,0,0,0
3,1.0,1590,11200,1.0,0,0,4,7,1590,0,1961,0,98092,47.2894,-122.188,1560,9750,247200,16,7,2014,0,53,9610,8190,0,0,0
3,3.5,3020,4082,2.0,0,0,3,9,2080,940,1954,2004,98199,47.651,-122.409,2060,5102,910000,6,5,2014,50,60,1062,3042,1,1,1
4,1.75,1870,16549,1.0,0,0,3,8,1870,0,1969,0,98072,47.7482,-122.083,1870,10804,419950,5,1,2015,0,46,14679,8934,0,0,0
3,1.0,880,8976,1.0,0,0,4,6,880,0,1966,0,98023,47.3056,-122.368,990,8760,160000,26,2,2015,0,49,8096,7770,0,0,0
4,3.5,3030,5494,3.0,0,0,3,9,3030,0,2014,0,98052,47.7103,-122.109,2910,5314,799950,22,9,2014,0,0,2464,2404,0,0,0
3,2.25,2140,11266,2.0,0,0,3,7,2140,0,1986,0,98019,47.7267,-121.966,2000,14174,400000,17,6,2014,0,28,9126,12174,0,0,0
5,2.0,2050,10200,1.0,0,0,3,6,1430,620,1956,0,98198,47.4136,-122.333,1940,8625,210000,5,5,2014,0,58,8150,6685,0,1,1
5,2.0,2050,10200,1.0,0,0,3,6,1430,620,1956,0,98198,47.4136,-122.333,1940,8625,475000,13,3,2015,0,59,8150,6685,0,1,1
3,2.5,2090,3821,2.0,0,0,3,7,2090,0,2008,0,98038,47.3655,-122.017,2040,4200,355900,4,5,2015,0,7,1731,2160,0,0,0
4,2.5,2630,8580,1.0,0,0,4,9,1700,930,1977,0,98005,47.5916,-122.166,2430,10240,710000,25,8,2014,0,37,5950,7810,0,1,0
4,1.75,2560,15000,1.0,0,0,3,7,1880,680,1974,0,98075,47.5952,-122.053,2210,15150,518000,7,4,2015,0,41,12440,12940,0,1,0
3,1.0,1200,5404,1.0,0,0,3,6,1200,0,1937,0,98117,47.6969,-122.368,1200,5987,375000,16,10,2014,0,77,4204,4787,0,0,1
3,1.5,1010,7755,1.0,0,0,3,6,1010,0,1953,0,98148,47.4238,-122.332,1270,8350,185000,7,11,2014,0,61,6745,7080,0,0,1
3,2.5,1520,3425,2.0,0,0,3,7,1520,0,1986,0,98052,47.6801,-122.161,1640,3425,402000,29,8,2014,0,28,1905,1785,0,0,0
4,2.0,1980,4500,2.0,0,0,4,7,1980,0,1910,0,98107,47.6728,-122.379,1550,2541,500000,22,1,2015,0,105,2520,991,0,0,1
4,2.5,3070,7207,2.0,0,0,4,10,2670,400,1927,0,98112,47.6325,-122.29,3190,7523,1720000,23,12,2014,0,87,4137,4333,0,1,1
5,3.5,5170,7197,3.0,1,4,3,11,3520,1650,1998,0,98155,47.7561,-122.271,3020,12880,1680000,1,10,2014,0,16,2027,9860,0,1,1
2,2.0,1140,690,2.0,0,0,3,8,760,380,2014,0,98112,47.6205,-122.3,1480,1171,570000,12,2,2015,0,1,-450,-309,0,1,1
8,2.75,2530,4800,2.0,0,0,4,7,1390,1140,1901,0,98112,47.6241,-122.305,1540,4800,680000,14,8,2014,0,113,2270,3260,0,1,1
3,2.25,1690,14615,2.0,0,0,4,7,1690,0,1979,0,98045,47.4492,-121.78,1390,11360,345000,9,12,2014,0,35,12925,9970,0,0,0
4,2.5,2150,3600,2.0,0,0,3,7,2150,0,2010,0,98038,47.3658,-122.019,2220,3915,355000,22,4,2015,0,5,1450,1695,0,0,0
3,1.5,1180,7700,1.0,0,0,4,7,1180,0,1959,0,98007,47.6133,-122.133,1510,8800,390000,22,9,2014,0,55,6520,7290,0,0,0
3,1.0,1400,9690,1.0,0,0,3,7,1400,0,1969,0,98023,47.3201,-122.398,1280,9600,128000,28,4,2015,0,46,8290,8320,0,0,0
3,1.75,1300,4800,2.0,0,1,4,7,1300,0,1912,0,98136,47.5457,-122.383,1300,4800,448500,26,8,2014,0,102,3500,3500,0,0,1
3,1.75,1590,9636,1.5,0,0,4,6,1590,0,1953,0,98155,47.754,-122.321,1800,9975,346000,9,11,2014,0,61,8046,8175,0,0,1
3,1.75,1990,5600,1.0,0,1,3,8,1330,660,1941,0,98199,47.65,-122.415,2630,6780,779000,3,9,2014,0,73,3610,4150,0,1,1
3,1.75,1510,9720,1.0,0,0,3,7,1510,0,1948,1976,98028,47.7728,-122.258,1520,10037,335000,3,2,2015,28,67,8210,8517,1,0,0
4,3.25,2910,1880,2.0,0,3,5,9,1830,1080,1914,0,98122,47.616,-122.282,3100,8200,1850000,11,9,2014,0,100,-1030,5100,0,1,1
2,1.5,1110,1189,3.0,0,0,3,8,1110,0,2000,0,98107,47.6711,-122.377,1420,1311,371000,22,8,2014,0,14,79,-109,0,0,1
4,2.5,1900,9775,1.0,0,0,5,7,1900,0,1967,0,98033,47.6856,-122.168,1990,10500,620000,27,10,2014,0,47,7875,8510,0,0,0
4,1.75,2290,10290,1.0,0,0,3,7,1340,950,1960,0,98146,47.5045,-122.369,1800,7605,343000,15,5,2014,0,54,8000,5805,0,1,1
3,1.0,1010,14948,1.0,0,0,5,6,1010,0,1969,0,98059,47.4772,-122.144,1510,9600,265000,14,10,2014,0,45,13938,8090,0,0,0
5,2.5,4670,15857,2.0,0,0,3,11,4670,0,1998,0,98074,47.63,-122.011,3810,14824,1000000,4,8,2014,0,16,11187,11014,0,0,0
4,3.5,4070,10976,2.0,0,0,3,10,4070,0,2004,0,98075,47.5805,-121.97,4080,10106,889000,14,4,2015,0,11,6906,6026,0,0,0
3,2.25,1630,10962,1.0,0,0,4,8,1100,530,1977,0,98030,47.3801,-122.166,1830,8470,305000,15,4,2015,0,38,9332,6640,0,1,0
2,2.5,1700,6635,2.0,0,0,4,8,1700,0,1976,0,98052,47.6655,-122.13,1700,6635,407000,30,10,2014,0,38,4935,4935,0,0,0
5,2.5,2070,12000,1.0,0,0,4,7,1340,730,1967,0,98008,47.626,-122.104,2090,12000,613000,3,6,2014,0,47,9930,9910,0,1,0
3,3.75,2050,6000,2.0,0,0,5,7,1550,500,1910,0,98103,47.6873,-122.332,1780,4000,645000,10,2,2015,0,105,3950,2220,0,1,1
4,3.5,4680,9700,2.0,0,0,3,10,3360,1320,2005,0,98006,47.5703,-122.165,2800,12343,1160000,18,6,2014,0,9,5020,9543,0,1,0
3,2.5,3800,13071,2.0,0,0,3,10,2730,1070,1994,0,98023,47.3076,-122.397,2980,11110,450000,18,3,2015,0,21,9271,8130,0,1,0
3,2.0,720,7598,1.0,0,0,5,6,720,0,1947,0,98106,47.5483,-122.36,1080,7209,300000,28,7,2014,0,67,6878,6129,0,0,1
3,2.5,1650,2802,2.0,0,0,3,7,1650,0,2004,0,98055,47.4328,-122.196,1490,2084,250000,28,8,2014,0,10,1152,594,0,0,0
4,3.0,3720,15048,3.0,0,0,3,7,3720,0,1979,2014,98059,47.5116,-122.144,2020,15180,500000,30,6,2014,35,35,11328,13160,1,0,0
3,2.5,1620,7320,2.0,0,0,3,7,1620,0,1989,0,98038,47.3617,-122.054,1550,7686,276900,28,1,2015,0,26,5700,6136,0,0,0
3,2.25,1700,12615,1.0,0,0,4,7,1300,400,1990,0,98033,47.6965,-122.197,1950,13163,660000,18,3,2015,0,25,10915,11213,0,1,0
3,1.75,1610,10796,1.0,0,0,3,7,1070,540,1951,0,98004,47.6272,-122.208,1940,10796,925000,8,4,2015,0,64,9186,8856,0,1,0
2,1.0,1210,7440,1.0,0,0,3,6,780,430,1940,0,98155,47.7376,-122.322,1070,7440,326000,18,3,2015,0,75,6230,6370,0,1,1
3,1.0,1300,9880,1.0,0,0,4,7,1300,0,1959,0,98003,47.3352,-122.297,2140,9600,205000,21,4,2015,0,56,8580,7460,0,0,0
3,2.5,1770,3205,2.0,0,0,3,9,1770,0,2005,0,98052,47.6658,-122.084,2120,4134,593567,29,4,2015,0,10,1435,2014,0,0,0
3,2.5,2060,11231,2.0,0,0,3,8,2060,0,1987,0,98072,47.7571,-122.141,2140,10224,440000,14,8,2014,0,27,9171,8084,0,0,0
3,2.5,3090,13316,2.0,0,0,3,10,3090,0,1992,0,98075,47.588,-122.079,2980,14437,751000,16,7,2014,0,22,10226,11457,0,0,0
2,1.75,1050,6500,1.5,0,2,4,6,1050,0,1925,0,98055,47.4727,-122.2,1320,10075,295000,9,9,2014,0,89,5450,8755,0,0,0
3,2.0,1300,2250,2.0,0,0,3,7,1300,0,1988,0,98103,47.6923,-122.332,1300,4500,422500,4,9,2014,0,26,950,3200,0,0,1
3,1.0,1160,8800,1.0,0,0,4,7,1160,0,1959,0,98008,47.6112,-122.128,1750,8400,480000,1,12,2014,0,55,7640,6650,0,0,0
4,2.5,3420,6233,2.0,0,0,3,9,3420,0,2006,0,98027,47.5416,-121.998,3350,5000,890900,25,7,2014,0,8,2813,1650,0,0,0
4,2.75,2620,6707,2.0,0,0,3,9,2620,0,2000,0,98075,47.5965,-122.038,2590,6530,672500,29,5,2014,0,14,4087,3940,0,0,0
4,1.5,1880,3500,1.0,0,0,4,7,1080,800,1926,0,98103,47.6835,-122.347,1690,3500,605000,10,10,2014,0,88,1620,1810,0,1,1
4,2.5,2330,7936,2.0,0,0,3,9,2330,0,1987,0,98074,47.6269,-122.03,2460,8137,565000,26,9,2014,0,27,5606,5677,0,0,0
4,1.75,2350,7574,1.0,0,0,3,8,1720,630,1979,0,98027,47.5634,-122.087,2220,8496,725000,6,5,2015,0,36,5224,6276,0,1,0
3,3.0,1560,1466,3.0,0,0,3,8,1560,0,2006,0,98103,47.6604,-122.352,1530,2975,640000,31,7,2014,0,8,-94,1445,0,0,1
4,1.0,1380,7110,1.5,0,0,3,6,1380,0,1939,0,98030,47.3846,-122.226,1430,7110,253750,26,2,2015,0,76,5730,5680,0,0,0
4,1.5,1350,8113,1.0,0,0,4,7,1350,0,1959,0,98004,47.5807,-122.196,1930,8113,595000,16,7,2014,0,55,6763,6183,0,0,0
4,2.5,3180,11652,2.0,0,1,3,9,3180,0,1977,0,98040,47.567,-122.212,3110,15183,850000,29,9,2014,0,37,8472,12073,0,0,0
3,2.5,1790,4065,2.0,0,0,3,8,1790,0,2009,0,98019,47.7344,-121.965,2480,4252,366000,2,10,2014,0,5,2275,1772,0,0,0
4,3.0,1986,6000,2.0,0,2,4,8,1746,240,1922,0,98136,47.5374,-122.39,1930,6200,715000,22,9,2014,0,92,4014,4270,0,1,1
4,2.5,2400,7215,2.0,0,0,3,8,2400,0,1992,0,98023,47.2944,-122.371,2220,7760,300000,11,12,2014,0,22,4815,5540,0,0,0
4,3.0,4590,9150,2.0,0,0,3,10,3490,1100,1981,0,98177,47.7234,-122.372,2910,12348,960000,3,6,2014,0,33,4560,9438,0,1,1
3,2.0,1970,3420,2.0,0,3,5,8,1970,0,1913,0,98103,47.6762,-122.354,1770,3420,812000,1,4,2015,0,102,1450,1650,0,0,1
3,1.0,1360,9948,1.0,0,0,3,6,1360,0,1977,0,98010,47.3422,-122.053,1670,8475,234950,9,5,2014,0,37,8588,6805,0,0,0
4,2.0,2710,4750,1.0,0,0,4,7,1460,1250,1919,0,98115,47.6756,-122.305,1700,3800,656500,12,6,2014,0,95,2040,2100,0,1,1
2,1.5,920,1598,2.0,0,0,3,7,920,0,1995,0,98133,47.7081,-122.342,1110,1598,255000,3,7,2014,0,19,678,488,0,0,1
3,2.25,1920,9680,1.0,0,0,4,7,1300,620,1961,0,98031,47.412,-122.195,1500,9516,260000,1,7,2014,0,53,7760,8016,0,1,0
3,2.5,2678,6607,2.0,0,0,3,9,2678,0,1998,0,98028,47.738,-122.235,2780,6607,546200,27,10,2014,0,16,3929,3827,0,0,0
3,1.0,1220,4541,1.0,0,0,3,7,890,330,1952,0,98108,47.5387,-122.294,1670,3429,280500,19,4,2015,0,63,3321,1759,0,1,1
3,1.75,1440,4000,1.0,0,0,4,7,1050,390,1979,0,98106,47.5329,-122.354,1560,4000,295000,11,8,2014,0,35,2560,2440,0,1,1
4,1.75,2420,520,1.5,0,0,3,7,2420,0,1900,0,98112,47.6209,-122.302,1200,1170,700000,22,10,2014,0,114,-1900,-30,0,0,1
3,2.0,2090,15790,1.0,0,0,3,9,2090,0,1992,0,98034,47.7296,-122.199,1820,8770,560000,20,11,2014,0,22,13700,6950,0,0,0
4,2.75,4030,10888,2.0,0,0,3,10,4030,0,1997,0,98075,47.5651,-122.034,3720,10756,912000,1,4,2015,0,18,6858,7036,0,0,0
3,1.75,1310,9282,1.0,0,0,4,7,1310,0,1976,0,98052,47.6844,-122.111,1310,8748,437000,8,5,2014,0,38,7972,7438,0,0,0
3,2.5,1800,3074,2.0,0,0,3,7,1800,0,2003,0,98072,47.7631,-122.149,1610,2929,447000,16,3,2015,0,12,1274,1319,0,0,0
3,1.0,1160,5969,1.0,0,0,3,7,880,280,1930,0,98115,47.6844,-122.306,1550,5120,508300,19,3,2015,0,85,4809,3570,0,1,1
3,1.5,1870,7853,1.0,0,0,3,7,1300,570,1962,0,98125,47.7045,-122.281,1870,8300,485000,31,7,2014,0,52,5983,6430,0,1,1
7,5.75,3700,7647,2.0,0,1,3,8,3700,0,1948,1984,98155,47.7393,-122.289,2510,7479,540000,7,5,2014,36,66,3947,4969,1,0,1
3,2.25,2280,8765,2.0,0,0,3,8,2280,0,1977,0,98058,47.4419,-122.133,1920,8265,356000,16,9,2014,0,37,6485,6345,0,0,0
4,2.0,1720,6099,1.0,0,0,4,7,860,860,1949,0,98115,47.6765,-122.287,1100,5671,525000,25,8,2014,0,65,4379,4571,0,1,1
4,2.75,3630,11775,2.0,0,0,3,10,3630,0,1999,0,98074,47.6378,-122.066,3800,12451,962800,24,3,2015,0,16,8145,8651,0,0,0
4,2.5,2040,6300,2.0,0,0,3,8,2040,0,2003,0,98031,47.3918,-122.185,2260,5877,315000,1,10,2014,0,11,4260,3617,0,0,0
3,2.25,1750,1879,3.0,0,0,3,8,1750,0,2001,0,98107,47.6722,-122.391,1750,3155,525000,20,6,2014,0,13,129,1405,0,0,1
2,2.25,1550,2285,2.0,0,0,3,8,1550,0,2007,0,98106,47.5398,-122.369,1550,2135,325000,30,4,2015,0,8,735,585,0,0,1
4,1.75,2500,8725,1.0,0,0,4,8,1500,1000,1966,0,98004,47.6304,-122.205,1900,8998,965800,23,4,2015,0,49,6225,7098,0,1,0
4,1.0,1440,3600,1.5,0,0,4,7,1440,0,1924,0,98116,47.5694,-122.385,1010,5175,550000,9,7,2014,0,90,2160,4165,0,0,1
4,1.0,1130,13927,1.5,0,0,3,6,1130,0,1929,0,98168,47.4939,-122.3,1800,8274,182200,21,10,2014,0,85,12797,6474,0,0,1
3,1.0,1210,8505,1.5,0,0,3,7,1210,0,1958,0,98106,47.5389,-122.353,1430,8505,315000,11,9,2014,0,56,7295,7075,0,0,1
2,1.0,960,5000,1.0,0,0,4,7,960,0,1900,0,98107,47.6755,-122.367,1330,5000,500000,25,8,2014,0,114,4040,3670,0,0,1
5,2.5,2160,7737,2.0,0,0,3,7,2160,0,1998,0,98065,47.5381,-121.872,2460,7737,480000,2,7,2014,0,16,5577,5277,0,0,0
3,1.75,3400,8965,1.0,0,2,5,9,1820,1580,1957,0,98105,47.6569,-122.273,3200,8500,1690000,20,5,2014,0,57,5565,5300,0,1,1
4,2.5,1900,9075,2.0,0,0,3,7,1900,0,1988,0,98133,47.7776,-122.352,1800,8460,407500,12,4,2015,0,27,7175,6660,0,0,1
4,2.5,3150,13700,2.0,0,0,4,9,3150,0,1966,0,98040,47.5309,-122.224,3200,11900,1260000,30,5,2014,0,48,10550,8700,0,0,0
3,1.0,1040,4480,1.0,0,0,3,7,870,170,1924,0,98109,47.6461,-122.356,1730,4200,642000,30,8,2014,0,90,3440,2470,0,1,1
3,1.75,1540,7558,1.0,0,0,3,8,1540,0,1964,0,98052,47.6707,-122.156,1540,7863,520000,9,1,2015,0,51,6018,6323,0,0,0
3,2.0,1820,5000,1.5,0,0,4,8,1720,100,1941,0,98116,47.5845,-122.395,2220,7200,750000,23,6,2014,0,73,3180,4980,0,1,1
5,1.5,1930,4500,1.5,0,0,3,8,1930,0,1929,0,98112,47.6401,-122.303,2083,4500,855000,7,4,2015,0,86,2570,2417,0,0,1
5,2.75,2920,5250,1.5,0,0,5,7,1800,1120,1911,0,98002,47.3072,-122.221,1220,5250,265000,10,9,2014,0,103,2330,4030,0,1,0
2,1.0,1200,12856,1.0,0,0,4,6,1200,0,1948,0,98027,47.5321,-122.034,1740,6098,546000,11,2,2015,0,67,11656,4358,0,0,0
2,2.5,2390,7489,1.0,0,0,3,8,2390,0,2007,0,98053,47.7243,-122.032,2170,7489,699950,26,11,2014,0,7,5099,5319,0,0,0
3,2.0,1270,10713,1.0,0,0,4,7,1270,0,1969,0,98034,47.7247,-122.181,1620,8250,435000,14,4,2015,0,46,9443,6630,0,0,0
4,1.5,1300,7200,1.0,0,0,4,7,1300,0,1970,0,98031,47.4179,-122.181,1420,7200,259500,6,5,2015,0,45,5900,5780,0,0,0
4,3.25,2290,4785,2.0,0,0,3,9,2290,0,2007,0,98038,47.3833,-122.037,2290,4785,359950,29,10,2014,0,7,2495,2495,0,0,0
3,1.75,1740,10000,1.0,0,0,3,7,1740,0,1976,2009,98074,47.617,-122.058,1350,7500,517000,15,12,2014,33,38,8260,6150,1,0,0
3,1.0,1590,5400,1.0,0,1,3,8,1280,310,1948,0,98118,47.5509,-122.261,2140,7161,579000,4,8,2014,0,66,3810,5021,0,1,1
4,2.0,2420,10735,1.5,0,0,3,7,2420,0,1967,0,98052,47.6899,-122.122,1570,9540,525000,5,9,2014,0,47,8315,7970,0,0,0
4,2.5,2130,9653,1.0,0,0,3,7,1500,630,1978,0,98031,47.4068,-122.175,2000,7988,320000,14,4,2015,0,37,7523,5988,0,1,0
4,1.75,1950,13320,1.0,0,0,4,8,1370,580,1969,0,98007,47.6196,-122.139,2120,12051,635000,13,5,2014,0,45,11370,9931,0,1,0
4,2.5,2150,5397,2.0,0,0,3,8,2150,0,1998,0,98058,47.4644,-122.151,2260,5080,400000,16,9,2014,0,16,3247,2820,0,0,0
3,1.75,1270,7700,1.0,0,0,4,7,1270,0,1968,0,98052,47.6711,-122.148,1510,7700,455000,10,10,2014,0,46,6430,6190,0,0,0
3,1.5,1390,7417,1.0,0,0,3,7,1390,0,1967,0,98001,47.3369,-122.275,1390,7665,162500,23,1,2015,0,48,6027,6275,0,0,0
2,2.5,1340,1240,2.0,0,0,3,8,1150,190,2008,0,98052,47.6858,-122.102,1280,1312,400000,13,11,2014,0,6,-100,32,0,1,0
3,1.0,1190,9000,1.0,0,0,3,7,1190,0,1968,0,98028,47.77,-122.264,1960,7200,268300,18,3,2015,0,47,7810,5240,0,0,0
6,4.5,3830,4800,3.0,0,0,3,9,3050,780,1919,2004,98119,47.6404,-122.361,1990,4800,989000,2,7,2014,85,95,970,2810,1,1,1
3,1.75,1780,10409,1.0,0,0,3,7,1280,500,1981,0,98058,47.4627,-122.168,1780,7415,342000,27,6,2014,0,33,8629,5635,0,1,0
4,2.5,3130,5999,2.0,0,0,3,7,3130,0,2006,0,98042,47.3837,-122.099,3020,5997,315000,25,3,2015,0,9,2869,2977,0,0,0
4,2.75,1830,8384,1.0,0,0,3,7,1320,510,1979,0,98034,47.733,-122.22,2190,7695,485000,28,4,2015,0,36,6554,5505,0,1,0
4,2.5,2550,7500,1.0,0,0,3,8,1750,800,1976,0,98023,47.3165,-122.386,2260,8800,277500,4,12,2014,0,38,4950,6540,0,1,0
4,1.75,1800,10890,1.5,0,0,4,6,1800,0,1912,0,98027,47.5312,-122.04,1530,9818,385000,6,8,2014,0,102,9090,8288,0,0,0
2,1.0,1630,7680,1.0,0,0,3,7,830,800,1947,0,98125,47.7092,-122.291,1250,7740,426000,17,11,2014,0,67,6050,6490,0,1,1
4,2.0,1870,6000,1.5,0,0,3,7,1870,0,1956,0,98125,47.7155,-122.315,1520,7169,310000,17,6,2014,0,58,4130,5649,0,0,1
4,2.0,1870,6000,1.5,0,0,3,7,1870,0,1956,0,98125,47.7155,-122.315,1520,7169,449000,26,1,2015,0,59,4130,5649,0,0,1
2,1.0,980,3915,1.0,0,0,4,7,980,0,1919,0,98118,47.5589,-122.29,1425,1576,375000,19,12,2014,0,95,2935,151,0,0,1
3,2.25,2860,10625,1.0,0,4,3,10,1920,940,1976,0,98115,47.6915,-122.273,2860,8075,1190000,30,3,2015,0,39,7765,5215,0,1,1
3,2.25,1470,5597,2.0,0,0,3,7,1470,0,1985,0,98029,47.5674,-122.019,1610,5217,468000,14,4,2015,0,30,4127,3607,0,0,0
1,1.0,1160,5000,2.0,0,0,3,7,1160,0,2000,0,98144,47.5883,-122.311,2060,5000,336000,3,4,2015,0,15,3840,2940,0,0,1
4,2.75,1940,6555,2.0,0,0,3,8,1940,0,1990,0,98038,47.3701,-122.041,1840,6912,392000,10,6,2014,0,24,4615,5072,0,0,0
4,2.25,1630,7969,1.0,0,0,3,7,1100,530,1977,0,98034,47.7336,-122.19,1580,7440,412500,7,8,2014,0,37,6339,5860,0,1,0
4,2.5,2755,11612,2.0,0,0,3,8,2755,0,2001,0,98019,47.7394,-121.965,2820,12831,545000,25,3,2015,0,14,8857,10011,0,0,0
5,2.0,1430,5600,1.5,0,0,3,6,1430,0,1947,0,98118,47.5192,-122.266,1860,5980,133000,20,12,2014,0,67,4170,4120,0,0,1
5,2.0,1430,5600,1.5,0,0,3,6,1430,0,1947,0,98118,47.5192,-122.266,1860,5980,440000,14,5,2015,0,68,4170,4120,0,0,1
4,2.25,1400,7341,1.0,0,0,3,7,1300,100,1961,0,98155,47.7565,-122.305,2090,7410,294450,5,12,2014,0,53,5941,5320,0,1,1
4,2.5,2520,7205,2.0,0,0,3,8,2520,0,1987,0,98003,47.343,-122.316,2350,7632,335000,26,8,2014,0,27,4685,5282,0,0,0
3,1.0,1290,10125,1.0,0,0,4,7,1290,0,1956,0,98028,47.7641,-122.265,1760,14460,362000,8,9,2014,0,58,8835,12700,0,0,0
3,1.75,1400,18002,1.0,0,0,3,6,1400,0,1977,0,98019,47.725,-121.967,2240,14068,322000,28,10,2014,0,37,16602,11828,0,0,0
2,1.0,740,8853,1.0,0,0,3,6,740,0,1943,0,98166,47.4793,-122.336,850,8775,230500,17,3,2015,0,72,8113,7925,0,0,1
4,2.0,1710,9996,1.0,0,0,3,7,1710,0,1950,0,98108,47.5472,-122.3,1550,6768,380000,5,3,2015,0,65,8286,5218,0,0,1
4,2.75,2414,7693,2.0,0,0,3,8,2414,0,2006,0,98002,47.3046,-122.222,1500,7177,292000,11,6,2014,0,8,5279,5677,0,0,0
3,1.0,1040,7500,1.0,0,0,4,6,1040,0,1954,0,98198,47.4206,-122.316,1270,8000,172500,12,8,2014,0,60,6460,6730,0,0,1
4,2.75,3540,7091,1.5,0,1,4,8,1970,1570,1947,0,98199,47.6467,-122.394,2200,6000,784000,24,7,2014,0,67,3551,3800,0,1,1
4,2.75,2530,11549,1.0,0,0,3,7,1700,830,1942,0,98033,47.6557,-122.197,2530,10000,525000,2,10,2014,0,72,9019,7470,0,1,0
3,2.5,2320,7609,2.0,0,0,3,8,2320,0,2003,0,98027,47.5391,-122.069,2590,4000,600000,4,7,2014,0,11,5289,1410,0,0,0
3,2.5,2530,16102,2.0,0,0,3,9,2530,0,1989,0,98038,47.371,-122.055,2370,14957,435000,27,10,2014,0,25,13572,12587,0,0,0
5,2.75,2790,7600,1.5,0,0,4,7,2790,0,1965,0,98056,47.4999,-122.165,1480,7600,359900,5,2,2015,0,50,4810,6120,0,0,0
4,1.75,1950,7139,1.0,1,4,3,7,1150,800,1957,0,98178,47.5121,-122.248,1600,13122,700000,11,12,2014,0,57,5189,11522,0,1,1
3,2.0,1020,889,2.0,0,0,3,7,720,300,2009,0,98126,47.5434,-122.375,1130,972,280000,12,3,2015,0,6,-131,-158,0,1,1
3,2.5,1380,1021,2.0,0,0,3,8,1160,220,2008,0,98122,47.6148,-122.309,1440,1021,540000,5,8,2014,0,6,-359,-419,0,1,1
4,2.75,3980,9209,2.0,0,0,3,11,3980,0,2002,0,98074,47.6286,-122.064,3800,9333,970000,6,3,2015,0,13,5229,5533,0,0,0
4,2.5,2080,7000,1.0,0,0,4,8,1400,680,1989,0,98058,47.4252,-122.163,2090,7082,330000,13,8,2014,0,25,4920,4992,0,1,0
3,1.75,1530,8000,2.0,0,0,3,7,1530,0,1978,0,98052,47.6971,-122.13,1530,7500,474000,3,7,2014,0,36,6470,5970,0,0,0
4,1.75,1930,9310,1.0,0,0,4,9,1930,0,1968,0,98008,47.6158,-122.108,2110,10290,670000,17,3,2015,0,47,7380,8180,0,0,0
4,3.25,2330,9687,2.0,0,3,3,9,2330,0,1918,0,98112,47.6264,-122.283,3880,9017,1300000,12,5,2014,0,96,7357,5137,0,0,1
4,2.5,3860,10361,2.0,0,2,4,10,2940,920,1985,0,98006,47.5517,-122.147,3720,13155,1160000,30,7,2014,0,29,6501,9435,0,1,0
4,2.5,2880,8061,2.0,0,0,3,9,2880,0,1988,0,98058,47.439,-122.152,2650,7660,440000,12,1,2015,0,27,5181,5010,0,0,0
2,2.5,1590,2088,2.0,0,0,3,9,1590,0,1997,0,98033,47.6897,-122.175,2320,3174,411000,28,7,2014,0,17,498,854,0,0,0
3,1.5,2150,4000,1.5,0,0,3,7,1470,680,1928,0,98144,47.5733,-122.312,1750,4000,500000,25,7,2014,0,86,1850,2250,0,1,1
4,1.75,2300,13342,1.5,1,4,3,7,2300,0,1934,1958,98125,47.7308,-122.282,2500,13342,1340000,18,12,2014,24,80,11042,10842,1,0,1
6,3.25,2900,6400,2.0,0,0,4,8,2300,600,1977,0,98199,47.6464,-122.401,2480,6400,696000,15,12,2014,0,37,3500,3920,0,1,1
3,2.25,1970,11088,1.0,0,0,4,8,1180,790,1967,0,98155,47.7651,-122.277,1970,10470,465000,6,5,2014,0,47,9118,8500,0,1,1
4,2.5,1740,7500,1.0,0,0,4,7,1220,520,1976,0,98052,47.6927,-122.124,1790,7350,518000,16,6,2014,0,38,5760,5560,0,1,0
3,2.0,1290,13282,1.0,0,0,3,7,1290,0,1978,0,98030,47.3787,-122.169,1290,12357,255000,30,4,2015,0,37,11992,11067,0,0,0
2,1.0,780,8271,1.0,0,0,4,6,780,0,1924,0,98115,47.7,-122.3,2220,8271,319000,20,8,2014,0,90,7491,6051,0,0,1
4,2.75,2210,3400,1.5,0,0,5,7,1470,740,1926,0,98115,47.6826,-122.311,1500,3400,719000,29,9,2014,0,88,1190,1900,0,1,1
5,3.5,5930,13288,2.0,0,2,3,11,3920,2010,1996,0,98027,47.5542,-122.097,3860,12062,1520000,14,7,2014,0,18,7358,8202,0,1,0
4,2.5,1950,4553,2.0,0,0,3,7,1950,0,2000,0,98056,47.5066,-122.175,1780,4598,322000,9,1,2015,0,15,2603,2818,0,0,0
4,1.0,1340,7920,1.0,0,0,4,7,1340,0,1970,0,98001,47.2845,-122.267,1090,9600,205000,5,3,2015,0,45,6580,8510,0,0,0
3,1.0,1590,6240,1.0,0,0,3,7,1060,530,1956,0,98146,47.4936,-122.337,1410,6240,229000,13,1,2015,0,59,4650,4830,0,1,1
3,2.25,1780,9672,1.0,0,0,3,8,1350,430,1960,0,98133,47.7774,-122.35,1860,10080,395000,30,10,2014,0,54,7892,8220,0,1,1
2,1.0,760,7272,1.0,0,0,4,7,760,0,1980,0,98003,47.3205,-122.33,1370,7866,183000,26,3,2015,0,35,6512,6496,0,0,0
3,1.75,1720,7800,1.0,0,0,4,7,1170,550,1978,0,98052,47.6928,-122.125,1760,7276,583500,5,9,2014,0,36,6080,5516,0,1,0
3,1.75,1790,9860,1.0,0,0,4,7,1410,380,1978,0,98052,47.6989,-122.12,1820,9555,539000,9,9,2014,0,36,8070,7735,0,1,0
4,2.75,3230,12651,2.0,0,0,4,8,3230,0,2002,0,98001,47.3157,-122.251,2550,12081,409000,20,3,2015,0,13,9421,9531,0,0,0
3,1.75,1400,4000,1.0,0,0,3,7,870,530,1951,0,98117,47.6913,-122.381,1400,4000,510250,28,5,2014,0,63,2600,2600,0,1,1
2,2.0,1370,3827,1.0,0,0,3,7,1020,350,1952,0,98199,47.652,-122.404,1550,5102,535000,2,12,2014,0,62,2457,3552,0,1,1
3,2.5,1600,7936,2.0,0,0,3,7,1600,0,1996,0,98038,47.3673,-122.017,1830,7936,280000,24,9,2014,0,18,6336,6106,0,0,0
3,1.0,950,8400,1.0,0,0,3,7,950,0,1958,0,98056,47.5104,-122.166,1250,8400,286000,9,4,2015,0,57,7450,7150,0,0,0
3,2.75,2210,7660,1.0,0,1,4,7,1460,750,1968,0,98116,47.5619,-122.4,2110,8750,710000,25,3,2015,0,47,5450,6640,0,1,1
2,1.0,930,6380,1.0,0,0,4,7,930,0,1940,0,98115,47.6915,-122.321,1180,6380,395000,9,7,2014,0,74,5450,5200,0,0,1
2,1.0,810,8494,1.0,0,0,3,6,810,0,1949,0,98155,47.7389,-122.324,1050,7975,237500,8,9,2014,0,65,7684,6925,0,0,1
3,2.0,1630,6550,1.0,0,0,5,7,850,780,1912,0,98126,47.5452,-122.379,1440,6550,464000,21,1,2015,0,103,4920,5110,0,1,1
3,1.75,1770,10080,1.0,0,0,3,8,1770,0,1968,0,98125,47.7218,-122.306,1860,10456,495000,21,10,2014,0,46,8310,8596,0,0,1
1,1.0,710,6060,1.0,0,0,4,6,710,0,1916,0,98118,47.5621,-122.283,1440,4545,257500,17,2,2015,0,99,5350,3105,0,0,1
3,2.5,2310,7485,2.0,0,0,3,8,2310,0,1986,0,98058,47.439,-122.135,2310,8142,362000,11,11,2014,0,28,5175,5832,0,0,0
33,1.75,1620,6000,1.0,0,0,5,7,1040,580,1947,0,98103,47.6878,-122.331,1330,4700,640000,25,6,2014,0,67,4380,3370,0,1,1
3,1.0,1140,8800,1.0,0,0,3,7,1140,0,1972,0,98001,47.2629,-122.275,1270,13560,172500,26,5,2014,0,42,7660,12290,0,0,0
2,1.0,1040,4880,1.0,0,0,3,7,1040,0,1910,1975,98115,47.6809,-122.311,1500,4590,596000,20,1,2015,65,105,3840,3090,1,0,1
4,2.5,2170,9796,1.0,0,0,4,8,1650,520,1980,0,98006,47.5505,-122.152,2350,9796,840000,30,4,2015,0,35,7626,7446,0,1,0
2,1.5,901,1245,3.0,0,0,3,7,901,0,2001,0,98115,47.6774,-122.325,1138,1137,435000,12,9,2014,0,13,344,-1,0,0,1
2,1.0,840,7870,1.0,0,0,3,6,840,0,1949,0,98155,47.7389,-122.326,1442,8131,251000,10,9,2014,0,65,7030,6689,0,0,1
4,1.0,1650,9750,1.0,0,0,4,7,1650,0,1964,0,98059,47.4991,-122.164,1650,10112,282500,6,11,2014,0,50,8100,8462,0,0,0
3,2.25,1380,7226,1.0,0,0,4,7,1140,240,1987,0,98042,47.3677,-122.091,1640,7823,265000,17,10,2014,0,27,5846,6183,0,1,0
3,1.0,910,10240,1.0,0,0,4,6,910,0,1969,0,98053,47.6729,-122.064,1140,10720,330000,17,12,2014,0,45,9330,9580,0,0,0
2,1.0,1230,3800,1.0,0,0,3,7,1230,0,1928,0,98115,47.6797,-122.292,1610,3800,435000,17,6,2014,0,86,2570,2190,0,0,1
3,1.75,1740,8560,1.0,0,0,3,8,1500,240,1948,0,98199,47.6475,-122.409,2240,5800,827235,1,12,2014,0,66,6820,3560,0,1,1
4,1.0,1290,5000,1.5,0,0,3,7,1290,0,1957,0,98146,47.513,-122.358,1440,2500,249950,30,5,2014,0,57,3710,1060,0,0,1
4,2.5,2150,7944,2.0,0,0,3,8,2150,0,1990,0,98092,47.259,-122.215,2170,8319,300499,21,10,2014,0,24,5794,6149,0,0,0
4,2.0,1560,5220,1.0,0,0,3,7,1560,0,1959,0,98115,47.6905,-122.305,1300,5220,449000,17,4,2015,0,56,3660,3920,0,0,1
2,1.0,1120,3220,1.0,0,0,4,7,1120,0,1923,0,98103,47.6588,-122.344,1440,3220,500000,17,10,2014,0,91,2100,1780,0,0,1
3,1.5,1790,7526,1.0,0,0,3,7,1790,0,1953,2014,98004,47.6387,-122.207,2080,10943,865000,30,9,2014,61,61,5736,8863,1,0,0
4,3.5,3290,5414,2.0,0,1,3,9,2360,930,2006,0,98034,47.7074,-122.219,1820,9609,899950,16,6,2014,0,8,2124,7789,0,1,0
4,1.0,1540,9541,1.5,0,0,4,7,1540,0,1961,0,98034,47.7104,-122.213,1290,9541,370000,28,8,2014,0,53,8001,8251,0,0,0
3,1.0,1010,9945,1.0,0,0,4,6,1010,0,1973,0,98065,47.5324,-121.763,1390,12710,310000,3,5,2014,0,41,8935,11320,0,0,0
4,2.25,2190,9113,2.0,0,0,3,7,2190,0,1986,0,98001,47.3241,-122.275,1570,8306,245000,5,9,2014,0,28,6923,6736,0,0,0
2,1.0,700,8100,1.0,0,0,3,6,700,0,1949,0,98155,47.7492,-122.311,1230,8100,254950,17,11,2014,0,65,7400,6870,0,0,1
6,4.5,3300,7480,2.0,0,0,3,8,3300,0,1980,0,98052,47.6796,-122.104,2470,7561,510000,22,7,2014,0,34,4180,5091,0,0,0
3,2.25,1370,5000,2.0,0,0,3,7,1370,0,1990,0,98019,47.7372,-121.981,1600,7724,299950,27,4,2015,0,25,3630,6124,0,0,0
4,2.5,2680,4500,2.0,0,0,3,8,2680,0,2011,0,98038,47.3561,-122.056,2010,4500,379950,21,8,2014,0,3,1820,2490,0,0,0
3,1.0,1390,4820,1.0,0,0,4,7,910,480,1926,0,98133,47.704,-122.343,1320,4820,350000,7,8,2014,0,88,3430,3500,0,1,1
3,2.5,1700,3575,2.0,0,0,3,7,1700,0,2000,0,98108,47.5418,-122.295,1590,3380,300000,18,6,2014,0,14,1875,1790,0,0,1
3,2.25,2510,6339,1.5,0,2,5,8,1810,700,1932,0,98199,47.6496,-122.391,1820,5741,994000,27,5,2014,0,82,3829,3921,0,1,1
3,1.5,1700,8067,1.0,0,0,3,7,1250,450,1956,0,98155,47.7384,-122.324,1340,7869,315000,19,11,2014,0,58,6367,6529,0,1,1
4,2.5,2180,11200,1.0,0,0,4,8,2180,0,1968,0,98072,47.7476,-122.086,1790,11200,480500,7,5,2014,0,46,9020,9410,0,0,0
3,1.0,1770,5720,1.5,0,0,4,7,1140,630,1926,0,98126,47.5546,-122.377,1500,4406,373000,16,6,2014,0,88,3950,2906,0,1,1
4,2.5,3290,5951,2.0,0,0,3,9,3290,0,2003,0,98075,47.5999,-121.976,3240,6159,728000,2,9,2014,0,11,2661,2919,0,0,0
4,3.5,3040,7125,2.0,0,1,3,8,2240,800,2002,0,98178,47.492,-122.225,2220,7800,415000,25,9,2014,0,12,4085,5580,0,1,1
4,2.5,2460,5091,2.0,0,0,3,9,2460,0,2003,0,98058,47.45,-122.121,2490,4750,427500,4,6,2014,0,11,2631,2260,0,0,0
3,2.0,970,10000,1.0,0,0,5,7,970,0,1972,0,98074,47.6205,-122.063,1230,7500,339300,10,11,2014,0,42,9030,6270,0,0,0
3,1.75,1320,6205,1.0,0,0,5,7,1320,0,1948,0,98133,47.7412,-122.343,1210,6205,313000,27,5,2014,0,66,4885,4995,0,0,1
3,3.5,1900,1612,2.0,0,0,3,8,1430,470,2008,0,98136,47.544,-122.385,1780,1525,431500,22,5,2014,0,6,-288,-255,0,1,1
3,1.5,1220,835,1.5,0,0,4,6,1220,0,1950,0,98103,47.6981,-122.341,1360,1251,415000,9,3,2015,0,65,-385,-109,0,0,1
3,1.75,1470,9750,1.0,0,0,4,7,1470,0,1978,0,98052,47.6975,-122.12,1800,9600,490000,16,3,2015,0,37,8280,7800,0,0,0
3,1.5,1400,9750,1.0,0,0,4,6,1400,0,1964,0,98030,47.3768,-122.17,1160,9750,275000,30,3,2015,0,51,8350,8590,0,0,0
2,1.0,1070,5080,1.0,0,0,5,6,1070,0,1942,0,98106,47.5224,-122.35,900,5080,325000,17,2,2015,0,73,4010,4180,0,0,1
5,3.75,3630,6000,1.5,0,0,3,9,2470,1160,2004,0,98033,47.6816,-122.199,2560,7560,1180000,10,6,2014,0,10,2370,5000,0,1,0
4,1.5,1970,4590,2.5,0,0,3,7,1970,0,1909,0,98103,47.666,-122.332,1900,4590,690000,1,10,2014,0,105,2620,2690,0,0,1
4,2.0,2010,9474,2.0,0,0,3,7,2010,0,1953,2003,98166,47.4234,-122.342,2140,10164,410000,30,3,2015,50,62,7464,8024,1,0,1
4,2.5,2820,5934,1.0,0,3,5,9,1770,1050,1952,0,98116,47.5706,-122.403,2230,6000,960000,1,8,2014,0,62,3114,3770,0,1,1
3,2.5,2530,8669,2.0,0,0,3,9,2530,0,1990,0,98023,47.3073,-122.395,2530,9469,299250,30,10,2014,0,24,6139,6939,0,0,0
2,1.0,710,14000,1.0,0,0,4,6,710,0,1953,0,98166,47.4379,-122.337,1500,10540,239000,14,7,2014,0,61,13290,9040,0,0,1
2,1.0,1210,9400,1.0,0,0,2,6,1210,0,1949,0,98106,47.5342,-122.36,1580,6026,235000,2,5,2014,0,65,8190,4446,0,0,1
4,2.5,2300,6087,2.0,0,0,3,7,2300,0,2001,0,98056,47.5125,-122.192,1770,5907,431000,1,7,2014,0,13,3787,4137,0,0,0
3,2.5,3110,6765,2.0,0,1,4,9,2550,560,1946,0,98115,47.6886,-122.276,2630,7626,1640000,7,7,2014,0,68,3655,4996,0,1,1
3,1.75,1990,6500,1.0,0,0,3,7,1090,900,1961,0,98055,47.488,-122.221,2150,6500,285000,3,12,2014,0,53,4510,4350,0,1,0
3,3.0,2630,10156,1.0,0,0,4,9,2630,0,1987,0,98006,47.5481,-122.156,2660,10455,778000,6,11,2014,0,27,7526,7795,0,0,0
3,1.0,1300,7975,1.0,0,0,4,7,1300,0,1958,0,98008,47.611,-122.122,1570,9075,415000,31,7,2014,0,56,6675,7505,0,0,0
2,1.75,1680,4500,1.0,0,0,3,8,1680,0,2004,0,98053,47.7132,-122.032,1670,4500,550285,12,1,2015,0,11,2820,2830,0,0,0
3,2.25,2180,9865,1.0,0,0,4,8,1660,520,1966,0,98040,47.5358,-122.235,2600,10034,910000,25,8,2014,0,48,7685,7434,0,1,0
3,2.5,2770,9136,2.0,0,0,3,10,2770,0,1991,0,98006,47.5605,-122.115,2890,8442,860000,29,5,2014,0,23,6366,5552,0,0,0
3,1.75,2120,5000,2.0,0,0,3,7,1980,140,1920,2010,98103,47.6666,-122.331,2020,5000,765000,3,10,2014,90,94,2880,2980,1,1,1
3,3.5,1370,1764,2.0,0,0,3,8,1180,190,2000,0,98119,47.6511,-122.368,1400,1398,525000,10,3,2015,0,15,394,-2,0,1,1
3,1.75,1990,5650,1.0,0,1,3,7,1320,670,1963,0,98178,47.5086,-122.252,2130,5650,345000,2,6,2014,0,51,3660,3520,0,1,1
3,2.25,2070,7800,1.0,0,0,3,7,1170,900,1964,0,98003,47.3431,-122.305,1570,8400,279000,4,3,2015,0,51,5730,6830,0,1,0
3,1.5,1320,8100,1.0,0,0,4,7,1320,0,1951,0,98177,47.7194,-122.371,1480,8100,500000,11,7,2014,0,63,6780,6620,0,0,1
3,1.0,1300,8160,1.0,0,0,4,7,1300,0,1960,0,98056,47.511,-122.172,1290,8970,237000,20,6,2014,0,54,6860,7680,0,0,0
3,1.75,1260,9346,1.0,0,0,4,7,1260,0,1963,0,98030,47.3713,-122.186,1800,9705,200500,26,6,2014,0,51,8086,7905,0,0,0
4,1.75,2400,9900,1.0,0,0,3,7,1250,1150,1957,0,98166,47.4631,-122.362,1960,9900,387500,24,3,2015,0,58,7500,7940,0,1,1
4,2.0,1950,8040,1.0,0,0,3,7,1950,0,1961,0,98125,47.7074,-122.29,1950,8092,392500,17,7,2014,0,53,6090,6142,0,0,1
3,2.0,1430,12430,1.0,0,0,4,7,1430,0,1957,0,98056,47.4903,-122.178,1200,8250,305000,13,2,2015,0,58,11000,7050,0,0,0
4,2.5,2110,10100,1.0,0,2,3,8,2110,0,1968,2005,98006,47.567,-122.151,2230,10100,981000,24,9,2014,37,46,7990,7870,1,0,0
4,2.5,2980,8770,2.0,0,0,3,10,2980,0,1990,0,98075,47.5814,-122.029,2940,9238,680000,9,12,2014,0,24,5790,6298,0,0,0
4,2.5,2068,7242,2.0,0,0,4,7,2068,0,1976,0,98001,47.3318,-122.281,1560,7524,276000,5,6,2014,0,38,5174,5964,0,0,0
4,3.5,3380,8330,2.0,0,0,3,8,3380,0,2000,0,98177,47.7741,-122.379,2220,8330,655500,6,5,2014,0,14,4950,6110,0,0,1
5,2.75,2810,13144,1.0,0,0,3,8,1440,1370,1964,0,98007,47.6199,-122.141,2480,13144,555000,29,12,2014,0,50,10334,10664,0,1,0
2,1.0,930,10505,1.0,0,0,3,6,930,0,1930,0,98148,47.4337,-122.329,1520,8881,235000,13,4,2015,0,85,9575,7361,0,0,1
3,1.0,1300,8879,1.0,0,0,3,7,920,380,1950,0,98155,47.7465,-122.326,1530,6960,325000,19,2,2015,0,65,7579,5430,0,1,1
3,1.0,1320,8100,1.0,0,0,3,6,880,440,1943,0,98166,47.4697,-122.351,1000,8100,268950,30,10,2014,0,71,6780,7100,0,1,1
3,1.5,1580,14040,1.0,0,0,3,7,1050,530,1980,0,98001,47.2932,-122.267,2240,12000,264500,10,11,2014,0,34,12460,9760,0,1,0
3,2.5,1620,5250,2.0,0,0,3,8,1620,0,1987,0,98003,47.3538,-122.301,1650,5250,240000,10,11,2014,0,27,3630,3600,0,0,0
2,1.5,2210,5000,1.0,0,2,3,8,1530,680,1951,0,98122,47.6122,-122.288,2700,5000,850000,31,3,2015,0,64,2790,2300,0,1,1
4,2.25,1740,9600,1.0,0,2,3,7,1160,580,1957,0,98188,47.432,-122.276,1630,9600,294950,22,10,2014,0,57,7860,7970,0,1,1
4,2.5,2780,7290,2.0,0,0,3,8,2780,0,1989,0,98059,47.509,-122.157,2450,7738,478000,15,10,2014,0,25,4510,5288,0,0,0
2,1.0,830,6893,1.0,0,0,3,7,830,0,1950,0,98125,47.7234,-122.328,1470,7200,222000,5,2,2015,0,65,6063,5730,0,0,1
4,2.5,2070,11286,2.0,0,0,3,8,2070,0,1996,0,98056,47.5284,-122.173,2440,10826,635000,8,4,2015,0,19,9216,8386,0,0,0
3,3.25,1390,1278,2.0,0,0,3,8,1140,250,2005,0,98107,47.6735,-122.375,1390,1256,469000,30,9,2014,0,9,-112,-134,0,1,1
4,2.5,2610,5866,2.0,0,0,3,8,2610,0,2005,0,98038,47.3441,-122.04,2480,5188,350000,25,7,2014,0,9,3256,2708,0,0,0
5,1.0,1460,11726,1.5,0,0,3,6,1290,170,1936,0,98146,47.5039,-122.361,1460,10450,180000,3,12,2014,0,78,10266,8990,0,1,1
3,1.5,1360,6000,1.0,0,0,3,6,860,500,1911,0,98103,47.6846,-122.345,1560,3000,360000,22,9,2014,0,103,4640,1440,0,1,1
4,2.5,2807,9430,2.0,0,0,3,8,2807,0,1996,0,98028,47.7449,-122.223,2028,11056,630000,18,6,2014,0,18,6623,9028,0,0,0
4,1.0,1340,2006,1.5,0,0,3,7,1340,0,1931,0,98119,47.6357,-122.373,2040,3625,615000,14,4,2015,0,84,666,1585,0,0,1
3,2.25,1340,7202,2.0,0,0,4,7,1340,0,1989,0,98038,47.3563,-122.039,1470,7395,279950,27,10,2014,0,25,5862,5925,0,0,0
3,1.0,1160,8813,1.0,0,0,3,7,1160,0,1952,0,98125,47.7257,-122.329,1200,7615,317000,11,6,2014,0,62,7653,6415,0,0,1
4,2.25,2470,7350,1.0,0,0,3,7,1600,870,1978,0,98052,47.6936,-122.128,1970,7700,618000,16,10,2014,0,36,4880,5730,0,1,0
5,1.75,2000,8713,1.0,0,2,3,7,1000,1000,1962,0,98008,47.5882,-122.117,2040,8449,620000,11,3,2015,0,53,6713,6409,0,1,0
3,1.0,1110,6250,1.0,0,0,3,7,1110,0,1956,0,98115,47.6977,-122.292,2010,6944,345000,6,5,2014,0,58,5140,4934,0,0,1
3,1.5,2240,3750,1.0,0,0,3,7,1220,1020,1952,0,98103,47.6624,-122.336,1570,3400,608000,10,10,2014,0,62,1510,1830,0,1,1
4,2.25,1920,11603,2.0,0,0,4,7,1920,0,1967,0,98058,47.4315,-122.169,1840,7350,325000,23,12,2014,0,47,9683,5510,0,0,0
3,1.75,2270,13000,1.0,0,0,5,8,2270,0,1968,0,98058,47.4474,-122.144,2440,10000,475000,12,11,2014,0,46,10730,7560,0,0,0
3,3.0,1530,9997,1.0,0,0,3,6,1020,510,1992,0,98001,47.2861,-122.252,1410,9997,154000,16,10,2014,0,22,8467,8587,0,1,0
4,2.5,2643,5750,2.0,0,0,3,8,2643,0,2012,0,98030,47.3519,-122.173,2406,5772,376950,23,10,2014,0,2,3107,3366,0,0,0
2,2.0,1250,3360,1.0,0,0,3,7,1250,0,1957,0,98103,47.6526,-122.349,1250,3360,500000,29,7,2014,0,57,2110,2110,0,0,1
3,1.0,880,9035,1.0,0,0,4,6,880,0,1967,0,98059,47.476,-122.151,1440,10350,230000,27,1,2015,0,48,8155,8910,0,0,0
4,2.5,2220,5900,2.0,0,0,3,8,2220,0,2014,0,98117,47.6956,-122.36,1620,5900,652600,6,1,2015,0,1,3680,4280,0,0,1
3,1.75,1130,7000,1.0,0,0,3,7,1130,0,1978,0,98023,47.307,-122.372,1830,8880,185000,29,12,2014,0,36,5870,7050,0,0,0
3,1.0,1450,8820,1.0,0,0,3,6,1050,400,1958,0,98168,47.4698,-122.264,1510,8820,274950,2,6,2014,0,56,7370,7310,0,1,1
2,1.0,760,6035,1.0,0,0,3,6,760,0,1920,0,98136,47.5443,-122.382,2110,6046,447000,10,2,2015,0,95,5275,3936,0,0,1
5,3.0,2720,9856,2.0,0,0,4,8,2720,0,1969,0,98059,47.4778,-122.146,1420,9685,436000,25,3,2015,0,46,7136,8265,0,0,0
3,1.75,2080,5000,2.0,0,0,5,8,2080,0,1906,0,98103,47.6717,-122.356,1820,5000,825000,6,10,2014,0,108,2920,3180,0,0,1
3,1.0,1080,16000,1.0,0,0,3,6,1080,0,1952,0,98001,47.2873,-122.251,1610,10007,225000,10,10,2014,0,62,14920,8397,0,0,0
3,2.5,1890,6088,2.0,0,0,3,7,1890,0,1996,0,98002,47.2886,-122.218,1700,6600,265000,9,3,2015,0,19,4198,4900,0,0,0
3,1.5,1500,5111,2.0,0,0,5,8,1500,0,1984,0,98122,47.6118,-122.284,2380,4519,765000,9,3,2015,0,31,3611,2139,0,0,1
4,2.0,1960,2166,1.5,0,0,4,7,1260,700,1926,0,98103,47.6545,-122.344,1670,4000,509000,4,11,2014,0,88,206,2330,0,1,1
4,1.75,2570,8640,1.0,0,0,4,8,2570,0,1958,0,98005,47.5956,-122.172,2520,8800,762450,10,3,2015,0,57,6070,6280,0,0,0
5,1.5,1830,9000,1.0,0,2,3,7,1030,800,1955,0,98155,47.7488,-122.292,2610,11175,465000,10,12,2014,0,59,7170,8565,0,1,1
3,1.75,1980,6250,1.0,0,1,5,7,1090,890,1910,0,98136,47.554,-122.385,1980,6250,564000,5,6,2014,0,104,4270,4270,0,1,1
2,1.0,1130,5236,1.0,0,0,4,6,1130,0,1942,0,98146,47.5103,-122.386,1010,5320,384500,21,4,2015,0,73,4106,4310,0,0,1
2,1.75,1820,8409,1.0,0,0,4,6,910,910,1948,0,98155,47.7538,-122.327,1300,8409,345000,1,12,2014,0,66,6589,7109,0,1,1
4,2.5,2340,6896,2.0,0,0,3,7,2340,0,2001,0,98059,47.4896,-122.14,2950,6775,465950,17,6,2014,0,13,4556,3825,0,0,0
3,1.75,1780,11096,1.0,0,0,3,7,1210,570,1979,0,98074,47.617,-122.051,1780,10640,325000,4,8,2014,0,35,9316,8860,0,1,0
3,1.75,1780,11096,1.0,0,0,3,7,1210,570,1979,0,98074,47.617,-122.051,1780,10640,500000,17,2,2015,0,36,9316,8860,0,1,0
4,3.0,2410,8284,1.0,0,0,5,7,1210,1200,1969,0,98034,47.7202,-122.22,2050,7940,475000,10,10,2014,0,45,5874,5890,0,1,0
3,1.5,1710,5120,2.0,0,0,4,7,1710,0,1920,0,98115,47.6801,-122.305,1530,5170,747000,16,3,2015,0,95,3410,3640,0,0,1
3,1.75,1740,6220,1.0,0,0,4,6,1740,0,1954,0,98177,47.762,-122.362,1630,8418,395000,22,8,2014,0,60,4480,6788,0,0,1
3,2.5,1995,1483,3.0,0,0,3,8,1760,235,2005,0,98102,47.6025,-122.31,1520,1173,505000,6,10,2014,0,9,-512,-347,0,1,1
3,2.0,1760,9282,1.0,0,0,5,7,1100,660,1947,0,98001,47.3413,-122.29,1730,7500,215000,17,10,2014,0,67,7522,5770,0,1,0
4,2.5,3000,5471,2.0,0,0,3,8,3000,0,2013,0,98059,47.4797,-122.126,2730,5471,540000,27,10,2014,0,1,2471,2741,0,0,0
3,1.75,1540,8925,1.0,0,0,4,7,1540,0,1957,0,98133,47.7762,-122.337,1620,10397,392500,19,11,2014,0,57,7385,8777,0,0,1
3,2.0,2160,15788,1.0,0,0,3,8,2160,0,1951,0,98004,47.6227,-122.207,2260,9787,987000,15,12,2014,0,63,13628,7527,0,0,0
3,2.0,2160,15788,1.0,0,0,3,8,2160,0,1951,0,98004,47.6227,-122.207,2260,9787,1190000,12,5,2015,0,64,13628,7527,0,0,0
3,2.0,1810,10684,2.0,0,0,3,8,1810,0,1987,0,98058,47.4619,-122.153,2140,9657,252500,13,11,2014,0,27,8874,7517,0,0,0
3,3.5,2440,3502,2.0,0,0,3,7,1970,470,2000,0,98005,47.589,-122.165,2440,3417,730000,23,4,2015,0,15,1062,977,0,1,0
6,2.75,3200,9200,1.0,0,2,4,8,1600,1600,1953,0,98146,47.492,-122.364,2220,9500,497300,5,5,2014,0,61,6000,7280,0,1,1
5,2.0,2290,7125,1.0,0,0,3,7,1190,1100,1964,0,98008,47.634,-122.119,1460,7920,580000,13,5,2014,0,50,4835,6460,0,1,0
4,3.5,3010,3600,2.0,0,0,3,9,2370,640,1999,0,98112,47.6341,-122.284,2650,4200,1280000,6,6,2014,0,15,590,1550,0,1,1
3,1.5,1360,1488,2.0,0,0,3,7,1120,240,2003,0,98199,47.6526,-122.384,1360,1573,396500,12,8,2014,0,11,128,213,0,1,1
4,2.5,2080,2999,2.0,0,0,3,8,2080,0,1998,0,98059,47.4909,-122.157,1630,3148,300000,31,7,2014,0,16,919,1518,0,0,0
3,1.0,1110,4800,1.5,0,0,3,7,1110,0,1946,0,98117,47.6857,-122.378,1510,4320,532000,12,3,2015,0,69,3690,2810,0,0,1
2,1.75,1560,4500,1.0,0,0,3,8,1560,0,2004,0,98053,47.7128,-122.032,1860,4500,579000,13,1,2015,0,11,2940,2640,0,0,0
4,2.5,3520,7815,2.0,0,3,3,10,3140,380,1929,0,98199,47.6429,-122.412,2790,6644,1400000,25,3,2015,0,86,4295,3854,0,1,1
3,1.75,1370,9288,1.0,0,0,4,7,1370,0,1988,0,98059,47.4824,-122.152,1500,9864,301950,18,7,2014,0,26,7918,8364,0,0,0
3,3.0,2340,2970,2.0,0,0,5,8,2160,180,1925,0,98103,47.6868,-122.348,1370,4000,660000,12,6,2014,0,89,630,2630,0,1,1
4,2.5,3170,10688,2.0,0,2,3,9,3170,0,2001,0,98001,47.3179,-122.257,3100,12610,455000,11,6,2014,0,13,7518,9510,0,0,0
3,1.75,1380,5060,1.0,0,0,3,7,1380,0,1986,0,98133,47.7059,-122.341,1030,5060,375000,16,12,2014,0,28,3680,4030,0,0,1
4,2.5,2700,6769,2.0,0,0,3,9,2700,0,1999,0,98042,47.3753,-122.155,2880,7968,470000,15,1,2015,0,16,4069,5088,0,0,0
3,2.5,1300,10484,2.0,0,0,3,8,1300,0,1983,0,98028,47.7768,-122.268,1380,7868,374990,31,3,2015,0,32,9184,6488,0,0,0
2,2.5,1900,3690,2.0,0,0,3,8,1900,0,2006,0,98053,47.7082,-122.019,1900,5153,541500,17,4,2015,0,9,1790,3253,0,0,0
3,2.5,3750,7821,2.0,0,0,3,9,3750,0,2001,0,98074,47.6325,-122.064,3210,8405,782500,24,4,2015,0,14,4071,5195,0,0,0
3,2.25,1552,3677,2.0,0,0,3,7,1552,0,2012,0,98092,47.3205,-122.178,1677,3677,264000,7,5,2015,0,3,2125,2000,0,0,0
4,2.5,2500,7417,2.0,0,0,3,9,2500,0,1991,0,98074,47.6251,-122.026,2770,8188,640000,15,7,2014,0,23,4917,5418,0,0,0
3,2.0,1770,8141,1.0,0,0,5,8,1770,0,1952,0,98177,47.7232,-122.371,1770,8100,660000,13,2,2015,0,63,6371,6330,0,0,1
3,2.5,2170,8140,2.0,0,0,3,9,2170,0,1994,0,98030,47.385,-122.169,2390,8100,389950,17,3,2015,0,21,5970,5710,0,0,0
3,2.25,1570,8111,2.0,0,0,3,8,1570,0,1984,0,98074,47.6324,-122.028,1990,7875,485000,23,2,2015,0,31,6541,5885,0,0,0
4,2.5,2480,4602,2.0,0,0,3,9,2480,0,2000,0,98052,47.6835,-122.161,3480,5739,840000,13,4,2015,0,15,2122,2259,0,0,0
2,1.0,1480,6210,1.0,0,0,3,7,1080,400,1950,0,98133,47.774,-122.351,1290,7509,331000,19,8,2014,0,64,4730,6219,0,1,1
3,2.0,2610,6000,1.0,0,0,5,7,1310,1300,1941,0,98115,47.675,-122.289,2330,4800,780000,16,10,2014,0,73,3390,2470,0,1,1
3,1.75,1700,8481,2.0,0,0,3,7,1700,0,1993,0,98003,47.2623,-122.305,1830,6600,300000,15,10,2014,0,21,6781,4770,0,0,0
3,1.75,1240,7620,1.0,0,0,3,7,1240,0,1968,2014,98166,47.4576,-122.348,1150,7620,361810,17,9,2014,46,46,6380,6470,1,0,1
3,1.0,1660,6582,1.0,0,0,5,7,1000,660,1946,0,98133,47.7169,-122.353,1110,6584,467000,15,5,2014,0,68,4922,5474,0,1,1
3,1.75,1620,10000,1.5,0,0,5,6,1620,0,1918,0,98178,47.5091,-122.262,1880,10000,399000,26,12,2014,0,96,8380,8120,0,0,1
3,1.75,1130,7500,1.5,0,0,4,7,1130,0,1908,0,98108,47.5254,-122.318,1240,6000,315450,15,10,2014,0,106,6370,4760,0,0,1
3,1.0,1310,5000,1.5,0,0,3,7,1310,0,1906,0,98103,47.6624,-122.347,1530,4800,600000,1,5,2015,0,109,3690,3270,0,0,1
4,2.0,1710,5200,1.0,0,0,4,7,910,800,1977,0,98042,47.3634,-122.09,1560,5200,247500,25,3,2015,0,38,3490,3640,0,1,0
3,1.0,2140,5037,1.0,0,0,3,7,2140,0,1957,0,98118,47.5494,-122.274,1630,6054,330000,30,1,2015,0,58,2897,4424,0,0,1
4,2.25,2350,7210,1.5,0,0,4,7,2350,0,1972,0,98011,47.7407,-122.183,1930,7519,500000,26,8,2014,0,42,4860,5589,0,0,0
3,1.0,1570,10050,1.0,0,0,3,7,1570,0,1963,0,98028,47.736,-122.231,2540,9940,367500,20,8,2014,0,51,8480,7400,0,0,0
4,1.75,2540,7620,1.0,0,3,3,8,1320,1220,1948,0,98116,47.5709,-122.406,2540,8613,655000,6,8,2014,0,66,5080,6073,0,1,1
5,2.75,2500,7140,1.0,0,0,4,7,1250,1250,1968,0,98008,47.6225,-122.108,2230,8400,530000,18,10,2014,0,46,4640,6170,0,1,0
3,2.0,1760,2875,2.0,0,2,3,7,1290,470,1988,0,98126,47.5602,-122.378,1760,4830,437500,25,11,2014,0,26,1115,3070,0,1,1
3,1.75,1760,10349,1.0,0,0,3,8,1760,0,1957,0,98005,47.6347,-122.173,1970,10933,575000,3,2,2015,0,58,8589,8963,0,0,0
4,2.5,1940,6887,2.0,0,0,3,7,1940,0,1990,0,98023,47.2911,-122.353,1870,6144,278000,7,11,2014,0,24,4947,4274,0,0,0
4,2.5,3010,6181,2.0,0,0,3,9,3010,0,2000,0,98056,47.5212,-122.192,2960,6515,568500,4,9,2014,0,14,3171,3555,0,0,0
4,3.0,2460,9606,1.0,0,0,3,8,2460,0,2012,0,98168,47.4889,-122.317,1730,7500,280000,26,3,2015,0,3,7146,5770,0,0,1
2,1.0,750,6350,1.0,0,0,3,5,750,0,1920,0,98103,47.6938,-122.356,920,6350,250000,19,8,2014,0,94,5600,5430,0,0,1
5,2.75,3710,13874,1.5,0,3,4,9,2340,1370,1977,0,98006,47.5686,-122.154,3370,13874,1250000,4,12,2014,0,37,10164,10504,0,1,0
3,2.5,3190,6899,2.0,0,0,3,9,3190,0,2014,0,98034,47.7153,-122.221,3190,6899,814842,11,7,2014,0,0,3709,3709,0,0,0
4,2.5,2181,5521,2.0,0,0,3,8,2181,0,2006,0,98001,47.3503,-122.291,2333,5143,340000,13,2,2015,0,9,3340,2810,0,0,0
3,1.75,1890,9100,2.0,0,0,4,7,1890,0,1952,0,98133,47.7676,-122.339,1640,9100,359950,10,6,2014,0,62,7210,7460,0,0,1
3,1.75,2610,5544,1.5,0,0,3,8,1680,930,1934,0,98117,47.684,-122.376,1330,5074,750000,21,6,2014,0,80,2934,3744,0,1,1
4,2.0,3090,8125,2.5,0,0,5,8,3090,0,1918,0,98117,47.6851,-122.395,1560,6250,1220000,26,9,2014,0,96,5035,4690,0,0,1
2,1.0,860,5040,1.0,0,0,3,7,860,0,1956,0,98117,47.6977,-122.365,1570,5040,370000,3,7,2014,0,58,4180,3470,0,0,1
3,1.0,1000,9170,1.0,0,0,3,7,1000,0,1980,0,98058,47.4405,-122.134,1610,9170,329950,15,4,2015,0,35,8170,7560,0,0,0
4,2.5,2960,5054,2.0,0,0,3,9,2960,0,2006,0,98038,47.3601,-122.035,2960,5000,385000,16,6,2014,0,8,2094,2040,0,0,0
2,1.0,1280,4635,1.0,0,0,3,6,840,440,1917,0,98118,47.5532,-122.28,1660,6180,230000,20,4,2015,0,98,3355,4520,0,1,1
4,3.5,3230,7200,1.0,0,1,3,10,1640,1590,2000,0,98033,47.6838,-122.212,2660,7200,1390000,30,7,2014,0,14,3970,4540,0,1,0
3,2.0,1830,4992,1.0,0,0,3,7,1230,600,1953,0,98118,47.5145,-122.27,2050,7740,210000,18,12,2014,0,61,3162,5690,0,1,1
3,1.75,1420,13187,1.0,0,0,4,7,1420,0,1974,0,98059,47.4608,-122.065,1620,13824,293000,31,7,2014,0,40,11767,12204,0,0,0
3,1.0,1580,3774,1.5,0,0,3,6,1580,0,1900,0,98117,47.6839,-122.361,1580,3860,465000,30,10,2014,0,114,2194,2280,0,0,1
2,1.75,1670,10725,1.0,0,0,3,7,1670,0,1965,0,98178,47.4893,-122.229,1600,10725,325000,14,4,2015,0,50,9055,9125,0,0,1
3,2.0,1670,7056,1.0,0,0,4,7,1670,0,1958,0,98002,47.3139,-122.212,1330,8415,180000,19,8,2014,0,56,5386,7085,0,0,0
6,3.0,2960,5000,1.0,0,0,3,8,1790,1170,1968,0,98103,47.6971,-122.341,1280,1251,650000,13,4,2015,0,47,2040,-29,0,1,1
4,2.75,2420,7102,1.0,0,0,5,7,1670,750,1946,0,98177,47.7042,-122.371,1620,7102,665000,24,9,2014,0,68,4682,5482,0,1,1
3,2.0,1420,16000,1.0,0,0,3,7,1420,0,1966,0,98166,47.478,-122.358,1900,12630,324450,17,10,2014,0,48,14580,10730,0,0,1
4,1.75,2170,5750,1.0,0,2,3,7,1370,800,1975,0,98116,47.5668,-122.383,1450,5750,588000,6,3,2015,0,40,3580,4300,0,1,1
4,1.0,1310,5200,1.5,0,0,3,6,1160,150,1945,0,98126,47.5384,-122.37,1090,5180,200000,21,5,2014,0,69,3890,4090,0,1,1
4,1.75,1830,11090,1.0,0,0,3,7,1060,770,1962,0,98028,47.7333,-122.246,1990,10917,383000,5,9,2014,0,52,9260,8927,0,1,0
3,2.0,1360,2500,1.0,0,0,3,7,730,630,1986,0,98107,47.6753,-122.363,1630,5000,499950,15,12,2014,0,28,1140,3370,0,1,1
5,2.5,3440,12350,1.0,0,2,4,9,1760,1680,1976,0,98003,47.3427,-122.325,3440,12763,549000,21,4,2015,0,39,8910,9323,0,1,0
5,3.0,2010,7264,1.0,0,0,3,7,1290,720,1990,0,98103,47.6945,-122.33,1510,7326,465000,22,1,2015,0,25,5254,5816,0,1,1
4,2.5,3030,7800,2.0,0,0,3,9,1580,1450,1991,0,98033,47.689,-122.196,2840,7435,799900,23,4,2015,0,24,4770,4595,0,1,0
3,3.5,4310,10842,2.0,0,2,3,10,3140,1170,1988,0,98177,47.7735,-122.386,2280,11106,1200000,22,8,2014,0,26,6532,8826,0,1,1
4,2.5,2120,15000,2.0,0,0,4,8,2120,0,1983,0,98052,47.7159,-122.1,2170,15000,637000,23,2,2015,0,32,12880,12830,0,0,0
4,1.0,2210,4366,2.0,0,0,3,8,2210,0,1901,0,98122,47.6105,-122.309,1740,1745,589000,16,12,2014,0,113,2156,5,0,0,1
3,1.75,1400,10350,1.0,0,0,4,7,1400,0,1976,0,98059,47.479,-122.132,1780,10457,305000,24,7,2014,0,38,8950,8677,0,0,0
4,2.25,2760,5200,2.0,0,0,3,7,1790,970,1910,2003,98144,47.589,-122.313,1310,2059,600000,31,3,2015,93,105,2440,749,1,1,1
4,2.5,2550,6256,2.0,0,0,3,9,2550,0,1992,0,98072,47.7742,-122.166,2460,8256,587000,31,5,2014,0,22,3706,5796,0,0,0
2,2.5,2220,4000,2.0,0,0,3,9,2220,0,2000,0,98112,47.6364,-122.28,1870,4000,1430000,5,5,2014,0,14,1780,2130,0,0,1
4,1.0,1320,11212,1.0,0,0,5,6,1320,0,1914,0,98002,47.3098,-122.209,1060,6766,250000,12,3,2015,0,101,9892,5706,0,0,0
3,3.0,2440,3202,2.0,0,0,4,8,1640,800,1982,0,98133,47.7152,-122.342,2440,3200,515000,24,4,2015,0,33,762,760,0,1,1
4,2.75,3780,10308,2.0,0,0,3,10,3780,0,1999,0,98075,47.589,-121.983,3500,10740,833000,9,5,2014,0,15,6528,7240,0,0,0
4,3.0,2360,6678,1.0,0,0,3,8,1760,600,1949,0,98115,47.6919,-122.313,1640,6380,550000,8,9,2014,0,65,4318,4740,0,1,1
2,1.0,890,6000,1.0,0,0,2,6,890,0,1919,0,98178,47.4976,-122.225,1100,6000,180000,19,3,2015,0,96,5110,4900,0,0,1
4,1.75,1770,9375,1.0,0,0,4,7,1170,600,1968,0,98052,47.6935,-122.112,1540,9375,507000,18,6,2014,0,46,7605,7835,0,1,0
3,3.5,2490,2722,2.0,0,0,3,8,2020,470,1999,0,98005,47.5893,-122.165,2490,2755,616950,20,11,2014,0,15,232,265,0,1,0
4,1.75,1890,10550,1.0,0,0,5,7,1010,880,1969,0,98056,47.5147,-122.193,1930,7291,372000,15,7,2014,0,45,8660,5361,0,1,0
2,1.0,1020,6380,1.0,0,0,3,7,1020,0,1930,1973,98115,47.6971,-122.317,1380,6380,290000,6,10,2014,43,84,5360,5000,1,0,1
4,2.75,2420,8438,2.0,0,0,3,8,2420,0,1997,0,98022,47.2089,-122.011,2270,8770,329990,9,3,2015,0,18,6018,6500,0,0,0
3,1.75,1600,8156,1.0,0,0,5,7,1600,0,1948,0,98155,47.7397,-122.3,1200,8156,393500,13,10,2014,0,66,6556,6956,0,0,1
5,3.25,3370,17458,1.0,0,2,5,10,2000,1370,1982,0,98040,47.5591,-122.229,4240,15202,1550000,13,5,2014,0,32,14088,10962,0,1,0
4,2.25,1720,8300,1.0,0,0,4,8,1720,0,1973,0,98023,47.3192,-122.385,2010,8000,240000,22,5,2014,0,41,6580,5990,0,0,0
3,1.0,1090,8640,1.0,0,0,4,6,1090,0,1973,0,98166,47.459,-122.355,1260,8400,285000,13,5,2014,0,41,7550,7140,0,0,1
3,1.5,1090,9862,1.0,0,0,3,8,1090,0,1987,0,98074,47.6256,-122.036,1710,9862,382500,14,4,2015,0,28,8772,8152,0,0,0
4,3.75,3600,16101,1.0,0,0,3,9,3600,0,1951,0,98112,47.6308,-122.287,3650,9506,1930000,31,3,2015,0,64,12501,5856,0,0,1
3,2.5,2760,9471,1.0,0,2,3,8,1760,1000,1956,0,98115,47.676,-122.272,3040,6765,800000,29,8,2014,0,58,6711,3725,0,1,1
4,1.75,2520,15205,1.0,0,0,4,7,2040,480,1954,0,98028,47.7642,-122.264,1680,10000,387846,15,12,2014,0,60,12685,8320,0,1,0
5,1.0,1760,4264,2.0,0,0,3,8,1760,0,1902,0,98112,47.6246,-122.312,2130,4264,780500,4,8,2014,0,112,2504,2134,0,0,1
3,1.75,1090,6775,1.0,0,0,4,7,850,240,1950,0,98115,47.6934,-122.321,1580,5760,680000,5,5,2015,0,65,5685,4180,0,1,1
5,1.75,1960,7875,1.0,0,0,4,7,1960,0,1968,0,98034,47.7256,-122.18,1800,7764,434400,24,12,2014,0,46,5915,5964,0,0,0
2,1.0,1220,17172,1.0,0,0,4,6,1220,0,1947,0,98033,47.6934,-122.163,1510,12915,370000,12,6,2014,0,67,15952,11405,0,0,0
3,1.75,1730,8073,1.0,0,0,3,8,1350,380,1971,0,98177,47.7694,-122.367,2500,8073,465000,13,3,2015,0,44,6343,5573,0,1,1
3,2.0,1830,6925,1.0,0,0,4,8,1830,0,1979,0,98058,47.4445,-122.123,2010,7350,323000,27,3,2015,0,36,5095,5340,0,0,0
4,2.5,1600,9921,2.0,0,0,3,7,1600,0,2009,0,98042,47.3678,-122.124,2140,5806,270000,5,1,2015,0,6,8321,3666,0,0,0
4,2.5,2710,6583,2.0,0,0,3,9,2710,0,2003,0,98059,47.4922,-122.141,2710,6583,560000,27,6,2014,0,11,3873,3873,0,0,0
3,1.0,1140,4500,1.0,0,0,3,6,840,300,1907,0,98144,47.5897,-122.314,1150,3000,450000,28,4,2015,0,108,3360,1850,0,1,1
2,1.0,930,7740,1.0,0,0,3,6,930,0,1924,0,98125,47.7091,-122.292,1250,7740,290000,26,6,2014,0,90,6810,6490,0,0,1
5,3.0,2380,5000,2.0,0,0,5,7,2380,0,1909,0,98107,47.6722,-122.389,1800,4650,705000,4,3,2015,0,106,2620,2850,0,0,1
3,2.25,1860,7200,1.0,0,0,4,7,1240,620,1977,0,98034,47.7332,-122.192,1560,7630,445000,8,8,2014,0,37,5340,6070,0,1,0
3,1.0,1440,11925,1.0,0,0,3,7,1440,0,1968,0,98003,47.2738,-122.3,1440,10425,229900,21,7,2014,0,46,10485,8985,0,0,0
4,2.5,2980,5896,2.0,0,0,3,8,2980,0,2001,0,98053,47.6872,-122.036,2900,5712,610000,10,3,2015,0,14,2916,2812,0,0,0
3,3.25,2670,5108,2.0,0,2,3,9,2670,0,2000,0,98065,47.5342,-121.866,2670,6500,535000,10,12,2014,0,14,2438,3830,0,0,0
3,1.75,2150,8925,1.0,0,0,4,7,2150,0,1960,0,98008,47.6253,-122.119,1100,7875,437400,4,2,2015,0,55,6775,6775,0,0,0
5,2.75,3160,10059,2.0,0,0,3,10,1740,1420,1978,0,98011,47.7477,-122.217,3120,11557,540000,12,8,2014,0,36,6899,8437,0,1,0
3,2.5,2810,4607,2.0,0,0,3,8,2810,0,2004,0,98011,47.7735,-122.227,2540,4871,533000,9,10,2014,0,10,1797,2331,0,0,0
3,2.5,2690,4819,2.0,0,0,3,7,2690,0,2004,0,98065,47.5302,-121.849,2360,4829,555000,3,4,2015,0,11,2129,2469,0,0,0
3,1.75,1230,9600,1.0,0,0,4,7,1230,0,1984,0,98042,47.3675,-122.095,1330,8250,239950,23,6,2014,0,30,8370,6920,0,0,0
3,1.0,950,9451,1.0,0,0,4,7,950,0,1977,0,98034,47.7308,-122.19,1480,8352,350000,8,1,2015,0,38,8501,6872,0,0,0
2,1.0,1200,4880,1.0,0,0,3,6,980,220,1943,0,98106,47.5276,-122.346,1040,4880,245000,16,6,2014,0,71,3680,3840,0,1,1
4,1.75,1670,9886,1.0,0,0,5,7,1670,0,1947,0,98125,47.7249,-122.287,2590,9997,456000,5,6,2014,0,67,8216,7407,0,0,1
4,2.25,2140,7701,1.0,0,0,4,7,1470,670,1977,0,98034,47.7213,-122.171,2130,8050,465000,13,8,2014,0,37,5561,5920,0,1,0
2,1.75,1440,4660,1.0,0,2,3,8,1440,0,2008,0,98053,47.7092,-122.015,1680,4989,445000,7,1,2015,0,7,3220,3309,0,0,0
5,2.75,3050,7500,1.0,0,0,4,8,1800,1250,1966,0,98034,47.7249,-122.187,2060,7848,517850,28,7,2014,0,48,4450,5788,0,1,0
5,2.75,2570,7260,2.0,0,0,3,8,2570,0,1996,0,98092,47.2622,-122.212,2200,7421,329000,30,9,2014,0,18,4690,5221,0,0,0
3,2.5,1840,2875,2.0,0,0,4,7,1840,0,1997,0,98116,47.562,-122.393,1240,5750,512500,15,5,2014,0,17,1035,4510,0,0,1
2,1.0,1250,8100,1.0,0,0,4,7,1250,0,1947,0,98125,47.7294,-122.329,1710,8100,365000,4,6,2014,0,67,6850,6390,0,0,1
3,1.0,1410,9384,1.0,0,0,3,7,1410,0,1948,0,98133,47.7161,-122.33,1990,9384,450500,20,3,2015,0,67,7974,7394,0,0,1
3,1.0,1560,8232,1.0,0,0,3,7,1560,0,1952,0,98004,47.623,-122.205,1930,8286,915000,16,10,2014,0,62,6672,6356,0,0,0
3,1.0,960,7314,1.0,0,0,5,6,960,0,1960,0,98002,47.2891,-122.221,990,7314,205000,20,6,2014,0,54,6354,6324,0,0,0
4,2.5,1870,8449,2.0,0,0,3,8,1870,0,1992,0,98188,47.4435,-122.274,2160,8113,314000,11,8,2014,0,22,6579,5953,0,0,1
2,1.0,900,9260,1.0,0,0,3,7,900,0,1946,0,98107,47.6695,-122.36,1230,6913,496000,2,7,2014,0,68,8360,5683,0,0,1
4,1.0,2050,7590,1.0,0,0,3,7,1280,770,1957,0,98178,47.4916,-122.224,2050,7800,329950,16,4,2015,0,58,5540,5750,0,1,1
4,2.0,2400,6000,2.0,0,0,3,6,2400,0,1913,1945,98011,47.7607,-122.209,1780,8732,375000,16,6,2014,32,101,3600,6952,1,0,0
3,2.5,1850,7777,2.0,0,0,5,8,1850,0,1989,0,98033,47.6908,-122.169,1850,8482,623000,20,6,2014,0,25,5927,6632,0,0,0
4,1.5,1220,9600,1.0,0,0,3,6,1220,0,1980,0,98014,47.6462,-121.909,1180,9000,310000,19,6,2014,0,34,8380,7820,0,0,0
4,2.25,2410,4560,2.0,0,2,5,9,1800,610,1929,0,98117,47.6796,-122.402,2150,5100,960000,28,5,2014,0,85,2150,2950,0,1,1
3,2.5,2300,9218,2.0,0,2,3,9,2300,0,1998,0,98027,47.5504,-122.077,2730,9930,683000,14,8,2014,0,16,6918,7200,0,0,0
5,2.5,2840,9425,1.0,0,0,4,7,1590,1250,1962,0,98155,47.7609,-122.297,1900,11600,425000,17,2,2015,0,53,6585,9700,0,1,1
5,2.75,1800,3780,1.5,0,0,3,7,1400,400,1926,0,98103,47.6831,-122.343,1400,3780,533000,6,5,2014,0,88,1980,2380,0,1,1
3,1.0,1190,9486,1.0,0,0,4,7,1190,0,1953,0,98166,47.4319,-122.339,2100,10400,375000,13,5,2014,0,61,8296,8300,0,0,1
3,2.0,1710,7225,2.0,0,0,4,7,1710,0,1988,0,98023,47.2917,-122.373,1710,7225,250500,4,6,2014,0,26,5515,5515,0,0,0
3,2.0,2060,4437,1.0,0,0,3,7,1030,1030,1929,0,98126,47.5705,-122.376,1750,4452,460000,11,6,2014,0,85,2377,2702,0,1,1
3,1.0,1360,6186,1.5,0,0,4,6,760,600,1941,0,98133,47.7503,-122.334,1610,7453,255544,14,4,2015,0,74,4826,5843,0,1,1
2,2.0,1680,4647,1.0,0,0,3,8,1680,0,2008,0,98053,47.7088,-122.015,1680,4950,560000,14,9,2014,0,6,2967,3270,0,0,0
4,2.5,2980,4074,2.0,0,0,3,8,2980,0,2011,0,98019,47.734,-121.965,2320,4255,480000,11,2,2015,0,4,1094,1935,0,0,0
3,2.75,2650,9752,1.0,0,0,3,9,2650,0,1989,0,98028,47.768,-122.259,3030,9910,580000,26,4,2015,0,26,7102,6880,0,0,0
3,2.5,1700,9100,1.0,0,0,3,8,1160,540,1998,0,98126,47.5369,-122.378,1590,8374,475000,28,6,2014,0,16,7400,6784,0,1,1
3,2.5,2520,10223,2.0,0,0,3,10,2520,0,1988,0,98074,47.631,-122.042,2630,10091,590000,17,9,2014,0,26,7703,7461,0,0,0
3,2.5,1630,8346,1.0,0,0,3,8,1630,0,1990,0,98092,47.2622,-122.219,2110,8619,264500,22,2,2015,0,25,6716,6509,0,0,0
2,1.0,730,2600,1.0,0,0,4,6,730,0,1918,0,98107,47.6751,-122.379,1480,3900,465000,27,10,2014,0,96,1870,2420,0,0,1
3,1.0,910,7620,1.0,0,2,3,7,910,0,1971,0,98106,47.5278,-122.343,1660,7620,290000,23,3,2015,0,44,6710,5960,0,0,1
4,4.5,4510,12873,2.0,0,2,3,12,4510,0,1998,0,98033,47.6491,-122.201,2200,8528,1820000,21,11,2014,0,16,8363,6328,0,0,0
3,1.0,1110,12150,1.0,0,0,4,7,1110,0,1957,0,98008,47.6034,-122.122,1490,8200,416000,15,6,2014,0,57,11040,6710,0,0,0
4,2.0,1450,8940,1.0,0,0,3,7,1450,0,1962,0,98034,47.7304,-122.24,1310,8914,360000,28,1,2015,0,53,7490,7604,0,0,0
4,2.75,2600,2750,1.5,0,0,3,7,1620,980,1936,0,98119,47.6413,-122.357,1960,3705,840000,12,5,2014,0,78,150,1745,0,1,1
2,1.0,730,9975,1.0,0,0,1,5,730,0,1943,0,98168,47.4808,-122.315,860,9000,81000,24,3,2015,0,72,9245,8140,0,0,1
3,2.25,2440,9200,1.0,0,1,4,8,2440,0,1950,0,98105,47.6629,-122.269,2750,6211,1290000,30,1,2015,0,65,6760,3461,0,0,1
4,1.75,2290,7380,1.0,0,0,3,7,1390,900,1963,0,98178,47.5034,-122.245,1170,7381,326000,25,11,2014,0,51,5090,6211,0,1,1
2,1.0,720,7500,1.0,0,2,3,6,720,0,1925,0,98136,47.5185,-122.392,1390,5000,447000,24,2,2015,0,90,6780,3610,0,0,1
3,1.0,940,7125,1.5,0,0,4,7,940,0,1958,0,98032,47.3756,-122.297,1170,7125,185000,3,10,2014,0,56,6185,5955,0,0,0
3,2.5,1540,7773,2.0,0,0,4,8,1540,0,1982,0,98034,47.722,-122.194,1630,7340,439950,23,7,2014,0,32,6233,5710,0,0,0
3,1.5,1140,10300,1.5,0,0,4,6,1140,0,1967,0,98045,47.4452,-121.77,1250,9975,234000,1,10,2014,0,47,9160,8725,0,0,0
4,2.5,2100,8886,2.0,0,0,4,7,2100,0,1964,0,98007,47.5947,-122.134,1840,9058,485000,31,12,2014,0,50,6786,7218,0,0,0
4,1.75,2670,6250,2.0,0,0,4,8,2020,650,1941,0,98199,47.6499,-122.391,1820,6250,750000,15,7,2014,0,73,3580,4430,0,1,1
4,2.0,2750,5527,2.0,0,0,3,8,2130,620,1901,1987,98119,47.6513,-122.368,1290,1764,865000,7,5,2015,86,114,2777,474,1,1,1
4,2.5,2570,9000,1.0,0,0,4,8,1590,980,1979,0,98023,47.2986,-122.372,2120,8571,287500,18,6,2014,0,35,6430,6451,0,1,0
3,1.75,1660,9673,1.0,0,0,3,7,1130,530,1976,0,98072,47.7628,-122.162,1260,9681,375000,8,7,2014,0,38,8013,8421,0,1,0
3,2.25,1700,8800,1.0,0,0,5,7,850,850,1969,0,98033,47.6863,-122.189,2180,8960,565000,5,9,2014,0,45,7100,6780,0,1,0
4,3.0,1530,8306,2.0,0,0,3,7,1530,0,2010,0,98042,47.3528,-122.146,1930,6925,260000,19,2,2015,0,5,6776,4995,0,0,0
3,1.0,1260,10900,1.0,0,0,4,6,1260,0,1943,0,98056,47.491,-122.188,1090,8137,190000,17,10,2014,0,71,9640,7047,0,0,0
5,2.0,2760,6420,1.0,0,0,5,7,1380,1380,1964,0,98118,47.5396,-122.276,1400,7112,399950,9,9,2014,0,50,3660,5712,0,1,1
3,2.5,1830,7062,2.0,0,0,3,7,1830,0,1990,0,98023,47.2895,-122.352,1820,6434,275000,26,3,2015,0,25,5232,4614,0,0,0
3,2.75,2160,4086,1.0,0,0,3,7,1380,780,1987,0,98126,47.5352,-122.38,1300,4080,528000,2,12,2014,0,27,1926,2780,0,1,1
3,2.0,1770,9685,1.0,0,0,3,5,1770,0,1948,0,98166,47.4753,-122.342,1520,11122,315000,17,10,2014,0,66,7915,9602,0,0,1
2,2.25,2210,5500,1.0,0,0,4,8,1410,800,1968,0,98117,47.697,-122.39,2140,6600,614306,21,8,2014,0,46,3290,4460,0,1,1
3,3.5,4560,14608,2.0,0,2,3,12,4560,0,1990,0,98034,47.6995,-122.228,4050,14226,1490000,31,3,2015,0,25,10048,10176,0,0,0
3,2.5,2110,3870,2.0,0,0,3,9,2110,0,2004,0,98029,47.5513,-121.994,2300,3870,590000,29,7,2014,0,10,1760,1570,0,0,0
3,1.0,1130,3600,1.0,0,0,3,6,1130,0,1908,0,98144,47.5978,-122.299,1710,2231,261500,17,3,2015,0,107,2470,521,0,0,1
4,2.5,1960,9898,2.0,0,0,3,8,1960,0,2001,0,98030,47.3834,-122.168,2130,7662,300000,23,5,2014,0,13,7938,5532,0,0,0
3,2.25,2230,4551,1.5,0,2,5,8,1450,780,1928,0,98178,47.5078,-122.236,2060,7200,439000,4,9,2014,0,86,2321,5140,0,1,1
5,2.25,2350,13000,1.0,0,0,3,7,2350,0,1961,0,98178,47.4939,-122.256,1570,11440,277554,4,9,2014,0,53,10650,9870,0,0,1
3,2.0,1340,8505,1.0,0,0,3,6,1340,0,1931,0,98168,47.4727,-122.297,1370,9000,215000,23,6,2014,0,83,7165,7630,0,0,1
4,2.0,1700,6375,1.0,0,0,4,7,850,850,1950,0,98115,47.6973,-122.295,1470,8360,420000,24,2,2015,0,65,4675,6890,0,1,1
3,2.5,1650,3436,2.0,0,0,3,7,1650,0,2003,0,98053,47.6819,-122.036,1680,3446,485000,8,4,2015,0,12,1786,1766,0,0,0
3,2.0,1540,8316,1.0,0,0,5,6,1540,0,1954,0,98002,47.323,-122.216,1250,8316,202500,22,12,2014,0,60,6776,7066,0,0,0
5,3.25,3920,8572,2.0,0,0,3,9,3920,0,2007,0,98065,47.5427,-121.887,3335,7258,710000,23,2,2015,0,8,4652,3923,0,0,0
4,2.5,3250,6933,2.0,0,0,3,8,3250,0,2009,0,98059,47.4956,-122.151,3030,5308,535000,30,4,2015,0,6,3683,2278,0,0,0
4,1.75,1360,7700,1.0,0,0,4,7,1360,0,1966,0,98058,47.4558,-122.177,1321,7756,260000,18,12,2014,0,48,6340,6435,0,0,0
3,2.0,1480,7480,1.0,0,0,4,7,1480,0,1992,0,98038,47.3542,-122.055,1680,7146,254000,28,5,2014,0,22,6000,5466,0,0,0
4,2.5,2360,5226,2.0,0,0,3,8,2360,0,2001,0,98034,47.712,-122.229,2440,5156,600000,21,5,2014,0,13,2866,2716,0,0,0
3,2.5,1800,2516,2.0,0,0,3,7,1800,0,2001,0,98108,47.5401,-122.293,1800,2562,285000,25,9,2014,0,13,716,762,0,0,1
3,1.0,1200,13100,1.0,0,0,3,6,1200,0,1943,0,98168,47.475,-122.258,1960,11285,165000,23,6,2014,0,71,11900,9325,0,0,1
2,1.0,710,6960,1.0,0,0,4,6,710,0,1943,0,98178,47.4886,-122.246,940,7680,216500,6,11,2014,0,71,6250,6740,0,0,1
4,2.5,2640,5595,2.0,0,0,3,8,2640,0,2011,0,98038,47.3551,-122.054,1840,5011,387990,19,9,2014,0,3,2955,3171,0,0,0
4,2.5,3010,5040,2.0,0,0,3,8,3010,0,2006,0,98133,47.709,-122.35,1090,5040,500000,4,11,2014,0,8,2030,3950,0,0,1
4,2.5,2770,5612,2.0,0,0,3,7,2770,0,2001,0,98053,47.686,-122.036,2770,5177,650000,23,10,2014,0,13,2842,2407,0,0,0
4,2.5,2310,4079,2.0,0,0,3,8,2310,0,2008,0,98117,47.6937,-122.361,1220,4800,646000,19,6,2014,0,6,1769,3580,0,0,1
4,3.0,2060,9138,1.0,0,0,3,8,1430,630,1992,0,98092,47.321,-122.185,2250,7820,323400,30,1,2015,0,23,7078,5570,0,1,0
3,2.5,1880,4200,2.0,0,0,3,7,1880,0,2007,0,98038,47.366,-122.017,2090,4200,300000,6,8,2014,0,7,2320,2110,0,0,0
5,2.0,2280,5400,1.5,0,0,4,7,1340,940,1947,0,98105,47.6674,-122.279,1770,5000,712500,7,10,2014,0,67,3120,3230,0,1,1
3,1.75,1380,3402,1.5,0,0,3,7,1380,0,1900,2000,98122,47.6109,-122.302,1500,5496,550000,9,6,2014,100,114,2022,3996,1,0,1
3,1.0,1180,7537,1.0,0,0,3,7,1180,0,1969,0,98034,47.7233,-122.221,1220,7425,400000,17,2,2015,0,46,6357,6205,0,0,0
4,1.75,1650,7200,1.0,0,0,3,7,1100,550,1977,0,98031,47.3944,-122.187,1620,7374,255000,28,10,2014,0,37,5550,5754,0,1,0
3,1.75,2030,9032,2.0,0,2,4,7,2030,0,1963,0,98008,47.586,-122.117,2350,8937,660000,5,12,2014,0,51,7002,6587,0,0,0
4,2.25,2110,6375,1.0,0,2,4,8,1600,510,1941,0,98115,47.6819,-122.272,2760,6375,925000,23,3,2015,0,74,4265,3615,0,1,1
4,2.25,2130,7210,1.0,0,0,5,7,1330,800,1965,0,98008,47.629,-122.117,1310,7896,534000,5,8,2014,0,49,5080,6586,0,1,0
3,1.0,1690,7700,1.0,0,0,4,7,1690,0,1969,0,98003,47.3444,-122.304,1590,7700,215000,19,11,2014,0,45,6010,6110,0,0,0
3,2.5,2510,12779,1.5,0,4,3,10,2510,0,1968,0,98034,47.6982,-122.231,2810,12225,1950000,14,10,2014,0,46,10269,9415,0,0,0
5,4.25,3530,7924,2.0,0,0,3,10,3530,0,2001,0,98040,47.5894,-122.243,1750,9226,1400000,13,5,2014,0,13,4394,7476,0,0,0
3,1.75,1470,8350,1.0,0,0,3,7,1470,0,1990,0,98001,47.2587,-122.253,1590,8182,212000,3,2,2015,0,25,6880,6592,0,0,0
3,1.75,1840,7300,1.0,0,0,3,8,1840,0,1966,0,98023,47.3122,-122.369,1920,8010,265000,19,6,2014,0,48,5460,6090,0,0,0
3,1.75,1860,5750,1.5,0,0,5,6,1300,560,1918,0,98116,47.5586,-122.383,1550,5750,400000,5,12,2014,0,96,3890,4200,0,1,1
4,2.5,1940,10133,2.0,0,0,3,8,1940,0,1992,0,98031,47.3877,-122.171,1940,7265,311500,13,2,2015,0,23,8193,5325,0,0,0
2,1.0,800,6050,1.0,0,0,4,6,800,0,1944,0,98178,47.5001,-122.242,880,6050,225000,17,10,2014,0,70,5250,5170,0,0,1
3,1.0,1400,8710,1.0,0,0,4,7,1400,0,1948,0,98146,47.5066,-122.377,1460,8710,380000,11,2,2015,0,67,7310,7250,0,0,1
4,2.5,2250,11370,2.0,0,0,3,8,2250,0,1991,0,98034,47.7115,-122.239,2190,9611,600000,8,7,2014,0,23,9120,7421,0,0,0
3,2.25,2230,9053,2.0,0,0,4,9,2230,0,1987,0,98007,47.6594,-122.144,2390,8038,600000,21,5,2014,0,27,6823,5648,0,0,0
3,2.5,1950,3000,2.0,0,0,3,7,1950,0,2001,0,98146,47.4938,-122.337,1620,6000,315000,18,12,2014,0,13,1050,4380,0,0,1
5,1.0,2550,4623,2.5,0,0,4,9,2550,0,1905,0,98122,47.6092,-122.294,1570,3875,847000,3,6,2014,0,109,2073,2305,0,0,1
4,2.5,2750,10351,2.0,0,0,3,10,2750,0,1998,0,98075,47.5894,-121.98,3370,10351,730000,9,4,2015,0,17,7601,6981,0,0,0
4,2.0,2290,11137,1.0,0,0,4,8,2290,0,1955,0,98004,47.5887,-122.201,2300,10463,1060000,14,5,2014,0,59,8847,8163,0,0,0
2,1.75,1720,5785,1.0,0,0,3,6,860,860,1948,2002,98118,47.5554,-122.274,1680,5184,664000,15,4,2015,54,67,4065,3504,1,1,1
4,3.0,2810,6000,2.0,0,0,3,9,2810,0,2007,0,98038,47.3689,-122.057,2790,6000,454450,27,4,2015,0,8,3190,3210,0,0,0
3,1.0,940,4200,1.0,0,0,3,7,940,0,1955,0,98103,47.6878,-122.35,1380,4080,341000,16,1,2015,0,60,3260,2700,0,0,1
4,1.0,1190,8875,1.5,0,0,4,7,1190,0,1946,0,98155,47.7487,-122.303,1190,8875,276693,29,10,2014,0,68,7685,7685,0,0,1
2,1.0,1390,11340,1.0,0,0,4,7,1390,0,1969,0,98168,47.4969,-122.3,1200,10224,185000,19,11,2014,0,45,9950,9024,0,0,1
2,2.5,1660,2258,2.0,0,0,3,7,1660,0,1981,0,98042,47.3793,-122.146,1740,2390,160000,17,9,2014,0,33,598,650,0,0,0
4,2.5,1920,8497,2.0,0,0,3,8,1920,0,1998,0,98092,47.2608,-122.209,1940,8436,270000,2,6,2014,0,16,6577,6496,0,0,0
4,1.5,1460,8760,1.0,0,0,3,7,1460,0,1958,0,98166,47.4698,-122.36,1610,9375,300000,18,7,2014,0,56,7300,7765,0,0,1
3,1.5,1370,10115,1.0,0,0,4,7,1370,0,1957,0,98022,47.2027,-122.0,1450,9282,264950,29,8,2014,0,57,8745,7832,0,0,0
2,1.0,1050,6250,1.0,0,0,4,6,840,210,1943,0,98168,47.5024,-122.333,1310,12500,209950,1,4,2015,0,72,5200,11190,0,1,1
3,2.5,3360,8708,2.0,0,0,3,9,3360,0,2006,0,98053,47.7037,-122.016,1810,4764,850000,30,3,2015,0,9,5348,2954,0,0,0
4,2.5,3160,11380,2.0,0,0,3,9,3160,0,1983,0,98074,47.6318,-122.039,2970,10385,645000,16,5,2014,0,31,8220,7415,0,0,0
3,2.5,2070,5013,2.0,0,0,3,8,2070,0,1987,0,98023,47.3202,-122.395,1670,5013,289950,21,8,2014,0,27,2943,3343,0,0,0
4,2.75,3260,4900,2.0,0,0,3,9,3260,0,2013,0,98059,47.4812,-122.123,3260,6132,565000,20,6,2014,0,1,1640,2872,0,0,0
3,2.25,1950,9600,1.0,0,0,4,7,1200,750,1987,0,98092,47.2762,-122.148,1760,8850,260000,22,12,2014,0,27,7650,7090,0,1,0
3,1.75,1330,10523,1.0,0,0,3,7,1000,330,1981,0,98055,47.4605,-122.206,1320,8775,295500,30,7,2014,0,33,9193,7455,0,1,0
4,2.0,1190,7877,1.5,0,0,5,7,1190,0,1946,0,98155,47.7538,-122.322,1480,9975,329000,11,12,2014,0,68,6687,8495,0,0,1
3,1.75,2770,15232,1.0,0,0,3,8,1570,1200,1976,0,98006,47.5706,-122.16,2340,11400,750000,30,3,2015,0,39,12462,9060,0,1,0
4,2.5,2310,7555,2.0,0,0,3,9,2310,0,1997,0,98155,47.7544,-122.303,1980,8416,495000,25,2,2015,0,18,5245,6436,0,0,1
3,1.75,1580,5750,1.0,0,2,4,8,1330,250,1947,0,98199,47.6339,-122.392,2480,5750,672500,4,5,2015,0,68,4170,3270,0,1,1
5,3.25,2800,3200,1.5,0,0,5,10,1910,890,1932,2002,98109,47.6421,-122.35,2450,3500,1310000,8,5,2014,70,82,400,1050,1,1,1
3,2.5,1500,9636,2.0,0,0,3,7,1500,0,1994,0,98011,47.75,-122.176,1700,9656,405000,1,8,2014,0,20,8136,7956,0,0,0
3,1.75,2140,5808,1.0,0,1,3,7,1070,1070,1947,0,98119,47.6435,-122.373,1930,5808,620000,16,1,2015,0,68,3668,3878,0,1,1
4,2.25,2330,7020,1.0,0,0,4,8,1450,880,1973,0,98006,47.562,-122.139,2330,8500,615000,22,9,2014,0,41,4690,6170,0,1,0
6,2.25,3830,11180,1.0,0,2,5,9,2440,1390,1962,0,98008,47.5849,-122.113,2500,10400,887000,4,9,2014,0,52,7350,7900,0,1,0
4,2.75,4510,5000,2.5,0,2,3,8,3270,1240,1941,2000,98117,47.6852,-122.4,2010,5000,1060000,22,9,2014,59,73,490,2990,1,1,1
3,2.25,3170,5000,2.0,0,0,5,10,2230,940,1975,0,98102,47.6349,-122.318,3170,5400,1600000,15,7,2014,0,39,1830,2230,0,1,1
3,1.5,1520,8519,1.0,0,0,3,7,1520,0,1954,0,98133,47.7712,-122.339,1570,9000,365000,31,12,2014,0,60,6999,7430,0,0,1
4,2.5,1830,9601,2.0,0,0,3,7,1830,0,2003,0,98038,47.3541,-122.015,1830,5892,321000,1,7,2014,0,11,7771,4062,0,0,0
3,2.5,1550,4486,2.0,0,0,3,7,1550,0,2000,0,98001,47.3299,-122.269,1700,4487,280000,7,5,2015,0,15,2936,2787,0,0,0
3,2.5,1520,3593,2.0,0,0,3,7,1520,0,2004,0,98038,47.3842,-122.042,1610,3612,288000,3,7,2014,0,10,2073,2002,0,0,0
3,2.0,1240,12285,1.0,0,0,3,7,620,620,1939,1991,98023,47.3219,-122.341,1560,11564,248500,27,2,2015,52,76,11045,10004,1,1,0
4,2.5,2380,13550,2.0,0,0,3,7,2380,0,1999,0,98188,47.4486,-122.288,1230,9450,330000,22,6,2014,0,15,11170,8220,0,0,1
5,3.5,2720,11454,2.0,0,0,3,9,1830,890,1988,0,98052,47.6466,-122.119,2920,11310,740000,22,7,2014,0,26,8734,8390,0,1,0
3,2.5,2210,8010,2.0,0,0,3,8,2210,0,1998,0,98045,47.4845,-121.775,2430,9600,445000,23,9,2014,0,16,5800,7170,0,0,0
2,1.0,1050,9600,1.0,0,0,4,6,1050,0,1959,0,98023,47.3274,-122.346,990,8880,198500,6,3,2015,0,56,8550,7890,0,0,0
7,2.5,1940,5458,2.0,0,0,3,7,1940,0,1994,0,98092,47.3191,-122.177,1710,5688,280000,25,6,2014,0,20,3518,3978,0,0,0
3,2.25,1420,3433,2.0,0,0,4,7,1420,0,1981,0,98034,47.7245,-122.163,1150,3432,336500,10,7,2014,0,33,2013,2282,0,0,0
3,2.5,1690,10336,2.0,0,0,4,7,1690,0,1989,0,98010,47.311,-122.003,1580,7700,267000,11,2,2015,0,26,8646,6120,0,0,0
3,1.0,1160,9180,1.0,0,0,3,7,1160,0,1968,0,98077,47.7427,-122.072,1160,10282,315000,2,5,2014,0,46,8020,9122,0,0,0
4,2.5,2040,7412,2.0,0,0,3,8,2040,0,1988,0,98074,47.6347,-122.026,2050,7830,545000,6,8,2014,0,26,5372,5780,0,0,0
2,1.0,1440,7130,1.0,0,2,3,7,1210,230,1948,0,98115,47.6778,-122.267,1970,7130,500000,24,12,2014,0,66,5690,5160,0,1,1
3,1.0,1390,9624,1.5,0,0,4,7,1390,0,1954,0,98155,47.7758,-122.301,1440,9624,299000,28,5,2014,0,60,8234,8184,0,0,1
3,2.5,1470,1445,2.0,0,0,3,8,1160,310,2005,0,98029,47.5468,-121.998,1470,1525,420000,5,5,2015,0,10,-25,55,0,1,0
3,2.5,1776,1248,3.0,0,0,3,8,1604,172,2006,0,98103,47.6539,-122.352,1780,1248,620000,7,4,2015,0,9,-528,-532,0,1,1
3,2.25,1640,12000,1.0,0,0,3,7,1180,460,1967,0,98008,47.6252,-122.104,1620,12000,575950,10,12,2014,0,47,10360,10380,0,1,0
4,2.5,2860,6600,2.0,0,0,3,9,2860,0,2000,0,98074,47.6067,-122.017,2790,6723,666500,4,9,2014,0,14,3740,3933,0,0,0
4,1.5,1740,7292,1.0,0,0,3,7,1020,720,1962,0,98168,47.4787,-122.302,1740,7573,180000,22,5,2014,0,52,5552,5833,0,1,1
3,1.75,1390,18200,1.0,0,0,4,7,1390,0,1962,0,98023,47.3208,-122.337,1810,9675,261350,23,6,2014,0,52,16810,7865,0,0,0
4,3.5,2730,5607,1.0,0,0,5,9,1660,1070,1948,0,98199,47.6387,-122.396,1720,5400,1030000,24,2,2015,0,67,2877,3680,0,1,1
3,1.75,1435,8960,1.0,0,0,4,8,1435,0,1969,0,98058,47.4525,-122.149,2030,9450,390000,29,4,2015,0,46,7525,7420,0,0,0
3,1.0,1640,12384,1.0,0,0,4,7,1090,550,1954,0,98003,47.3256,-122.298,1550,11200,253500,26,6,2014,0,60,10744,9650,0,1,0
4,2.5,1580,7800,1.0,0,0,4,7,1580,0,1959,0,98059,47.481,-122.163,1320,7800,255000,22,9,2014,0,55,6220,6480,0,0,0
3,2.5,1740,3721,2.0,0,0,3,8,1740,0,2009,0,98002,47.3363,-122.213,2030,3794,257000,10,10,2014,0,5,1981,1764,0,0,0
2,1.75,1900,13122,1.0,1,4,3,7,1100,800,1954,0,98178,47.5121,-122.248,1650,13160,869000,22,7,2014,0,60,11222,11510,0,1,1
4,2.5,3130,10860,2.0,0,0,3,10,3130,0,1990,0,98075,47.56,-122.04,3130,10860,745000,12,11,2014,0,24,7730,7730,0,0,0
4,3.5,3500,9525,2.0,0,0,3,10,3500,0,1999,0,98040,47.5641,-122.221,2630,9525,1350000,26,9,2014,0,15,6025,6895,0,0,0
3,1.75,2130,7500,1.0,0,0,4,7,1090,1040,1956,0,98166,47.4593,-122.343,1590,7500,350000,20,10,2014,0,58,5370,5910,0,1,1
3,2.5,950,1110,2.0,0,0,3,8,950,0,2003,0,98102,47.6226,-122.319,1230,1215,475000,19,6,2014,0,11,160,-15,0,0,1
3,2.5,1720,11656,2.0,0,0,3,8,1720,0,1987,1999,98052,47.6791,-122.113,1890,10336,540000,18,9,2014,12,27,9936,8446,1,0,0
2,1.0,830,2699,1.0,0,0,3,7,830,0,1996,0,98038,47.3839,-122.038,1030,3574,175000,28,5,2014,0,18,1869,2544,0,0,0
2,0.75,660,5240,1.0,0,0,4,4,660,0,1912,0,98032,47.3881,-122.234,850,5080,100000,3,7,2014,0,102,4580,4230,0,0,0
5,1.0,2590,4652,2.0,0,0,4,8,2310,280,1907,0,98122,47.6038,-122.294,2360,4650,890000,9,10,2014,0,107,2062,2290,0,1,1
3,2.5,1600,4271,2.0,0,0,3,7,1600,0,2000,0,98001,47.3303,-122.269,1700,4746,280000,7,5,2014,0,14,2671,3046,0,0,0
4,4.25,4390,13833,2.0,0,3,3,10,3320,1070,2003,0,98029,47.5566,-122.026,3850,11652,1050000,27,6,2014,0,11,9443,7802,0,1,0
4,2.5,3560,12047,2.0,0,0,3,10,3560,0,1988,0,98023,47.3019,-122.341,3420,11250,486000,9,7,2014,0,26,8487,7830,0,0,0
3,2.5,1640,7847,2.0,0,0,3,8,1640,0,1987,0,98029,47.5684,-122.018,1870,6079,480000,23,7,2014,0,27,6207,4209,0,0,0
3,1.75,1500,6180,1.0,0,0,4,6,1060,440,1947,0,98118,47.5689,-122.284,1740,6180,440000,7,5,2014,0,67,4680,4440,0,1,1
3,3.25,3990,8505,2.0,0,2,3,9,2870,1120,1922,1999,98144,47.5744,-122.283,3640,8505,1500000,5,9,2014,77,92,4515,4865,1,1,1
3,1.75,1470,7590,1.0,0,0,3,7,1470,0,1988,0,98117,47.6964,-122.362,1700,5080,449950,14,8,2014,0,26,6120,3380,0,0,1
2,1.0,700,2334,1.0,0,0,3,7,700,0,1945,0,98117,47.701,-122.39,2300,5000,367000,19,5,2014,0,69,1634,2700,0,0,1
4,3.25,3960,12895,2.0,0,0,3,11,3960,0,2001,0,98059,47.5211,-122.151,3870,12040,1190000,1,12,2014,0,13,8935,8170,0,0,0
3,1.0,900,7576,1.0,0,0,4,6,900,0,1959,0,98002,47.2881,-122.22,1220,7452,201000,1,5,2015,0,56,6676,6232,0,0,0
3,1.75,2010,3800,2.0,0,0,2,7,2010,0,1922,0,98112,47.6408,-122.307,1540,3800,575000,23,12,2014,0,92,1790,2260,0,0,1
3,2.5,1940,10350,1.0,0,0,3,7,1420,520,1979,0,98001,47.3385,-122.256,1810,7800,295000,15,4,2015,0,36,8410,5990,0,1,0
3,1.0,1510,8760,1.0,0,0,4,6,1510,0,1946,0,98002,47.3015,-122.216,1040,7828,190000,20,2,2015,0,69,7250,6788,0,0,0
2,3.0,2020,5000,1.0,0,0,3,8,1350,670,1952,0,98117,47.6758,-122.375,1160,1118,742500,7,5,2015,0,63,2980,-42,0,1,1
6,3.5,4430,11453,2.0,0,0,3,9,3000,1430,2001,0,98056,47.5156,-122.204,2730,5661,875000,12,3,2015,0,14,7023,2931,0,1,0
4,2.25,3070,8400,2.0,0,0,4,8,3070,0,1970,0,98034,47.7316,-122.169,1880,8000,600000,19,6,2014,0,44,5330,6120,0,0,0
3,1.5,1460,11100,1.0,0,0,3,7,1460,0,1956,0,98003,47.3253,-122.298,1460,11100,207000,22,9,2014,0,58,9640,9640,0,0,0
4,2.75,3260,5335,2.0,0,0,3,9,3260,0,2003,0,98065,47.5414,-121.864,3180,5438,650000,21,4,2015,0,12,2075,2258,0,0,0
2,1.0,830,5610,1.0,0,0,3,6,830,0,1922,0,98126,47.5674,-122.367,1310,2793,275000,12,5,2015,0,93,4780,1483,0,0,1
4,2.5,2390,4200,2.0,0,0,3,9,2150,240,1924,0,98102,47.6272,-122.318,2800,5250,1200000,8,4,2015,0,91,1810,2450,0,1,1
3,2.0,1130,7200,1.0,0,0,4,6,1130,0,1944,0,98166,47.4779,-122.342,1270,7500,262500,14,10,2014,0,70,6070,6230,0,0,1
2,1.0,1120,8661,1.0,0,0,3,7,1120,0,1946,0,98125,47.7034,-122.307,1470,7205,399000,25,9,2014,0,68,7541,5735,0,0,1
4,1.5,1410,10648,1.0,0,0,4,7,1410,0,1966,0,98030,47.3736,-122.188,1410,10522,139000,24,2,2015,0,49,9238,9112,0,0,0
3,2.5,1750,4797,2.0,0,0,4,7,1750,0,1991,0,98033,47.6954,-122.199,1750,4293,575000,26,8,2014,0,23,3047,2543,0,0,0
2,1.0,1040,3200,1.0,0,0,3,7,1040,0,1926,0,98103,47.6558,-122.334,1890,4000,580000,20,11,2014,0,88,2160,2110,0,0,1
3,2.25,1630,2490,2.0,0,0,3,7,1630,0,2004,0,98053,47.6807,-122.031,1630,2680,468000,25,7,2014,0,10,860,1050,0,0,0
3,1.0,1380,10112,1.0,0,0,4,7,940,440,1963,0,98023,47.3196,-122.351,1240,10112,230000,10,3,2015,0,52,8732,8872,0,1,0
5,3.5,2660,6978,2.0,0,0,3,8,1980,680,1996,0,98092,47.2631,-122.212,2220,7294,332100,8,10,2014,0,18,4318,5074,0,1,0
2,1.0,620,6600,1.0,0,0,3,6,620,0,1963,0,98168,47.4862,-122.33,1050,6600,175000,17,3,2015,0,52,5980,5550,0,0,1
4,2.25,2600,10660,2.0,0,0,4,8,2600,0,1979,0,98006,47.5533,-122.156,3150,10660,817000,5,8,2014,0,35,8060,7510,0,0,0
4,3.0,2150,8119,2.0,0,0,3,8,2150,0,1953,2004,98039,47.6335,-122.236,1590,8119,1200000,8,4,2015,51,62,5969,6529,1,0,0
3,1.75,1470,6550,1.0,0,2,3,7,1070,400,1916,0,98126,47.5463,-122.381,1440,6550,525000,20,4,2015,0,99,5080,5110,0,1,1
3,1.0,1380,7282,1.5,0,0,5,6,1380,0,1915,0,98002,47.3006,-122.223,860,4826,189000,11,2,2015,0,100,5902,3966,0,0,0
3,2.5,1680,1683,2.0,0,0,3,9,1120,560,2014,0,98119,47.6425,-122.374,1610,1618,629950,5,3,2015,0,1,3,8,0,1,1
1,1.0,1000,9084,1.0,1,3,3,7,1000,0,1950,0,98146,47.5007,-122.382,1090,6536,641500,10,3,2015,0,65,8084,5446,0,0,1
3,2.25,1630,7573,1.0,0,2,3,7,1230,400,1983,0,98034,47.7273,-122.211,1550,7695,490000,12,9,2014,0,31,5943,6145,0,1,0
3,1.75,1790,15142,1.0,0,0,3,7,1360,430,1976,0,98072,47.7362,-122.172,1910,7500,415000,18,2,2015,0,39,13352,5590,0,1,0
2,1.0,890,6380,1.0,0,0,3,6,890,0,1951,0,98115,47.691,-122.303,990,6380,250000,15,10,2014,0,63,5490,5390,0,0,1
3,1.5,1290,8175,1.0,0,0,4,7,820,470,1952,0,98004,47.6296,-122.205,2130,8577,781000,20,8,2014,0,62,6885,6447,0,1,0
4,2.25,2420,7927,1.0,0,0,4,7,1400,1020,1973,0,98133,47.7583,-122.343,2120,7693,400000,20,6,2014,0,41,5507,5573,0,1,1
4,3.0,3680,7105,2.0,0,2,3,10,2890,790,2008,0,98115,47.6956,-122.311,1580,6815,935000,20,8,2014,0,6,3425,5235,0,1,1
4,3.25,4240,11189,2.0,0,2,3,10,4240,0,2006,0,98033,47.6526,-122.191,3390,12540,1660000,15,10,2014,0,8,6949,9150,0,0,0
5,2.75,3130,9450,1.0,0,0,4,8,1580,1550,1973,0,98023,47.3099,-122.384,1900,9000,302300,29,12,2014,0,41,6320,7100,0,1,0
2,1.0,900,6656,1.0,0,0,3,7,900,0,1940,0,98126,47.5467,-122.377,1230,6400,355000,7,5,2015,0,75,5756,5170,0,0,1
3,2.25,2880,7599,1.0,0,2,3,9,1710,1170,1958,2002,98033,47.6938,-122.215,2920,12401,1540000,17,6,2014,44,56,4719,9481,1,1,0
4,1.75,2390,17717,1.0,0,0,4,8,2390,0,1964,0,98040,47.5755,-122.218,2390,10730,926250,30,3,2015,0,51,15327,8340,0,0,0
3,1.75,1450,7620,1.0,0,0,4,7,1050,400,1955,0,98166,47.4569,-122.354,1380,7620,300000,23,3,2015,0,60,6170,6240,0,1,1
3,1.75,1070,9000,1.0,0,0,4,7,1070,0,1978,0,98052,47.6984,-122.132,1700,8400,361500,21,7,2014,0,36,7930,6700,0,0,0
3,1.5,1740,9840,1.0,0,0,4,8,1740,0,1963,0,98040,47.5748,-122.237,1930,9840,616000,5,11,2014,0,51,8100,7910,0,0,0
2,1.75,1210,1161,2.0,0,0,3,8,1210,0,2014,0,98029,47.5513,-121.998,1700,2285,395000,13,4,2015,0,1,-49,585,0,0,0
3,1.5,2100,10000,1.0,0,0,4,7,2100,0,1954,0,98198,47.4222,-122.331,1300,7500,245000,6,10,2014,0,60,7900,6200,0,0,1
3,1.0,1060,9600,1.0,0,0,4,6,1060,0,1962,0,98023,47.2878,-122.358,1060,9604,206000,3,6,2014,0,52,8540,8544,0,0,0
4,2.5,3280,16575,1.0,0,0,3,9,2190,1090,1972,0,98188,47.426,-122.285,1570,13209,706000,13,10,2014,0,42,13295,11639,0,1,1
3,1.5,1660,6000,1.5,0,0,3,7,1660,0,1937,0,98199,47.6409,-122.401,1640,6000,578000,26,1,2015,0,78,4340,4360,0,0,1
5,3.0,3070,5252,2.0,0,0,3,8,3070,0,2005,0,98042,47.3666,-122.128,2760,5203,341950,28,7,2014,0,9,2182,2443,0,0,0
3,1.0,1150,9048,1.0,0,0,2,7,1150,0,1922,0,98033,47.6755,-122.177,1550,8207,305000,11,12,2014,0,92,7898,6657,0,0,0
3,2.75,1710,3600,1.0,0,0,3,7,1590,120,1909,0,98119,47.642,-122.36,1710,3600,575000,10,10,2014,0,105,1890,1890,0,1,1
4,2.25,2130,7200,2.0,0,0,3,7,2130,0,1972,0,98034,47.7152,-122.168,1990,7200,445000,7,1,2015,0,43,5070,5210,0,0,0
3,1.0,1050,7560,1.0,0,0,3,7,1050,0,1951,0,98126,47.525,-122.371,1490,7560,333000,18,8,2014,0,63,6510,6070,0,0,1
4,2.5,2520,3980,2.0,0,0,3,8,2520,0,2005,0,98027,47.5401,-122.07,2610,3980,598500,7,8,2014,0,9,1460,1370,0,0,0
2,1.0,700,6000,1.0,0,0,3,6,700,0,1943,0,98055,47.4671,-122.212,1320,6000,225000,14,10,2014,0,71,5300,4680,0,0,0
4,2.5,2640,4200,2.0,0,0,3,8,2640,0,1998,0,98074,47.6038,-122.02,2460,4200,570000,14,7,2014,0,16,1560,1740,0,0,0
5,2.0,2330,6783,1.0,0,0,3,7,1310,1020,1956,0,98115,47.6955,-122.295,1930,6783,630000,7,8,2014,0,58,4453,4853,0,1,1
5,2.25,2830,7738,2.0,0,0,4,8,2830,0,1977,0,98006,47.5582,-122.136,2300,9840,779000,16,4,2015,0,38,4908,7540,0,0,0
4,3.5,3720,13591,2.0,0,3,3,10,3720,0,2004,0,98065,47.536,-121.858,4210,14282,760000,21,1,2015,0,11,9871,10072,0,0,0
5,1.75,1890,9600,1.0,0,0,4,7,1890,0,1960,0,98028,47.7391,-122.241,2350,5308,322968,9,1,2015,0,55,7710,2958,0,0,0
4,2.5,2910,7287,2.0,0,0,3,8,2910,0,1998,0,98065,47.5354,-121.869,2420,6180,595000,29,7,2014,0,16,4377,3760,0,0,0
4,1.0,1300,18836,1.0,0,0,4,7,1300,0,1941,0,98056,47.5029,-122.188,1540,8498,321000,13,10,2014,0,73,17536,6958,0,0,0
3,1.0,1340,4284,1.0,0,0,3,7,1080,260,1910,0,98105,47.6633,-122.324,1960,4080,530000,7,5,2014,0,104,2944,2120,0,1,1
2,1.75,1060,1241,2.0,0,0,3,7,960,100,2008,0,98144,47.5999,-122.3,1170,1400,352750,9,6,2014,0,6,181,230,0,1,1
4,2.5,2480,8563,2.0,0,0,3,8,2480,0,1992,0,98038,47.381,-122.033,2460,8660,424950,4,2,2015,0,23,6083,6200,0,0,0
5,2.75,2220,4000,1.0,0,0,3,7,1230,990,1973,0,98144,47.5754,-122.305,1580,4000,427000,30,5,2014,0,41,1780,2420,0,1,1
4,2.5,3220,5120,2.0,0,0,3,9,2420,800,2000,0,98118,47.5434,-122.27,1770,7680,558000,5,8,2014,0,14,1900,5910,0,1,1
2,2.0,1600,5643,1.0,0,0,3,7,1600,0,1954,0,98115,47.6968,-122.279,1600,5746,438200,10,11,2014,0,60,4043,4146,0,0,1
1,1.0,640,4800,1.0,0,0,3,6,640,0,1918,0,98136,47.5551,-122.382,1250,2847,340000,29,9,2014,0,96,4160,1597,0,0,1
4,3.75,3610,7904,3.0,0,0,3,11,3290,320,1994,0,98117,47.6992,-122.385,2460,7300,830005,28,8,2014,0,20,4294,4840,0,1,1
4,3.25,3420,5012,2.0,0,0,3,10,2330,1090,2008,0,98019,47.732,-121.982,2320,5465,548000,9,9,2014,0,6,1592,3145,0,1,0
3,1.75,1840,5101,1.0,0,0,5,7,1040,800,1952,0,98108,47.5585,-122.317,1340,5000,411715,4,6,2014,0,62,3261,3660,0,1,1
6,4.25,5860,13928,2.0,0,3,3,10,4150,1710,2013,0,98006,47.5382,-122.114,5790,13928,1750000,2,2,2015,0,2,8068,8138,0,1,0
3,3.0,3450,16200,2.0,0,0,3,10,3450,0,1983,0,98074,47.6319,-122.041,3130,12150,688000,18,6,2014,0,31,12750,9020,0,0,0
4,2.5,2350,5100,2.0,0,0,3,8,2350,0,2003,0,98038,47.3507,-122.007,2190,5100,399950,17,3,2015,0,12,2750,2910,0,0,0
3,1.0,1250,4590,1.5,0,0,3,6,970,280,1903,0,98115,47.6757,-122.327,1830,4080,555000,27,3,2015,0,112,3340,2250,0,1,1
3,2.0,2000,3207,1.0,0,0,4,7,1100,900,1916,0,98103,47.6561,-122.341,1460,3200,677000,22,5,2014,0,98,1207,1740,0,1,1
3,2.0,2260,9568,1.0,0,0,3,8,1780,480,1985,0,98074,47.6457,-122.058,2250,9744,539000,6,6,2014,0,29,7308,7494,0,1,0
3,1.75,1510,6597,1.0,0,0,4,6,950,560,1939,0,98144,47.5938,-122.315,1460,5320,410000,19,8,2014,0,75,5087,3860,0,1,1
2,2.25,1800,2748,2.0,0,0,4,9,1800,0,1979,0,98008,47.6104,-122.113,1800,2755,472000,10,3,2015,0,36,948,955,0,0,0
3,2.5,2420,8856,1.0,0,3,3,9,1620,800,1957,0,98118,47.5405,-122.263,2650,9750,755000,26,10,2014,0,57,6436,7100,0,1,1
5,1.75,1750,8325,1.0,0,0,5,7,1750,0,1966,0,98031,47.4007,-122.198,1430,8325,269900,5,8,2014,0,48,6575,6895,0,0,0
3,2.25,2640,7544,1.0,0,0,3,10,2640,0,1995,0,98004,47.6224,-122.195,2650,7904,1220000,30,10,2014,0,19,4904,5254,0,0,0
3,2.5,1460,1613,2.0,0,0,3,8,1180,280,2007,0,98117,47.6781,-122.375,1460,1403,544000,30,6,2014,0,7,153,-57,0,1,1
2,1.0,1570,5000,1.5,0,3,4,8,1570,0,1924,0,98144,47.5955,-122.294,1760,3000,800000,28,4,2015,0,91,3430,1240,0,0,1
3,1.0,1010,7500,1.0,0,0,4,7,1010,0,1975,0,98074,47.6172,-122.061,1250,10000,315000,22,8,2014,0,39,6490,8750,0,0,0
4,1.0,1200,7200,1.5,0,0,3,6,1200,0,1944,0,98178,47.4951,-122.248,1070,6050,227000,10,6,2014,0,70,6000,4980,0,0,1
3,3.0,1820,1641,3.0,0,0,3,8,1540,280,2006,0,98119,47.6482,-122.358,1720,1501,625000,2,7,2014,0,8,-179,-219,0,1,1
4,5.0,5810,7440,2.0,0,0,3,10,3790,2020,2004,0,98033,47.6878,-122.212,3010,7200,1880000,2,9,2014,0,10,1630,4190,0,1,0
4,2.5,3010,9600,1.0,0,2,3,9,1510,1500,1979,0,98006,47.5519,-122.156,2780,10000,822600,11,2,2015,0,36,6590,7220,0,1,0
4,2.5,1910,8947,1.0,0,0,4,8,1160,750,1970,0,98011,47.7374,-122.183,1920,7350,515000,23,4,2015,0,45,7037,5430,0,1,0
4,2.0,1640,5014,1.0,0,0,4,7,930,710,1982,0,98106,47.5545,-122.356,1600,5452,377000,12,5,2015,0,33,3374,3852,0,1,1
3,1.0,1480,17360,1.0,0,1,3,8,1480,0,1954,0,98136,47.5179,-122.387,2250,8720,600000,4,3,2015,0,61,15880,6470,0,0,1
4,1.75,2520,7770,1.0,0,0,3,8,1680,840,1965,0,98177,47.7721,-122.372,2340,7770,525300,14,11,2014,0,49,5250,5430,0,1,1
2,1.0,840,7200,1.0,0,0,4,5,840,0,1907,0,98032,47.3769,-122.237,1030,7200,202000,29,12,2014,0,107,6360,6170,0,0,0
3,2.5,3140,10983,2.0,0,0,3,10,3140,0,1991,0,98075,47.5595,-122.04,3140,10983,810000,25,7,2014,0,23,7843,7843,0,0,0
3,1.0,1480,8415,1.0,0,0,3,7,1080,400,1967,0,98188,47.4585,-122.283,1780,8512,175000,16,3,2015,0,48,6935,6732,0,1,1
4,1.75,1920,7986,1.0,0,0,3,7,960,960,1952,0,98125,47.7209,-122.318,1700,7452,440000,15,10,2014,0,62,6066,5752,0,1,1
2,1.0,770,8636,1.0,0,0,2,6,770,0,1951,0,98146,47.5075,-122.358,1110,8636,197000,30,3,2015,0,64,7866,7526,0,0,1
3,1.0,1010,7384,1.0,0,2,5,6,1010,0,1943,0,98056,47.4905,-122.191,1010,8000,254000,6,3,2015,0,72,6374,6990,0,0,0
3,1.0,1460,10000,1.5,0,0,3,7,1460,0,2002,0,98074,47.6214,-122.063,1910,10000,405000,20,6,2014,0,12,8540,8090,0,0,0
2,1.0,940,4264,1.0,0,0,5,7,940,0,1949,0,98126,47.5314,-122.378,1630,4472,416000,27,3,2015,0,66,3324,2842,0,0,1
4,2.75,2840,4864,3.0,0,0,3,9,2840,0,2014,0,98052,47.7103,-122.108,2990,5314,779950,19,9,2014,0,0,2024,2324,0,0,0
4,2.75,1910,7210,1.0,0,0,4,7,1430,480,1980,0,98030,47.3693,-122.169,1750,7446,200000,12,1,2015,0,35,5300,5696,0,1,0
4,2.5,2430,8509,2.0,0,0,3,9,2430,0,1992,0,98029,47.5714,-121.991,2760,8509,658100,17,7,2014,0,22,6079,5749,0,0,0
2,1.75,1610,4104,1.0,0,0,3,7,950,660,1996,0,98118,47.5565,-122.275,1510,5284,397000,14,7,2014,0,18,2494,3774,0,1,1
3,3.75,2780,5002,2.0,0,0,3,10,2780,0,1999,0,98007,47.5939,-122.15,3110,5717,815000,15,10,2014,0,15,2222,2607,0,0,0
2,1.0,1160,8504,1.0,0,0,4,7,1160,0,1949,0,98155,47.7364,-122.295,1320,8504,345000,16,10,2014,0,65,7344,7184,0,0,1
4,2.5,1850,7199,2.0,0,0,4,7,1850,0,1989,0,98031,47.4031,-122.172,1940,7432,305500,24,9,2014,0,25,5349,5492,0,0,0
3,2.25,2120,13090,1.0,0,0,3,8,2120,0,1997,0,98002,47.296,-122.219,1400,12039,340000,8,7,2014,0,17,10970,10639,0,0,0
5,2.5,2620,12763,1.0,0,0,3,7,1400,1220,1979,0,98034,47.72,-122.213,2390,9156,330000,26,2,2015,0,36,10143,6766,0,1,0
4,2.5,2060,3608,2.0,0,0,3,7,2060,0,2004,0,98198,47.362,-122.309,2060,3608,269000,21,4,2015,0,11,1548,1548,0,0,1
3,1.0,1060,9525,1.0,0,0,3,7,1060,0,1966,0,98052,47.6855,-122.111,1630,9525,349950,12,6,2014,0,48,8465,7895,0,0,0
3,1.0,1500,6240,1.0,0,0,4,7,1500,0,1953,0,98125,47.7281,-122.311,1230,6240,431000,4,3,2015,0,62,4740,5010,0,0,1
4,1.75,2380,5700,2.0,0,1,4,7,1820,560,1946,0,98105,47.6656,-122.271,2190,5700,735000,17,10,2014,0,68,3320,3510,0,1,1
5,3.0,3045,5030,2.0,0,0,3,8,3045,0,1999,0,98058,47.4386,-122.127,3045,5322,414000,17,7,2014,0,15,1985,2277,0,0,0
3,2.5,1700,4105,2.0,0,0,3,8,1700,0,1992,0,98122,47.6078,-122.292,1880,3665,619500,20,5,2014,0,22,2405,1785,0,0,1
3,1.75,1240,13869,1.0,0,0,4,7,1240,0,1957,0,98033,47.6919,-122.21,1970,7790,675000,30,10,2014,0,57,12629,5820,0,0,0
3,1.0,1410,7854,1.0,0,0,4,7,1410,0,1971,0,98034,47.7303,-122.192,1460,7500,380500,23,4,2015,0,44,6444,6040,0,0,0
3,1.5,880,6600,1.0,0,0,5,6,880,0,1945,0,98178,47.5002,-122.247,1020,6600,253000,17,6,2014,0,69,5720,5580,0,0,1
2,1.0,740,9003,1.0,0,0,3,5,740,0,1949,0,98031,47.4217,-122.197,1230,8050,157500,28,5,2014,0,65,8263,6820,0,0,0
4,2.0,2030,9300,1.0,0,0,4,8,2030,0,1976,0,98052,47.6658,-122.149,1800,9018,627000,9,6,2014,0,38,7270,7218,0,0,0
4,2.5,2090,7241,1.0,0,0,4,7,1140,950,2001,0,98034,47.726,-122.221,1510,7402,469500,24,9,2014,0,13,5151,5892,0,1,0
2,1.0,920,8341,1.0,0,0,3,7,920,0,1939,0,98146,47.5015,-122.38,2330,9792,319950,19,6,2014,0,75,7421,7462,0,0,1
3,1.0,1180,7200,1.0,0,0,4,7,1180,0,1968,0,98058,47.4249,-122.178,1180,7200,249500,18,2,2015,0,47,6020,6020,0,0,0
3,1.0,1260,3230,1.5,0,0,3,7,1260,0,1907,0,98119,47.644,-122.369,1700,3500,485000,23,2,2015,0,108,1970,1800,0,0,1
5,3.0,3690,10260,1.0,0,4,4,9,2070,1620,1967,0,98005,47.5919,-122.176,3160,14000,1130000,24,10,2014,0,47,6570,10840,0,1,0
3,1.75,1700,17355,1.0,0,0,3,7,1200,500,1978,0,98038,47.3637,-122.057,1900,9528,314500,28,6,2014,0,36,15655,7628,0,1,0
2,1.0,770,8149,1.0,0,0,3,6,770,0,1948,0,98155,47.7467,-122.3,880,8149,220000,3,4,2015,0,67,7379,7269,0,0,1
3,2.5,2020,7800,1.0,0,0,4,7,1330,690,1958,0,98133,47.7368,-122.337,1870,7800,444950,24,11,2014,0,56,5780,5930,0,1,1
4,2.5,2030,9825,1.0,0,0,3,8,1330,700,1985,0,98115,47.6892,-122.3,2180,7500,598000,25,8,2014,0,29,7795,5320,0,1,1
4,3.5,2690,6164,2.0,0,0,3,9,2690,0,2002,0,98075,47.599,-121.973,2910,5000,699850,16,6,2014,0,12,3474,2090,0,0,0
3,2.5,1750,3354,2.0,0,0,4,7,1750,0,1991,0,98033,47.6953,-122.199,1750,4286,595000,8,5,2014,0,23,1604,2536,0,0,0
4,2.5,2330,14289,2.0,0,0,4,8,2330,0,1978,0,98007,47.5916,-122.148,2210,12823,542500,9,5,2014,0,36,11959,10613,0,0,0
3,1.75,1720,6960,1.0,0,0,3,7,1140,580,1978,0,98052,47.6972,-122.129,1720,7280,450000,12,5,2015,0,37,5240,5560,0,1,0
3,2.0,2420,8800,1.0,0,0,4,7,1420,1000,1959,0,98188,47.4322,-122.291,1546,8666,298500,28,7,2014,0,55,6380,7120,0,1,1
2,1.0,710,1136,2.0,0,0,4,7,710,0,1943,0,98102,47.6414,-122.329,1370,1173,403950,9,6,2014,0,71,426,-197,0,0,1
2,1.0,710,4240,1.0,0,0,4,6,710,0,1942,0,98106,47.5226,-122.351,850,5200,271000,29,12,2014,0,72,3530,4350,0,0,1
2,1.0,1510,3844,1.0,0,0,4,7,1510,0,1923,1970,98133,47.7038,-122.348,1170,3844,335000,11,9,2014,47,91,2334,2674,1,0,1
2,2.25,1610,1968,2.0,0,0,5,7,1610,0,1979,0,98056,47.5184,-122.196,1950,1968,305000,16,12,2014,0,35,358,18,0,0,0
3,3.0,1880,2200,2.0,0,0,3,8,1520,360,2007,0,98107,47.6666,-122.367,1500,1426,630000,17,3,2015,0,8,320,-74,0,1,1
2,1.75,1220,5000,1.0,0,0,5,7,860,360,1921,0,98055,47.4906,-122.204,1120,5000,253000,3,6,2014,0,93,3780,3880,0,1,0
4,1.75,2060,7900,1.0,0,0,4,7,1070,990,1957,0,98008,47.6028,-122.12,1830,8000,395000,19,9,2014,0,57,5840,6170,0,1,0
3,2.5,1340,10290,1.0,0,0,4,7,1140,200,1981,0,98042,47.3553,-122.149,1760,7903,265000,17,10,2014,0,33,8950,6143,0,1,0
2,1.0,1030,9192,1.0,0,0,4,6,1030,0,1959,0,98058,47.4565,-122.181,1030,9190,225000,21,7,2014,0,55,8162,8160,0,0,0
4,2.5,2717,4513,2.0,0,0,3,8,2717,0,2005,0,98001,47.3373,-122.266,2550,4841,338500,17,9,2014,0,9,1796,2291,0,0,0
2,1.75,1360,8100,1.0,0,0,3,7,860,500,1975,0,98177,47.7295,-122.359,1830,6766,300000,12,5,2014,0,39,6740,4936,0,1,1
2,1.0,1260,7810,2.0,0,0,3,6,1260,0,1945,0,98178,47.5003,-122.248,1260,7755,255000,20,8,2014,0,69,6550,6495,0,0,1
4,3.0,2240,8504,2.0,0,0,3,7,2240,0,1992,0,98155,47.7348,-122.295,1570,8460,337000,20,6,2014,0,22,6264,6890,0,0,1
3,2.25,2080,9740,2.0,0,0,3,8,2080,0,1988,0,98092,47.261,-122.219,2080,8705,324900,16,4,2015,0,27,7660,6625,0,0,0
3,2.75,2760,8476,1.0,0,0,4,8,1690,1070,1967,0,98040,47.5402,-122.215,2610,9835,821000,7,7,2014,0,47,5716,7225,0,1,0
4,3.5,3310,6000,2.0,0,2,3,8,2200,1110,2010,0,98136,47.5511,-122.391,1420,6000,885000,2,3,2015,0,5,2690,4580,0,1,1
4,2.0,1630,10375,1.0,0,0,5,7,1630,0,1968,0,98077,47.7566,-122.073,1360,10026,360000,10,6,2014,0,46,8745,8666,0,0,0
3,1.0,900,7500,1.0,0,0,4,7,900,0,1972,0,98034,47.7314,-122.237,1960,7500,304000,27,5,2014,0,42,6600,5540,0,0,0
2,1.0,880,2400,1.0,0,0,3,6,760,120,1918,0,98118,47.5643,-122.275,1180,6300,376000,16,3,2015,0,97,1520,5120,0,1,1
4,1.5,1620,7875,1.0,0,0,3,7,1620,0,1956,0,98008,47.6041,-122.126,1890,8400,425000,4,11,2014,0,58,6255,6510,0,0,0
3,1.75,1610,7200,1.0,0,0,3,8,1090,520,1973,0,98112,47.6279,-122.287,3790,7200,1180000,22,5,2014,0,41,5590,3410,0,1,1
3,2.5,1730,1803,2.0,0,0,3,7,1730,0,2005,0,98166,47.4648,-122.335,1190,7980,187000,22,7,2014,0,9,73,6790,0,0,1
2,1.5,1640,4080,1.5,0,0,5,7,1540,100,1916,0,98105,47.6624,-122.325,1880,4080,710000,27,6,2014,0,98,2440,2200,0,1,1
3,1.75,1840,7350,1.0,0,0,3,8,1370,470,1974,0,98033,47.6729,-122.166,1920,8518,585000,25,3,2015,0,41,5510,6598,0,1,0
4,2.75,3800,12200,2.0,0,3,4,10,3800,0,1986,0,98006,47.5689,-122.156,3710,14796,950000,18,12,2014,0,28,8400,11086,0,0,0
4,2.5,2780,6369,1.0,0,0,3,8,1590,1190,1978,0,98034,47.7284,-122.216,2170,7490,505000,12,5,2014,0,36,3589,5320,0,1,0
1,1.0,560,4120,1.0,0,0,3,4,560,0,1947,0,98106,47.5335,-122.348,980,4120,90000,18,4,2015,0,68,3560,3140,0,0,1
4,2.0,2060,3060,2.0,0,0,3,7,2060,0,1968,0,98118,47.5631,-122.285,1630,3766,400000,9,4,2015,0,47,1000,2136,0,0,1
3,1.0,1140,7785,1.0,0,0,3,8,1140,0,1954,0,98177,47.709,-122.363,2080,10620,407000,17,2,2015,0,61,6645,8540,0,0,1
3,1.5,1890,4400,1.5,0,0,5,7,1890,0,1919,0,98105,47.6662,-122.326,1620,4080,651000,19,12,2014,0,95,2510,2460,0,0,1
3,2.25,2090,7450,1.0,0,0,3,7,1350,740,1978,0,98155,47.7598,-122.303,1740,7644,485000,5,2,2015,0,37,5360,5904,0,1,1
4,2.75,3460,13168,2.0,0,0,4,8,3460,0,1932,1986,98022,47.2046,-121.996,1500,7670,460000,13,1,2015,54,83,9708,6170,1,0,0
2,1.0,1320,6135,1.0,0,0,4,7,880,440,1942,0,98126,47.5265,-122.379,1050,4693,369000,9,3,2015,0,73,4815,3643,0,1,1
2,1.0,810,4755,1.0,0,0,3,7,810,0,1980,0,98118,47.5313,-122.28,1180,4755,155000,16,9,2014,0,34,3945,3575,0,0,1
3,1.0,1880,5450,1.5,0,0,4,8,1880,0,1924,0,98112,47.6453,-122.302,2580,5450,1000000,15,12,2014,0,90,3570,2870,0,0,1
4,2.5,2680,11590,2.0,0,0,4,9,2680,0,1988,0,98058,47.4395,-122.163,2580,8225,419625,11,2,2015,0,27,8910,5645,0,0,0
3,2.0,2040,6880,2.0,0,0,4,7,2040,0,1954,0,98133,47.7601,-122.351,1710,7597,435000,18,2,2015,0,61,4840,5887,0,0,1
4,1.75,2180,7876,1.0,0,0,4,7,1290,890,1977,0,98056,47.5157,-122.191,1960,7225,379000,11,5,2015,0,38,5696,5265,0,1,0
4,2.25,1870,5371,2.0,0,0,3,7,1870,0,2009,0,98038,47.3844,-122.036,2380,4502,293000,24,2,2015,0,6,3501,2122,0,0,0
4,2.75,2310,7851,1.0,0,0,4,8,1790,520,1989,0,98006,47.5473,-122.187,2230,7359,592100,6,8,2014,0,25,5541,5129,0,1,0
3,1.75,1120,9730,1.0,0,0,3,7,1120,0,1944,1989,98011,47.7372,-122.221,2530,8717,362000,10,11,2014,45,70,8610,6187,1,0,0
3,1.0,1340,10035,1.0,0,0,3,7,1340,0,1959,0,98178,47.4916,-122.254,2090,10035,227000,3,12,2014,0,55,8695,7945,0,0,1
3,1.75,1260,8487,1.0,0,0,3,7,1260,0,1970,0,98011,47.7664,-122.201,1890,13051,335500,19,8,2014,0,44,7227,11161,0,0,0
5,2.5,2400,4496,2.0,0,0,3,7,2400,0,2004,0,98042,47.3692,-122.126,1880,4319,338000,26,3,2015,0,11,2096,2439,0,0,0
3,1.0,940,7200,1.0,0,0,4,7,940,0,1954,0,98002,47.2979,-122.223,1090,7800,163500,22,10,2014,0,60,6260,6710,0,0,0
2,1.0,860,5000,1.0,0,0,3,7,860,0,1949,0,98178,47.5005,-122.267,1130,6000,199988,24,11,2014,0,65,4140,4870,0,0,1
3,2.25,2390,7875,1.0,0,1,3,10,1980,410,1948,0,98105,47.6515,-122.278,3720,9075,1190000,25,7,2014,0,66,5485,5355,0,1,1
4,2.5,3130,5200,2.0,0,0,3,7,3130,0,2005,0,98042,47.3828,-122.098,3020,5200,320000,7,4,2015,0,10,2070,2180,0,0,0
6,2.25,3550,11780,1.0,0,0,4,8,2960,590,1948,0,98125,47.7218,-122.312,2360,8850,450000,16,6,2014,0,66,8230,6490,0,1,1
2,2.0,1470,2541,2.0,0,0,3,6,1470,0,2005,0,98038,47.3502,-122.02,1310,2721,249900,30,10,2014,0,9,1071,1411,0,0,0
2,1.0,910,9869,1.0,0,0,3,6,910,0,1957,0,98058,47.4572,-122.184,1480,9750,223000,12,6,2014,0,57,8959,8270,0,0,0
4,2.25,1780,10416,1.0,0,0,5,7,1060,720,1963,0,98055,47.4414,-122.189,1780,9975,350000,5,5,2015,0,52,8636,8195,0,1,0
5,2.0,2730,7344,1.0,0,0,5,7,1510,1220,1962,0,98058,47.4602,-122.171,1730,7700,310000,9,4,2015,0,53,4614,5970,0,1,0
2,1.0,900,8000,1.0,0,0,4,6,900,0,1954,0,98198,47.4217,-122.317,1240,8000,185000,12,8,2014,0,60,7100,6760,0,0,1
4,2.5,2905,4874,2.0,0,0,3,9,2905,0,2003,0,98031,47.4084,-122.169,2900,5271,365000,12,12,2014,0,11,1969,2371,0,0,0
3,1.5,2230,9120,1.0,0,0,3,7,1390,840,1959,0,98146,47.5008,-122.358,1420,8450,333500,23,4,2015,0,56,6890,7030,0,1,1
3,2.25,1680,8450,1.0,0,0,3,8,1340,340,1960,0,98177,47.7575,-122.361,1850,8300,385000,20,11,2014,0,54,6770,6450,0,1,1
3,1.5,1240,11200,1.0,0,0,4,7,1240,0,1954,0,98006,47.5716,-122.138,1240,11008,345000,20,5,2014,0,60,9960,9768,0,0,0
3,3.0,3230,8625,2.0,0,3,3,10,2220,1010,1998,0,98116,47.562,-122.404,2330,6022,1260000,10,11,2014,0,16,5395,3692,0,1,1
4,2.5,2560,10400,1.0,0,0,4,7,1280,1280,1965,0,98027,47.5225,-122.04,1740,11050,440000,23,5,2014,0,49,7840,9310,0,1,0
3,2.5,2600,4724,2.0,0,0,3,7,2600,0,2002,0,98065,47.5359,-121.878,2400,4724,444500,25,9,2014,0,12,2124,2324,0,0,0
4,1.0,1660,6075,1.5,0,0,5,7,1660,0,1915,0,98117,47.6755,-122.403,1810,5400,680000,12,3,2015,0,100,4415,3590,0,0,1
3,1.75,1140,8558,1.0,0,0,4,7,1140,0,1982,0,98033,47.7027,-122.198,1490,10530,420000,9,9,2014,0,32,7418,9040,0,0,0
3,2.25,3050,10689,2.0,0,0,4,9,3050,0,1988,0,98092,47.3326,-122.201,2697,10925,438500,29,12,2014,0,26,7639,8228,0,0,0
2,1.0,800,10625,1.0,0,0,3,6,800,0,1942,0,98168,47.496,-122.317,1130,10625,109500,18,9,2014,0,72,9825,9495,0,0,1
4,2.75,1700,7495,1.0,0,0,4,7,1200,500,1964,0,98133,47.7589,-122.354,1650,7495,461000,10,4,2015,0,51,5795,5845,0,1,1
4,1.75,2630,9645,1.0,0,0,4,9,2630,0,1963,0,98040,47.5459,-122.228,2690,10439,968000,11,8,2014,0,51,7015,7749,0,0,0
3,1.75,1960,7705,1.0,0,0,4,7,980,980,1950,0,98106,47.53,-122.347,1380,4349,355000,23,9,2014,0,64,5745,2969,0,1,1
5,2.5,1960,7350,1.0,0,0,4,7,1360,600,1969,0,98058,47.4368,-122.165,1900,7350,256500,26,3,2015,0,46,5390,5450,0,1,0
3,2.25,1950,8661,1.0,0,0,4,8,1950,0,1966,0,98023,47.3127,-122.362,1950,8800,269000,23,12,2014,0,48,6711,6850,0,0,0
4,3.5,3600,5217,2.0,0,0,3,9,2720,880,1947,2014,98112,47.6189,-122.286,2270,5217,1350000,12,11,2014,67,67,1617,2947,1,1,1
3,2.25,2060,9552,1.0,0,0,4,9,1610,450,1975,0,98040,47.5402,-122.231,2930,11212,885000,20,6,2014,0,39,7492,8282,0,1,0
3,2.0,1640,9825,1.0,0,0,4,7,1090,550,1971,0,98034,47.7244,-122.2,1500,9750,455000,23,4,2015,0,44,8185,8250,0,1,0
4,2.5,2730,4800,1.5,0,0,5,8,2230,500,1909,0,98119,47.642,-122.358,2190,4200,980000,9,6,2014,0,105,2070,2010,0,1,1
3,1.75,1530,6300,1.0,0,0,3,6,1530,0,1942,2004,98126,47.516,-122.375,920,6300,412500,1,8,2014,62,72,4770,5380,1,0,1
4,3.5,3060,4777,2.0,0,0,3,9,3060,0,2007,0,98029,47.555,-122.0,3060,4935,740000,17,12,2014,0,7,1717,1875,0,0,0
4,2.25,2860,5658,2.0,0,3,3,10,2130,730,1933,0,98199,47.6395,-122.409,2700,5221,1300000,23,8,2014,0,81,2798,2521,0,1,1
2,1.5,1030,798,3.0,0,0,3,8,1030,0,2008,0,98103,47.6975,-122.34,1020,1026,326000,12,3,2015,0,7,-232,6,0,0,1
4,2.5,2460,4200,2.0,0,0,3,8,2460,0,1998,0,98074,47.6041,-122.02,2460,4200,568500,7,6,2014,0,16,1740,1740,0,0,0
4,2.5,2500,8282,2.0,0,0,3,9,2500,0,2013,0,98056,47.5127,-122.169,2500,8046,620000,22,9,2014,0,1,5782,5546,0,0,0
3,1.75,1830,7600,2.0,0,0,3,7,1490,340,1947,0,98106,47.5317,-122.351,1300,4000,283000,17,4,2015,0,68,5770,2700,0,1,1
6,3.25,2820,4536,2.0,0,0,4,8,1930,890,1917,0,98105,47.6688,-122.309,2820,4536,875000,14,8,2014,0,97,1716,1716,0,1,1
4,2.25,3750,5000,2.0,0,0,5,8,2440,1310,1924,0,98115,47.6747,-122.303,2170,4590,1310000,27,5,2015,0,91,1250,2420,0,1,1
3,2.5,2070,6145,2.0,0,0,3,7,2070,0,2003,0,98092,47.3357,-122.172,2070,5297,289950,23,10,2014,0,11,4075,3227,0,0,0
3,2.5,1780,7192,1.0,0,0,4,7,1250,530,1974,0,98031,47.4093,-122.173,1870,8500,252500,14,11,2014,0,40,5412,6630,0,1,0
4,2.25,2200,6750,1.0,0,0,5,8,1480,720,1959,0,98056,47.5215,-122.202,2710,6750,376000,29,10,2014,0,55,4550,4040,0,1,0
4,2.5,3240,13978,1.0,0,0,3,9,1860,1380,1977,0,98074,47.6298,-122.057,3150,12767,635700,22,5,2014,0,37,10738,9617,0,1,0
4,2.5,2880,12349,2.0,0,0,3,10,2880,0,1996,0,98075,47.5879,-121.973,3490,11539,710000,28,10,2014,0,18,9469,8049,0,0,0
3,1.75,1570,5120,1.0,0,2,3,7,980,590,1947,0,98177,47.7166,-122.365,2420,7200,440000,1,3,2015,0,68,3550,4780,0,1,1
3,2.5,3180,7904,1.0,0,0,3,8,1810,1370,2006,0,98056,47.489,-122.181,1950,7800,439000,30,6,2014,0,8,4724,5850,0,1,0
2,1.5,1310,12196,1.5,0,0,3,6,1310,0,1970,0,98052,47.6487,-122.122,2970,12196,455000,16,6,2014,0,44,10886,9226,0,0,0
2,1.0,910,9612,1.0,0,0,4,7,910,0,1981,0,98058,47.4297,-122.152,1410,9611,225000,19,5,2014,0,33,8702,8201,0,0,0
3,1.0,1460,10914,1.0,0,0,4,7,1460,0,1959,0,98058,47.4511,-122.173,1490,8314,250000,28,7,2014,0,55,9454,6824,0,0,0
3,1.75,2720,4720,1.5,0,0,4,7,1580,1140,1925,0,98105,47.6691,-122.29,1660,4640,685000,7,4,2015,0,90,2000,2980,0,1,1
5,2.75,2280,10319,1.0,0,0,3,8,1300,980,1959,0,98177,47.7566,-122.363,2370,8056,420000,20,6,2014,0,55,8039,5686,0,1,1
2,1.0,670,1675,1.0,0,0,5,6,670,0,1960,0,98144,47.5918,-122.295,1220,1740,245000,22,11,2014,0,54,1005,520,0,0,1
4,2.0,1480,15000,1.0,0,0,4,7,1480,0,1957,0,98055,47.4312,-122.196,1450,8768,275000,4,11,2014,0,57,13520,7318,0,0,0
3,2.0,2330,8000,1.0,0,0,3,7,1390,940,1986,0,98023,47.2958,-122.368,1570,7227,270000,29,10,2014,0,28,5670,5657,0,1,0
4,3.0,2170,2500,2.0,0,0,3,8,1710,460,1997,0,98115,47.6742,-122.303,2170,4080,767250,21,10,2014,0,17,330,1910,0,1,1
3,2.0,1760,9900,1.0,0,0,4,7,1760,0,1943,0,98166,47.4783,-122.338,1190,9900,229000,4,9,2014,0,71,8140,8710,0,0,1
4,2.5,2370,6557,2.0,0,0,3,9,2370,0,1998,0,98042,47.423,-122.155,2370,7378,369000,5,12,2014,0,16,4187,5008,0,0,0
2,1.0,720,6050,1.0,0,0,2,5,720,0,1951,0,98125,47.7259,-122.29,1480,7280,338500,2,2,2015,0,64,5330,5800,0,0,1
3,1.0,950,4000,1.0,0,0,3,7,780,170,1949,0,98118,47.5232,-122.284,1230,4000,256000,29,4,2015,0,66,3050,2770,0,1,1
3,2.5,1980,9725,2.0,0,0,3,8,1980,0,1994,0,98045,47.4856,-121.802,2070,9834,470000,4,3,2015,0,21,7745,7764,0,0,0
3,2.5,2540,7680,2.0,0,1,4,9,2540,0,1940,2001,98177,47.7175,-122.364,2490,7680,675000,27,5,2014,61,74,5140,5190,1,0,1
4,2.75,2760,7533,1.0,0,0,3,8,1400,1360,1997,0,98042,47.371,-122.108,2340,7943,369950,10,11,2014,0,17,4773,5603,0,1,0
5,3.5,2950,7980,2.0,0,3,3,9,2350,600,2005,0,98065,47.5339,-121.858,2950,7980,615000,15,9,2014,0,9,5030,5030,0,1,0
3,1.75,2150,3503,2.0,0,0,3,8,1870,280,1921,0,98112,47.6285,-122.303,3920,6402,950000,28,7,2014,0,93,1353,2482,0,1,1
4,2.5,2760,5750,2.0,0,0,3,8,2760,0,1993,0,98112,47.627,-122.303,2760,5390,799500,21,10,2014,0,21,2990,2630,0,0,1
2,1.0,840,11600,1.0,0,0,3,6,840,0,1952,0,98168,47.492,-122.302,1610,9120,187000,9,7,2014,0,62,10760,7510,0,0,1
5,2.25,2890,12478,2.0,0,0,3,9,2890,0,1977,0,98074,47.6295,-122.052,2570,11880,598000,20,5,2014,0,37,9588,9310,0,0,0
3,2.25,2060,10160,1.0,0,0,4,8,1340,720,1967,0,98155,47.7712,-122.285,2320,11186,429950,17,4,2015,0,48,8100,8866,0,1,1
5,2.25,1700,13500,1.5,0,0,4,7,1700,0,1962,0,98059,47.4611,-122.067,1810,14550,347950,31,3,2015,0,53,11800,12740,0,0,0
3,1.0,1210,10185,1.0,0,0,3,6,1210,0,1957,0,98146,47.4873,-122.345,1320,10245,205000,29,10,2014,0,57,8975,8925,0,0,1
3,2.25,1590,9200,1.0,0,0,4,7,1110,480,1979,0,98092,47.2917,-122.184,1880,9200,225000,27,3,2015,0,36,7610,7320,0,1,0
4,2.25,2620,10536,1.0,0,0,3,8,1520,1100,1979,0,98075,47.5847,-122.075,2760,12431,705000,6,10,2014,0,35,7916,9671,0,1,0
5,2.5,3190,6178,2.0,0,0,3,8,3190,0,2003,0,98059,47.5104,-122.154,2480,7548,535000,5,5,2015,0,12,2988,5068,0,0,0
3,2.0,1450,9044,2.0,0,0,3,7,1450,0,1990,0,98022,47.1955,-121.987,1450,9044,222500,21,1,2015,0,25,7594,7594,0,0,0
2,1.5,1270,1282,2.0,0,0,3,8,1000,270,2006,0,98106,47.5581,-122.363,1270,1325,313500,24,4,2015,0,9,12,55,0,1,1
3,2.25,2730,7521,2.0,0,2,3,9,2730,0,1992,0,98011,47.7704,-122.196,2700,8204,632000,17,3,2015,0,23,4791,5504,0,0,0
3,2.0,1840,3432,2.0,0,0,3,7,1840,0,2012,0,98155,47.7368,-122.295,1280,7573,467000,22,3,2015,0,3,1592,6293,0,0,1
3,2.25,1970,7210,1.0,0,0,4,8,1380,590,1978,0,98030,47.3821,-122.171,1970,7350,339000,24,4,2015,0,37,5240,5380,0,1,0
3,2.75,3200,6699,2.0,0,0,3,9,3200,0,2004,0,98075,47.5884,-121.991,3020,6699,712000,19,6,2014,0,10,3499,3679,0,0,0
3,1.0,1060,10050,1.0,0,0,4,7,1060,0,1967,0,98028,47.7355,-122.231,1570,9938,335000,20,5,2014,0,47,8990,8368,0,0,0
3,3.25,1740,1693,2.0,0,0,3,8,1360,380,2007,0,98116,47.558,-122.382,1130,1626,470000,17,7,2014,0,7,-47,496,0,1,1
3,1.0,810,7000,1.0,0,0,3,7,810,0,1968,0,98052,47.6591,-122.134,1820,7589,367000,24,7,2014,0,46,6190,5769,0,0,0
3,2.5,2460,4399,2.0,0,0,3,7,2460,0,2007,0,98065,47.5415,-121.884,2060,4399,440500,24,5,2014,0,7,1939,2339,0,0,0
4,1.0,2100,9288,1.0,0,0,4,7,1050,1050,1968,0,98058,47.4558,-122.171,1600,8550,305000,27,5,2014,0,46,7188,6950,0,1,0
3,1.75,1530,5000,1.0,0,2,3,7,1020,510,1948,0,98117,47.6806,-122.36,1530,5000,635000,8,9,2014,0,66,3470,3470,0,1,1
3,2.25,1670,4800,1.5,0,3,3,8,1670,0,1903,0,98119,47.6356,-122.367,2300,4800,1020000,27,6,2014,0,111,3130,2500,0,0,1
2,2.5,1175,1366,2.0,0,0,3,8,740,435,2005,0,98103,47.6962,-122.342,1710,1255,342000,2,6,2014,0,9,191,-455,0,1,1
3,2.25,2130,8800,1.0,0,0,3,8,1270,860,1978,0,98030,47.383,-122.168,1960,8075,283000,11,11,2014,0,36,6670,6115,0,1,0
4,2.5,1700,4268,2.0,0,0,3,7,1700,0,2000,0,98001,47.3303,-122.268,1700,4488,245000,8,8,2014,0,14,2568,2788,0,0,0
3,2.5,2600,5540,2.0,0,0,3,8,2600,0,2004,0,98038,47.3446,-122.041,2600,5540,355500,5,6,2014,0,10,2940,2940,0,0,0
3,1.0,1460,5000,1.0,0,0,4,7,1460,0,1934,1960,98115,47.6837,-122.32,1790,4000,395000,9,4,2015,26,81,3540,2210,1,0,1
4,2.25,2010,7280,2.0,0,0,4,8,2010,0,1988,0,98032,47.3585,-122.286,1660,7579,324900,16,12,2014,0,26,5270,5919,0,0,0
3,1.75,1320,5750,1.5,0,0,5,7,1320,0,1918,0,98116,47.5848,-122.391,1440,5750,660000,8,5,2014,0,96,4430,4310,0,0,1
3,2.5,1960,8469,2.0,0,0,4,8,1960,0,1984,0,98052,47.7236,-122.105,2040,8189,552321,6,11,2014,0,30,6509,6149,0,0,0
2,1.75,2050,11900,1.0,0,0,4,8,2050,0,1950,0,98004,47.6209,-122.219,2980,11900,1100000,28,5,2014,0,64,9850,8920,0,0,0
3,1.5,1800,9216,1.0,0,0,4,7,1800,0,1950,0,98001,47.2739,-122.249,1400,10022,237000,25,8,2014,0,64,7416,8622,0,0,0
2,1.0,1210,5600,1.5,0,0,3,7,1210,0,1922,0,98136,47.5322,-122.392,1400,5028,402000,4,5,2015,0,93,4390,3628,0,0,1
3,1.75,1880,8706,1.0,0,0,3,7,940,940,1927,0,98155,47.7362,-122.292,1880,7200,395900,20,3,2015,0,88,6826,5320,0,1,1
2,1.75,860,5535,1.0,0,0,3,7,860,0,1948,0,98103,47.6901,-122.331,1420,4960,442000,22,10,2014,0,66,4675,3540,0,0,1
3,2.0,1390,10155,1.0,0,0,3,7,1130,260,1980,0,98003,47.2575,-122.305,1790,10155,190500,12,8,2014,0,34,8765,8365,0,1,0
4,2.75,3340,7230,2.0,0,0,3,9,3340,0,1996,0,98027,47.549,-122.096,3230,7529,808000,20,11,2014,0,18,3890,4299,0,0,0
4,2.5,2040,6685,2.0,0,0,3,8,2040,0,1998,0,98133,47.7413,-122.354,1890,8253,500000,26,8,2014,0,16,4645,6363,0,0,1
4,2.75,3010,15992,2.0,0,0,3,11,3010,0,1996,0,98075,47.5895,-121.994,3330,12333,775000,19,6,2014,0,18,12982,9003,0,0,0
5,1.75,2110,8500,1.0,0,0,3,7,1100,1010,1962,0,98133,47.7737,-122.35,2020,8500,300000,10,11,2014,0,52,6390,6480,0,1,1
5,1.75,2110,8500,1.0,0,0,3,7,1100,1010,1962,0,98133,47.7737,-122.35,2020,8500,496000,10,4,2015,0,53,6390,6480,0,1,1
4,2.5,2510,6853,2.0,0,2,3,9,2510,0,2006,0,98038,47.3547,-122.003,3400,6965,448000,20,6,2014,0,8,4343,3565,0,0,0
3,1.75,1120,5500,1.5,0,0,4,7,1120,0,1925,0,98136,47.5445,-122.391,1490,5500,464600,23,5,2014,0,89,4380,4010,0,0,1
3,1.0,1530,2370,2.0,0,0,3,8,1530,0,1901,0,98122,47.6108,-122.303,1310,2370,590000,28,7,2014,0,113,840,1060,0,0,1
3,2.5,1800,3300,2.0,0,0,3,7,1690,110,2004,0,98118,47.5491,-122.276,1570,3902,399000,7,10,2014,0,10,1500,2332,0,1,1
2,1.0,1030,6000,1.0,0,0,3,7,1030,0,1925,0,98118,47.5669,-122.283,1510,5000,305000,15,10,2014,0,89,4970,3490,0,0,1
3,1.75,1210,6175,1.0,0,0,3,7,1210,0,1976,0,98034,47.7291,-122.202,1520,7475,478000,21,11,2014,0,38,4965,5955,0,0,0
4,2.25,1790,7203,1.0,0,0,4,7,1110,680,1973,0,98155,47.7709,-122.294,2270,9000,430000,3,6,2014,0,41,5413,6730,0,1,1
4,1.5,1550,5053,1.0,0,0,4,7,1180,370,1963,0,98118,47.5499,-122.274,1450,5639,433000,1,7,2014,0,51,3503,4189,0,1,1
3,1.0,1170,7395,1.0,0,0,4,7,1170,0,1969,0,98055,47.4627,-122.19,1430,7920,255000,18,8,2014,0,45,6225,6490,0,0,0
3,1.0,1120,10125,1.0,0,0,3,6,1120,0,1961,0,98059,47.4794,-122.078,1120,8820,305000,22,4,2015,0,54,9005,7700,0,0,0
4,1.0,1040,4420,1.5,0,0,3,6,1040,0,1944,0,98117,47.6945,-122.368,1310,4920,396000,25,2,2015,0,71,3380,3610,0,0,1
4,2.5,2460,7350,2.0,0,0,3,9,2460,0,1989,0,98023,47.3061,-122.349,2390,8568,347500,8,5,2014,0,25,4890,6178,0,0,0
4,2.5,3690,11468,2.0,0,0,3,11,3690,0,1987,0,98027,47.5699,-122.092,3370,10751,900000,14,8,2014,0,27,7778,7381,0,0,0
3,2.25,1670,3135,2.0,0,0,3,8,1220,450,2002,0,98199,47.6478,-122.396,1630,1596,540000,24,2,2015,0,13,1465,-34,0,1,1
3,2.0,1340,9750,1.0,0,0,4,7,890,450,1974,0,98024,47.5644,-121.898,1460,12900,324950,27,1,2015,0,41,8410,11440,0,1,0
3,2.25,2610,3357,2.0,0,0,4,7,1980,630,1926,0,98112,47.638,-122.306,1940,3357,1050000,29,4,2015,0,89,747,1417,0,1,1
4,1.75,1540,7200,1.0,0,0,3,7,1260,280,1966,0,98003,47.3424,-122.308,1540,8416,221000,29,10,2014,0,48,5660,6876,0,1,0
3,2.0,1640,7201,1.0,0,0,3,8,1640,0,1948,0,98125,47.7216,-122.289,1750,7201,405000,11,6,2014,0,66,5561,5451,0,0,1
4,1.75,1930,7245,1.0,0,0,4,8,1510,420,1972,0,98008,47.6396,-122.112,1880,7245,588000,22,8,2014,0,42,5315,5365,0,1,0
3,2.0,1430,10850,1.0,0,0,3,7,1430,0,1994,0,98001,47.2671,-122.233,1610,8015,234950,9,9,2014,0,20,9420,6405,0,0,0
4,1.5,2430,4995,1.5,0,0,4,7,1730,700,1928,0,98144,47.5782,-122.292,2240,5000,580000,7,10,2014,0,86,2565,2760,0,1,1
5,3.0,2460,7240,1.0,0,0,3,9,1840,620,1991,0,98006,47.5486,-122.189,2530,7885,637000,16,7,2014,0,23,4780,5355,0,1,0
4,2.25,2490,6973,1.0,0,0,4,8,1490,1000,1953,0,98199,47.6516,-122.409,1780,5612,704000,30,10,2014,0,61,4483,3832,0,1,1
2,1.0,880,9750,1.0,0,0,5,6,880,0,1938,0,98168,47.4885,-122.298,1220,9406,210000,25,9,2014,0,76,8870,8186,0,0,1
4,2.5,2110,3750,2.0,0,0,3,8,2110,0,2000,0,98117,47.6789,-122.363,1700,5000,772000,16,5,2014,0,14,1640,3300,0,0,1
4,1.75,1850,4388,2.0,0,0,5,8,1850,0,1941,0,98117,47.6885,-122.381,1410,4107,763000,27,4,2015,0,74,2538,2697,0,0,1
2,1.5,2060,7713,1.5,0,0,4,7,2060,0,1930,0,98030,47.3722,-122.185,1780,7713,213500,18,2,2015,0,85,5653,5933,0,0,0
2,1.0,1360,9367,1.0,0,0,4,6,680,680,1924,0,98155,47.7689,-122.315,1360,7543,255000,20,12,2014,0,90,8007,6183,0,1,1
3,2.0,2000,10490,1.0,0,0,3,8,1430,570,1978,0,98033,47.6976,-122.166,1530,7659,423500,17,10,2014,0,36,8490,6129,0,1,0
3,2.75,2230,14400,1.0,0,0,4,8,1460,770,1977,0,98075,47.5791,-122.048,2200,13280,550000,8,9,2014,0,37,12170,11080,0,1,0
3,2.75,1820,7517,1.0,0,0,3,9,1820,0,1997,0,98116,47.5705,-122.406,2540,8035,795000,21,1,2015,0,18,5697,5495,0,0,1
4,3.0,2740,2811,2.0,0,0,3,8,2240,500,2003,0,98072,47.7738,-122.158,2740,3596,495000,15,8,2014,0,11,71,856,0,1,0
4,2.5,2710,6558,2.0,0,0,3,9,2710,0,1997,0,98058,47.434,-122.109,2710,7635,455000,2,3,2015,0,18,3848,4925,0,0,0
2,1.0,910,9753,1.0,0,0,3,5,910,0,1947,0,98032,47.3897,-122.236,1160,7405,85000,5,3,2015,0,68,8843,6245,0,0,0
4,2.0,1980,10585,1.5,0,0,2,6,1980,0,1924,0,98055,47.4836,-122.214,1360,7810,239000,4,11,2014,0,90,8605,6450,0,0,0
3,1.0,1040,10080,1.0,0,0,3,6,1040,0,1959,0,98023,47.329,-122.343,1000,8736,184900,30,7,2014,0,55,9040,7736,0,0,0
4,2.25,2810,8560,1.0,0,0,3,8,1610,1200,1979,0,98058,47.4437,-122.124,2400,7600,386000,21,4,2015,0,36,5750,5200,0,1,0
4,2.5,2000,5962,2.0,0,0,3,8,2000,0,1999,0,98133,47.7695,-122.35,1790,10500,415000,4,6,2014,0,15,3962,8710,0,0,1
3,1.0,1530,6372,1.0,0,0,3,7,1210,320,1962,0,98118,47.535,-122.289,1960,6426,387000,12,5,2015,0,53,4842,4466,0,1,1
6,4.0,5110,7128,2.5,0,0,4,11,5110,0,1906,0,98112,47.6285,-122.304,4110,6480,2140000,4,3,2015,0,109,2018,2370,0,0,1
2,1.0,750,4000,1.0,0,0,4,6,750,0,1926,0,98118,47.5547,-122.272,1120,5038,422000,11,5,2015,0,89,3250,3918,0,0,1
3,1.0,1200,6250,1.0,0,0,3,6,920,280,1943,0,98168,47.5095,-122.331,1280,9375,280000,27,5,2014,0,71,5050,8095,0,1,1
5,2.5,3580,8921,2.0,0,0,3,9,3580,0,2000,0,98033,47.693,-122.202,2710,9308,1150000,3,7,2014,0,14,5341,6598,0,0,0
3,2.5,2010,11618,2.0,0,0,3,7,2010,0,1990,0,98022,47.1956,-121.985,1550,9354,279000,10,11,2014,0,24,9608,7804,0,0,0
4,2.0,1730,3884,1.0,0,0,5,7,1060,670,1924,0,98103,47.6624,-122.349,1360,3563,569000,23,6,2014,0,90,2154,2203,0,1,1
2,1.0,860,5080,1.0,0,0,3,7,860,0,1960,0,98032,47.39,-122.236,1250,6477,209950,10,4,2015,0,55,4220,5227,0,0,0
3,1.5,1370,7697,1.0,0,0,3,7,1370,0,1939,0,98177,47.7153,-122.361,1370,7697,468000,17,3,2015,0,76,6327,6327,0,0,1
3,1.75,1360,9603,1.0,0,0,3,7,1360,0,1963,0,98198,47.3959,-122.309,2240,10605,237100,30,4,2015,0,52,8243,8365,0,0,1
4,2.5,2530,8169,2.0,0,0,3,8,2530,0,1993,0,98003,47.2634,-122.312,2220,8013,336000,8,7,2014,0,21,5639,5793,0,0,0
4,2.0,1680,3813,2.0,0,0,4,7,1680,0,1900,0,98144,47.593,-122.293,2540,3996,500000,22,12,2014,0,114,2133,1456,0,0,1
3,2.5,1580,6860,2.0,0,0,3,7,1580,0,1995,0,98055,47.4447,-122.188,1580,7050,290000,26,4,2015,0,20,5280,5470,0,0,0
7,3.5,3890,8342,2.0,0,4,3,9,2840,1050,1968,0,98117,47.7011,-122.392,2870,8342,1190000,14,3,2015,0,47,4452,5472,0,1,1
5,2.0,1600,4168,1.5,0,0,3,7,1600,0,1927,0,98126,47.5297,-122.381,1190,4168,365000,25,7,2014,0,87,2568,2978,0,0,1
3,1.0,1200,9668,1.0,0,0,5,6,1200,0,1975,0,98092,47.3156,-122.128,1200,9800,146300,25,3,2015,0,40,8468,8600,0,0,0
3,1.75,1760,10780,1.0,0,0,3,8,1760,0,1977,0,98005,47.5938,-122.154,2090,10780,554000,9,6,2014,0,37,9020,8690,0,0,0
3,2.0,1670,7700,1.0,0,0,3,7,1170,500,1972,0,98034,47.725,-122.2,1500,7875,424000,18,6,2014,0,42,6030,6375,0,1,0
4,3.5,4640,9827,2.0,0,2,3,10,3210,1430,2007,0,98027,47.5524,-122.078,3810,8207,1350000,29,4,2015,0,8,5187,4397,0,1,0
4,1.5,1800,6750,1.5,0,0,4,7,1800,0,1950,0,98115,47.6868,-122.285,1420,5900,508500,19,11,2014,0,64,4950,4480,0,0,1
3,1.75,1210,8864,1.0,0,0,3,7,1210,0,1985,0,98042,47.3639,-122.08,1510,8062,244500,1,5,2015,0,30,7654,6552,0,0,0
2,2.5,1280,1566,2.0,0,0,3,7,1280,0,2005,0,98055,47.4336,-122.195,1460,1845,206000,20,11,2014,0,9,286,385,0,0,0
3,2.0,1650,7104,2.0,0,0,3,8,1650,0,1945,1986,98177,47.7053,-122.374,1730,7104,643500,5,9,2014,41,69,5454,5374,1,0,1
4,1.75,1590,10523,2.0,0,0,4,7,1590,0,1922,0,98133,47.7358,-122.342,1610,8568,372500,20,5,2014,0,92,8933,6958,0,0,1
5,2.0,1900,5000,1.0,0,2,3,8,1720,180,1957,0,98107,47.6735,-122.362,1770,5000,630000,15,7,2014,0,57,3100,3230,0,1,1
2,2.5,1500,3608,2.0,0,0,3,8,1500,0,2005,0,98029,47.5472,-121.994,2080,2686,418000,10,7,2014,0,9,2108,606,0,0,0
4,2.5,2689,6688,2.0,0,0,3,9,2689,0,2006,0,98030,47.3803,-122.184,2665,5700,425000,25,2,2015,0,9,3999,3035,0,0,0
4,2.75,3250,5500,2.0,0,0,3,9,3250,0,2007,0,98027,47.5398,-121.997,3920,6000,800000,5,2,2015,0,8,2250,2080,0,0,0
2,1.0,960,13438,1.0,0,0,3,7,960,0,1951,0,98168,47.4745,-122.295,1630,11656,208000,8,12,2014,0,63,12478,10026,0,0,1
3,1.75,1650,9600,1.0,0,0,4,7,1650,0,1977,0,98075,47.5779,-122.044,2040,12220,476000,14,7,2014,0,37,7950,10180,0,0,0
3,2.5,1690,5171,2.0,0,0,3,8,1690,0,2003,0,98023,47.2779,-122.347,2550,5025,277500,2,2,2015,0,12,3481,2475,0,0,0
4,2.75,2310,4020,3.0,0,0,5,8,2310,0,1979,0,98122,47.6154,-122.291,2270,3750,890000,8,7,2014,0,35,1710,1480,0,0,1
3,3.5,1790,1288,3.0,0,0,3,8,1390,400,2000,0,98199,47.651,-122.384,1560,1426,450000,23,3,2015,0,15,-502,-134,0,1,1
3,1.0,1230,8750,1.0,0,0,3,6,1230,0,1965,0,98003,47.3266,-122.334,1230,8750,205000,25,6,2014,0,49,7520,7520,0,0,0
3,2.0,1620,2640,1.5,0,0,5,8,1620,0,1929,0,98115,47.6884,-122.322,1470,4080,665000,18,7,2014,0,85,1020,2610,0,0,1
4,2.75,2440,12051,1.0,0,0,5,8,1440,1000,1966,0,98133,47.7456,-122.351,2030,8006,518000,3,10,2014,0,48,9611,5976,0,1,1
4,2.25,2100,7350,2.0,0,0,3,8,2100,0,1979,0,98033,47.7019,-122.171,1780,7350,465000,24,9,2014,0,35,5250,5570,0,0,0
3,2.5,3040,7232,2.0,0,0,3,7,3040,0,2003,0,98092,47.3355,-122.168,2760,6926,330000,17,6,2014,0,11,4192,4166,0,0,0
4,3.0,2490,5064,2.0,0,0,3,7,2490,0,2007,0,98056,47.5139,-122.189,2470,5064,449400,26,12,2014,0,7,2574,2594,0,0,0
3,2.75,2690,10443,1.0,0,0,3,9,2690,0,2007,0,98053,47.7185,-122.024,1440,4185,829000,6,2,2015,0,8,7753,2745,0,0,0
4,1.75,2190,9752,1.0,0,0,3,8,2190,0,1964,0,98034,47.7108,-122.239,2040,9964,450000,20,2,2015,0,51,7562,7924,0,0,0
3,1.75,1490,9120,1.0,0,0,5,7,1490,0,1959,0,98059,47.4806,-122.163,1340,8040,310000,1,10,2014,0,55,7630,6700,0,0,0
3,2.0,2060,4040,1.0,0,0,4,8,1120,940,1947,0,98103,47.6798,-122.352,1500,4000,605000,3,6,2014,0,67,1980,2500,0,1,1
3,1.75,1400,4000,1.5,0,0,4,7,1400,0,1925,0,98117,47.6902,-122.388,1050,4330,545000,22,9,2014,0,89,2600,3280,0,0,1
5,2.25,3000,13899,2.0,0,0,4,8,3000,0,1975,0,98052,47.6373,-122.105,2270,10763,600000,3,7,2014,0,39,10899,8493,0,0,0
3,1.0,1440,5000,2.0,0,0,3,7,1440,0,1910,0,98103,47.6741,-122.354,1850,4500,560000,13,5,2014,0,104,3560,2650,0,0,1
3,1.0,1170,3348,1.5,0,0,4,7,1170,0,1924,0,98117,47.687,-122.378,1590,4219,457000,24,11,2014,0,90,2178,2629,0,0,1
2,1.0,1770,8640,1.5,0,0,3,6,1520,250,1949,0,98117,47.6926,-122.363,1060,4804,585000,5,5,2014,0,65,6870,3744,0,1,1
3,2.0,1860,13374,1.0,0,0,3,8,1860,0,1985,0,98027,47.5397,-122.054,1960,9797,560000,7,5,2014,0,29,11514,7837,0,0,0
2,1.0,770,3008,1.0,0,0,4,5,770,0,1917,0,98116,47.5686,-122.389,1550,4563,345000,5,4,2015,0,98,2238,3013,0,0,1
4,3.5,3820,17745,2.0,0,2,3,8,2440,1380,1955,0,98108,47.557,-122.295,2520,9640,550000,20,7,2014,0,59,13925,7120,0,1,1
4,2.5,3190,8195,2.0,0,0,3,10,3190,0,2006,0,98038,47.3555,-122.003,3400,7607,589950,24,6,2014,0,8,5005,4207,0,0,0
3,1.5,1320,13200,1.0,0,0,3,7,1320,0,1970,0,98059,47.5009,-122.143,1730,13200,327000,2,6,2014,0,44,11880,11470,0,0,0
2,2.5,1140,1182,3.0,0,0,3,8,1140,0,2007,0,98107,47.6713,-122.383,1290,1189,425000,3,6,2014,0,7,42,-101,0,0,1
3,1.0,860,7030,1.0,0,0,3,7,860,0,1973,0,98034,47.7151,-122.211,1360,7500,350000,1,8,2014,0,41,6170,6140,0,0,0
3,1.75,1540,10545,2.0,0,0,4,6,1540,0,1978,0,98045,47.4451,-121.763,1540,10000,273000,11,3,2015,0,37,9005,8460,0,0,0
4,2.25,2160,9525,1.0,0,0,3,8,1080,1080,1961,0,98040,47.5651,-122.221,2780,9525,750000,20,3,2015,0,54,7365,6745,0,1,0
3,1.5,1450,9477,1.0,0,0,4,7,1450,0,1963,0,98031,47.4215,-122.203,1460,9477,240000,9,10,2014,0,51,8027,8017,0,0,0
3,1.75,1830,9620,1.0,0,0,4,8,1830,0,1978,0,98023,47.3123,-122.389,1990,8280,400000,20,3,2015,0,37,7790,6290,0,0,0
3,1.5,1630,6625,1.0,0,0,5,7,980,650,1980,0,98023,47.29,-122.368,1440,7145,230000,3,10,2014,0,34,4995,5705,0,1,0
4,2.5,2500,8215,2.0,0,0,3,8,2500,0,1990,0,98031,47.4124,-122.204,2360,7801,372000,13,4,2015,0,25,5715,5441,0,0,0
3,1.75,1470,4950,1.0,0,0,3,7,1030,440,1984,0,98133,47.7325,-122.337,1100,5250,459500,5,7,2014,0,30,3480,4150,0,1,1
4,2.5,2170,7700,1.0,0,0,3,7,1420,750,1969,0,98034,47.7216,-122.219,1710,7770,465000,6,11,2014,0,45,5530,6060,0,1,0
3,2.0,2120,7560,1.0,0,0,3,9,2120,0,1991,0,98058,47.435,-122.16,2660,7700,386000,30,5,2014,0,23,5440,5040,0,0,0
3,2.5,1530,3464,2.0,0,0,3,8,1530,0,1998,0,98007,47.6179,-122.141,1530,3446,546000,9,6,2014,0,16,1934,1916,0,0,0
3,1.75,2710,9088,1.0,0,0,4,7,2060,650,1965,0,98001,47.3073,-122.272,1690,10454,278000,27,10,2014,0,49,6378,8764,0,1,0
3,2.5,2860,8935,2.0,0,0,3,8,2860,0,2004,0,98065,47.5336,-121.855,2650,6167,540000,18,9,2014,0,10,6075,3517,0,0,0
4,1.0,1120,7104,1.5,0,0,3,7,1120,0,1946,0,98177,47.7055,-122.372,1370,7104,554000,17,6,2014,0,68,5984,5734,0,0,1
3,1.0,1730,7210,1.0,0,0,3,7,1430,300,1963,0,98001,47.3404,-122.28,1820,7210,210000,27,8,2014,0,51,5480,5390,0,1,0
2,1.0,1010,5408,1.0,0,0,4,6,1010,0,1926,0,98032,47.3759,-122.238,980,7800,225000,4,5,2015,0,89,4398,6820,0,0,0
4,2.5,2350,6624,2.0,0,0,3,9,2350,0,1990,0,98074,47.6262,-122.045,2590,11240,561600,15,7,2014,0,24,4274,8650,0,0,0
6,5.25,2860,5682,2.0,0,0,3,7,2860,0,1978,0,98002,47.303,-122.221,1390,5956,300000,20,5,2014,0,36,2822,4566,0,0,0
4,3.5,4285,9567,2.0,0,1,5,10,3485,800,1946,0,98199,47.6434,-122.409,2960,6902,1650000,27,8,2014,0,68,5282,3942,0,1,1
3,1.0,1310,9612,1.0,0,0,3,7,960,350,1962,0,98001,47.2958,-122.285,1310,9812,150000,26,6,2014,0,52,8302,8502,0,1,0
2,1.75,2320,6250,1.0,0,0,3,7,1400,920,1948,0,98136,47.5468,-122.386,1420,6250,400950,24,9,2014,0,66,3930,4830,0,1,1
4,2.25,2210,8101,2.0,0,0,3,9,2210,0,1985,0,98074,47.6475,-122.07,2330,8842,620000,21,1,2015,0,30,5891,6512,0,0,0
4,2.75,2090,14141,1.5,0,0,4,8,1680,410,1941,0,98166,47.4333,-122.347,1990,12920,449000,18,8,2014,0,73,12051,10930,0,1,1
4,2.5,2240,4025,1.0,0,2,3,7,1250,990,1926,2005,98115,47.6818,-122.311,1380,3500,630000,28,7,2014,79,88,1785,2120,1,1,1
2,1.0,1180,7200,1.0,0,0,4,6,1180,0,1949,0,98133,47.7475,-122.342,1180,7200,336000,14,4,2015,0,66,6020,6020,0,0,1
4,2.0,1970,7451,1.0,0,0,3,8,1350,620,1962,0,98133,47.765,-122.335,1980,7510,352500,9,3,2015,0,53,5481,5530,0,1,1
2,1.0,840,12750,1.0,0,0,3,6,840,0,1925,0,98055,47.484,-122.211,1480,6969,150000,16,10,2014,0,89,11910,5489,0,0,0
2,1.0,840,12750,1.0,0,0,3,6,840,0,1925,0,98055,47.484,-122.211,1480,6969,175000,24,4,2015,0,90,11910,5489,0,0,0
3,2.0,1830,10873,1.0,0,0,3,8,1830,0,1989,0,98023,47.3066,-122.394,2490,8976,305000,31,7,2014,0,25,9043,6486,0,0,0
3,1.5,1800,4700,1.0,0,0,3,7,1200,600,1941,0,98117,47.6858,-122.385,1580,4700,607500,15,7,2014,0,73,2900,3120,0,1,1
2,1.0,1250,5040,1.0,0,0,3,7,950,300,1920,0,98117,47.6959,-122.365,1290,5040,505000,18,11,2014,0,94,3790,3750,0,1,1
3,1.75,2440,10179,1.0,0,0,4,7,1220,1220,1962,0,98198,47.4118,-122.314,1650,9711,280500,27,10,2014,0,52,7739,8061,0,1,1
5,2.75,3060,6895,2.0,0,0,3,8,3060,0,2003,0,98042,47.3809,-122.098,2590,6895,381000,12,8,2014,0,11,3835,4305,0,0,0
5,2.25,2230,9600,1.0,0,0,3,8,1320,910,1978,0,98077,47.7466,-122.076,2080,9760,482000,22,5,2014,0,36,7370,7680,0,1,0
3,1.0,1270,6900,1.0,0,0,3,7,1270,0,1977,0,98034,47.7279,-122.192,1480,7280,379950,22,10,2014,0,37,5630,5800,0,0,0
2,1.0,860,6510,1.0,0,0,3,7,860,0,1952,0,98004,47.6021,-122.202,1740,10800,605000,30,3,2015,0,63,5650,9060,0,0,0
1,1.0,820,1060,1.0,0,0,3,8,760,60,2007,0,98126,47.5472,-122.372,1770,1853,194000,20,5,2014,0,7,240,83,0,1,1
4,2.25,2090,8579,2.0,0,0,3,8,2090,0,1987,0,98074,47.6364,-122.03,1850,8843,546200,1,4,2015,0,28,6489,6993,0,0,0
3,1.75,1860,9629,1.0,0,0,4,7,1240,620,1961,0,98059,47.4913,-122.143,1940,9629,315000,3,4,2015,0,54,7769,7689,0,1,0
3,1.5,900,8690,1.5,0,0,5,6,900,0,1941,0,98116,47.5751,-122.393,1000,6150,465000,17,12,2014,0,73,7790,5150,0,0,1
4,2.75,3100,7501,2.0,0,0,3,10,3100,0,1998,0,98052,47.6859,-122.109,3140,8672,795000,8,8,2014,0,16,4401,5532,0,0,0
4,2.25,2300,9100,1.0,0,0,3,7,1280,1020,1977,0,98058,47.4576,-122.16,1640,9100,265000,26,8,2014,0,37,6800,7460,0,1,0
4,2.5,3110,11857,2.0,0,4,3,11,2040,1070,1990,0,98117,47.6952,-122.402,3110,11570,1300000,12,1,2015,0,25,8747,8460,0,1,1
3,1.0,1130,12212,1.0,0,0,3,6,1130,0,1942,0,98146,47.4952,-122.34,1190,9240,126500,5,5,2015,0,73,11082,8050,0,0,1
4,2.5,2920,7901,2.0,0,0,3,9,2920,0,2004,0,98052,47.7036,-122.125,3020,7900,760000,5,8,2014,0,10,4981,4880,0,0,0
2,1.25,1230,1569,2.0,0,0,3,9,1050,180,2009,0,98112,47.6193,-122.304,1100,1230,540000,3,9,2014,0,5,339,130,0,1,1
5,2.75,2190,12687,1.0,0,0,5,7,1370,820,1978,0,98028,47.7762,-122.257,2280,10784,446000,19,5,2014,0,36,10497,8504,0,1,0
1,0.75,850,5600,1.0,0,2,3,6,850,0,1903,1994,98019,47.7654,-121.48,900,12250,170000,26,3,2015,91,112,4750,11350,1,0,0
3,2.5,1500,7420,1.0,0,0,3,7,1000,500,1972,0,98034,47.7236,-122.174,1840,7272,379000,23,10,2014,0,42,5920,5432,0,1,0
9,4.0,4620,5508,2.5,0,0,3,11,3870,750,1915,0,98105,47.6684,-122.309,2710,4320,1400000,17,3,2015,0,100,888,1610,0,1,1
4,2.75,3150,7035,2.0,0,0,3,9,3150,0,2004,0,98075,47.5979,-121.974,3200,7035,800000,20,6,2014,0,10,3885,3835,0,0,0
3,1.0,1300,10139,1.0,0,0,3,7,1300,0,1962,2007,98042,47.3427,-122.087,1260,10139,260000,16,3,2015,45,53,8839,8879,1,0,0
5,2.5,3160,8000,1.0,0,0,4,7,1580,1580,1960,0,98040,47.5735,-122.208,2440,8079,820000,10,3,2015,0,55,4840,5639,0,1,0
3,2.25,1790,7125,1.0,0,0,3,7,1220,570,1974,0,98034,47.7184,-122.226,2040,7950,392000,2,9,2014,0,40,5335,5910,0,1,0
3,2.5,1650,4636,2.0,0,0,3,8,1650,0,1999,0,98075,47.5997,-122.016,1650,4504,465000,22,4,2015,0,16,2986,2854,0,0,0
4,2.5,2070,7312,1.0,0,0,4,7,1230,840,1977,0,98052,47.6958,-122.12,1770,7668,449950,22,8,2014,0,37,5242,5898,0,1,0
3,1.5,1580,8841,1.5,0,0,5,7,1180,400,1923,0,98103,47.6931,-122.352,1580,7512,520000,28,4,2015,0,92,7261,5932,0,1,1
4,2.25,2170,10000,1.0,0,0,3,8,1420,750,1975,0,98008,47.6219,-122.109,2390,11000,546800,28,8,2014,0,39,7830,8610,0,1,0
4,2.75,2220,11925,1.0,0,0,3,7,1560,660,1953,1985,98004,47.6381,-122.205,2500,11377,825000,24,3,2015,32,62,9705,8877,1,1,0
3,1.75,1440,11364,1.0,0,0,3,7,1440,0,1985,0,98155,47.743,-122.328,1950,9390,337000,22,4,2015,0,30,9924,7440,0,0,1
2,1.0,720,6686,1.0,0,0,3,6,720,0,1942,0,98117,47.7003,-122.362,1200,6686,333000,11,6,2014,0,72,5966,5486,0,0,1
2,2.0,1120,780,2.0,0,0,3,8,760,360,2004,0,98116,47.5788,-122.41,1120,1322,380000,11,11,2014,0,10,-340,202,0,1,1
3,2.5,1970,8426,2.0,0,0,3,8,1970,0,1992,0,98003,47.2674,-122.306,1970,9197,280000,28,4,2015,0,23,6456,7227,0,0,0
3,1.5,1420,9081,1.0,0,0,4,6,1420,0,1990,0,98022,47.1948,-121.999,1090,8410,202000,20,11,2014,0,24,7661,7320,0,0,0
4,2.5,2250,4119,2.0,0,0,3,8,2250,0,2001,0,98075,47.5973,-122.034,2290,3115,585000,27,4,2015,0,14,1869,825,0,0,0
4,2.0,2630,9663,1.0,0,1,4,8,1330,1300,1956,0,98056,47.4841,-122.19,1900,8894,435000,4,11,2014,0,58,7033,6994,0,1,0
2,2.25,1280,2574,2.0,0,0,3,7,1280,0,1992,0,98144,47.5939,-122.302,1250,3960,364000,24,9,2014,0,22,1294,2710,0,0,1
3,1.0,1260,8280,1.0,0,0,3,6,1260,0,1946,0,98115,47.7,-122.299,2100,8280,300000,14,5,2014,0,68,7020,6180,0,0,1
2,1.75,1930,4601,1.0,0,0,3,8,1930,0,2006,0,98053,47.7196,-122.022,1670,4500,558000,17,3,2015,0,9,2671,2830,0,0,0
1,1.5,1048,4800,1.0,0,0,3,7,1048,0,1942,0,98055,47.4759,-122.212,950,4800,199950,11,8,2014,0,72,3752,3850,0,0,0
3,2.25,1640,8400,1.0,0,0,4,8,1640,0,1962,0,98006,47.5484,-122.172,2110,8400,515000,27,8,2014,0,52,6760,6290,0,0,0
4,2.5,2380,4950,2.0,0,0,3,8,2380,0,2004,0,98136,47.5382,-122.391,1370,5120,590000,7,11,2014,0,10,2570,3750,0,0,1
4,2.0,2530,15520,1.0,0,0,5,8,2220,310,1964,0,98005,47.613,-122.167,2500,13300,813500,23,7,2014,0,50,12990,10800,0,1,0
3,2.25,2330,3600,1.5,0,0,3,8,2330,0,1971,0,98074,47.631,-122.061,2050,4275,490000,28,4,2015,0,44,1270,2225,0,0,0
3,2.25,2160,9612,2.0,0,0,3,7,2160,0,1994,0,98022,47.1927,-122.011,1970,9247,277000,27,8,2014,0,20,7452,7277,0,0,0
4,2.5,2280,9827,2.0,0,0,3,8,2280,0,1995,0,98033,47.6883,-122.168,1660,9827,649800,25,9,2014,0,19,7547,8167,0,0,0
3,1.0,1280,3200,1.5,0,0,3,7,1280,0,1903,0,98122,47.6029,-122.307,1320,1676,425000,23,7,2014,0,111,1920,356,0,0,1
2,1.0,850,4650,1.0,0,0,3,7,850,0,1975,0,98117,47.6926,-122.365,980,4700,460000,29,3,2015,0,40,3800,3720,0,0,1
5,2.5,2690,11745,1.0,0,0,3,8,1790,900,1960,0,98177,47.7708,-122.362,2670,7905,469000,10,7,2014,0,54,9055,5235,0,1,1
4,1.75,2440,5000,1.0,0,0,3,8,1340,1100,1954,0,98117,47.6823,-122.371,2170,5000,566000,10,6,2014,0,60,2560,2830,0,1,1
3,2.5,1930,10460,2.0,0,0,3,8,1930,0,1996,0,98059,47.4938,-122.161,2290,8228,407500,2,5,2014,0,18,8530,5938,0,0,0
2,1.0,800,8775,1.0,0,0,3,6,800,0,1942,0,98125,47.7171,-122.307,1470,8976,353500,28,10,2014,0,72,7975,7506,0,0,1
4,2.5,1990,9656,2.0,0,0,3,7,1990,0,1994,0,98010,47.3125,-121.998,1500,9656,264950,22,8,2014,0,20,7666,8156,0,0,0
3,2.5,2550,10355,2.0,0,0,3,9,2550,0,1990,0,98011,47.739,-122.203,2550,10084,547500,28,10,2014,0,24,7805,7534,0,0,0
3,2.25,1370,7087,2.0,0,0,3,7,1370,0,1993,0,98038,47.3504,-122.035,1400,6600,264500,17,11,2014,0,21,5717,5200,0,0,0
3,2.0,2020,8118,1.0,0,0,3,7,1020,1000,1963,0,98008,47.5866,-122.118,1670,8118,507500,20,5,2014,0,51,6098,6448,0,1,0
3,3.5,1560,2198,2.0,0,0,3,8,1180,380,2006,0,98116,47.5812,-122.403,1550,1467,560000,8,10,2014,0,8,638,-83,0,1,1
6,2.0,3560,5120,2.5,0,2,3,9,3560,0,1900,0,98122,47.6056,-122.311,2130,5120,835000,24,3,2015,0,115,1560,2990,0,0,1
3,1.5,2120,6290,1.0,0,0,4,8,1220,900,1949,0,98108,47.5658,-122.318,1620,5400,440000,26,6,2014,0,65,4170,3780,0,1,1
3,2.5,2920,5629,1.0,0,2,5,8,1460,1460,1955,0,98199,47.642,-122.405,2380,5000,1020000,28,7,2014,0,59,2709,2620,0,1,1
2,1.0,1340,7788,1.0,0,2,3,7,1340,0,1947,0,98178,47.5094,-122.244,2550,7788,300000,23,5,2014,0,67,6448,5238,0,0,1
3,1.0,1230,4800,1.5,0,0,1,6,1230,0,1916,0,98117,47.6941,-122.365,1230,4800,125000,10,12,2014,0,98,3570,3570,0,0,1
4,3.5,2840,5900,2.0,0,0,3,10,1920,920,1910,2008,98118,47.5543,-122.268,1300,4900,986000,5,11,2014,98,104,3060,3600,1,1,1
4,2.5,2080,5650,1.0,0,0,3,7,1680,400,1950,0,98178,47.5107,-122.257,1270,5650,315000,12,8,2014,0,64,3570,4380,0,1,1
4,2.5,2070,7007,2.0,0,0,3,7,2070,0,1996,0,98031,47.3968,-122.171,2130,8100,320000,12,8,2014,0,18,4937,5970,0,0,0
4,3.25,4010,13797,2.0,0,0,3,11,4010,0,2003,0,98059,47.5229,-122.152,3980,12120,972000,4,12,2014,0,11,9787,8140,0,0,0
3,2.5,2190,10000,1.0,0,0,4,7,1540,650,1957,0,98040,47.5419,-122.214,2880,11782,760000,9,9,2014,0,57,7810,8902,0,1,0
4,3.0,1730,7264,2.0,0,0,3,6,1730,0,1920,0,98168,47.4738,-122.264,1500,12104,265000,3,9,2014,0,94,5534,10604,0,0,1
2,1.0,1250,4558,1.0,0,0,3,7,1250,0,1948,0,98126,47.5318,-122.379,1180,4494,355000,18,11,2014,0,66,3308,3314,0,0,1
5,2.5,2080,8347,1.0,0,0,4,7,1460,620,1975,0,98034,47.7334,-122.168,1840,7713,474950,26,8,2014,0,39,6267,5873,0,1,0
4,2.0,2180,17180,2.0,0,0,4,7,2180,0,1977,0,98014,47.698,-121.92,1880,14043,470000,27,8,2014,0,37,15000,12163,0,0,0
2,1.5,1840,3825,1.0,0,0,3,8,1040,800,1928,0,98117,47.6808,-122.38,1290,5100,520000,28,10,2014,0,86,1985,3810,0,1,1
2,1.0,1370,11584,1.0,0,0,4,6,1370,0,1950,0,98198,47.4224,-122.293,1330,8012,237600,17,11,2014,0,64,10214,6682,0,0,1
2,1.0,950,2784,1.0,0,0,4,8,950,0,1972,0,98198,47.3793,-122.321,1080,3899,162950,11,7,2014,0,42,1834,2819,0,0,1
3,1.75,1690,6375,1.0,0,0,3,8,1690,0,1903,2002,98024,47.5247,-121.926,1270,7774,457000,11,11,2014,99,111,4685,6504,1,0,0
3,2.5,1780,11000,1.0,0,0,4,8,1210,570,1980,0,98006,47.5574,-122.149,2310,9700,635000,8,8,2014,0,34,9220,7390,0,1,0
4,3.0,2840,4120,1.5,0,0,4,8,2060,780,1931,0,98118,47.5683,-122.283,1840,5871,735000,30,5,2014,0,83,1280,4031,0,1,1
2,2.5,2000,5150,2.0,0,4,3,9,2000,0,1992,0,98034,47.7056,-122.223,2510,6800,910000,18,9,2014,0,22,3150,4290,0,0,0
3,3.25,1570,2048,2.0,0,0,3,8,1290,280,2006,0,98126,47.548,-122.375,1570,2006,346500,21,10,2014,0,8,478,436,0,1,1
4,2.5,2370,9517,1.0,0,0,3,9,1630,740,1984,0,98074,47.6222,-122.034,2440,9035,655000,5,9,2014,0,30,7147,6595,0,1,0
3,1.0,1300,10125,1.0,0,0,4,6,1300,0,1959,0,98002,47.2921,-122.215,1300,10125,137000,17,2,2015,0,56,8825,8825,0,0,0
3,2.5,2620,11056,2.0,0,0,3,9,2620,0,1988,0,98011,47.7378,-122.218,2560,8688,557500,15,7,2014,0,26,8436,6128,0,0,0
5,2.25,2780,10192,2.0,0,0,4,9,2780,0,1978,0,98007,47.6134,-122.152,2740,9900,830000,20,6,2014,0,36,7412,7160,0,0,0
3,1.0,1310,3963,1.0,0,0,5,7,1310,0,1986,0,98052,47.6826,-122.096,1010,3363,420000,14,10,2014,0,28,2653,2353,0,0,0
2,1.0,1100,7500,1.0,0,0,3,7,1100,0,1951,0,98125,47.7235,-122.326,1920,7149,353000,3,4,2015,0,64,6400,5229,0,0,1
3,2.5,1270,1180,3.0,0,0,3,8,1270,0,2001,0,98107,47.6697,-122.392,1320,1180,445700,2,5,2014,0,13,-90,-140,0,0,1
4,1.0,1270,6459,1.5,0,0,3,7,1270,0,1918,0,98118,47.5441,-122.273,1300,4100,226000,17,7,2014,0,96,5189,2800,0,0,1
3,1.0,890,9870,1.0,0,0,4,7,890,0,1960,0,98056,47.5398,-122.178,1270,9861,358000,5,12,2014,0,54,8980,8591,0,0,0
3,1.75,1480,8667,1.0,0,0,5,7,740,740,1954,0,98006,47.5718,-122.136,1600,10644,501000,5,3,2015,0,61,7187,9044,0,1,0
5,2.5,3210,12000,1.0,0,0,4,8,1830,1380,1968,0,98007,47.6205,-122.148,2450,12000,725000,13,6,2014,0,46,8790,9550,0,1,0
3,2.25,1870,7200,1.0,0,0,3,7,1390,480,1975,0,98072,47.734,-122.174,1830,7876,350500,11,8,2014,0,39,5330,6046,0,1,0
5,2.5,3990,3839,1.0,0,0,4,8,1990,2000,1962,0,98112,47.6236,-122.299,2090,5000,610000,2,6,2014,0,52,-151,2910,0,1,1
2,1.0,1160,5029,1.0,0,0,3,7,910,250,1940,0,98115,47.6723,-122.266,1220,5029,605125,6,11,2014,0,74,3869,3809,0,1,1
2,1.75,1060,1202,2.0,0,0,3,7,760,300,2003,0,98136,47.5426,-122.388,1060,1493,335000,7,10,2014,0,11,142,433,0,1,1
3,2.0,1100,9165,1.0,0,0,4,7,1100,0,1969,0,98034,47.7304,-122.231,1510,8500,397000,31,12,2014,0,45,8065,6990,0,0,0
3,2.0,1190,10299,1.0,0,0,3,7,1190,0,1994,0,98010,47.314,-122.0,1700,9849,240000,24,11,2014,0,20,9109,8149,0,0,0
3,2.0,1030,11118,1.0,0,0,5,7,1030,0,1970,0,98003,47.3463,-122.308,1300,7920,240000,26,9,2014,0,44,10088,6620,0,0,0
2,1.5,1140,14373,1.0,0,0,3,7,1140,0,1949,1996,98011,47.7354,-122.219,2140,9860,262500,20,11,2014,47,65,13233,7720,1,0,0
3,1.5,2260,5300,1.0,0,0,3,7,1200,1060,1940,0,98103,47.6756,-122.348,1950,5000,440000,22,9,2014,0,74,3040,3050,0,1,1
3,1.0,1140,3240,1.5,0,0,4,6,1140,0,1910,0,98014,47.7093,-121.364,1140,4700,160000,23,3,2015,0,105,2100,3560,0,0,0
4,1.0,1860,4736,1.5,0,0,1,7,1860,0,1901,0,98112,47.6251,-122.3,1800,4000,427000,11,6,2014,0,113,2876,2200,0,0,1
4,3.5,4080,10666,2.0,0,0,3,9,4080,0,2005,0,98053,47.6818,-122.023,3920,8154,920000,1,7,2014,0,9,6586,4234,0,0,0
4,2.5,3280,7100,2.0,0,4,3,10,2180,1100,1911,1987,98119,47.6285,-122.362,3240,6674,2300000,5,8,2014,76,103,3820,3434,1,1,1
4,1.75,2300,11700,1.0,0,0,4,9,1960,340,1977,0,98052,47.6331,-122.094,2840,12000,615000,5,5,2014,0,37,9400,9160,0,1,0
3,2.0,2230,4800,1.5,0,0,4,7,1290,940,1915,0,98199,47.645,-122.386,1650,5040,736500,22,8,2014,0,99,2570,3390,0,1,1
3,2.5,1920,1649,2.5,0,0,3,8,1600,320,2004,0,98116,47.5901,-122.388,1650,3053,542500,19,11,2014,0,10,-271,1403,0,1,1
2,1.0,700,5000,1.0,0,0,5,6,700,0,1952,0,98056,47.4927,-122.172,1040,5200,191000,19,3,2015,0,63,4300,4160,0,0,0
4,2.5,2740,11975,2.0,0,0,4,8,2740,0,1991,0,98074,47.6315,-122.028,2310,9068,730000,18,7,2014,0,23,9235,6758,0,0,0
5,2.25,3440,5000,2.0,0,2,5,9,3440,0,1901,0,98122,47.6127,-122.286,2822,5000,1230000,25,11,2014,0,113,1560,2178,0,0,1
1,1.0,650,15364,1.0,0,0,4,5,650,0,1967,0,98042,47.3721,-122.159,1630,7952,129000,4,6,2014,0,47,14714,6322,0,0,0
3,1.5,1500,10018,1.0,0,0,4,7,1500,0,1957,0,98058,47.468,-122.163,1500,10937,284000,9,7,2014,0,57,8518,9437,0,0,0
3,2.5,2490,5978,2.0,0,0,3,9,2490,0,2003,0,98074,47.6298,-122.022,2710,6629,645000,21,3,2015,0,12,3488,3919,0,0,0
3,1.5,1330,7600,1.0,0,0,4,7,1330,0,1968,0,98023,47.3103,-122.366,1500,7776,218000,24,6,2014,0,46,6270,6276,0,0,0
4,3.5,3190,6875,2.0,0,2,3,8,2120,1070,1999,0,98034,47.7082,-122.221,2550,6875,675000,9,10,2014,0,15,3685,4325,0,1,0
3,2.5,1590,2910,2.0,0,0,3,7,1110,480,1984,0,98115,47.6855,-122.321,1590,3880,575000,29,12,2014,0,30,1320,2290,0,1,1
2,1.0,830,5720,1.0,0,0,4,6,830,0,1950,0,98133,47.7339,-122.339,1150,5250,225000,30,10,2014,0,64,4890,4100,0,0,1
3,2.25,1810,5107,2.0,0,0,3,8,1810,0,1989,0,98033,47.6882,-122.171,1760,5454,626000,8,4,2015,0,26,3297,3694,0,0,0
4,1.75,2180,13529,1.0,0,0,3,7,1090,1090,1956,0,98155,47.7516,-122.294,2000,13529,405000,13,5,2014,0,58,11349,11529,0,1,1
3,1.0,1090,3523,1.0,0,0,4,6,1090,0,1969,0,98092,47.3161,-122.182,1030,3200,152500,29,10,2014,0,45,2433,2170,0,0,0
4,2.5,2160,6825,2.0,0,0,3,8,2160,0,1994,0,98031,47.4111,-122.2,2020,7035,325000,16,7,2014,0,20,4665,5015,0,0,0
3,1.0,2110,10005,1.0,0,0,5,7,1110,1000,1924,0,98033,47.688,-122.168,1360,9827,475300,29,5,2014,0,90,7895,8467,0,1,0
3,1.75,2180,7318,1.0,0,0,4,7,1210,970,1967,0,98126,47.5251,-122.37,2140,7560,485000,8,4,2015,0,48,5138,5420,0,1,1
3,2.5,2100,2200,2.0,0,0,4,7,1500,600,1919,0,98122,47.614,-122.294,1750,4400,720000,12,4,2015,0,96,100,2650,0,1,1
3,1.75,1410,6886,1.0,0,0,3,7,1410,0,1924,2013,98133,47.7183,-122.353,1410,6561,465000,15,5,2014,89,90,5476,5151,1,0,1
3,1.5,1020,9072,1.0,0,0,3,7,920,100,1930,0,98115,47.695,-122.301,1620,7930,489000,4,6,2014,0,84,8052,6310,0,1,1
3,2.25,2090,7500,1.0,0,0,4,7,1280,810,1977,0,98031,47.3951,-122.172,1800,7350,288000,8,1,2015,0,38,5410,5550,0,1,0
3,1.75,1350,9793,1.0,0,0,4,7,1350,0,1968,0,98022,47.1981,-122.003,1690,8080,225000,8,8,2014,0,46,8443,6390,0,0,0
3,1.75,2650,11774,1.0,0,1,3,8,2240,410,1952,0,98146,47.4909,-122.363,2650,10120,499000,21,4,2015,0,63,9124,7470,0,1,1
3,2.5,2040,4627,2.0,0,0,3,8,2040,0,1992,0,98052,47.6365,-122.108,2230,4500,580000,13,6,2014,0,22,2587,2270,0,0,0
4,1.5,2340,5000,2.0,0,0,3,8,2100,240,1912,0,98122,47.6065,-122.291,2320,5500,730000,23,4,2015,0,103,2660,3180,0,1,1
4,2.25,1770,7799,2.0,0,0,3,7,1770,0,1998,0,98031,47.4192,-122.202,1770,7778,325000,27,3,2015,0,17,6029,6008,0,0,0
3,1.75,1100,8662,1.0,0,0,5,7,1100,0,1964,0,98056,47.5368,-122.173,1100,9240,421000,15,4,2015,0,51,7562,8140,0,0,0
3,2.5,1490,4078,2.0,0,0,3,8,1490,0,1998,0,98059,47.4915,-122.155,1310,2767,316000,20,1,2015,0,17,2588,1457,0,0,0
2,1.0,1460,4200,1.0,0,0,4,6,880,580,1914,0,98117,47.6774,-122.361,1540,4200,415000,4,8,2014,0,100,2740,2660,0,1,1
3,2.25,1350,2839,2.0,0,0,3,7,1350,0,2003,0,98053,47.6824,-122.036,1650,3093,401000,22,9,2014,0,11,1489,1443,0,0,0
3,0.75,1030,12700,1.0,0,0,4,5,1030,0,1944,0,98032,47.3877,-122.236,1140,6955,229950,24,2,2015,0,71,11670,5815,0,0,0
3,1.75,1820,9875,1.0,0,0,4,8,1820,0,1966,0,98008,47.6243,-122.094,2670,10000,539950,30,3,2015,0,49,8055,7330,0,0,0
3,2.0,1170,5360,1.0,0,0,3,6,1170,0,1919,0,98106,47.5181,-122.364,1180,7200,335000,5,6,2014,0,95,4190,6020,0,0,1
3,2.5,1450,3748,2.0,0,0,3,7,1450,0,2004,0,98065,47.532,-121.85,1970,3748,339000,7,7,2014,0,10,2298,1778,0,0,0
4,1.75,2200,8545,1.0,0,0,4,7,1100,1100,1918,1982,98133,47.7481,-122.353,1940,9315,414950,20,10,2014,64,96,6345,7375,1,1,1
4,2.0,1610,8976,1.0,0,0,4,8,1610,0,1966,0,98004,47.6011,-122.192,1930,8976,650000,2,12,2014,0,48,7366,7046,0,0,0
3,2.25,1850,7800,2.0,0,0,3,9,1850,0,1974,0,98023,47.3146,-122.379,2360,8000,295000,20,3,2015,0,41,5950,5640,0,0,0
4,2.25,2250,3600,2.0,0,0,4,9,2010,240,1912,1994,98119,47.643,-122.37,1910,3990,975000,13,4,2015,82,103,1350,2080,1,1,1
3,1.5,1580,10100,1.0,0,0,4,7,1580,0,1961,0,98055,47.4423,-122.193,1650,10032,296500,19,12,2014,0,53,8520,8382,0,0,0
5,1.5,1890,10880,1.0,0,0,3,7,1890,0,1962,0,98034,47.7196,-122.197,1670,9750,420000,29,12,2014,0,52,8990,8080,0,0,0
3,2.5,2140,9492,2.0,0,0,3,8,2140,0,1994,0,98092,47.3289,-122.204,2180,9184,302000,23,7,2014,0,20,7352,7004,0,0,0
4,1.75,1770,7336,1.0,0,0,4,8,1770,0,1986,0,98058,47.4265,-122.163,2030,8183,350000,9,4,2015,0,29,5566,6153,0,0,0
3,2.0,1640,4218,1.0,0,0,4,7,910,730,1941,0,98103,47.6546,-122.344,1670,4000,645000,13,5,2015,0,74,2578,2330,0,1,1
4,2.75,1820,5400,1.0,0,0,4,7,1220,600,1988,0,98056,47.5204,-122.205,1630,5400,430000,11,11,2014,0,26,3580,3770,0,1,0
4,1.0,1410,6000,1.0,0,0,3,7,810,600,1925,0,98126,47.566,-122.373,1500,4800,413000,13,5,2014,0,89,4590,3300,0,1,1
3,1.0,1240,7300,1.0,0,0,3,7,1240,0,1968,0,98033,47.6775,-122.168,1240,8260,420000,1,12,2014,0,46,6060,7020,0,0,0
3,2.25,1780,8050,1.0,0,0,4,7,1230,550,1979,0,98052,47.6977,-122.126,1780,7200,495000,29,10,2014,0,35,6270,5420,0,1,0
4,4.5,4240,13162,2.0,0,0,3,10,4240,0,2004,0,98039,47.6193,-122.229,3010,12163,2190000,12,8,2014,0,10,8922,9153,0,0,0
4,2.5,1900,5001,1.0,0,0,3,8,1200,700,2008,0,98133,47.7289,-122.335,1950,4680,500000,1,12,2014,0,6,3101,2730,0,1,1
3,1.0,1010,6000,1.5,0,0,3,7,1010,0,1919,1977,98119,47.6438,-122.357,1960,4000,636100,1,10,2014,58,95,4990,2040,1,0,1
4,2.5,2870,12648,2.0,0,0,4,9,2870,0,1986,0,98029,47.5632,-122.017,2560,12648,720000,3,6,2014,0,28,9778,10088,0,0,0
3,1.75,1620,12825,1.0,0,0,3,8,1340,280,1962,0,98003,47.3321,-122.323,2076,11200,298000,4,5,2015,0,53,11205,9124,0,1,0
2,1.75,1480,4000,1.0,0,0,4,6,740,740,1925,0,98117,47.6916,-122.38,1060,4000,409000,29,7,2014,0,89,2520,2940,0,1,1
4,2.5,2650,5706,2.0,0,0,3,9,2650,0,2005,0,98042,47.3515,-122.164,2760,5749,370000,26,12,2014,0,9,3056,2989,0,0,0
5,1.0,1410,9000,1.0,0,0,5,7,1410,0,1967,0,98023,47.3054,-122.369,1200,8346,230000,25,7,2014,0,47,7590,7146,0,0,0
3,2.0,1360,6685,1.0,0,0,3,7,1360,0,1952,0,98155,47.7365,-122.324,1300,8138,290000,24,3,2015,0,63,5325,6838,0,0,1
4,2.25,2930,9840,1.0,0,0,4,8,1560,1370,1977,0,98023,47.3103,-122.382,2800,8374,420000,19,2,2015,0,38,6910,5574,0,1,0
4,2.5,3500,10891,2.0,0,2,3,10,3500,0,1995,0,98027,47.5533,-122.093,3820,13521,917000,22,7,2014,0,19,7391,9701,0,0,0
5,3.25,3160,5000,2.0,0,2,3,10,2180,980,2005,0,98199,47.6464,-122.405,3160,5746,957000,25,6,2014,0,9,1840,2586,0,1,1
5,2.5,2870,4712,2.0,0,0,3,9,2870,0,2014,0,98006,47.5463,-122.182,2870,6768,760369,17,10,2014,0,0,1842,3898,0,0,0
2,1.0,1500,18540,1.0,0,0,3,8,1500,0,1950,0,98168,47.4727,-122.281,1700,9355,170000,4,6,2014,0,64,17040,7655,0,0,1
3,2.5,2120,10021,1.0,0,0,4,8,1230,890,1976,0,98006,47.5621,-122.135,2690,10183,625000,29,4,2015,0,39,7901,7493,0,1,0
3,1.5,1590,6750,1.0,0,0,3,7,1080,510,1976,0,98034,47.73,-122.191,1590,7400,357000,2,12,2014,0,38,5160,5810,0,1,0
3,2.25,1830,8276,1.0,0,0,3,8,1350,480,1989,0,98074,47.6336,-122.025,1920,8276,583000,7,4,2015,0,26,6446,6356,0,1,0
3,2.0,1210,9097,1.0,0,0,4,7,1210,0,1954,0,98168,47.4849,-122.303,1360,10125,173250,20,8,2014,0,60,7887,8765,0,0,1
4,2.0,1590,10331,1.5,0,0,4,7,1590,0,1956,0,98133,47.7273,-122.332,1400,9434,414050,16,7,2014,0,58,8741,8034,0,0,1
3,1.75,1050,6150,1.5,0,0,4,6,950,100,1928,0,98116,47.5715,-122.394,1360,6150,400000,18,6,2014,0,86,5100,4790,0,1,1
4,2.25,2070,7500,2.0,0,0,4,7,2070,0,1977,0,98034,47.727,-122.217,2080,7700,465000,6,6,2014,0,37,5430,5620,0,0,0
3,2.25,1740,9682,1.0,0,0,5,8,1740,0,1969,0,98056,47.5138,-122.173,2100,9536,425000,18,8,2014,0,45,7942,7436,0,0,0
2,1.0,1200,9000,1.0,0,0,3,6,1200,0,1958,0,98023,47.3277,-122.349,1040,9600,179950,11,12,2014,0,56,7800,8560,0,0,0
3,2.5,1710,7230,2.0,0,0,3,7,1710,0,1996,0,98003,47.2778,-122.298,1720,6537,275000,21,4,2015,0,19,5520,4817,0,0,0
4,2.5,1840,13493,2.0,0,0,3,7,1840,0,1994,0,98001,47.2649,-122.242,1430,11463,190000,15,7,2014,0,20,11653,10033,0,0,0
3,1.75,1900,5520,1.0,0,0,3,7,1280,620,1982,0,98118,47.5549,-122.292,1330,5196,385000,6,5,2014,0,32,3620,3866,0,1,1
4,1.0,2300,9583,1.0,0,0,3,6,1220,1080,1928,0,98024,47.5671,-121.89,1200,11325,303000,29,4,2015,0,87,7283,10125,0,1,0
3,1.0,970,7503,1.0,0,0,4,6,970,0,1967,0,98058,47.4688,-122.163,1230,9504,165000,5,1,2015,0,48,6533,8274,0,0,0
2,2.0,1270,5000,1.0,0,0,3,6,1270,0,1944,0,98107,47.6729,-122.363,2190,5000,600000,30,4,2015,0,71,3730,2810,0,0,1
3,2.5,1480,9743,2.0,0,0,4,7,1480,0,1996,0,98010,47.3293,-122.001,1810,9601,269950,2,9,2014,0,18,8263,7791,0,0,0
4,2.0,1590,6750,1.0,0,0,3,7,1590,0,1951,0,98102,47.6406,-122.317,2370,4500,670500,23,5,2014,0,63,5160,2130,0,0,1
4,1.5,1690,9391,1.0,0,0,3,7,1290,400,1960,0,98155,47.7438,-122.329,1780,9390,420000,12,2,2015,0,55,7701,7610,0,1,1
3,1.75,1500,7200,1.0,0,0,3,7,1500,0,1957,0,98133,47.7748,-122.337,1650,7392,360000,24,6,2014,0,57,5700,5742,0,0,1
4,2.5,2320,8721,2.0,0,0,3,8,2320,0,1991,0,98034,47.7326,-122.226,2260,8268,562500,3,10,2014,0,23,6401,6008,0,0,0
3,2.5,3300,11525,1.0,0,0,5,8,1650,1650,1961,0,98198,47.4113,-122.315,1950,9680,360500,18,8,2014,0,53,8225,7730,0,1,1
3,2.25,1445,1471,2.0,0,0,3,7,1300,145,2003,0,98027,47.5342,-122.072,1410,1399,389999,21,5,2014,0,11,26,-11,0,1,0
4,3.0,1890,13140,1.0,0,0,4,7,1270,620,1967,0,98027,47.5221,-122.044,1900,11160,450000,27,8,2014,0,47,11250,9260,0,1,0
4,2.0,1760,8400,1.0,0,0,3,7,1060,700,1962,0,98003,47.3258,-122.323,1280,8415,247500,3,3,2015,0,53,6640,7135,0,1,0
3,1.0,1050,6240,1.0,0,0,5,5,1050,0,1948,0,98146,47.4933,-122.338,1410,6240,208000,19,2,2015,0,67,5190,4830,0,0,1
3,2.5,1980,7309,2.0,0,0,3,7,1980,0,1993,0,98034,47.7257,-122.172,2060,9681,455000,26,12,2014,0,21,5329,7621,0,0,0
4,1.75,2120,7680,1.0,0,0,4,7,1060,1060,1950,0,98177,47.7172,-122.361,1530,7680,379400,10,11,2014,0,64,5560,6150,0,1,1
3,1.0,1300,8800,1.0,0,0,3,7,1300,0,1977,0,98053,47.64,-121.966,1600,12210,326188,21,8,2014,0,37,7500,10610,0,0,0
2,2.5,1160,2174,2.0,0,0,3,7,1160,0,1998,0,98106,47.5264,-122.366,1380,1919,168000,22,5,2014,0,16,1014,539,0,0,1
4,2.5,2340,8990,2.0,0,0,3,8,2340,0,2003,0,98038,47.3781,-122.03,2980,6718,314000,16,5,2014,0,11,6650,3738,0,0,0
3,1.75,1440,8957,1.0,0,0,4,7,1440,0,1957,0,98008,47.6008,-122.118,1340,8780,550000,16,3,2015,0,58,7517,7440,0,0,0
4,2.25,1980,15086,2.0,0,0,3,8,1980,0,1981,0,98074,47.647,-122.064,2100,10927,530000,30,6,2014,0,33,13106,8827,0,0,0
3,1.75,1680,10685,1.0,0,0,4,7,1680,0,1966,0,98033,47.6556,-122.193,3340,10390,637500,6,2,2015,0,49,9005,7050,0,0,0
3,2.5,1390,2815,2.0,0,0,3,8,1390,0,1999,0,98126,47.566,-122.366,1390,3700,400000,28,4,2015,0,16,1425,2310,0,0,1
5,2.75,3100,9825,2.0,0,2,4,8,3100,0,1950,1982,98125,47.7188,-122.281,2120,8400,700000,10,6,2014,32,64,6725,6280,1,0,1
3,2.5,1680,8512,2.0,0,0,3,7,1680,0,1991,0,98022,47.1952,-121.986,1580,8512,272000,14,11,2014,0,23,6832,6932,0,0,0
4,2.5,2710,6474,2.0,0,0,3,8,2710,0,2004,0,98065,47.5383,-121.878,2870,6968,600000,17,4,2015,0,11,3764,4098,0,0,0
2,1.0,840,7020,1.5,0,0,4,7,840,0,1943,0,98136,47.5513,-122.394,1310,7072,450600,2,4,2015,0,72,6180,5762,0,0,1
3,2.25,2090,8095,2.0,0,2,3,10,2090,0,1988,0,98136,47.5287,-122.385,1940,5635,550000,28,10,2014,0,26,6005,3695,0,0,1
3,1.0,1120,8407,1.0,0,0,5,6,1120,0,1987,0,98022,47.2051,-122.006,1250,8658,225000,23,1,2015,0,28,7287,7408,0,0,0
3,1.5,1210,5200,1.0,0,0,5,6,1210,0,1969,0,98042,47.3615,-122.087,1120,5200,132825,18,2,2015,0,46,3990,4080,0,0,0
3,1.5,1210,5200,1.0,0,0,5,6,1210,0,1969,0,98042,47.3615,-122.087,1120,5200,219950,30,4,2015,0,46,3990,4080,0,0,0
5,2.0,1940,6000,1.0,0,0,5,7,970,970,1945,0,98115,47.6875,-122.287,1700,6000,580000,28,5,2014,0,69,4060,4300,0,1,1
3,1.75,1270,6017,1.0,0,0,4,7,1030,240,1990,0,98028,47.737,-122.225,1630,7381,406000,2,4,2015,0,25,4747,5751,0,1,0
3,1.75,1680,2400,1.5,0,0,3,7,1170,510,1929,0,98117,47.6849,-122.367,1080,4560,469000,16,7,2014,0,85,720,3480,0,1,1
3,2.5,2090,6045,2.0,0,0,3,8,2090,0,2000,0,98056,47.4947,-122.174,2040,6392,415000,10,6,2014,0,14,3955,4352,0,0,0
3,1.5,1000,13991,1.0,0,0,4,7,1000,0,1956,0,98006,47.5643,-122.138,1520,11465,390000,8,12,2014,0,58,12991,9945,0,0,0
3,1.75,1350,10125,1.0,0,0,3,8,1350,0,1967,0,98003,47.3334,-122.298,1520,9720,251000,15,4,2015,0,48,8775,8200,0,0,0
3,2.5,3280,6750,2.0,0,1,3,9,2440,840,2001,0,98126,47.5219,-122.38,1770,6387,750000,12,3,2015,0,14,3470,4617,0,1,1
4,2.5,2390,5071,2.0,0,0,3,9,1760,630,1988,0,98122,47.6144,-122.283,1940,5071,845000,7,4,2015,0,27,2681,3131,0,1,1
3,1.0,1380,5864,1.0,0,0,3,7,790,590,1944,0,98133,47.7049,-122.339,1509,5864,322000,25,2,2015,0,71,4484,4355,0,1,1
4,2.25,3070,9210,2.0,0,0,3,8,2740,330,2010,0,98011,47.7638,-122.196,2580,9660,664500,7,5,2015,0,5,6140,7080,0,1,0
3,1.75,2190,3800,1.5,0,2,4,8,2190,0,1923,0,98109,47.643,-122.355,2190,3880,988000,7,1,2015,0,92,1610,1690,0,0,1
2,1.75,1990,4000,1.0,0,0,5,7,1090,900,1952,0,98103,47.6889,-122.342,1270,5700,625000,6,7,2014,0,62,2010,4430,0,1,1
3,1.75,2070,9827,1.0,0,0,4,7,1420,650,1967,0,98027,47.522,-122.05,2150,9827,503000,7,4,2015,0,48,7757,7677,0,1,0
4,2.25,2170,10500,1.0,0,2,4,8,1270,900,1960,0,98166,47.4394,-122.338,2080,11019,431000,9,5,2014,0,54,8330,8939,0,1,1
3,1.75,1910,10230,1.0,0,0,4,7,1290,620,1964,0,98031,47.4185,-122.207,1590,10800,250000,26,11,2014,0,50,8320,9210,0,1,0
4,2.5,2100,4237,2.0,0,0,3,8,2100,0,2006,0,98031,47.3901,-122.174,2100,4575,268500,5,6,2014,0,8,2137,2475,0,0,0
4,2.5,2290,4539,2.0,0,0,3,7,2290,0,2001,0,98058,47.4753,-122.172,1710,7200,295000,29,5,2014,0,13,2249,5490,0,0,0
3,2.25,2130,11782,1.0,0,0,4,8,1590,540,1977,0,98040,47.5423,-122.215,2700,11782,780000,25,7,2014,0,37,9652,9082,0,1,0
2,1.0,860,7250,1.0,0,0,3,6,860,0,1949,0,98133,47.7206,-122.35,1270,7250,305000,18,8,2014,0,65,6390,5980,0,0,1
5,2.75,2880,4425,2.0,0,0,3,8,2880,0,2005,0,98052,47.7048,-122.109,2940,6581,733000,1,4,2015,0,10,1545,3641,0,0,0
4,2.75,2100,11894,1.0,0,0,4,8,1720,380,1968,0,98004,47.6006,-122.194,2390,9450,640000,16,9,2014,0,46,9794,7060,0,1,0
4,2.5,2360,9600,1.0,0,2,3,8,1630,730,1973,0,98040,47.5889,-122.249,2140,6300,840000,17,4,2015,0,42,7240,4160,0,1,0
5,3.25,3680,10300,1.5,0,0,4,10,3680,0,1927,0,98105,47.6548,-122.28,2690,7200,1480000,10,12,2014,0,87,6620,4510,0,0,1
3,1.0,1560,8100,1.0,0,0,4,8,1140,420,1952,0,98177,47.7261,-122.364,2130,8100,525000,26,3,2015,0,63,6540,5970,0,1,1
4,2.75,1680,11180,1.0,0,0,4,7,1680,0,1966,0,98052,47.6557,-122.127,2400,9627,625000,14,5,2014,0,48,9500,7227,0,0,0
3,2.0,1380,3600,3.0,0,0,3,8,1380,0,2015,0,98122,47.6074,-122.305,1480,3600,350000,17,6,2014,0,-1,2220,2120,0,0,1
4,2.75,2610,4160,3.0,0,0,5,8,1910,700,1910,0,98103,47.6901,-122.357,1470,4140,650000,16,6,2014,0,104,1550,2670,0,1,1
2,1.0,870,4000,1.0,0,2,3,7,870,0,1950,0,98126,47.5682,-122.374,1690,4000,435000,23,10,2014,0,64,3130,2310,0,0,1
3,1.0,1210,9622,1.0,0,1,3,8,1210,0,1955,2009,98006,47.5728,-122.179,1580,9714,660000,26,6,2014,54,59,8412,8134,1,0,0
3,1.0,1150,12877,1.0,0,0,4,6,1150,0,1970,0,98053,47.6614,-122.056,1490,12150,350000,2,3,2015,0,45,11727,10660,0,0,0
3,2.5,3110,6000,1.0,0,2,3,8,1560,1550,1967,0,98106,47.5331,-122.353,2060,6000,435000,25,3,2015,0,48,2890,3940,0,1,1
3,3.0,2430,10500,1.0,0,0,4,8,2150,280,1983,0,98003,47.2579,-122.312,1670,9800,272000,24,11,2014,0,31,8070,8130,0,1,0
3,1.75,1460,7800,1.0,0,0,2,7,1040,420,1979,0,98023,47.3035,-122.382,1310,7865,233000,15,1,2015,0,36,6340,6555,0,1,0
4,1.5,1330,5750,1.5,0,2,3,7,1330,0,1915,0,98116,47.5681,-122.384,1360,5750,500000,16,9,2014,0,99,4420,4390,0,0,1
4,1.75,2040,9322,1.0,0,0,3,8,1440,600,1977,0,98155,47.7611,-122.298,1910,10026,540000,2,4,2015,0,38,7282,8116,0,1,1
3,2.5,2375,4094,2.0,0,0,3,9,2375,0,2002,0,98052,47.6627,-122.086,2095,4442,712000,1,7,2014,0,12,1719,2347,0,0,0
4,2.5,2480,4504,2.0,0,0,3,7,2480,0,2005,0,98059,47.4998,-122.15,2950,4504,425000,25,9,2014,0,9,2024,1554,0,0,0
3,1.75,1580,6099,1.0,0,0,5,7,790,790,1944,0,98168,47.4807,-122.29,1330,6099,242000,5,8,2014,0,70,4519,4769,0,1,1
5,3.25,2740,9629,1.0,0,0,5,7,1390,1350,1977,0,98011,47.7645,-122.197,2150,10500,515000,3,7,2014,0,37,6889,8350,0,1,0
4,1.75,1920,7700,2.0,0,0,4,7,1920,0,1970,0,98056,47.5381,-122.177,1310,7700,415000,8,7,2014,0,44,5780,6390,0,0,0
3,2.75,2200,9600,1.0,0,3,4,8,1570,630,1977,0,98003,47.3438,-122.323,2680,9896,375000,10,12,2014,0,37,7400,7216,0,1,0
3,1.0,910,7194,1.0,0,0,4,7,910,0,1971,0,98001,47.3337,-122.275,1530,7200,182500,27,10,2014,0,43,6284,5670,0,0,0
3,1.5,1860,10379,1.0,0,0,3,7,1240,620,1963,0,98198,47.3962,-122.309,2240,11328,310000,23,3,2015,0,52,8519,9088,0,1,1
3,1.75,1510,6000,1.0,0,0,3,7,1060,450,1947,0,98136,47.5535,-122.39,1610,6000,360000,27,10,2014,0,67,4490,4390,0,1,1
4,3.5,3920,9555,2.0,0,0,3,9,3920,0,2004,0,98053,47.6797,-122.025,3920,8598,889000,8,4,2015,0,11,5635,4678,0,0,0
2,1.0,1330,3698,1.0,0,0,3,7,1330,0,1952,0,98117,47.6866,-122.372,1900,5000,450500,10,4,2015,0,63,2368,3100,0,0,1
4,2.25,1964,3541,2.0,0,0,3,9,1964,0,2013,0,98030,47.3594,-122.201,1757,3547,342000,22,4,2015,0,2,1577,1790,0,0,0
3,2.0,1520,3451,1.0,0,0,3,8,1520,0,1996,0,98177,47.7753,-122.375,1800,3451,413000,14,7,2014,0,18,1931,1651,0,0,1
2,1.0,770,9370,1.0,0,0,3,7,770,0,1947,0,98155,47.762,-122.321,1060,9352,180000,5,9,2014,0,67,8600,8292,0,0,1
4,2.5,3210,14910,2.0,0,0,3,10,3210,0,1995,0,98074,47.6073,-122.062,3280,14910,770000,18,6,2014,0,19,11700,11630,0,0,0
3,1.75,1070,7200,1.0,0,0,3,7,1070,0,1994,0,98010,47.3129,-122.023,1280,7200,224400,13,8,2014,0,20,6130,5920,0,0,0
3,1.5,1430,8861,1.0,0,0,3,7,1430,0,1956,0,98188,47.4454,-122.289,1080,9425,280000,30,4,2015,0,59,7431,8345,0,0,1
3,2.5,1670,2575,2.0,0,0,3,8,1670,0,2000,0,98027,47.531,-122.047,1670,2897,500000,19,3,2015,0,15,905,1227,0,0,0
2,1.0,710,9000,1.0,0,0,5,6,710,0,1943,0,98166,47.4811,-122.339,1230,9000,153000,3,2,2015,0,72,8290,7770,0,0,1
3,2.25,1920,4833,1.0,0,0,4,7,1060,860,1921,0,98133,47.7067,-122.352,1580,5134,385000,13,6,2014,0,93,2913,3554,0,1,1
2,1.0,750,5534,1.0,0,0,3,7,750,0,1947,0,98177,47.7017,-122.36,1050,5534,325000,19,8,2014,0,67,4784,4484,0,0,1
4,3.0,2210,4191,2.0,0,0,3,7,2210,0,2004,0,98002,47.2959,-122.225,890,4288,315000,9,4,2015,0,11,1981,3398,0,0,0
4,2.5,1660,9760,2.0,0,0,3,7,1660,0,1994,0,98030,47.3635,-122.188,1580,9614,294999,17,6,2014,0,20,8100,8034,0,0,0
3,1.75,1910,17003,1.5,0,0,4,8,1910,0,1963,0,98001,47.3095,-122.283,1820,14806,175000,27,10,2014,0,51,15093,12986,0,0,0
3,1.75,1910,17003,1.5,0,0,4,8,1910,0,1963,0,98001,47.3095,-122.283,1820,14806,299000,6,4,2015,0,52,15093,12986,0,0,0
2,1.0,780,9750,1.0,0,0,3,6,780,0,1937,0,98168,47.4816,-122.322,1670,9750,146000,9,2,2015,0,78,8970,8080,0,0,1
3,2.25,1650,10336,1.0,0,0,3,7,1500,150,1962,0,98133,47.7757,-122.35,1420,10260,290000,5,11,2014,0,52,8686,8840,0,1,1
3,3.25,3230,7800,2.0,0,3,3,10,3230,0,2005,0,98199,47.6348,-122.403,3030,6600,1780000,8,8,2014,0,9,4570,3570,0,0,1
2,1.0,810,4800,1.0,0,0,3,6,810,0,1919,0,98118,47.5614,-122.27,1040,4800,367500,29,5,2014,0,95,3990,3760,0,0,1
4,2.5,2750,15099,2.0,0,0,3,8,2750,0,1994,0,98019,47.7298,-121.972,2500,14564,535000,27,3,2015,0,21,12349,12064,0,0,0
3,1.75,1960,5520,1.0,0,0,4,7,1080,880,1952,0,98199,47.6535,-122.397,1720,5760,655000,21,8,2014,0,62,3560,4040,0,1,1
4,3.5,2790,10125,1.5,0,0,5,8,2790,0,1985,0,98040,47.5651,-122.22,2570,10125,1300000,3,6,2014,0,29,7335,7555,0,0,0
4,2.25,2230,11200,1.0,0,0,4,7,1300,930,1977,0,98011,47.7691,-122.167,2090,10563,480000,21,3,2015,0,38,8970,8473,0,1,0
3,1.5,1280,4720,1.0,0,0,4,7,850,430,1941,0,98126,47.5509,-122.377,1280,4720,465000,21,4,2015,0,74,3440,3440,0,1,1
3,2.0,1240,10800,1.0,0,0,3,7,1240,0,1967,2010,98058,47.449,-122.155,1480,8840,297950,8,5,2014,43,47,9560,7360,1,0,0
3,2.0,1860,3600,1.5,0,0,3,7,1110,750,1915,0,98122,47.6102,-122.296,1680,3695,590000,15,4,2015,0,100,1740,2015,0,1,1
4,2.75,2410,6000,1.0,0,0,5,8,1410,1000,1950,0,98107,47.6707,-122.399,1760,6000,805000,22,5,2014,0,64,3590,4240,0,1,1
3,2.25,1960,7708,1.0,0,0,4,7,1490,470,1984,0,98023,47.2981,-122.374,1580,8063,204250,20,1,2015,0,31,5748,6483,0,1,0
3,2.25,1710,4561,2.0,0,0,4,8,1710,0,1994,0,98029,47.5691,-122.004,1810,4770,500000,16,7,2014,0,20,2851,2960,0,0,0
4,2.5,3480,12696,1.0,0,0,4,9,1980,1500,1977,0,98042,47.3816,-122.153,3480,14175,490000,17,9,2014,0,37,9216,10695,0,1,0
2,1.0,700,7303,1.0,0,0,5,5,700,0,1953,0,98056,47.4934,-122.166,960,6060,209995,21,7,2014,0,61,6603,5100,0,0,0
4,2.5,2830,8399,2.0,0,0,3,9,2830,0,1998,0,98075,47.5851,-122.034,2520,6890,680000,16,10,2014,0,16,5569,4370,0,0,0
3,1.75,1120,7740,1.0,0,0,4,6,860,260,1948,0,98125,47.7107,-122.291,1240,7740,355000,2,10,2014,0,66,6620,6500,0,1,1
2,1.0,1310,6600,1.0,0,0,3,6,1310,0,1942,0,98168,47.4834,-122.332,1240,6600,280000,22,4,2015,0,73,5290,5360,0,0,1
3,2.25,1710,11500,1.0,0,0,3,7,1210,500,1978,0,98028,47.7675,-122.267,1800,11500,385000,5,6,2014,0,36,9790,9700,0,1,0
4,2.75,2200,9778,1.0,0,0,4,8,1100,1100,1962,0,98006,47.5472,-122.176,2140,11321,505000,1,7,2014,0,52,7578,9181,0,1,0
4,3.25,3310,8897,2.0,0,0,3,9,2380,930,1991,0,98003,47.2655,-122.31,2490,8638,429900,22,8,2014,0,23,5587,6148,0,1,0
4,2.5,2280,9874,2.0,0,0,3,9,2280,0,1989,0,98034,47.7099,-122.229,2670,9782,560000,21,7,2014,0,25,7594,7112,0,0,0
3,2.0,1640,4875,1.0,0,0,4,7,1040,600,1977,0,98042,47.3661,-122.094,1640,5200,231000,29,9,2014,0,37,3235,3560,0,1,0
2,1.0,750,5217,1.0,0,0,4,6,750,0,1943,0,98106,47.5188,-122.353,760,4440,135000,27,4,2015,0,72,4467,3680,0,0,1
4,3.0,3520,4895,1.0,0,0,3,8,1980,1540,1954,0,98107,47.6678,-122.361,1570,2153,800000,23,6,2014,0,60,1375,583,0,1,1
3,2.5,2720,8622,2.0,0,0,3,8,2720,0,2002,0,98059,47.4954,-122.163,1950,8603,420000,20,12,2014,0,12,5902,6653,0,0,0
3,1.0,1660,9600,1.0,0,0,3,7,1660,0,1963,0,98034,47.708,-122.216,2020,9600,360000,22,10,2014,0,51,7940,7580,0,0,0
4,2.5,2560,8780,2.0,0,0,3,9,2560,0,1992,0,98029,47.5717,-121.991,2780,8357,642000,30,5,2014,0,22,6220,5577,0,0,0
3,2.0,1080,5077,1.0,0,0,3,7,1080,0,1985,0,98052,47.6836,-122.095,1070,3471,379950,6,4,2015,0,30,3997,2401,0,0,0
3,1.75,2050,11041,1.5,0,0,5,9,2050,0,1959,0,98005,47.5968,-122.174,2530,11041,745000,11,7,2014,0,55,8991,8511,0,0,0
4,2.0,2670,3240,1.5,0,0,4,9,1780,890,1930,0,98144,47.5841,-122.294,1820,4000,630000,29,7,2014,0,84,570,2180,0,1,1
3,2.5,1730,7200,2.0,0,0,4,7,1730,0,1985,0,98031,47.4029,-122.196,1770,7396,250000,5,5,2015,0,30,5470,5626,0,0,0
3,1.0,990,9798,1.0,0,0,3,7,990,0,1968,0,98072,47.767,-122.164,1210,9870,275000,24,6,2014,0,46,8808,8660,0,0,0
6,3.0,3560,4290,1.0,0,0,4,7,1780,1780,1957,0,98118,47.5282,-122.269,3040,6000,435000,1,5,2015,0,58,730,2960,0,1,1
2,1.0,700,8174,1.0,0,0,3,5,700,0,1941,0,98146,47.5136,-122.349,1250,8046,175000,5,3,2015,0,74,7474,6796,0,0,1
4,1.75,1880,3880,1.5,0,0,4,7,1090,790,1944,0,98107,47.6635,-122.362,1390,3880,560000,12,6,2014,0,70,2000,2490,0,1,1
4,2.25,1870,9680,1.0,0,0,4,7,1170,700,1959,0,98034,47.7157,-122.234,2000,9790,325000,20,5,2014,0,55,7810,7790,0,1,0
3,2.75,2500,5568,2.0,0,0,5,9,2500,0,1905,0,98112,47.6258,-122.312,2810,5568,1190000,17,6,2014,0,109,3068,2758,0,0,1
3,2.5,2570,10431,2.0,0,0,3,9,2570,0,1989,0,98031,47.4188,-122.213,2590,10078,399950,27,6,2014,0,25,7861,7488,0,0,0
4,2.5,2940,10382,2.0,0,0,4,9,2940,0,1991,0,98059,47.5333,-122.151,2980,10547,752000,17,6,2014,0,23,7442,7567,0,0,0
4,1.5,2150,11026,1.0,0,0,4,7,2150,0,1952,0,98028,47.7635,-122.263,1760,10283,400000,25,9,2014,0,62,8876,8523,0,0,0
3,2.0,1330,6000,1.0,0,0,4,7,630,700,1900,0,98108,47.5255,-122.327,1140,6000,240000,30,5,2014,0,114,4670,4860,0,1,1
5,2.5,3220,4759,2.0,0,0,3,8,3220,0,2003,0,98075,47.5957,-122.032,2550,4759,640000,11,11,2014,0,11,1539,2209,0,0,0
3,2.5,2710,6174,2.0,0,0,3,9,2710,0,1998,0,98056,47.512,-122.174,2730,7266,564450,2,4,2015,0,17,3464,4536,0,0,0
3,2.5,1680,4226,2.0,0,0,3,8,1680,0,2003,0,98042,47.3684,-122.123,1800,5559,286000,17,3,2015,0,12,2546,3759,0,0,0
3,2.5,1930,5344,2.0,0,0,3,7,1930,0,2004,0,98053,47.6783,-122.032,2410,5080,531800,19,2,2015,0,11,3414,2670,0,0,0
4,2.25,2140,10943,1.0,0,0,3,7,1550,590,1977,0,98034,47.7271,-122.215,2350,9000,502000,24,10,2014,0,37,8803,6650,0,1,0
3,1.0,1350,10000,1.0,0,0,4,7,1350,0,1954,0,98006,47.5741,-122.133,1450,10000,450000,20,10,2014,0,60,8650,8550,0,0,0
3,1.0,1320,5250,1.5,0,0,5,7,1320,0,1913,0,98126,47.5566,-122.378,1490,5250,526000,13,10,2014,0,101,3930,3760,0,0,1
3,1.75,2100,8298,1.0,0,0,4,7,1230,870,1952,0,98166,47.4601,-122.36,1700,10830,335000,14,1,2015,0,63,6198,9130,0,1,1
2,1.0,710,14700,1.0,0,0,5,6,710,0,1926,0,98168,47.4939,-122.318,1320,14700,187250,3,12,2014,0,88,13990,13380,0,0,1
3,2.25,2350,6000,1.0,0,0,5,7,1020,1330,1948,0,98115,47.6809,-122.305,1570,5000,735000,11,8,2014,0,66,3650,3430,0,1,1
3,1.0,1180,8400,1.0,0,0,3,7,1180,0,1951,0,98125,47.7028,-122.295,1740,7020,425000,18,2,2015,0,64,7220,5280,0,0,1
3,2.0,1490,7697,1.0,0,0,3,7,1490,0,1994,0,98059,47.4852,-122.164,1540,7529,305000,21,8,2014,0,20,6207,5989,0,0,0
3,1.0,1000,9450,1.0,0,0,3,6,1000,0,1962,0,98055,47.4562,-122.193,1300,13500,212000,14,4,2015,0,53,8450,12200,0,0,0
5,2.25,2300,11505,1.0,0,0,3,8,1300,1000,1963,0,98030,47.3812,-122.223,2350,11505,298950,18,9,2014,0,51,9205,9155,0,1,0
3,1.75,1330,8136,1.0,0,0,4,7,1330,0,1977,0,98033,47.7001,-122.173,1330,8136,525000,16,3,2015,0,38,6806,6806,0,0,0
4,3.25,3200,7081,2.0,0,0,3,9,3200,0,2004,0,98075,47.5886,-121.989,3120,6094,707000,14,5,2014,0,10,3881,2974,0,0,0
3,2.75,2590,12063,2.0,0,0,3,10,2590,0,1993,0,98006,47.5527,-122.12,2850,8469,695000,26,6,2014,0,21,9473,5619,0,0,0
3,2.75,2590,12063,2.0,0,0,3,10,2590,0,1993,0,98006,47.5527,-122.12,2850,8469,796500,1,12,2014,0,21,9473,5619,0,0,0
4,2.5,2030,8100,1.0,0,0,3,7,1150,880,1973,0,98034,47.7404,-122.186,1770,8071,420000,23,7,2014,0,41,6070,6301,0,1,0
3,1.75,1670,9900,1.0,0,0,4,8,1670,0,1957,0,98005,47.595,-122.172,2410,8800,620000,23,8,2014,0,57,8230,6390,0,0,0
4,2.0,1440,10920,1.0,0,0,3,5,1440,0,1943,0,98056,47.5049,-122.18,1500,11902,275000,27,2,2015,0,72,9480,10402,0,0,0
3,2.5,2820,7200,1.0,0,3,3,9,1780,1040,1979,0,98177,47.7691,-122.388,2300,7200,705000,24,9,2014,0,35,4380,4900,0,1,1
3,1.75,1690,7735,1.0,0,0,4,7,1060,630,1976,0,98001,47.3324,-122.28,1580,7503,197000,6,5,2014,0,38,6045,5923,0,1,0
3,1.75,1420,8126,1.0,0,0,3,8,1420,0,1991,0,98031,47.3871,-122.189,1730,7954,265000,5,5,2015,0,24,6706,6224,0,0,0
4,1.75,1790,5341,1.0,0,0,4,7,1050,740,1951,0,98166,47.4663,-122.363,1540,6916,297000,20,11,2014,0,63,3551,5376,0,1,1
3,1.75,1320,12528,1.0,0,0,4,7,1320,0,1970,0,98042,47.3234,-122.142,1340,11039,207500,19,8,2014,0,44,11208,9699,0,0,0
3,2.5,1509,1418,3.0,0,0,3,8,1509,0,2014,0,98133,47.7047,-122.34,1509,1991,410000,19,8,2014,0,0,-91,482,0,0,1
3,2.0,1610,8416,1.0,0,0,3,7,1610,0,1994,0,98031,47.397,-122.187,1600,8308,268000,3,10,2014,0,20,6806,6708,0,0,0
3,1.0,1160,7491,1.0,0,0,4,6,1160,0,1917,0,98177,47.7024,-122.359,1800,2267,417500,18,8,2014,0,97,6331,467,0,0,1
4,2.25,2500,8500,2.0,0,0,4,8,2500,0,1979,0,98006,47.5569,-122.151,2470,9100,760000,4,8,2014,0,35,6000,6630,0,0,0
3,2.5,1540,1326,3.0,0,0,3,8,1390,150,1995,0,98119,47.6457,-122.374,1680,1592,499000,5,7,2014,0,19,-214,-88,0,1,1
4,2.5,1910,7683,2.0,0,0,3,8,1910,0,1987,0,98027,47.5644,-122.092,1980,8485,620000,18,6,2014,0,27,5773,6505,0,0,0
3,2.5,2340,6837,2.0,0,0,3,7,2340,0,1992,0,98030,47.3608,-122.194,1850,6209,315000,10,7,2014,0,22,4497,4359,0,0,0
3,2.5,2060,4730,2.0,0,0,4,8,2060,0,1994,0,98033,47.6874,-122.178,1980,5010,624950,9,4,2015,0,21,2670,3030,0,0,0
3,2.25,1960,12350,1.0,0,0,4,7,1960,0,1961,0,98027,47.5247,-122.052,1920,13608,525000,28,4,2015,0,54,10390,11688,0,0,0
2,1.5,1150,3927,2.0,0,0,3,7,1150,0,1982,0,98034,47.7248,-122.162,1400,3425,300000,8,8,2014,0,32,2777,2025,0,0,0
4,2.75,2330,7200,1.0,0,0,4,8,1560,770,1977,0,98023,47.3203,-122.385,2350,7600,299900,10,3,2015,0,38,4870,5250,0,1,0
3,2.5,2210,10119,1.0,0,0,4,7,1450,760,1966,0,98030,47.3783,-122.22,2110,10119,299000,12,6,2014,0,48,7909,8009,0,1,0
4,1.75,1900,10588,1.0,0,0,5,6,1900,0,1958,0,98002,47.289,-122.212,1530,10587,265000,13,6,2014,0,56,8688,9057,0,0,0
3,1.0,1340,15600,1.0,0,0,4,6,1340,0,1978,0,98042,47.3224,-122.143,1320,9800,124740,28,5,2014,0,36,14260,8480,0,0,0
8,3.5,4440,6480,2.0,0,3,5,10,3140,1300,1959,0,98112,47.631,-122.303,4440,8640,1970000,28,5,2014,0,55,2040,4200,0,1,1
4,1.0,1370,5339,1.5,0,0,4,6,1370,0,1948,0,98168,47.5046,-122.3,1280,7048,219000,15,2,2015,0,67,3969,5768,0,0,1
5,1.0,1420,6250,1.5,0,0,4,8,1420,0,1926,0,98116,47.5807,-122.389,1420,6250,569950,16,4,2015,0,89,4830,4830,0,0,1
3,2.25,1820,8316,1.0,0,0,5,7,1320,500,1960,0,98005,47.5849,-122.169,1780,8400,680000,11,8,2014,0,54,6496,6620,0,1,0
4,1.5,2650,6900,2.0,0,0,4,9,2400,250,1909,0,98112,47.6275,-122.305,2420,6900,1460000,29,9,2014,0,105,4250,4480,0,1,1
3,1.0,910,7700,1.0,0,0,4,7,910,0,1971,0,98034,47.7303,-122.238,1250,7700,300000,18,6,2014,0,43,6790,6450,0,0,0
3,2.5,1680,1683,2.0,0,0,3,9,1120,560,2014,0,98119,47.6424,-122.374,1610,1249,629950,10,3,2015,0,1,3,-361,0,1,1
2,1.75,1550,9230,1.0,0,0,3,6,970,580,1969,0,98045,47.4701,-121.744,1550,10856,349900,2,12,2014,0,45,7680,9306,0,1,0
4,2.5,2780,6235,2.0,0,0,3,8,2780,0,2001,0,98075,47.5976,-122.039,2670,4410,690000,12,8,2014,0,13,3455,1740,0,0,0
5,4.0,4070,11334,2.0,0,0,3,10,4070,0,2014,0,98033,47.6771,-122.187,2640,9401,1450000,25,2,2015,0,1,7264,6761,0,0,0
3,2.5,3240,12625,2.0,0,0,3,11,3240,0,1987,0,98040,47.5327,-122.232,3470,12331,1290000,21,1,2015,0,28,9385,8861,0,0,0
3,3.5,2480,10800,2.0,0,0,3,8,2480,0,1998,0,98074,47.6083,-122.06,2380,11310,640000,12,8,2014,0,16,8320,8930,0,0,0
4,2.5,3630,8387,2.0,0,0,3,10,3630,0,1997,0,98042,47.3623,-122.127,3370,8869,490000,23,12,2014,0,17,4757,5499,0,0,0
5,2.5,3160,5635,2.0,0,0,3,9,3160,0,2003,0,98027,47.5362,-122.067,3670,6087,685000,10,10,2014,0,11,2475,2417,0,0,0
4,1.0,1370,7140,2.0,0,0,3,6,1370,0,1942,0,98146,47.512,-122.376,1090,6300,387500,3,4,2015,0,73,5770,5210,0,0,1
2,1.5,1070,1236,2.0,0,0,3,8,1000,70,2005,0,98116,47.5619,-122.382,1170,1888,401750,21,4,2015,0,10,166,718,0,1,1
4,2.0,2180,8800,1.0,0,0,5,7,1170,1010,1977,0,98038,47.3676,-122.046,1630,8800,254950,26,8,2014,0,37,6620,7170,0,1,0
4,2.5,3290,8147,2.0,0,0,3,10,3290,0,2003,0,98052,47.7048,-122.107,3290,7467,856500,15,7,2014,0,11,4857,4177,0,0,0
3,1.0,1430,5000,1.0,0,0,4,6,1080,350,1919,0,98115,47.6724,-122.296,1630,4600,552000,23,5,2014,0,95,3570,2970,0,1,1
4,2.5,1890,7200,1.0,0,0,4,7,1500,390,1978,0,98034,47.7278,-122.218,2070,7200,506500,10,9,2014,0,36,5310,5130,0,1,0
3,2.25,1760,4539,2.0,0,0,3,8,1760,0,1988,0,98029,47.5754,-122.013,1960,4808,500000,27,5,2014,0,26,2779,2848,0,0,0
4,2.75,2230,10160,1.0,0,0,3,7,1400,830,1968,0,98168,47.5123,-122.32,1740,10080,280000,29,7,2014,0,46,7930,8340,0,1,1
3,1.75,1630,11475,1.0,0,0,4,7,1330,300,1979,0,98045,47.4635,-121.746,1630,11475,308000,6,3,2015,0,36,9845,9845,0,1,0
3,2.5,2350,7035,2.0,0,0,3,8,2350,0,1989,0,98029,47.5713,-122.02,2270,7192,613500,5,2,2015,0,26,4685,4922,0,0,0
3,1.75,1550,9720,1.0,0,0,3,7,1050,500,1976,0,98010,47.3433,-122.037,1550,9750,255000,8,7,2014,0,38,8170,8200,0,1,0
3,1.75,1740,6800,1.5,0,0,4,7,1740,0,1949,0,98126,47.5314,-122.373,990,6800,450000,25,10,2014,0,65,5060,5810,0,0,1
4,1.75,1840,7275,1.0,0,0,3,7,1090,750,1976,0,98031,47.4002,-122.189,1840,7275,279000,8,5,2015,0,39,5435,5435,0,1,0
3,2.5,2010,3200,2.0,0,0,3,9,2010,0,2009,0,98027,47.5463,-122.015,2250,3200,625000,23,1,2015,0,6,1190,950,0,0,0
3,1.75,1670,7415,1.0,0,0,3,7,1320,350,1987,0,98042,47.3776,-122.116,1650,8585,274950,27,5,2014,0,27,5745,6935,0,1,0
3,1.75,1820,6038,1.0,0,0,4,7,1040,780,1952,0,98126,47.5233,-122.378,1700,6040,423000,23,10,2014,0,62,4218,4340,0,1,1
2,1.0,720,5820,1.0,0,1,5,6,720,0,1950,0,98028,47.7598,-122.255,952,5820,350000,26,2,2015,0,65,5100,4868,0,0,0
4,1.75,2370,10140,1.0,0,0,3,7,1460,910,1968,0,98001,47.3352,-122.278,1450,7800,305000,30,3,2015,0,47,7770,6350,0,1,0
3,1.75,2120,11340,1.0,0,3,4,7,1060,1060,1966,0,98198,47.4109,-122.329,1830,8650,368000,17,11,2014,0,48,9220,6820,0,1,1
3,1.75,1290,6604,1.0,0,0,3,7,1290,0,1984,0,98023,47.323,-122.349,1440,6682,232000,26,9,2014,0,30,5314,5242,0,0,0
4,3.0,1800,2500,2.0,0,0,3,7,1800,0,2000,0,98108,47.5333,-122.294,1830,6900,250000,26,11,2014,0,14,700,5070,0,0,1
3,1.75,1230,8917,1.0,0,0,4,7,1230,0,1966,0,98058,47.4528,-122.172,1420,7938,220000,11,2,2015,0,49,7687,6518,0,0,0
3,2.0,1380,2500,1.0,0,0,3,7,750,630,1986,0,98107,47.6753,-122.363,1630,3800,435000,13,8,2014,0,28,1120,2170,0,1,1
2,1.0,740,7680,1.0,0,0,4,6,740,0,1922,0,98126,47.5245,-122.371,1080,7680,350000,24,6,2014,0,92,6940,6600,0,0,1
5,2.5,1720,10202,1.5,0,0,3,7,1720,0,1970,0,98058,47.4572,-122.167,1720,8478,206325,13,8,2014,0,44,8482,6758,0,0,0
5,2.5,1720,10202,1.5,0,0,3,7,1720,0,1970,0,98058,47.4572,-122.167,1720,8478,339000,27,2,2015,0,45,8482,6758,0,0,0
4,2.5,2100,7355,1.0,0,0,5,7,2100,0,1969,0,98059,47.5078,-122.161,1750,7200,399000,18,3,2015,0,46,5255,5450,0,0,0
2,1.0,1210,7667,1.0,0,0,3,6,900,310,1950,0,98199,47.6571,-122.396,1330,6462,529000,19,2,2015,0,65,6457,5132,0,1,1
4,2.5,2210,7722,2.0,0,0,3,9,2210,0,1999,0,98075,47.5992,-122.019,2970,8683,640000,4,3,2015,0,16,5512,5713,0,0,0
4,2.5,2470,2550,3.0,0,0,3,8,2470,0,2004,0,98117,47.6765,-122.389,1270,3060,735000,6,11,2014,0,10,80,1790,0,0,1
3,2.0,2540,7200,1.5,0,3,4,8,1600,940,1905,0,98144,47.5972,-122.292,2040,5900,775000,7,5,2014,0,109,4660,3860,0,1,1
3,4.25,5150,7800,2.5,0,2,3,11,4170,980,1954,0,98112,47.6288,-122.282,4270,7800,2250000,25,7,2014,0,60,2650,3530,0,1,1
4,4.5,3420,7440,3.0,0,0,3,9,3420,0,2014,0,98103,47.6875,-122.33,1360,5580,1350000,28,1,2015,0,1,4020,4220,0,0,1
4,2.5,2270,11500,1.0,0,0,3,8,1540,730,1967,0,98034,47.7089,-122.241,2020,10918,380000,27,8,2014,0,47,9230,8898,0,1,0
4,2.5,2270,11500,1.0,0,0,3,8,1540,730,1967,0,98034,47.7089,-122.241,2020,10918,624900,18,2,2015,0,48,9230,8898,0,1,0
3,2.5,1470,1779,2.0,0,0,3,8,1160,310,2005,0,98029,47.5472,-121.998,1470,1576,379770,7,11,2014,0,9,309,106,0,1,0
3,1.75,1280,16200,1.0,0,0,3,8,1030,250,1976,0,98077,47.7427,-122.071,1160,10565,340000,3,12,2014,0,38,14920,9405,0,1,0
4,2.75,2830,8126,2.0,0,0,3,8,2830,0,2005,0,98059,47.4863,-122.14,2830,7916,515500,15,1,2015,0,10,5296,5086,0,0,0
4,2.25,1970,7125,1.5,0,0,3,7,1500,470,1908,0,98115,47.6725,-122.293,1980,4750,600000,17,11,2014,0,106,5155,2770,0,1,1
4,1.0,1020,11383,1.5,0,0,5,6,1020,0,1947,0,98155,47.7429,-122.321,1290,11213,364000,1,12,2014,0,67,10363,9923,0,0,1
4,2.5,2250,7526,2.0,0,0,3,8,2250,0,1989,0,98059,47.5123,-122.15,1980,7526,440000,26,6,2014,0,25,5276,5546,0,0,0
2,1.0,800,6240,1.0,0,0,3,6,800,0,1954,0,98125,47.7257,-122.296,1530,8000,285000,28,5,2014,0,60,5440,6470,0,0,1
3,1.0,1560,4500,1.5,0,0,5,7,1560,0,1915,0,98112,47.6204,-122.292,1530,4500,669000,1,4,2015,0,100,2940,2970,0,0,1
4,2.0,2100,13468,1.0,0,0,5,7,1050,1050,1962,0,98125,47.7139,-122.292,1470,8675,475000,2,7,2014,0,52,11368,7205,0,1,1
2,1.0,990,4000,1.0,0,0,4,7,990,0,1911,0,98103,47.6589,-122.341,1560,4000,747000,4,5,2015,0,104,3010,2440,0,0,1
3,1.5,1060,5750,1.0,0,0,2,7,1060,0,1981,0,98126,47.5532,-122.372,1060,5750,317000,5,1,2015,0,34,4690,4690,0,0,1
2,1.0,1270,8164,1.0,0,0,4,6,1270,0,1941,0,98125,47.7116,-122.311,1580,9095,390000,28,8,2014,0,73,6894,7515,0,0,1
4,2.5,2740,5000,2.0,0,0,3,9,2740,0,2012,0,98107,47.674,-122.371,1660,5000,1070000,22,4,2015,0,3,2260,3340,0,0,1
4,2.75,2470,5500,1.0,0,3,3,9,1570,900,1960,2005,98107,47.6586,-122.358,1620,5500,1210000,21,10,2014,45,54,3030,3880,1,1,1
3,1.75,1970,5100,1.0,0,0,3,7,1130,840,1908,1965,98117,47.6831,-122.379,1250,4080,580000,27,3,2015,57,107,3130,2830,1,1,1
4,2.5,2070,10244,1.0,0,0,3,8,1370,700,1969,0,98006,47.5592,-122.178,2070,9683,518000,13,11,2014,0,45,8174,7613,0,1,0
3,1.75,1010,6552,1.0,0,0,3,7,1010,0,1969,0,98042,47.375,-122.117,1010,6552,147500,4,12,2014,0,45,5542,5542,0,0,0
4,2.25,2220,8125,1.0,0,0,4,8,1450,770,1965,0,98006,47.5429,-122.177,1980,8700,555000,24,4,2015,0,50,5905,6720,0,1,0
2,2.0,1090,934,3.0,0,0,3,8,1090,0,2008,0,98109,47.6341,-122.342,1090,1376,427500,30,6,2014,0,6,-156,286,0,0,1
3,2.5,1490,3840,2.0,0,0,3,7,1490,0,2002,0,98042,47.374,-122.133,2060,4384,265950,17,7,2014,0,12,2350,2324,0,0,0
2,1.0,700,6046,1.0,0,0,3,6,700,0,1950,0,98133,47.7172,-122.34,990,6790,247500,1,12,2014,0,64,5346,5800,0,0,1
4,1.0,1450,8960,1.0,0,0,3,6,1450,0,1943,0,98146,47.4972,-122.348,1160,7680,244000,23,5,2014,0,71,7510,6520,0,0,1
3,2.5,2120,6602,2.0,0,0,4,8,2120,0,1989,0,98029,47.5669,-122.012,2330,7795,578550,23,3,2015,0,26,4482,5465,0,0,0
4,2.5,1670,3315,2.0,0,0,3,7,1670,0,2005,0,98029,47.5532,-121.998,1650,2051,451000,17,6,2014,0,9,1645,401,0,0,0
2,1.75,1810,4220,2.0,0,0,3,8,1810,0,2004,0,98053,47.7177,-122.034,1350,4479,489000,26,8,2014,0,10,2410,3129,0,0,0
3,2.0,1420,4080,1.5,0,0,3,7,1420,0,1905,2013,98103,47.6872,-122.349,1420,4590,485000,6,5,2014,108,109,2660,3170,1,0,1
4,2.5,2570,10155,2.0,0,0,3,9,2570,0,1994,0,98030,47.3842,-122.17,2770,10155,379000,28,1,2015,0,21,7585,7385,0,0,0
3,1.75,2050,5160,1.5,0,0,4,8,1300,750,1926,0,98112,47.6374,-122.304,2220,5960,739000,19,3,2015,0,89,3110,3740,0,1,1
3,1.0,920,6460,1.0,0,0,5,6,920,0,1969,0,98042,47.3665,-122.082,920,4770,189950,25,11,2014,0,45,5540,3850,0,0,0
4,3.0,2320,4468,2.0,0,0,3,8,2160,160,1999,0,98029,47.546,-122.009,2330,3541,637500,22,12,2014,0,15,2148,1211,0,1,0
3,3.0,3450,16740,1.0,0,4,4,9,1960,1490,1949,1993,98177,47.7067,-122.38,3220,12528,2230000,27,1,2015,44,66,13290,9308,1,1,1
3,1.0,1660,8800,1.0,0,0,4,7,960,700,1963,0,98023,47.3212,-122.352,1370,10112,209950,4,12,2014,0,51,7140,8742,0,1,0
3,1.0,1130,7000,1.0,0,0,3,6,830,300,1944,0,98125,47.7132,-122.283,1050,7000,460000,20,2,2015,0,71,5870,5950,0,1,1
4,2.5,2550,5835,2.0,0,0,3,8,2550,0,1998,0,98065,47.5373,-121.87,2420,5817,543500,20,10,2014,0,16,3285,3397,0,0,0
4,2.75,2420,5773,2.0,0,0,3,8,2420,0,2005,0,98038,47.3772,-122.029,2420,6200,376000,5,6,2014,0,9,3353,3780,0,0,0
3,2.25,1470,1703,2.0,0,0,3,8,1470,0,2005,0,98029,47.5478,-121.999,1380,1107,430000,28,10,2014,0,9,233,-273,0,0,0
7,2.75,2310,2400,1.5,0,0,3,6,2310,0,1915,0,98117,47.6775,-122.39,1340,3825,580000,11,7,2014,0,99,90,2485,0,0,1
5,3.5,3370,16846,2.0,0,1,3,9,2650,720,1998,0,98027,47.5584,-122.089,3330,13000,600000,3,2,2015,0,17,13476,9670,0,1,0
3,1.5,1940,3570,2.0,0,0,4,8,1740,200,1916,0,98105,47.6618,-122.325,1580,3570,815000,29,4,2015,0,99,1630,1990,0,1,1
3,2.5,2420,8252,2.0,0,0,3,7,2420,0,1998,0,98065,47.5382,-121.871,2420,5818,455600,27,5,2014,0,16,5832,3398,0,0,0
3,1.0,1010,9514,1.0,0,0,3,7,1010,0,1969,0,98059,47.4936,-122.105,1010,9514,270000,15,5,2014,0,45,8504,8504,0,0,0
5,4.0,2710,2800,3.0,0,0,3,10,2380,330,1974,2008,98119,47.6346,-122.364,1530,3600,1200000,14,8,2014,34,40,90,2070,1,1,1
2,1.5,1340,3600,1.5,0,0,3,7,1340,0,1903,0,98119,47.6358,-122.364,1340,3600,525000,10,7,2014,0,111,2260,2260,0,0,1
3,1.75,1310,9645,1.0,0,0,3,7,1310,0,1979,0,98198,47.4051,-122.29,1440,9893,242000,28,5,2014,0,35,8335,8453,0,0,1
3,2.75,1890,3938,2.0,0,0,3,8,1890,0,1999,0,98065,47.5336,-121.867,1890,4142,475000,2,4,2015,0,16,2048,2252,0,0,0
4,3.0,2580,5511,2.0,0,0,3,8,2580,0,1999,0,98058,47.4286,-122.185,2010,5600,370000,11,11,2014,0,15,2931,3590,0,0,0
4,2.75,3500,7200,2.0,0,0,3,9,3500,0,2005,0,98053,47.6818,-122.025,3920,7666,788600,23,5,2014,0,9,3700,3746,0,0,0
2,1.0,1040,13100,1.0,0,0,5,6,1040,0,1912,0,98032,47.3877,-122.234,910,5080,160000,7,5,2014,0,102,12060,4170,0,0,0
4,3.0,2190,5085,2.0,0,0,4,8,2190,0,1992,0,98029,47.5693,-122.002,2130,5142,520000,24,9,2014,0,22,2895,3012,0,0,0
3,1.75,1530,4000,2.0,0,0,3,8,1530,0,1985,0,98136,47.5239,-122.388,2140,5000,725000,18,7,2014,0,29,2470,2860,0,0,1
4,1.0,1480,6500,1.5,0,0,4,7,1480,0,1914,0,98118,47.5282,-122.267,2380,6000,335000,3,10,2014,0,100,5020,3620,0,0,1
3,2.75,3370,13929,2.0,0,0,3,9,2650,720,1986,0,98092,47.3411,-122.197,2150,14048,425000,13,5,2015,0,29,10559,11898,0,1,0
5,2.5,2100,14395,1.0,0,0,3,7,1140,960,1983,0,98155,47.7723,-122.317,1830,8700,420000,14,3,2015,0,32,12295,6870,0,1,1
2,1.0,2240,7200,1.0,0,0,4,7,1120,1120,1940,0,98118,47.5631,-122.271,1390,6000,435000,19,9,2014,0,74,4960,4610,0,1,1
3,2.5,1650,3031,2.0,0,0,3,7,1650,0,2003,0,98053,47.682,-122.034,1560,3070,438000,17,7,2014,0,11,1381,1510,0,0,0
4,2.75,2630,7505,2.0,0,0,3,8,2630,0,1994,0,98052,47.6846,-122.163,2670,7506,725000,17,6,2014,0,20,4875,4836,0,0,0
4,1.75,2330,4000,2.0,0,0,5,8,1300,1030,1924,0,98105,47.666,-122.289,2040,4000,840000,28,5,2014,0,90,1670,1960,0,1,1
3,2.5,1970,2752,2.0,0,0,3,8,1970,0,1978,0,98052,47.6345,-122.108,1850,2778,425500,15,7,2014,0,36,782,928,0,0,0
3,2.5,2820,14890,1.0,0,4,3,9,1770,1050,1985,0,98034,47.7019,-122.228,3740,14890,853505,12,9,2014,0,29,12070,11150,0,1,0
2,1.0,590,10945,1.5,0,0,3,5,590,0,1983,0,98010,47.3364,-122.033,2020,15180,398000,22,5,2014,0,31,10355,13160,0,0,0
3,2.5,2060,4399,2.0,0,0,3,7,2060,0,2007,0,98065,47.5415,-121.884,2060,4399,418500,4,6,2014,0,7,2339,2339,0,0,0
3,1.5,1890,5000,1.5,0,0,3,9,1890,0,1929,0,98109,47.6312,-122.353,2560,5000,826000,31,12,2014,0,85,3110,2440,0,0,1
4,2.5,2810,10986,2.0,0,0,3,10,2810,0,1997,0,98075,47.5943,-121.981,3540,10986,742000,11,6,2014,0,17,8176,7446,0,0,0
4,1.75,2190,8400,2.0,0,0,2,8,2190,0,1978,0,98023,47.3003,-122.373,2410,7700,286000,14,1,2015,0,37,6210,5290,0,0,0
3,2.5,1440,3060,2.0,0,0,3,7,1440,0,2003,0,98053,47.6821,-122.035,1650,3060,421200,1,10,2014,0,11,1620,1410,0,0,0
3,3.0,2480,14141,1.0,0,0,3,8,1500,980,1994,0,98038,47.3778,-122.033,2480,10667,390000,31,7,2014,0,20,11661,8187,0,1,0
4,2.5,2780,6737,2.0,0,0,3,9,2780,0,2002,0,98006,47.5656,-122.122,2750,7950,739000,19,9,2014,0,12,3957,5200,0,0,0
4,3.0,2180,12196,2.0,0,0,4,7,2180,0,1968,0,98027,47.5338,-122.033,1500,6534,499900,24,7,2014,0,46,10016,5034,0,0,0
3,2.25,3340,13805,1.0,0,0,3,8,3340,0,1950,1992,98155,47.744,-122.292,2060,12304,670000,3,12,2014,42,64,10465,10244,1,0,1
3,2.25,2560,3996,1.5,0,0,3,8,2150,410,1910,0,98112,47.6321,-122.306,2970,4320,842500,13,10,2014,0,104,1436,1350,0,1,1
3,2.5,2230,7200,3.0,0,3,3,9,2230,0,1996,0,98118,47.558,-122.265,2230,7200,836500,3,9,2014,0,18,4970,4970,0,0,1
2,1.0,900,1818,2.0,0,0,4,7,900,0,1945,0,98199,47.6485,-122.397,1570,1830,334000,26,3,2015,0,70,918,260,0,0,1
3,1.0,1010,9920,1.0,0,0,3,6,1010,0,1977,0,98042,47.3238,-122.14,1270,9680,179900,28,8,2014,0,37,8910,8410,0,0,0
3,2.0,1580,5289,1.0,0,0,3,7,870,710,1940,0,98103,47.6881,-122.342,1310,5535,563000,26,11,2014,0,74,3709,4225,0,1,1
3,2.5,1890,6300,2.0,0,0,3,7,1890,0,2003,0,98038,47.3673,-122.031,2100,6525,310000,3,3,2015,0,12,4410,4425,0,0,0
4,2.25,2160,8817,1.0,0,0,3,7,1460,700,1965,0,98133,47.7595,-122.356,1880,8817,335000,19,8,2014,0,49,6657,6937,0,1,1
4,2.25,2160,8817,1.0,0,0,3,7,1460,700,1965,0,98133,47.7595,-122.356,1880,8817,499950,6,2,2015,0,50,6657,6937,0,1,1
2,1.0,1410,5101,1.5,0,0,3,8,1410,0,1927,0,98103,47.6872,-122.333,1410,4224,658500,26,7,2014,0,87,3691,2814,0,0,1
2,1.5,1430,1650,3.0,0,0,3,7,1430,0,1999,0,98125,47.7222,-122.29,1430,1650,297000,29,10,2014,0,15,220,220,0,0,1
6,1.75,2380,4080,2.0,0,0,3,8,2380,0,1917,0,98105,47.6629,-122.325,2030,4080,725000,20,6,2014,0,97,1700,2050,0,0,1
3,1.0,1030,6127,1.0,0,0,3,7,880,150,1947,0,98125,47.7192,-122.32,1610,6127,252500,9,5,2014,0,67,5097,4517,0,1,1
3,2.5,1070,1155,2.0,0,0,3,7,720,350,2005,0,98102,47.5617,-122.385,1120,2594,330000,13,6,2014,0,9,85,1474,0,1,1
3,2.5,2320,9610,1.0,0,0,3,9,1730,590,1990,0,98011,47.7394,-122.204,2450,9608,525000,10,2,2015,0,25,7290,7158,0,1,0
2,1.75,1270,7500,1.0,0,0,4,7,1270,0,1982,0,98074,47.6186,-122.063,1280,7500,365000,6,8,2014,0,32,6230,6220,0,0,0
4,3.0,2570,9104,2.0,0,2,3,7,2570,0,1930,0,98116,47.5821,-122.401,1630,4950,500000,27,3,2015,0,85,6534,3320,0,0,1
3,1.0,920,4875,1.0,0,0,5,6,920,0,1969,0,98042,47.3648,-122.081,960,5200,179950,12,11,2014,0,45,3955,4240,0,0,0
1,0.75,480,9750,1.0,0,0,2,4,480,0,1948,0,98146,47.4982,-122.362,1550,9924,145000,25,8,2014,0,66,9270,8374,0,0,1
4,3.0,2483,5701,2.0,0,0,3,8,2483,0,2005,0,98030,47.3623,-122.199,2075,5720,331000,22,4,2015,0,10,3218,3645,0,0,0
3,2.25,2140,3000,2.0,0,0,3,9,2140,0,1905,2006,98103,47.6767,-122.351,1430,4712,780000,20,6,2014,101,109,860,3282,1,0,1
3,1.75,1900,4000,1.0,0,0,3,7,1300,600,1965,0,98103,47.6854,-122.331,1880,4000,855000,14,5,2015,0,50,2100,2120,0,1,1
3,2.25,1650,7739,1.0,0,0,3,8,1290,360,1986,0,98003,47.3532,-122.304,1650,6033,225000,14,10,2014,0,28,6089,4383,0,1,0
3,1.0,1510,9100,1.0,0,0,3,7,1510,0,1966,0,98003,47.3331,-122.319,1180,7220,199000,14,7,2014,0,48,7590,6040,0,0,0
4,4.25,4960,6000,2.5,0,0,3,11,3680,1280,1909,2003,98109,47.6437,-122.356,2160,4080,1430000,29,5,2014,94,105,1040,1920,1,1,1
3,2.0,2710,4500,1.5,0,0,4,8,1880,830,1929,0,98115,47.6747,-122.295,2060,4500,805000,2,5,2014,0,85,1790,2440,0,1,1
3,1.0,940,9198,1.0,0,0,3,7,940,0,1968,0,98052,47.6889,-122.117,1430,8370,347000,9,9,2014,0,46,8258,6940,0,0,0
3,2.25,1600,10240,1.0,0,0,3,7,1090,510,1979,0,98034,47.7281,-122.232,1520,9394,390000,19,6,2014,0,35,8640,7874,0,1,0
4,2.5,2640,3899,2.0,0,0,3,7,2640,0,2000,0,98011,47.754,-122.217,2460,4057,436000,10,11,2014,0,14,1259,1597,0,0,0
3,2.5,1630,1587,3.0,0,0,3,8,1630,0,2004,0,98107,47.6693,-122.393,1500,1527,557000,23,7,2014,0,10,-43,27,0,0,1
3,1.0,830,9600,1.0,0,0,3,7,830,0,1959,0,98032,47.3698,-122.297,1240,9198,135000,6,4,2015,0,56,8770,7958,0,0,0
3,2.5,1800,14036,2.0,0,0,3,8,1800,0,1993,0,98019,47.7334,-121.97,2450,14025,425000,25,3,2015,0,22,12236,11575,0,0,0
3,2.25,2060,9953,1.0,0,0,5,8,1070,990,1964,0,98040,47.5767,-122.233,2340,9600,648752,8,4,2015,0,51,7893,7260,0,1,0
4,2.75,1910,11356,1.0,0,0,5,7,1160,750,1977,0,98033,47.6999,-122.2,1770,11357,630100,24,3,2015,0,38,9446,9587,0,1,0
3,1.5,1320,2625,2.0,0,0,3,7,1320,0,1986,0,98133,47.7316,-122.338,1230,5250,269000,18,8,2014,0,28,1305,4020,0,0,1
3,1.0,1220,5038,1.0,0,0,5,6,1220,0,1942,0,98056,47.496,-122.189,1140,5038,250000,27,4,2015,0,73,3818,3898,0,0,0
5,2.75,3100,5298,2.0,0,0,3,7,3100,0,2007,0,98065,47.5369,-121.887,2440,5250,475000,20,3,2015,0,8,2198,2810,0,0,0
1,1.0,550,5700,1.0,0,0,2,6,550,0,1916,0,98117,47.6846,-122.366,1100,4560,290000,19,11,2014,0,98,5150,3460,0,0,1
3,1.0,1080,10639,1.5,0,0,3,7,1080,0,1953,0,98002,47.3171,-122.219,1470,10600,219000,18,11,2014,0,61,9559,9130,0,0,0
2,1.0,880,6650,1.0,0,0,5,6,880,0,1918,0,98117,47.6914,-122.372,1250,6650,416000,29,9,2014,0,96,5770,5400,0,0,1
2,1.0,720,8914,1.0,0,0,3,6,720,0,1949,0,98188,47.4488,-122.274,1100,8916,179000,13,4,2015,0,66,8194,7816,0,0,1
4,2.75,2030,9120,1.0,0,0,4,7,2030,0,1988,0,98003,47.282,-122.303,1790,7627,302000,15,7,2014,0,26,7090,5837,0,0,0
4,2.0,2040,8281,2.0,0,1,3,7,2040,0,1961,0,98033,47.6689,-122.195,2560,8281,565000,27,4,2015,0,54,6241,5721,0,0,0
3,1.0,1570,8316,1.0,0,0,3,7,1070,500,1962,0,98031,47.3943,-122.198,2030,8295,281700,22,4,2015,0,53,6746,6265,0,1,0
2,1.0,1500,3420,1.0,0,0,3,7,1500,0,1902,0,98103,47.661,-122.338,2050,3420,480000,27,6,2014,0,112,1920,1370,0,0,1
3,1.75,1260,11224,1.0,0,0,5,7,1260,0,1947,0,98155,47.7444,-122.321,1570,11052,375000,4,9,2014,0,67,9964,9482,0,0,1
3,1.5,1390,13860,2.0,0,0,3,7,1390,0,1979,0,98045,47.4704,-121.747,1390,11860,345000,13,10,2014,0,35,12470,10470,0,0,0
3,3.0,2850,9375,1.0,0,0,3,8,2240,610,1977,0,98055,47.4655,-122.209,1800,9375,300000,23,2,2015,0,38,6525,7575,0,1,0
4,2.5,2070,2992,2.0,0,0,3,8,2070,0,2002,0,98058,47.4496,-122.12,1900,2957,364950,22,4,2015,0,13,922,1057,0,0,0
3,3.25,2650,7819,1.0,0,2,4,8,1760,890,1956,0,98056,47.4821,-122.192,2400,7727,410000,2,12,2014,0,58,5169,5327,0,1,0
3,1.75,1220,8817,1.0,0,0,3,7,1220,0,1978,0,98023,47.3111,-122.396,2000,8028,231000,14,4,2015,0,37,7597,6028,0,0,0
3,2.0,1630,8702,1.0,0,0,3,9,1630,0,1987,0,98056,47.5168,-122.193,2250,9890,445000,23,5,2014,0,27,7072,7640,0,0,0
2,2.5,1785,779,2.0,0,0,3,7,1595,190,1975,0,98004,47.5959,-122.198,1780,794,530000,8,7,2014,0,39,-1006,-986,0,1,0
3,2.5,1260,972,2.0,0,0,3,8,840,420,2008,0,98144,47.5872,-122.316,1270,925,353500,26,12,2014,0,6,-288,-345,0,1,1
3,1.5,1380,11130,1.0,0,0,3,7,1380,0,1960,0,98003,47.3146,-122.323,1380,9200,209950,7,5,2014,0,54,9750,7820,0,0,0
3,1.75,2330,7200,1.0,0,0,4,8,1320,1010,1950,0,98118,47.565,-122.274,1820,7200,650000,23,4,2015,0,65,4870,5380,0,1,1
2,1.0,840,4239,1.0,0,0,3,7,840,0,1948,0,98126,47.5319,-122.382,1120,4494,325000,20,6,2014,0,66,3399,3374,0,0,1
3,2.25,1730,9516,1.0,0,0,3,8,1180,550,1978,0,98030,47.3823,-122.166,1870,8165,257000,28,8,2014,0,36,7786,6295,0,1,0
4,2.5,2230,5970,2.0,0,0,4,7,2230,0,2002,0,98042,47.3745,-122.131,1970,4919,337000,30,6,2014,0,12,3740,2949,0,0,0
3,2.5,1790,4038,2.0,0,0,3,8,1790,0,2005,0,98029,47.5499,-121.998,1700,3365,541000,26,9,2014,0,9,2248,1665,0,0,0
3,2.5,2280,10879,2.0,0,0,3,9,2280,0,1984,0,98074,47.6217,-122.034,2400,9536,577500,14,11,2014,0,30,8599,7136,0,0,0
3,2.5,2430,5128,1.0,0,1,3,8,1270,1160,1978,0,98136,47.5198,-122.389,2510,5330,560000,24,11,2014,0,36,2698,2820,0,1,1
5,3.0,3730,5500,1.5,0,0,3,7,2160,1570,1927,0,98102,47.6507,-122.32,1890,5500,979700,29,10,2014,0,87,1770,3610,0,1,1
5,3.0,2230,8560,1.0,0,0,3,8,1150,1080,1960,2014,98008,47.6154,-122.115,2040,8560,750000,25,7,2014,54,54,6330,6520,1,1,0
2,1.0,770,2971,1.0,0,2,3,7,770,0,1923,0,98102,47.6358,-122.322,1440,4000,407500,8,8,2014,0,91,2201,2560,0,0,1
4,1.75,1814,5000,1.0,0,0,4,7,944,870,1951,0,98115,47.684,-122.281,1290,5000,530000,23,5,2014,0,63,3186,3710,0,1,1
4,1.75,1920,9350,1.0,0,0,4,7,1000,920,1977,0,98002,47.292,-122.195,1910,8400,235000,6,4,2015,0,38,7430,6490,0,1,0
4,2.5,1860,3840,1.5,0,0,3,7,1170,690,1928,2014,98117,47.6886,-122.359,1400,3840,715000,7,4,2015,86,87,1980,2440,1,1,1
5,3.0,2750,10000,1.0,0,0,4,7,1730,1020,1957,0,98008,47.5878,-122.13,2520,10000,795000,21,4,2015,0,58,7250,7480,0,1,0
4,2.5,1930,9653,1.0,0,0,4,9,1930,0,1968,0,98023,47.3367,-122.335,2100,10454,465000,9,5,2014,0,46,7723,8354,0,0,0
3,2.5,1950,8251,2.0,0,0,3,7,1950,0,1990,0,98001,47.343,-122.28,1540,8588,287600,13,5,2014,0,24,6301,7048,0,0,0
6,3.0,2470,9328,2.0,0,0,3,8,2470,0,1982,0,98007,47.6025,-122.153,2470,9454,630000,30,12,2014,0,32,6858,6984,0,0,0
3,2.25,1630,6449,1.0,0,0,3,7,1310,320,1986,0,98011,47.7275,-122.232,1620,7429,445000,1,4,2015,0,29,4819,5809,0,1,0
3,1.75,1490,5000,1.0,0,1,3,8,1250,240,1954,0,98136,47.5257,-122.392,1980,5000,565000,25,2,2015,0,61,3510,3020,0,1,1
3,2.5,1740,1844,2.0,0,0,3,8,1320,420,2008,0,98106,47.5248,-122.365,1740,1789,330000,19,8,2014,0,6,104,49,0,1,1
4,2.75,1900,6000,1.0,0,2,3,7,1300,600,1961,0,98178,47.495,-122.229,2230,6000,463000,18,12,2014,0,53,4100,3770,0,1,1
5,4.0,4510,15175,2.0,0,0,3,10,4510,0,1969,2002,98040,47.5309,-122.228,3510,13500,1870000,6,5,2014,33,45,10665,9990,1,0,0
3,1.0,1090,6710,1.5,0,0,5,5,1090,0,1912,0,98002,47.3066,-122.217,1170,6708,219500,26,6,2014,0,102,5620,5538,0,0,0
3,1.75,1720,7200,1.0,0,0,3,7,1420,300,1959,0,98125,47.7062,-122.304,1380,8000,622200,27,10,2014,0,55,5480,6620,0,1,1
2,3.25,1400,1243,3.0,0,0,3,8,1400,0,2000,0,98103,47.6534,-122.353,1400,1335,474800,28,5,2014,0,14,-157,-65,0,0,1
4,2.5,2090,9702,1.0,0,0,5,7,1320,770,1965,0,98133,47.7467,-122.339,1850,7200,465000,11,6,2014,0,49,7612,5350,0,1,1
3,1.75,1580,9049,1.0,0,0,3,8,1580,0,1966,0,98177,47.7776,-122.375,2100,8446,389950,14,10,2014,0,48,7469,6346,0,0,1
3,2.0,1500,2506,1.0,0,0,3,7,870,630,2003,0,98144,47.5962,-122.301,1500,4662,395000,5,9,2014,0,11,1006,3162,0,1,1
4,2.5,2030,5202,2.0,0,0,3,8,2030,0,2001,0,98031,47.388,-122.176,2260,5232,304500,19,12,2014,0,13,3172,2972,0,0,0
3,1.0,1020,8484,1.0,0,0,3,6,1020,0,1949,0,98155,47.7719,-122.31,1180,9660,307000,14,3,2015,0,66,7464,8480,0,0,1
3,2.5,1540,7120,1.0,0,0,3,7,770,770,1938,2013,98038,47.3729,-122.037,1000,6638,485000,7,1,2015,75,77,5580,5638,1,1,0
5,4.25,3920,11412,2.0,0,0,3,7,3920,0,1955,2005,98006,47.5766,-122.151,1400,9750,650500,22,1,2015,50,60,7492,8350,1,0,0
4,2.5,3180,10105,2.0,0,0,4,9,3180,0,1986,0,98040,47.5328,-122.226,2670,10355,960000,2,2,2015,0,29,6925,7685,0,0,0
3,2.5,2330,9160,2.0,0,0,3,9,2330,0,1997,0,98006,47.5467,-122.181,2460,9160,710000,13,2,2015,0,18,6830,6700,0,0,0
4,1.75,1950,4200,1.0,0,0,5,7,1040,910,1951,0,98115,47.6755,-122.285,1450,5000,601000,24,7,2014,0,63,2250,3550,0,1,1
5,1.75,3250,13702,1.0,0,2,3,8,1650,1600,1965,0,98055,47.4883,-122.225,2620,11328,463828,4,5,2015,0,50,10452,8708,0,1,0
4,1.0,1130,8308,1.5,0,0,4,6,1130,0,1944,0,98166,47.4669,-122.355,1130,8652,293000,11,2,2015,0,71,7178,7522,0,0,1
3,2.5,2620,4800,2.0,0,0,3,7,2620,0,2002,0,98053,47.6849,-122.037,2400,4756,597500,20,10,2014,0,12,2180,2356,0,0,0
4,1.75,2180,10200,1.0,0,2,3,8,2000,180,1966,0,98028,47.7638,-122.27,2590,10445,440000,26,1,2015,0,49,8020,7855,0,1,0
3,1.75,1960,8136,1.0,0,0,3,7,980,980,1948,0,98106,47.5208,-122.364,1070,7480,340000,15,5,2014,0,66,6176,6410,0,1,1
3,1.75,1960,8136,1.0,0,0,3,7,980,980,1948,0,98106,47.5208,-122.364,1070,7480,363000,17,3,2015,0,67,6176,6410,0,1,1
2,1.0,1150,3600,1.0,0,0,3,6,1150,0,1910,0,98144,47.5729,-122.31,1160,4000,270000,14,7,2014,0,104,2450,2840,0,0,1
4,2.5,2800,6820,2.0,0,0,4,7,2800,0,1997,0,98042,47.3695,-122.108,2060,6820,365000,27,8,2014,0,17,4020,4760,0,0,0
3,2.0,1310,2550,1.0,0,0,3,7,780,530,1986,0,98103,47.6911,-122.35,1460,5100,428000,9,6,2014,0,28,1240,3640,0,1,1
3,2.5,1430,10200,1.0,0,0,3,7,1430,0,1960,0,98033,47.7012,-122.166,1470,10350,405000,24,10,2014,0,54,8770,8880,0,0,0
4,2.5,2340,9748,1.0,0,1,3,8,1610,730,1981,0,98003,47.3363,-122.331,2070,8241,339900,11,7,2014,0,33,7408,6171,0,1,0
3,1.0,1290,11250,1.0,0,0,3,7,1290,0,1956,0,98166,47.4743,-122.341,1410,11196,275000,23,12,2014,0,58,9960,9786,0,0,1
2,1.0,760,6380,1.0,0,0,3,6,760,0,1941,0,98115,47.6914,-122.31,1590,6380,361600,17,7,2014,0,73,5620,4790,0,0,1
6,2.0,2780,13950,2.5,0,0,4,7,2780,0,1955,1964,98030,47.3738,-122.226,2120,13950,325000,20,3,2015,9,60,11170,11830,1,0,0
3,2.0,2090,4077,1.5,0,0,4,8,1530,560,1931,0,98112,47.6433,-122.3,2010,4132,1050000,19,12,2014,0,83,1987,2122,0,1,1
3,1.0,1110,7962,1.0,0,0,3,7,1110,0,1962,0,98146,47.5035,-122.36,1200,8094,210000,3,6,2014,0,52,6852,6894,0,0,1
3,2.0,1790,7879,1.5,0,0,3,7,1790,0,1998,0,98001,47.2634,-122.289,1790,7879,258000,1,12,2014,0,16,6089,6089,0,0,0
3,1.5,1830,9848,1.0,0,0,5,7,1830,0,1962,0,98056,47.539,-122.18,1830,8168,468000,8,7,2014,0,52,8018,6338,0,0,0
4,3.5,2850,2910,2.0,0,2,3,8,1970,880,1905,1996,98115,47.6855,-122.321,1460,3880,710000,4,5,2015,91,110,60,2420,1,1,1
3,1.0,1420,6000,1.0,0,0,3,6,1420,0,1941,0,98146,47.4913,-122.336,1480,6000,268000,21,4,2015,0,74,4580,4520,0,0,1
2,1.0,790,7252,1.0,0,0,3,5,790,0,1930,0,98146,47.5048,-122.365,1260,11470,115000,16,1,2015,0,85,6462,10210,0,0,1
3,2.5,2300,4307,2.0,0,0,3,8,2300,0,1998,0,98034,47.7326,-122.197,2010,4307,500000,13,5,2015,0,17,2007,2297,0,0,0
3,2.0,1310,7349,1.0,0,0,3,7,870,440,1995,0,98030,47.3639,-122.186,1690,6580,241500,23,2,2015,0,20,6039,4890,0,1,0
4,2.5,2790,10289,2.0,0,0,3,9,2790,0,1987,0,98006,47.5483,-122.158,2650,10126,982000,7,11,2014,0,27,7499,7476,0,0,0
3,2.5,1360,7293,2.0,0,0,3,8,1360,0,1988,0,98003,47.3304,-122.302,1540,7353,248500,6,1,2015,0,27,5933,5813,0,0,0
4,2.5,2510,5936,2.0,0,0,3,9,2510,0,1998,0,98075,47.5847,-122.032,2760,6060,665000,31,12,2014,0,16,3426,3300,0,0,0
3,3.0,4560,16339,2.0,0,2,3,10,4040,520,2001,0,98034,47.7024,-122.243,2620,11561,1220000,14,7,2014,0,13,11779,8941,0,1,0
2,1.0,780,3910,1.0,0,0,3,6,780,0,1918,0,98126,47.566,-122.38,1500,5060,380000,9,7,2014,0,96,3130,3560,0,0,1
3,2.0,1410,7998,1.0,0,0,4,7,1410,0,1940,0,98178,47.4968,-122.277,1780,8278,220000,16,6,2014,0,74,6588,6498,0,0,1
4,2.0,2530,5650,1.5,0,0,4,8,1910,620,1910,0,98116,47.5778,-122.382,1310,5750,631500,7,7,2014,0,104,3120,4440,0,1,1
3,2.0,1270,6760,1.0,0,0,5,7,1270,0,1972,0,98034,47.7381,-122.179,1550,5734,386100,19,12,2014,0,42,5490,4184,0,0,0
4,4.5,3180,4606,2.0,0,3,4,9,1990,1190,1929,0,98199,47.6402,-122.405,2110,5323,1050000,13,8,2014,0,85,1426,3213,0,1,1
2,1.75,1450,4000,1.5,0,0,4,7,1350,100,1903,0,98105,47.6571,-122.326,1310,4000,650000,22,1,2015,0,112,2550,2690,0,1,1
4,2.5,2650,12001,2.0,0,0,4,9,2650,0,1984,0,98006,47.5496,-122.14,2880,14054,870000,10,10,2014,0,30,9351,11174,0,0,0
3,1.75,1240,8611,1.0,0,0,4,7,1240,0,1973,0,98133,47.7175,-122.331,1700,8037,380000,17,8,2014,0,41,7371,6337,0,0,1
2,1.0,820,8423,1.0,0,2,3,6,820,0,1957,0,98055,47.4741,-122.2,1960,9140,265000,9,2,2015,0,58,7603,7180,0,0,0
2,1.0,1890,5202,1.5,0,0,4,7,1890,0,1909,0,98117,47.6786,-122.379,1670,5100,645500,30,5,2014,0,105,3312,3430,0,0,1
3,2.0,1270,3090,2.0,0,0,5,7,1270,0,1911,0,98117,47.685,-122.359,1440,3090,570000,13,9,2014,0,103,1820,1650,0,0,1
4,2.5,3350,11688,1.0,0,2,3,10,1760,1590,1995,0,98006,47.5507,-122.133,4240,10804,1200000,17,2,2015,0,20,8338,6564,0,1,0
2,1.0,1550,3200,1.5,0,0,3,8,1550,0,1927,0,98112,47.6368,-122.306,1800,3937,605000,27,10,2014,0,87,1650,2137,0,0,1
3,1.0,920,9812,1.0,0,0,4,7,920,0,1962,0,98001,47.2958,-122.284,1188,9812,199500,10,6,2014,0,52,8892,8624,0,0,0
2,1.0,950,4800,1.0,0,0,3,6,950,0,1941,0,98144,47.5864,-122.301,1420,5400,445000,15,3,2015,0,74,3850,3980,0,0,1
4,1.75,2040,3570,1.0,0,0,4,7,1020,1020,1917,0,98144,47.5754,-122.288,1790,4206,495000,16,10,2014,0,97,1530,2416,0,1,1
4,1.75,1870,5200,2.0,0,0,4,7,1200,670,1937,0,98115,47.6843,-122.283,1790,5000,594000,12,6,2014,0,77,3330,3210,0,1,1
3,1.75,1720,5280,1.0,0,0,4,8,900,820,1943,0,98199,47.6493,-122.401,1600,6000,465000,19,8,2014,0,71,3560,4400,0,1,1
2,1.0,1020,13647,1.0,0,0,5,6,1020,0,1915,1974,98022,47.2848,-121.927,980,8250,160000,22,4,2015,59,100,12627,7270,1,0,0
4,2.5,2690,6099,2.0,0,0,3,9,2690,0,1998,0,98092,47.3314,-122.171,2520,6168,340000,4,12,2014,0,16,3409,3648,0,0,0
3,1.5,1070,5150,1.0,0,0,4,6,1070,0,1940,0,98106,47.5335,-122.349,1020,4800,249000,18,8,2014,0,74,4080,3780,0,0,1
4,2.25,2050,7201,2.0,0,0,3,8,2050,0,1994,0,98033,47.7003,-122.165,1970,7350,500000,6,5,2015,0,21,5151,5380,0,0,0
3,1.5,1660,15600,2.0,0,0,3,7,1660,0,1981,0,98001,47.2589,-122.279,1660,14400,220000,26,6,2014,0,33,13940,12740,0,0,0
5,1.75,2810,9360,1.0,0,0,4,7,1520,1290,1965,0,98055,47.4361,-122.193,1770,9360,368500,12,8,2014,0,49,6550,7590,0,1,0
4,2.25,2460,14600,1.0,0,0,4,8,1720,740,1977,0,98042,47.3762,-122.16,2460,14600,439950,29,9,2014,0,37,12140,12140,0,1,0
3,1.75,1230,12000,1.0,0,0,3,6,1230,0,1970,0,98001,47.2878,-122.251,1550,12000,179900,24,9,2014,0,44,10770,10450,0,0,0
4,2.5,2360,4367,2.0,0,0,3,8,2360,0,2003,0,98011,47.7731,-122.167,2360,4868,490000,28,5,2014,0,11,2007,2508,0,0,0
4,1.75,1730,11890,1.0,0,0,2,7,980,750,1955,0,98004,47.5979,-122.194,2100,12325,425000,29,9,2014,0,59,10160,10225,0,1,0
4,2.0,1770,3332,2.0,0,0,3,7,1630,140,1924,1975,98118,47.5563,-122.281,1640,4000,447500,16,1,2015,51,91,1562,2360,1,1,1
5,2.75,3030,13640,2.0,0,0,4,8,3030,0,1980,0,98007,47.6186,-122.146,2500,13225,768000,23,7,2014,0,34,10610,10725,0,0,0
3,1.75,2380,6000,1.5,0,0,3,7,1320,1060,1935,0,98178,47.498,-122.222,1290,6000,285000,21,5,2014,0,79,3620,4710,0,1,1
4,1.5,1540,7886,2.0,0,0,3,7,1540,0,1967,0,98034,47.734,-122.193,1550,7396,415000,14,7,2014,0,47,6346,5846,0,0,0
3,2.25,1580,4379,2.0,0,0,4,8,1580,0,1994,0,98029,47.5694,-122.005,1770,4187,500000,23,7,2014,0,20,2799,2417,0,0,0
4,2.5,3200,5772,2.0,0,0,3,8,3200,0,2003,0,98042,47.3486,-122.153,3010,5772,337000,3,11,2014,0,11,2572,2762,0,0,0
4,2.5,2220,6800,2.0,0,0,3,7,2220,0,2002,0,98059,47.49,-122.15,2220,5303,419950,19,9,2014,0,12,4580,3083,0,0,0
4,2.75,2240,8162,2.0,0,0,5,7,1380,860,1946,0,98133,47.7427,-122.34,1550,8163,290000,7,1,2015,0,69,5922,6613,0,1,1
2,1.75,1640,4176,1.0,0,0,4,7,1040,600,1948,0,98118,47.5162,-122.26,1460,5200,349950,18,7,2014,0,66,2536,3740,0,1,1
3,1.5,1170,4950,1.0,0,0,4,7,1170,0,1960,0,98007,47.6057,-122.135,1570,7700,330000,16,5,2014,0,54,3780,6130,0,0,0
3,2.5,2100,7851,2.0,0,0,3,8,2100,0,1986,0,98052,47.7242,-122.105,2100,8187,515000,31,10,2014,0,28,5751,6087,0,0,0
4,2.5,2600,17388,2.0,0,0,3,9,2600,0,1996,0,98059,47.5283,-122.146,2950,11553,665000,22,5,2014,0,18,14788,8603,0,0,0
3,1.75,1630,5999,1.5,0,0,4,7,1630,0,1985,0,98198,47.3816,-122.313,1540,7500,265000,26,8,2014,0,29,4369,5960,0,0,1
4,3.0,2560,5606,2.0,0,0,3,9,2560,0,2004,0,98092,47.3274,-122.178,2667,7334,350000,24,6,2014,0,10,3046,4667,0,0,0
2,1.5,980,1296,2.0,0,0,3,7,840,140,2001,0,98133,47.7075,-122.336,1100,1228,260000,13,11,2014,0,13,316,128,0,1,1
3,2.0,2160,8091,1.5,0,0,3,8,2160,0,2000,0,98003,47.3474,-122.303,2190,8297,355000,26,9,2014,0,14,5931,6107,0,0,0
3,3.0,3030,5156,1.5,0,0,4,9,2080,950,1929,0,98119,47.647,-122.369,1910,5720,879000,28,10,2014,0,85,2126,3810,0,1,1
4,3.5,3560,7178,2.0,0,3,3,10,2590,970,2006,0,98052,47.7054,-122.107,3290,6978,833000,18,8,2014,0,8,3618,3688,0,1,0
2,1.0,760,6407,1.0,0,0,3,6,760,0,1943,0,98178,47.4977,-122.259,1050,8580,261590,7,1,2015,0,72,5647,7530,0,0,1
3,3.0,2260,2400,2.0,0,0,3,7,2260,0,1909,1972,98122,47.6094,-122.31,1320,2790,512500,5,11,2014,63,105,140,1470,1,0,1
2,1.75,1560,3200,1.0,0,0,5,7,880,680,1946,0,98199,47.6419,-122.394,2060,4940,600000,27,4,2015,0,69,1640,2880,0,1,1
5,3.0,2270,6664,1.0,0,0,3,7,1340,930,1995,0,98125,47.7191,-122.315,1870,6187,417500,6,10,2014,0,19,4394,4317,0,1,1
5,3.0,3480,15185,2.0,0,0,4,8,3480,0,1964,0,98040,47.5757,-122.216,3030,14257,970000,27,5,2014,0,50,11705,11227,0,0,0
3,2.25,1900,7479,2.0,0,0,4,7,1900,0,1992,0,98038,47.3495,-122.037,1520,6559,316000,12,8,2014,0,22,5579,5039,0,0,0
4,3.0,2350,9952,1.0,0,0,3,9,1650,700,1989,0,98031,47.4194,-122.211,2440,9100,397500,6,3,2015,0,26,7602,6660,0,1,0
3,2.5,2390,5500,1.0,0,3,3,9,1700,690,1952,0,98199,47.6389,-122.409,2700,5500,1350000,21,7,2014,0,62,3110,2800,0,1,1
4,2.5,3730,9847,2.0,0,0,3,10,3730,0,1997,0,98075,47.587,-121.976,3490,10219,840000,21,8,2014,0,17,6117,6729,0,0,0
4,2.5,1630,4473,2.0,0,0,3,7,1630,0,2003,0,98038,47.3546,-122.015,1830,5082,312900,27,5,2014,0,11,2843,3252,0,0,0
2,1.0,1130,6908,1.5,0,0,3,6,1130,0,1945,0,98155,47.745,-122.313,1150,6908,325000,26,3,2015,0,70,5778,5758,0,0,1
3,1.75,2140,3584,1.0,0,0,3,7,1070,1070,1952,0,98199,47.636,-122.391,1620,4000,680000,19,7,2014,0,62,1444,2380,0,1,1
4,2.5,3220,7873,2.0,0,0,3,10,3220,0,1994,0,98075,47.5849,-122.03,2610,8023,763000,4,3,2015,0,21,4653,5413,0,0,0
3,2.5,1800,3300,2.0,0,0,3,7,1690,110,2004,0,98118,47.5491,-122.276,1570,4097,475000,8,4,2015,0,11,1500,2527,0,1,1
2,2.5,809,940,2.0,0,0,3,7,809,0,2003,0,98136,47.5499,-122.384,1260,4240,219000,21,11,2014,0,11,131,2980,0,0,1
3,2.25,1820,9694,1.0,0,0,3,7,1240,580,1977,0,98074,47.6157,-122.05,1820,9694,415000,23,3,2015,0,38,7874,7874,0,1,0
2,1.0,580,7500,1.0,0,0,3,5,580,0,1943,0,98178,47.4852,-122.251,1700,11250,90000,23,5,2014,0,71,6920,9550,0,0,1
2,1.0,580,7500,1.0,0,0,3,5,580,0,1943,0,98178,47.4852,-122.251,1700,11250,220000,31,3,2015,0,72,6920,9550,0,0,1
3,2.0,2900,5650,1.0,0,2,3,8,1520,1380,1959,0,98116,47.5789,-122.396,1810,6250,616000,26,2,2015,0,56,2750,4440,0,1,1
2,1.0,1060,5754,1.0,0,0,4,6,1060,0,1917,0,98117,47.6931,-122.372,1460,7200,395350,24,4,2015,0,98,4694,5740,0,0,1
4,3.0,2320,7200,1.0,0,0,3,7,1260,1060,1943,2000,98040,47.5893,-122.232,1760,7200,770000,19,3,2015,57,72,4880,5440,1,1,0
2,1.0,1760,4441,1.0,0,0,3,8,1310,450,1950,0,98126,47.5311,-122.381,1350,5748,428950,6,11,2014,0,64,2681,4398,0,1,1
4,3.75,3370,6766,2.0,0,0,3,9,3370,0,2005,0,98052,47.7063,-122.106,3530,6766,800000,17,12,2014,0,9,3396,3236,0,0,0
4,1.0,1940,5753,1.5,0,0,3,7,1940,0,1947,0,98177,47.7188,-122.358,2170,6075,401000,19,6,2014,0,67,3813,3905,0,0,1
4,2.0,2520,7334,1.0,0,0,3,7,1600,920,1955,0,98125,47.7263,-122.291,2040,7937,303697,26,2,2015,0,60,4814,5897,0,1,1
3,1.0,1360,8968,1.0,0,0,3,7,1360,0,1956,0,98125,47.7105,-122.289,1490,7355,355000,15,9,2014,0,58,7608,5865,0,0,1
2,1.0,800,5040,1.0,0,0,3,6,800,0,1960,0,98117,47.6953,-122.362,1020,5040,350000,20,8,2014,0,54,4240,4020,0,0,1
4,2.5,3010,9323,2.0,0,0,3,10,3010,0,1992,0,98075,47.578,-122.053,2840,8413,754999,14,4,2015,0,23,6313,5573,0,0,0
3,1.75,2340,5500,2.0,0,2,3,9,2340,0,1988,0,98102,47.6451,-122.319,2830,5500,982218,31,3,2015,0,27,3160,2670,0,0,1
3,2.0,1780,8621,1.0,0,0,3,8,1780,0,1992,0,98059,47.5062,-122.149,2470,8542,406500,27,9,2014,0,22,6841,6072,0,0,0
2,1.75,1720,3000,1.0,0,0,5,7,860,860,1925,0,98103,47.686,-122.351,1360,4500,565000,17,2,2015,0,90,1280,3140,0,1,1
2,1.0,830,4500,1.0,0,0,3,6,830,0,1920,0,98118,47.5248,-122.265,1092,5350,160000,6,11,2014,0,94,3670,4258,0,0,1
3,1.0,1090,6320,1.0,0,0,3,6,890,200,1954,0,98146,47.4976,-122.35,1460,7080,220000,15,1,2015,0,61,5230,5620,0,1,1
5,4.25,5040,9466,2.0,0,0,3,11,5040,0,2004,0,98059,47.5282,-122.133,4300,9417,1280000,13,2,2015,0,11,4426,5117,0,0,0
5,2.75,3500,5040,2.0,0,2,3,9,2950,550,1927,2007,98126,47.5527,-122.379,1450,5040,970000,8,7,2014,80,87,1540,3590,1,1,1
3,1.0,1080,6250,1.0,0,0,2,5,1080,0,1950,0,98168,47.5045,-122.33,1070,6250,115000,24,9,2014,0,64,5170,5180,0,0,1
3,1.0,1080,6250,1.0,0,0,2,5,1080,0,1950,0,98168,47.5045,-122.33,1070,6250,124000,15,12,2014,0,64,5170,5180,0,0,1
3,1.0,1080,6250,1.0,0,0,2,5,1080,0,1950,0,98168,47.5045,-122.33,1070,6250,157000,11,3,2015,0,65,5170,5180,0,0,1
3,1.0,870,5200,1.0,0,0,5,6,870,0,1969,0,98042,47.3702,-122.078,870,5200,183000,25,7,2014,0,45,4330,4330,0,0,0
4,2.5,2830,6163,2.0,0,0,3,9,2830,0,2000,0,98056,47.5227,-122.19,2730,6202,527000,9,9,2014,0,14,3333,3472,0,0,0
4,2.0,1880,14653,2.0,0,0,3,8,1880,0,1978,0,98014,47.6959,-121.921,1750,14858,407193,6,6,2014,0,36,12773,13108,0,0,0
4,2.75,3600,5040,2.0,0,0,3,9,2610,990,2004,0,98199,47.6487,-122.388,1590,5040,970000,13,3,2015,0,11,1440,3450,0,1,1
4,2.5,2340,5600,2.0,0,0,3,7,2340,0,1921,2013,98146,47.5117,-122.379,1310,5600,535000,27,5,2014,92,93,3260,4290,1,0,1
3,2.0,2040,13125,1.0,0,0,3,6,810,1230,1910,0,98168,47.478,-122.278,1460,10582,245000,14,8,2014,0,104,11085,9122,0,1,1
3,1.75,1310,12750,1.0,0,0,3,7,1310,0,1993,0,98059,47.4695,-122.07,1790,13500,337000,23,6,2014,0,21,11440,11710,0,0,0
3,2.0,1470,6000,1.0,0,0,3,8,1090,380,1950,1996,98033,47.6829,-122.202,1880,7799,630000,21,3,2015,46,65,4530,5919,1,1,0
3,1.75,1370,9900,1.0,0,0,4,7,1370,0,1983,0,98003,47.2575,-122.312,1490,9600,320000,6,6,2014,0,31,8530,8110,0,0,0
3,1.0,1080,7486,1.5,0,0,3,6,990,90,1942,0,98146,47.4838,-122.335,1170,7800,228500,26,2,2015,0,73,6406,6630,0,1,1
3,2.5,1990,7577,2.0,0,0,3,7,1990,0,1990,0,98023,47.2908,-122.351,1900,7152,293000,23,2,2015,0,25,5587,5252,0,0,0
3,1.0,1310,7000,1.0,0,0,4,7,1310,0,1958,0,98008,47.6019,-122.123,1280,7300,447000,24,9,2014,0,56,5690,6020,0,0,0
3,1.75,1640,10762,1.0,0,0,3,7,1130,510,1988,0,98042,47.3586,-122.074,1680,10259,226500,7,5,2014,0,26,9122,8579,0,1,0
3,2.25,1770,8000,1.0,0,0,4,7,1350,420,1976,0,98072,47.7358,-122.17,1850,7875,436000,9,12,2014,0,38,6230,6025,0,1,0
3,2.5,2050,4876,2.0,0,0,3,8,2050,0,2005,0,98072,47.7746,-122.158,2320,4065,451000,4,8,2014,0,9,2826,1745,0,0,0
2,1.0,1340,7250,1.0,0,0,4,7,1340,0,1951,0,98125,47.7015,-122.32,1450,7026,450000,28,10,2014,0,63,5910,5576,0,0,1
3,1.5,2240,5300,1.0,0,0,5,7,1120,1120,1955,0,98117,47.6927,-122.395,1740,7110,635000,1,12,2014,0,59,3060,5370,0,1,1
2,1.0,880,17743,1.0,0,0,4,5,880,0,1951,0,98031,47.4115,-122.197,1217,13000,292500,25,3,2015,0,64,16863,11783,0,0,0
3,2.5,2170,4905,2.0,0,0,3,8,2170,0,2004,0,98038,47.3503,-122.039,2300,4935,329900,20,5,2014,0,10,2735,2635,0,0,0
2,1.5,1260,6660,1.5,0,0,4,7,1260,0,1926,0,98115,47.6792,-122.287,2140,4770,531000,18,11,2014,0,88,5400,2630,0,0,1
3,1.75,1880,13300,1.0,0,0,3,7,1380,500,1967,0,98004,47.634,-122.204,3550,10883,725000,31,7,2014,0,47,11420,7333,0,1,0
3,2.5,1620,7410,1.0,0,0,5,7,1620,0,1955,0,98133,47.7708,-122.335,1450,8121,355300,25,5,2014,0,59,5790,6671,0,0,1
3,2.5,1610,10022,2.0,0,0,3,7,1610,0,1996,0,98003,47.2583,-122.3,1820,10017,280000,27,4,2015,0,19,8412,8197,0,0,0
4,2.75,3330,9143,2.0,0,0,4,10,3330,0,1995,0,98033,47.6821,-122.19,2390,9143,1100000,30,6,2014,0,19,5813,6753,0,0,0
4,2.0,1370,4000,2.0,0,0,3,9,1370,0,1951,1994,98199,47.6593,-122.394,2010,5720,605004,5,6,2014,43,63,2630,3710,1,0,1
2,1.0,690,6000,1.0,0,0,3,6,690,0,1949,0,98118,47.5621,-122.283,840,3030,260000,9,3,2015,0,66,5310,2190,0,0,1
4,2.5,3170,4979,2.0,0,0,4,7,2570,600,1925,0,98103,47.6655,-122.34,2060,5000,748000,23,7,2014,0,89,1809,2940,0,1,1
2,2.0,1990,6180,1.0,0,0,4,7,1010,980,1941,0,98115,47.6792,-122.303,1470,5150,776000,16,4,2015,0,74,4190,3680,0,1,1
4,1.0,1080,6095,1.5,0,0,4,6,1080,0,1924,0,98103,47.6962,-122.346,1200,5060,425000,16,9,2014,0,90,5015,3860,0,0,1
4,1.0,1870,14703,1.5,0,0,3,6,1090,780,1928,0,98118,47.5274,-122.281,1650,6045,230000,8,1,2015,0,87,12833,4395,0,1,1
3,1.75,1670,12075,1.0,0,0,3,7,1370,300,1958,0,98155,47.7681,-122.307,1800,12123,418000,30,1,2015,0,57,10405,10323,0,1,1
5,2.75,3460,7977,2.0,0,0,3,9,3460,0,2011,0,98074,47.5908,-122.062,3390,6630,858450,24,11,2014,0,3,4517,3240,0,0,0
3,2.0,1930,12443,1.0,0,0,3,7,1930,0,1969,0,98045,47.4906,-121.775,1400,12183,390000,7,10,2014,0,45,10513,10783,0,0,0
4,3.0,2370,3836,2.0,0,0,3,9,1750,620,1969,2008,98107,47.6718,-122.394,1690,4698,957000,16,9,2014,39,45,1466,3008,1,1,1
3,1.0,1180,6000,1.0,0,0,3,7,1180,0,1950,0,98115,47.6853,-122.286,1680,6000,507000,4,9,2014,0,64,4820,4320,0,0,1
2,1.0,1320,4750,1.5,0,0,4,7,1320,0,1928,0,98107,47.6729,-122.38,1360,2873,575000,25,2,2015,0,87,3430,1513,0,0,1
3,1.75,1350,4000,1.5,0,0,4,7,1350,0,1925,0,98103,47.6581,-122.354,1880,4000,700000,27,4,2015,0,90,2650,2120,0,0,1
2,1.5,1068,1452,2.0,0,0,3,7,1068,0,1990,0,98028,47.753,-122.244,1078,1357,239950,5,2,2015,0,25,384,279,0,0,0
3,1.0,1580,8240,1.0,0,0,4,7,1040,540,1978,0,98030,47.3542,-122.181,1480,9200,253000,3,11,2014,0,36,6660,7720,0,1,0
4,1.0,1690,3417,1.5,0,0,3,7,1690,0,1907,0,98199,47.663,-122.402,1970,4800,540000,27,3,2015,0,108,1727,2830,0,0,1
3,4.0,5120,4600,3.0,0,2,3,11,4490,630,2008,0,98034,47.7052,-122.223,2510,5918,1550000,6,2,2015,0,7,-520,3408,0,1,0
4,3.25,2420,4000,1.5,0,0,5,9,1870,550,1911,0,98105,47.6567,-122.325,1810,4000,920000,12,6,2014,0,103,1580,2190,0,1,1
3,2.5,1910,5562,2.0,0,0,3,8,1910,0,1988,0,98029,47.5738,-122.017,1940,4647,496600,5,11,2014,0,26,3652,2707,0,0,0
3,2.25,1440,10500,1.0,0,0,3,8,1130,310,1983,0,98023,47.318,-122.391,1510,8125,246000,16,10,2014,0,31,9060,6615,0,1,0
5,3.0,2320,8400,1.0,0,0,3,7,1510,810,1963,0,98106,47.557,-122.365,1200,4800,350000,5,5,2015,0,52,6080,3600,0,1,1
3,2.0,1670,4572,1.5,0,0,3,8,1670,0,1931,0,98117,47.6854,-122.373,1480,4890,585000,23,5,2014,0,83,2902,3410,0,0,1
3,1.75,1390,11700,1.0,0,0,4,7,1390,0,1966,0,98033,47.7002,-122.192,1060,8686,450000,23,3,2015,0,49,10310,7626,0,0,0
3,2.5,2620,8950,2.0,0,0,3,9,2620,0,1992,0,98006,47.5523,-122.119,2850,8809,746000,12,5,2014,0,22,6330,5959,0,0,0
3,2.5,3040,7880,2.0,0,0,3,9,3040,0,2004,0,98056,47.5277,-122.184,3040,7880,598555,27,10,2014,0,10,4840,4840,0,0,0
3,2.5,2990,10711,1.0,1,4,3,9,1560,1430,1976,1991,98198,47.3573,-122.324,2870,11476,820000,30,10,2014,15,38,7721,8606,1,1,1
3,2.25,1740,5460,1.0,0,0,3,7,1210,530,1998,0,98038,47.3648,-122.046,1740,7500,266500,21,10,2014,0,16,3720,5760,0,1,0
3,2.75,2240,3600,2.5,0,0,3,7,1650,590,1901,0,98102,47.6244,-122.326,1716,3120,625000,4,9,2014,0,113,1360,1404,0,1,1
4,2.0,1610,6200,1.0,0,0,4,7,1610,0,1979,0,98198,47.3833,-122.306,1610,7500,243500,10,12,2014,0,35,4590,5890,0,0,1
2,1.0,700,5829,1.0,0,0,3,6,700,0,1945,0,98103,47.6958,-122.357,1160,6700,340000,17,3,2015,0,70,5129,5540,0,0,1
5,3.0,2730,9519,1.0,0,0,3,8,1670,1060,2014,0,98155,47.7504,-122.307,1150,9519,559950,18,9,2014,0,0,6789,8369,0,1,1
3,2.75,1780,15114,1.0,0,0,3,7,1080,700,1980,0,98003,47.258,-122.305,1792,10155,315000,19,2,2015,0,35,13334,8363,0,1,0
3,3.0,2060,3200,2.0,0,0,3,8,2060,0,1907,1984,98102,47.637,-122.324,1760,2669,800000,28,1,2015,77,108,1140,909,1,0,1
3,2.25,1360,5111,1.5,0,0,5,7,1360,0,1934,0,98115,47.6988,-122.313,1900,5111,550000,11,9,2014,0,80,3751,3211,0,0,1
3,2.0,1430,14250,1.0,0,0,3,7,1430,0,1953,0,98033,47.701,-122.199,1530,11475,465000,6,11,2014,0,61,12820,9945,0,0,0
3,2.25,1840,5752,2.0,0,0,3,7,1840,0,2003,0,98034,47.7042,-122.187,1670,2462,465000,28,5,2014,0,11,3912,792,0,0,0
4,2.25,2000,8068,2.0,0,0,5,8,2000,0,1976,0,98006,47.5584,-122.137,2080,7837,710000,10,4,2015,0,39,6068,5757,0,0,0
3,2.5,1820,11012,2.0,0,0,3,8,1820,0,1988,0,98074,47.6358,-122.026,1860,7767,505000,16,12,2014,0,26,9192,5907,0,0,0
2,2.0,1070,8400,1.0,0,0,4,7,1070,0,1980,0,98031,47.4014,-122.186,1430,8190,217500,21,11,2014,0,34,7330,6760,0,0,0
2,1.0,930,3750,1.0,0,0,4,7,930,0,1909,0,98115,47.6733,-122.296,1740,4300,500000,2,9,2014,0,105,2820,2560,0,0,1
2,2.0,1040,5796,1.0,0,2,4,6,1040,0,1921,0,98155,47.7362,-122.29,2300,5796,325000,18,2,2015,0,94,4756,3496,0,0,1
4,2.25,1960,12436,2.0,0,0,3,8,1960,0,1984,0,98074,47.6276,-122.037,1960,12436,500000,25,8,2014,0,30,10476,10476,0,0,0
3,1.5,2200,5000,1.5,0,0,3,9,2200,0,1932,0,98199,47.6404,-122.408,2860,5000,924000,19,5,2014,0,82,2800,2140,0,0,1
2,1.5,830,1034,2.0,0,0,3,8,830,0,2009,0,98144,47.5926,-122.3,1130,2534,345000,15,4,2015,0,6,204,1404,0,0,1
4,3.5,3920,11086,2.0,0,0,3,10,3920,0,1999,0,98065,47.5416,-121.869,3740,10880,825000,16,3,2015,0,16,7166,7140,0,0,0
3,2.0,2560,14680,1.0,0,0,3,8,1330,1230,1987,0,98052,47.648,-122.118,2390,13848,599000,8,7,2014,0,27,12120,11458,0,1,0
3,1.5,1350,7620,1.0,0,0,5,6,1350,0,1941,0,98166,47.4565,-122.35,1350,7620,211000,12,5,2014,0,73,6270,6270,0,0,1
4,2.75,3210,8520,1.0,0,2,4,7,1810,1400,1976,0,98177,47.7743,-122.388,2450,7360,750000,7,1,2015,0,39,5310,4910,0,1,1
3,2.5,1690,3322,2.0,0,0,3,7,1690,0,2003,0,98053,47.6824,-122.036,1650,3446,479000,16,1,2015,0,12,1632,1796,0,0,0
4,2.5,2550,10623,2.0,0,0,3,9,2550,0,1992,0,98029,47.5695,-121.992,2750,8100,612500,27,2,2015,0,23,8073,5350,0,0,0
4,2.5,3560,8960,2.0,0,0,3,10,3560,0,2001,0,98033,47.6903,-122.213,1660,7680,1360000,23,2,2015,0,14,5400,6020,0,0,0
4,2.5,3060,5000,2.0,0,0,3,9,3060,0,2006,0,98059,47.5395,-122.188,2870,5548,710000,15,12,2014,0,8,1940,2678,0,0,0
3,2.5,1690,8564,2.0,0,0,4,7,1690,0,1992,0,98038,47.3518,-122.057,1690,7532,295000,5,5,2015,0,23,6874,5842,0,0,0
3,2.25,1520,7199,2.0,0,0,4,7,1520,0,1992,0,98038,47.3492,-122.034,1410,6751,275250,2,7,2014,0,22,5679,5341,0,0,0
4,2.5,2040,5770,2.0,0,0,3,7,2040,0,1994,0,98038,47.3522,-122.059,1570,6753,250000,12,9,2014,0,20,3730,5183,0,0,0
4,1.75,1360,4840,1.5,0,0,4,7,1360,0,1928,0,98126,47.556,-122.376,1320,4840,399500,8,7,2014,0,86,3480,3520,0,0,1
3,2.5,2000,9202,2.0,0,0,4,7,2000,0,1992,0,98038,47.3516,-122.057,1750,7827,225000,9,5,2014,0,22,7202,6077,0,0,0
3,2.5,1650,4648,2.0,0,0,3,8,1650,0,2001,0,98075,47.5968,-122.015,1800,5637,500000,12,1,2015,0,14,2998,3837,0,0,0
3,3.0,2500,8304,2.0,0,0,3,8,2500,0,1997,0,98031,47.4022,-122.166,2290,7855,364900,9,6,2014,0,17,5804,5565,0,0,0
3,1.5,1140,7500,1.0,0,0,3,7,1140,0,1976,0,98074,47.619,-122.064,1380,7500,356000,13,11,2014,0,38,6360,6120,0,0,0
3,2.75,2870,6600,2.0,0,2,3,8,2870,0,1984,0,98008,47.5745,-122.113,2570,7925,755000,2,12,2014,0,30,3730,5355,0,0,0
2,1.0,830,8183,1.0,0,0,5,6,830,0,1950,0,98155,47.7366,-122.302,1180,8184,327500,12,8,2014,0,64,7353,7004,0,0,1
3,2.25,1960,10139,2.0,0,0,3,8,1960,0,1984,0,98074,47.6481,-122.061,2080,9753,605000,15,4,2015,0,31,8179,7673,0,0,0
4,1.5,1130,5200,1.0,0,0,3,6,1130,0,1968,0,98042,47.3616,-122.089,1140,5200,179950,13,4,2015,0,47,4070,4060,0,0,0
3,2.75,2770,5800,1.0,0,0,4,8,1650,1120,1959,0,98199,47.6496,-122.413,2340,5800,1080000,7,4,2015,0,56,3030,3460,0,1,1
3,2.5,2650,12247,2.0,0,0,3,9,2650,0,2002,0,98001,47.3185,-122.259,2920,8965,425000,30,4,2015,0,13,9597,6045,0,0,0
3,2.75,2500,6350,2.0,0,0,5,9,2370,130,1979,0,98122,47.6035,-122.285,2090,5454,990000,17,9,2014,0,35,3850,3364,0,1,1
3,2.25,2490,8800,2.0,0,0,4,8,2490,0,1975,0,98006,47.5666,-122.132,2690,10000,590000,11,11,2014,0,39,6310,7310,0,0,0
3,1.75,1500,7560,1.0,0,0,3,7,1500,0,1979,0,98003,47.3467,-122.296,1500,7560,242000,8,4,2015,0,36,6060,6060,0,0,0
4,1.5,1880,6200,1.0,0,2,5,8,1440,440,1954,0,98146,47.5035,-122.384,2070,6500,680000,25,6,2014,0,60,4320,4430,0,1,1
3,2.5,1340,4200,2.0,0,0,3,7,1340,0,2002,0,98002,47.2942,-122.226,990,4520,217000,27,3,2015,0,13,2860,3530,0,0,0
3,2.5,1960,3953,2.0,0,0,3,8,1960,0,1999,0,98059,47.4904,-122.158,1690,3593,395000,21,4,2015,0,16,1993,1903,0,0,0
3,2.25,2030,9791,1.0,0,0,4,8,1500,530,1984,0,98059,47.534,-122.161,2030,11031,572500,19,5,2014,0,30,7761,9001,0,1,0
5,3.0,2200,6380,1.0,0,0,3,7,1440,760,1987,0,98125,47.7033,-122.322,1960,5800,559900,9,9,2014,0,27,4180,3840,0,1,1
3,2.0,2540,4750,1.5,0,0,5,9,1840,700,1930,0,98117,47.6838,-122.4,2190,4750,845000,24,6,2014,0,84,2210,2560,0,1,1
3,2.0,1520,7131,1.0,0,0,3,8,1520,0,1993,0,98023,47.3061,-122.361,1890,7379,241000,28,7,2014,0,21,5611,5489,0,0,0
3,2.25,2360,5504,2.0,0,0,4,8,2080,280,1913,0,98122,47.617,-122.288,2840,5470,1330000,1,10,2014,0,101,3144,2630,0,1,1
3,1.75,1340,2805,1.5,0,0,3,7,1340,0,1919,0,98144,47.5922,-122.297,1650,2805,475000,29,4,2015,0,96,1465,1155,0,0,1
2,1.5,1400,5810,2.0,0,0,3,7,1400,0,1940,0,98103,47.6843,-122.341,1470,3920,575000,18,2,2015,0,75,4410,2450,0,0,1
4,1.5,1580,10260,1.0,0,0,4,7,1030,550,1955,0,98007,47.5984,-122.147,1520,7000,475000,30,4,2015,0,60,8680,5480,0,1,0
2,1.0,2120,6897,1.0,0,0,4,7,1060,1060,1923,0,98118,47.5566,-122.278,1900,4462,600000,8,12,2014,0,91,4777,2562,0,1,1
2,1.0,1640,5200,1.0,0,0,4,7,1040,600,1937,0,98199,47.6426,-122.403,1780,5040,515000,6,11,2014,0,77,3560,3260,0,1,1
3,2.25,1890,8400,1.0,0,0,3,8,1520,370,1977,0,98034,47.7103,-122.232,1830,7980,425000,18,3,2015,0,38,6510,6150,0,1,0
4,2.0,1710,3875,1.5,0,0,4,7,1710,0,1907,0,98122,47.6086,-122.294,1710,3812,565000,7,10,2014,0,107,2165,2102,0,0,1
2,2.0,1140,8282,1.0,0,0,3,6,1140,0,1924,2009,98033,47.6949,-122.21,1650,9000,498000,23,5,2014,85,90,7142,7350,1,0,0
4,3.0,2720,3800,2.0,0,0,5,8,1800,920,1919,0,98115,47.6756,-122.306,1940,4001,739000,6,6,2014,0,95,1080,2061,0,1,1
2,1.75,1650,4000,1.0,0,0,4,7,950,700,1947,0,98108,47.5622,-122.319,1060,4110,355000,4,6,2014,0,67,2350,3050,0,1,1
3,1.75,1790,7485,1.0,0,0,4,8,1330,460,1979,0,98023,47.3118,-122.34,1970,8097,263000,15,7,2014,0,35,5695,6127,0,1,0
4,1.75,1680,6834,1.5,0,0,3,7,1680,0,1948,0,98125,47.716,-122.307,950,7425,375000,5,9,2014,0,66,5154,6475,0,0,1
3,1.75,2200,12231,1.0,0,0,4,7,1250,950,1964,0,98056,47.5076,-122.173,2200,9825,322000,30,9,2014,0,50,10031,7625,0,1,0
2,1.0,830,5100,1.0,0,0,3,6,830,0,1941,0,98103,47.6932,-122.346,1050,5100,325000,29,4,2015,0,74,4270,4050,0,0,1
2,1.0,770,4800,1.0,0,0,3,7,770,0,1943,0,98136,47.527,-122.383,1390,4800,290000,21,10,2014,0,71,4030,3410,0,0,1
4,2.5,3280,6181,2.0,0,0,3,10,3280,0,2001,0,98074,47.6484,-122.081,3110,7570,809950,11,6,2014,0,13,2901,4460,0,0,0
3,3.25,2080,3025,2.0,0,2,4,8,1220,860,1984,0,98122,47.6051,-122.289,2680,6518,969500,9,10,2014,0,30,945,3838,0,1,1
5,3.5,4150,13232,2.0,0,0,3,11,4150,0,2006,0,98003,47.3417,-122.182,3840,15121,635000,6,2,2015,0,9,9082,11281,0,0,0
3,2.25,1780,7332,2.0,0,0,3,7,1780,0,1987,0,98038,47.3593,-122.051,1510,7625,272450,29,10,2014,0,27,5552,6115,0,0,0
4,1.75,1460,9750,1.0,0,0,4,7,1460,0,1967,0,98008,47.6205,-122.102,1820,9840,427000,24,4,2015,0,48,8290,8020,0,0,0
3,1.0,1410,8174,1.0,0,0,3,8,1410,0,1958,0,98056,47.4969,-122.178,1500,8058,261500,1,4,2015,0,57,6764,6558,0,0,0
4,2.25,2170,9665,1.0,0,0,4,8,1300,870,1976,0,98006,47.5444,-122.165,2170,12054,488800,20,6,2014,0,38,7495,9884,0,1,0
2,1.0,690,5200,1.0,0,0,3,6,690,0,1918,0,98136,47.556,-122.395,1380,5700,340000,25,2,2015,0,97,4510,4320,0,0,1
4,3.0,3000,10297,2.0,0,0,3,8,3000,0,2003,0,98042,47.3684,-122.073,2520,8366,398950,11,8,2014,0,11,7297,5846,0,0,0
3,1.0,870,5200,1.0,0,0,5,6,870,0,1969,0,98042,47.3701,-122.078,1020,5200,217000,21,3,2015,0,46,4330,4180,0,0,0
4,1.0,1540,7350,1.0,0,0,4,6,770,770,1969,0,98023,47.3318,-122.34,910,8000,160000,30,12,2014,0,45,5810,7090,0,1,0
3,1.0,1270,8800,1.0,0,0,3,7,1270,0,1968,0,98052,47.6703,-122.15,1560,8250,447000,2,9,2014,0,46,7530,6690,0,0,0
3,1.75,2190,6450,1.0,0,0,3,8,1480,710,1957,0,98136,47.5284,-122.391,2190,6450,765000,24,4,2015,0,58,4260,4260,0,1,1
4,2.5,2790,8111,2.0,0,0,3,9,2480,310,2004,0,98058,47.4492,-122.116,2550,7634,445000,22,8,2014,0,10,5321,5084,0,1,0
3,1.0,1510,6000,1.0,0,0,3,8,1170,340,1953,0,98118,47.5168,-122.285,1125,6000,310000,28,3,2015,0,62,4490,4875,0,1,1
2,1.75,1800,7191,1.0,0,3,4,7,990,810,1952,0,98056,47.4828,-122.191,1940,7400,380000,9,4,2015,0,63,5391,5460,0,1,0
4,1.0,2410,6975,1.0,0,0,3,7,1510,900,1957,0,98108,47.5692,-122.295,1880,6255,325000,24,11,2014,0,57,4565,4375,0,1,1
4,2.75,2250,7412,1.0,0,0,4,8,1480,770,1975,0,98058,47.4449,-122.129,2070,7632,345000,17,6,2014,0,39,5162,5562,0,1,0
3,1.0,950,4760,1.5,0,0,3,6,950,0,1929,0,98106,47.5236,-122.348,1080,4760,300000,18,11,2014,0,85,3810,3680,0,0,1
2,1.0,1560,10125,1.0,0,0,4,7,1130,430,1954,0,98155,47.7488,-122.304,1680,10125,410000,17,2,2015,0,61,8565,8445,0,1,1
2,1.5,1940,5700,1.0,0,0,3,7,970,970,1937,0,98117,47.6881,-122.367,1250,5700,535000,19,9,2014,0,77,3760,4450,0,1,1
4,2.5,2040,5523,2.0,0,0,3,7,2040,0,1999,0,98148,47.432,-122.328,1720,6646,345000,3,7,2014,0,15,3483,4926,0,0,1
5,1.0,1700,11727,1.5,0,0,4,7,1700,0,1954,0,98033,47.686,-122.172,1740,8212,539000,10,4,2015,0,61,10027,6472,0,0,0
4,2.5,3700,12500,1.0,0,0,5,8,1920,1780,1973,0,98006,47.5403,-122.168,2020,8350,590000,24,10,2014,0,41,8800,6330,0,1,0
2,1.75,1050,2926,1.0,0,0,4,8,1050,0,1974,0,98198,47.3811,-122.317,1150,3802,187000,15,8,2014,0,40,1876,2652,0,0,1
3,2.0,1690,9583,1.0,0,0,4,7,1690,0,1969,0,98059,47.4825,-122.164,1690,9583,270000,9,5,2014,0,45,7893,7893,0,0,0
2,1.0,1120,6180,1.0,0,0,4,7,1120,0,1939,0,98115,47.6824,-122.301,1420,5356,546000,29,3,2015,0,76,5060,3936,0,0,1
3,1.75,1490,1036,2.0,0,0,3,10,1090,400,2008,0,98199,47.6588,-122.403,1460,1206,520000,2,7,2014,0,6,-454,-254,0,1,1
5,2.0,2220,6000,1.5,0,0,4,7,1390,830,1925,0,98144,47.5822,-122.295,1600,6000,515000,29,12,2014,0,89,3780,4400,0,1,1
3,2.5,2160,6000,1.5,0,0,4,8,1880,280,1939,0,98105,47.6582,-122.28,2300,6000,990000,17,7,2014,0,75,3840,3700,0,1,1
2,1.0,870,10492,1.0,0,0,3,7,870,0,1937,0,98106,47.5467,-122.365,1300,7987,382000,7,5,2015,0,78,9622,6687,0,0,1
4,3.5,3370,5000,2.0,0,2,3,8,2470,900,2008,0,98126,47.5714,-122.38,1820,5000,900000,26,6,2014,0,6,1630,3180,0,1,1
3,2.75,3370,5350,1.5,0,1,4,7,2310,1060,1910,0,98136,47.5373,-122.39,1720,5618,675000,21,4,2015,0,105,1980,3898,0,1,1
2,1.0,880,3300,1.0,0,0,4,7,880,0,1909,0,98107,47.6566,-122.36,1960,5500,460000,14,11,2014,0,105,2420,3540,0,0,1
2,1.0,940,5375,1.0,0,0,4,5,940,0,1952,0,98198,47.4206,-122.324,1200,7500,234000,3,6,2014,0,62,4435,6300,0,0,1
3,1.0,1340,7191,1.0,0,0,3,7,1340,0,1974,0,98034,47.7148,-122.212,1340,7215,399000,29,4,2015,0,41,5851,5875,0,0,0
3,1.5,1440,12040,1.0,0,0,4,7,1440,0,1959,0,98042,47.3715,-122.16,1720,12040,253500,2,4,2015,0,56,10600,10320,0,0,0
3,1.5,1750,12632,1.0,0,0,4,7,1750,0,1952,0,98033,47.6736,-122.176,1740,12196,475000,20,8,2014,0,62,10882,10456,0,0,0
5,3.5,3990,5000,2.0,0,0,3,8,2910,1080,2004,0,98118,47.54,-122.27,1310,5000,740000,30,3,2015,0,11,1010,3690,0,1,1
3,2.5,2860,4442,2.0,0,0,3,8,2860,0,2000,0,98199,47.661,-122.396,1440,4400,799000,13,6,2014,0,14,1582,2960,0,0,1
4,2.5,1940,3864,2.0,0,0,3,8,1940,0,2003,0,98058,47.4507,-122.12,1900,3864,390000,23,4,2015,0,12,1924,1964,0,0,0
2,1.5,1400,11245,1.0,0,0,5,7,1400,0,1947,0,98155,47.7469,-122.321,1220,11241,421000,15,9,2014,0,67,9845,10021,0,0,1
3,2.5,1770,6033,2.0,0,0,4,7,1770,0,1987,0,98042,47.3764,-122.119,1590,6510,296500,28,1,2015,0,28,4263,4920,0,0,0
4,2.0,1710,4178,1.5,0,0,4,8,1710,0,1926,0,98112,47.6373,-122.3,1760,4178,895000,13,8,2014,0,88,2468,2418,0,0,1
4,2.5,2810,11897,2.0,0,0,3,8,2810,0,2003,0,98092,47.3251,-122.186,1770,4240,386000,11,8,2014,0,11,9087,2470,0,0,0
3,1.0,1580,5000,1.5,0,0,3,7,1580,0,1926,0,98117,47.684,-122.386,1280,4000,749000,10,6,2014,0,88,3420,2720,0,0,1
3,1.0,1440,8681,1.5,0,0,3,7,1440,0,1937,0,98115,47.6976,-122.283,1700,7770,523000,10,11,2014,0,77,7241,6070,0,0,1
4,2.5,2420,9147,2.0,0,0,3,10,2420,0,1998,0,98003,47.3221,-122.322,1400,7200,389000,28,10,2014,0,16,6727,5800,0,0,0
4,1.5,1930,15000,1.0,0,0,5,7,1930,0,1946,0,98198,47.3864,-122.312,1620,7500,270000,25,8,2014,0,68,13070,5880,0,0,1
4,2.5,2240,6944,1.0,0,2,3,7,1310,930,1979,0,98001,47.338,-122.258,1780,7477,287500,5,9,2014,0,35,4704,5697,0,1,0
2,1.0,920,3780,1.0,0,0,3,6,920,0,1910,0,98103,47.6576,-122.348,1570,2640,427000,27,5,2014,0,104,2860,1070,0,0,1
4,1.75,1520,9600,1.0,0,0,4,7,1000,520,1955,0,98006,47.5763,-122.154,1510,9000,508450,5,9,2014,0,59,8080,7490,0,1,0
3,2.0,1460,6250,1.5,0,0,4,7,1460,0,1912,0,98103,47.6693,-122.333,1690,4750,705000,22,12,2014,0,102,4790,3060,0,0,1
3,1.5,1430,11173,1.0,0,0,1,7,1430,0,1955,0,98006,47.5734,-122.153,1520,11659,380000,1,5,2015,0,60,9743,10139,0,0,0
3,2.5,2500,4203,2.0,0,0,3,8,2500,0,2001,0,98065,47.5346,-121.875,2460,4798,539900,29,7,2014,0,13,1703,2338,0,0,0
2,1.0,720,7250,1.0,0,0,3,5,720,0,1943,0,98027,47.5267,-122.032,1760,7250,330000,3,9,2014,0,71,6530,5490,0,0,0
2,1.0,1140,5720,1.0,0,0,3,7,850,290,1947,0,98115,47.6827,-122.298,1410,5832,455000,2,6,2014,0,67,4580,4422,0,1,1
4,4.0,3530,10935,2.0,0,0,3,10,3530,0,1992,0,98023,47.3016,-122.342,3360,11250,510000,7,10,2014,0,22,7405,7890,0,0,0
3,1.0,1320,7000,1.0,0,0,4,7,1320,0,1967,0,98002,47.2787,-122.205,1260,7455,206000,17,6,2014,0,47,5680,6195,0,0,0
4,3.0,2170,8240,1.0,0,0,4,8,1370,800,1968,0,98052,47.6291,-122.093,2020,7944,592500,22,5,2014,0,46,6070,5924,0,1,0
3,2.5,2020,7512,2.0,0,0,4,8,2020,0,1981,0,98033,47.6927,-122.206,2410,8500,744000,23,10,2014,0,33,5492,6090,0,0,0
3,2.5,1990,3694,2.0,0,0,3,8,1990,0,1989,0,98042,47.3872,-122.154,2110,3842,334500,27,10,2014,0,25,1704,1732,0,0,0
4,2.0,2660,3900,1.5,0,0,4,7,1480,1180,1923,0,98112,47.6398,-122.306,2350,3900,886000,5,6,2014,0,91,1240,1550,0,1,1
4,2.5,2360,13500,1.0,0,0,4,8,1780,580,1973,0,98052,47.6315,-122.103,2780,12400,600000,21,10,2014,0,41,11140,9620,0,1,0
3,1.75,1360,5850,1.0,0,0,4,7,1000,360,1938,0,98116,47.5711,-122.391,1540,5850,550000,8,4,2015,0,77,4490,4310,0,1,1
2,1.0,1230,5000,1.0,0,0,5,6,1230,0,1911,0,98022,47.2064,-121.988,1230,5413,184900,21,8,2014,0,103,3770,4183,0,0,0
3,1.5,1260,7964,1.0,0,0,4,7,1260,0,1955,0,98148,47.4307,-122.334,1510,8776,245000,8,5,2014,0,59,6704,7266,0,0,1
2,1.0,1040,4172,1.0,0,0,3,7,1040,0,1946,0,98112,47.6308,-122.302,3120,4800,370000,23,9,2014,0,68,3132,1680,0,0,1
4,2.5,2700,9700,1.0,0,0,3,8,1670,1030,1978,0,98011,47.7752,-122.198,2470,9228,480000,21,4,2015,0,37,7000,6758,0,1,0
3,1.75,1800,4429,2.0,0,0,4,7,1800,0,1906,0,98103,47.6842,-122.357,1310,4429,579000,21,11,2014,0,108,2629,3119,0,0,1
3,1.5,1590,7260,1.0,0,0,3,7,1080,510,1964,0,98133,47.7753,-122.353,1590,7594,339275,9,10,2014,0,50,5670,6004,0,1,1
3,1.75,1370,10780,1.0,0,0,3,7,1370,0,1959,0,98168,47.4727,-122.298,1370,10317,170000,20,1,2015,0,56,9410,8947,0,0,1
4,2.5,3320,7644,2.0,0,0,3,10,3320,0,1995,0,98006,47.5541,-122.106,3320,9472,950000,14,5,2014,0,19,4324,6152,0,0,0
4,2.5,2980,9235,1.0,0,0,4,8,1690,1290,1977,0,98006,47.5513,-122.162,2690,10046,623000,16,9,2014,0,37,6255,7356,0,1,0
3,2.5,1350,2053,3.0,0,0,3,8,1350,0,2005,0,98117,47.6758,-122.386,1350,4150,477000,19,5,2014,0,9,703,2800,0,0,1
3,1.0,1160,9600,1.0,0,0,4,7,1160,0,1967,0,98077,47.7419,-122.073,1160,9730,330000,10,10,2014,0,47,8440,8570,0,0,0
3,2.25,1480,5400,2.0,0,0,4,8,1480,0,1914,0,98122,47.6095,-122.296,1280,3600,600000,12,6,2014,0,100,3920,2320,0,0,1
3,2.0,1640,2808,1.0,0,3,4,7,820,820,1924,0,98144,47.5945,-122.291,2270,5328,570000,7,7,2014,0,90,1168,3058,0,1,1
4,2.5,2680,7178,2.0,0,0,3,8,2680,0,2004,0,98065,47.5325,-121.856,2540,7133,515000,28,5,2014,0,10,4498,4593,0,0,0
4,2.25,2440,9889,1.0,0,0,3,7,1540,900,1952,0,98115,47.6932,-122.3,1710,6284,805000,29,4,2015,0,63,7449,4574,0,1,1
3,2.25,1780,9598,2.0,0,0,4,7,1780,0,1985,0,98030,47.3718,-122.182,1820,7533,245000,4,2,2015,0,30,7818,5713,0,0,0
4,2.5,2170,7275,1.0,0,0,3,8,1820,350,1978,0,98027,47.5672,-122.09,2390,7275,638150,18,7,2014,0,36,5105,4885,0,1,0
4,2.5,2060,13500,1.0,0,0,3,7,1260,800,1968,0,98042,47.4229,-122.153,1610,10714,269950,11,8,2014,0,46,11440,9104,0,1,0
3,1.5,1050,5525,1.0,0,0,5,6,1050,0,1969,0,98042,47.3608,-122.083,1100,5200,195000,20,9,2014,0,45,4475,4100,0,0,0
2,1.0,790,7095,1.0,0,0,3,6,790,0,1944,0,98178,47.4928,-122.239,1150,7200,159100,11,3,2015,0,71,6305,6050,0,0,1
3,1.0,1010,6120,1.0,0,0,3,6,1010,0,1942,0,98033,47.6648,-122.204,1260,5977,550000,6,3,2015,0,73,5110,4717,0,0,0
2,1.0,1040,4600,1.0,0,0,4,6,1040,0,1950,0,98118,47.5387,-122.277,1390,5897,299000,1,8,2014,0,64,3560,4507,0,0,1
4,3.5,3130,4500,2.0,0,0,3,9,2060,1070,2014,0,98103,47.677,-122.33,1500,4500,1380000,21,1,2015,0,1,1370,3000,0,1,1
2,1.0,900,4500,1.0,0,0,3,6,900,0,1951,0,98055,47.4881,-122.204,860,4500,249500,7,4,2015,0,64,3600,3640,0,0,0
4,1.0,1470,5450,1.5,0,0,3,7,1470,0,1918,0,98112,47.6458,-122.306,2160,5450,700000,25,2,2015,0,97,3980,3290,0,0,1
3,2.25,2440,8378,1.0,0,0,3,7,1480,960,1962,0,98028,47.7705,-122.26,2510,9602,565000,19,3,2015,0,53,5938,7092,0,1,0
4,1.75,2520,11017,1.0,0,0,4,7,1320,1200,1956,0,98133,47.7604,-122.356,1660,8775,425000,3,5,2015,0,59,8497,7115,0,1,1
4,1.75,1760,6000,1.0,0,0,3,7,880,880,1946,0,98119,47.6508,-122.373,2040,6000,620047,27,2,2015,0,69,4240,3960,0,1,1
3,2.25,1820,13362,1.0,0,0,3,8,1220,600,1977,0,98075,47.5898,-122.052,2050,15000,480000,23,9,2014,0,37,11542,12950,0,1,0
3,2.25,1820,13362,1.0,0,0,3,8,1220,600,1977,0,98075,47.5898,-122.052,2050,15000,515000,7,4,2015,0,38,11542,12950,0,1,0
4,1.5,2440,8040,1.0,0,0,4,8,1440,1000,1950,0,98177,47.7081,-122.374,2140,7920,849000,1,10,2014,0,64,5600,5780,0,1,1
3,1.75,2280,3446,2.0,0,0,3,8,2280,0,1949,1991,98125,47.715,-122.282,1610,6670,718000,19,11,2014,42,65,1166,5060,1,0,1
3,2.25,1980,8000,1.0,0,0,4,9,1560,420,1974,0,98023,47.3149,-122.378,2360,8000,295000,6,5,2014,0,40,6020,5640,0,1,0
5,1.75,2360,6150,1.0,0,0,5,7,1180,1180,1940,0,98107,47.6732,-122.4,2100,5500,871000,30,4,2015,0,75,3790,3400,0,1,1
3,3.75,3890,7140,1.0,0,2,3,8,2390,1500,1943,2007,98178,47.5073,-122.239,1820,7320,430000,28,5,2014,64,71,3250,5500,1,1,1
4,2.5,2300,10880,1.0,0,0,4,7,1190,1110,1961,0,98028,47.7341,-122.242,1960,10400,440000,25,8,2014,0,53,8580,8440,0,1,0
2,1.0,910,6490,1.0,0,0,3,7,910,0,1942,0,98115,47.6892,-122.306,1040,6490,405000,27,5,2014,0,72,5580,5450,0,0,1
3,2.0,1140,11620,1.0,0,0,3,7,1140,0,1994,0,98045,47.4991,-121.783,1140,8400,340000,11,8,2014,0,20,10480,7260,0,0,0
4,2.5,2390,5249,2.0,0,0,3,9,2390,0,2006,0,98074,47.6194,-122.026,2600,5342,675000,10,7,2014,0,8,2859,2742,0,0,0
3,1.0,1150,4945,1.0,0,2,3,7,1150,0,1943,0,98126,47.5663,-122.379,1390,4945,480000,27,5,2014,0,71,3795,3555,0,0,1
5,2.0,2330,8586,1.0,0,0,4,7,1270,1060,1961,0,98133,47.7671,-122.334,1550,8287,362500,20,10,2014,0,53,6256,6737,0,1,1
3,2.5,2420,9000,2.0,0,0,4,9,2420,0,1987,0,98007,47.6599,-122.146,2630,9000,752888,22,8,2014,0,27,6580,6370,0,0,0
4,1.75,960,8863,1.0,0,0,5,6,580,380,1949,0,98118,47.5372,-122.289,1720,8249,255000,18,11,2014,0,65,7903,6529,0,1,1
1,1.75,1010,10900,1.0,0,0,4,6,1010,0,1968,0,98019,47.7391,-121.982,1410,8359,283700,13,8,2014,0,46,9890,6949,0,0,0
4,2.5,2370,6000,2.0,0,0,3,8,2370,0,2001,0,98030,47.3732,-122.179,2190,6070,335000,25,8,2014,0,13,3630,3880,0,0,0
3,1.75,2880,18296,1.0,0,0,3,8,1580,1300,1958,0,98168,47.4881,-122.281,1380,9592,285000,3,6,2014,0,56,15416,8212,0,1,1
4,2.25,2400,7738,1.5,0,0,3,8,2400,0,1964,0,98148,47.4562,-122.33,2170,8452,278000,13,8,2014,0,50,5338,6282,0,0,1
5,2.5,3670,8960,1.5,0,0,3,8,3670,0,1973,0,98052,47.6654,-122.142,2340,9425,731000,27,3,2015,0,42,5290,7085,0,0,0
3,1.5,1140,15890,1.0,0,0,3,7,840,300,1985,0,98045,47.4752,-121.757,1200,15247,335000,10,3,2015,0,30,14750,14047,0,1,0
6,1.0,1530,4305,1.5,0,0,4,7,1530,0,1921,0,98115,47.6862,-122.31,1530,3800,642000,25,2,2015,0,94,2775,2270,0,0,1
4,1.75,1720,4240,1.5,0,0,4,7,1460,260,1925,0,98144,47.579,-122.294,1930,4280,540000,2,6,2014,0,89,2520,2350,0,1,1
3,1.75,1570,4375,1.0,0,0,3,7,970,600,1940,0,98116,47.5889,-122.389,1790,5750,560000,20,1,2015,0,75,2805,3960,0,1,1
5,2.75,1990,3750,1.5,0,0,4,7,1990,0,1913,0,98107,47.6733,-122.358,1820,5000,852000,22,8,2014,0,101,1760,3180,0,0,1
2,1.0,930,5650,1.0,0,2,3,7,930,0,1941,0,98126,47.5478,-122.377,1340,6400,306000,27,4,2015,0,74,4720,5060,0,0,1
3,1.75,1550,7820,1.0,0,0,4,7,1210,340,1981,0,98034,47.717,-122.163,1550,6900,440000,10,9,2014,0,33,6270,5350,0,1,0
4,1.0,1650,8250,1.0,0,0,3,7,1650,0,1966,0,98008,47.6366,-122.118,2240,9776,517000,28,4,2015,0,49,6600,7536,0,0,0
2,1.0,800,6380,1.0,0,2,3,7,800,0,1940,0,98115,47.691,-122.309,920,5940,379000,23,5,2014,0,74,5580,5020,0,0,1
2,1.0,930,6098,1.0,0,0,4,6,930,0,1919,0,98027,47.5289,-122.03,1730,9000,360000,13,10,2014,0,95,5168,7270,0,0,0
4,1.5,2550,4000,1.5,0,0,4,7,1760,790,1926,0,98115,47.6811,-122.318,1840,4000,645000,29,10,2014,0,88,1450,2160,0,1,1
2,1.0,720,4760,1.0,0,0,5,5,720,0,1942,0,98056,47.496,-122.186,840,4760,217000,7,11,2014,0,72,4040,3920,0,0,0
2,1.0,620,4760,1.0,0,0,3,6,620,0,1941,0,98126,47.5292,-122.376,620,4760,255000,18,11,2014,0,73,4140,4140,0,0,1
3,2.5,2360,12164,2.0,0,0,3,10,2360,0,1987,0,98029,47.5596,-122.022,2400,11260,625000,21,7,2014,0,27,9804,8860,0,0,0
3,1.75,1760,8400,1.0,0,0,4,8,1460,300,1960,0,98136,47.5355,-122.39,1980,8400,680000,10,6,2014,0,54,6640,6420,0,1,1
5,2.25,2480,12070,2.0,0,0,3,9,2480,0,1978,0,98074,47.631,-122.052,2570,12000,615000,18,6,2014,0,36,9590,9430,0,0,0
3,1.0,1040,6860,2.0,0,0,3,6,1040,0,1942,0,98146,47.5121,-122.375,1030,6512,239000,3,6,2014,0,72,5820,5482,0,0,1
4,2.0,2090,3610,1.5,0,0,5,7,1790,300,1927,0,98115,47.6881,-122.313,1660,3767,619400,11,6,2014,0,87,1520,2107,0,1,1
2,1.0,700,4000,1.0,0,0,3,6,700,0,1943,0,98136,47.5487,-122.391,1060,6000,330000,13,10,2014,0,71,3300,4940,0,0,1
2,1.0,760,7114,1.0,0,0,3,6,760,0,1946,0,98103,47.7005,-122.352,780,7102,430000,23,3,2015,0,69,6354,6322,0,0,1
4,5.25,6500,14986,2.0,0,0,3,11,5180,1320,2001,0,98039,47.6304,-122.236,2270,8119,2460000,8,7,2014,0,13,8486,5849,0,1,0
3,2.0,1840,6000,2.0,0,0,5,7,1720,120,1946,0,98033,47.6828,-122.207,1390,6000,778000,23,7,2014,0,68,4160,4610,0,1,0
3,2.0,1090,7350,1.0,0,0,4,7,1090,0,1990,0,98042,47.3687,-122.085,1490,7741,219000,28,7,2014,0,24,6260,6251,0,0,0
4,2.25,1900,8272,1.0,0,0,4,9,1460,440,1966,0,98040,47.5803,-122.227,2040,8479,715000,30,1,2015,0,49,6372,6439,0,1,0
2,1.0,1280,5026,1.0,0,2,4,8,1020,260,1951,0,98115,47.6938,-122.312,1540,6380,425000,12,12,2014,0,63,3746,4840,0,1,1
3,1.0,1510,15022,1.0,0,0,3,7,1510,0,1962,0,98003,47.3304,-122.304,1510,12970,239000,17,7,2014,0,52,13512,11460,0,0,0
1,1.0,920,8282,1.5,0,0,3,6,920,0,1944,1980,98011,47.761,-122.214,2260,14025,310000,16,12,2014,36,70,7362,11765,1,0,0
2,1.0,700,8120,1.0,0,0,3,7,700,0,1927,0,98115,47.6962,-122.321,1130,5599,400000,23,2,2015,0,88,7420,4469,0,0,1
3,1.0,1440,4300,1.5,0,0,3,8,1440,0,1929,0,98117,47.6847,-122.372,1640,4500,600000,12,8,2014,0,85,2860,2860,0,0,1
4,4.0,2740,8250,2.0,0,0,4,9,2740,0,1990,0,98042,47.3735,-122.156,2290,8250,415000,26,1,2015,0,25,5510,5960,0,0,0
2,1.0,1400,8220,1.0,0,0,3,7,1400,0,1949,0,98133,47.7228,-122.357,1760,8220,401000,8,8,2014,0,65,6820,6460,0,0,1
3,1.75,2270,7156,1.0,0,0,3,7,1370,900,1948,0,98168,47.4864,-122.316,1210,7156,292000,15,12,2014,0,66,4886,5946,0,1,1
3,2.25,1310,12825,1.0,0,0,3,7,1310,0,1950,2013,98166,47.4515,-122.368,1600,11250,291750,22,7,2014,63,64,11515,9650,1,0,1
3,1.75,1680,7455,1.0,0,0,4,8,1680,0,1968,0,98023,47.3112,-122.378,2040,8214,227000,18,2,2015,0,47,5775,6174,0,0,0
3,2.25,2260,13209,1.0,0,0,3,9,2260,0,1977,0,98005,47.6385,-122.167,2820,12534,675000,17,7,2014,0,37,10949,9714,0,0,0
3,2.25,1350,980,2.0,0,0,3,8,1050,300,2007,0,98144,47.5998,-122.312,1350,1245,397500,6,10,2014,0,7,-370,-105,0,1,1
2,1.5,1820,8867,2.0,0,0,3,7,1820,0,1921,0,98168,47.4764,-122.269,1430,9288,206000,18,6,2014,0,93,7047,7858,0,0,1
3,3.5,3380,3333,3.0,0,0,3,10,2800,580,2008,0,98122,47.6162,-122.288,2790,5000,1190000,30,7,2014,0,6,-47,2210,0,1,1
4,2.5,2430,3249,2.0,0,0,3,8,2430,0,2010,0,98059,47.5048,-122.155,2650,3844,427500,8,10,2014,0,4,819,1194,0,0,0
2,1.0,940,6000,1.0,0,0,3,6,940,0,1943,0,98146,47.4907,-122.336,1310,6000,115000,25,7,2014,0,71,5060,4690,0,0,1
3,1.5,2070,5386,1.0,0,0,4,7,1140,930,1948,0,98117,47.6896,-122.374,1770,5386,559000,9,6,2014,0,66,3316,3616,0,1,1
4,1.0,1510,1501,1.5,0,0,3,7,1510,0,1906,0,98103,47.6526,-122.342,1560,1602,420000,27,10,2014,0,108,-9,42,0,0,1
2,1.0,700,5940,1.0,0,0,3,7,700,0,1948,0,98133,47.7289,-122.337,1070,5995,282150,22,9,2014,0,66,5240,4925,0,0,1
3,1.0,1150,3090,1.0,0,0,3,6,1150,0,1910,0,98118,47.5506,-122.276,1150,5664,260000,23,2,2015,0,105,1940,4514,0,0,1
3,2.5,2340,3466,2.0,0,0,3,7,2340,0,2004,0,98065,47.5322,-121.851,1970,3739,428000,2,10,2014,0,10,1126,1769,0,0,0
3,3.25,1510,1245,3.0,0,0,3,7,1510,0,2007,0,98133,47.7293,-122.343,1510,1245,319950,15,10,2014,0,7,-265,-265,0,0,1
2,1.0,1150,5000,1.0,0,0,4,7,1050,100,1924,0,98115,47.6846,-122.317,1463,4320,552000,11,9,2014,0,90,3850,2857,0,1,1
4,2.75,2190,2867,1.5,0,0,5,7,1470,720,1929,0,98115,47.6868,-122.308,1600,3800,637000,9,2,2015,0,86,677,2200,0,1,1
4,1.75,1980,9000,1.0,0,0,2,7,1480,500,1978,0,98023,47.3071,-122.381,1980,9360,213000,9,6,2014,0,36,7020,7380,0,1,0
3,1.0,960,7200,1.0,0,0,4,6,960,0,1958,0,98166,47.4583,-122.353,1060,7620,215000,28,4,2015,0,57,6240,6560,0,0,1
3,1.75,2180,6120,1.0,0,2,3,8,1380,800,1949,0,98199,47.6501,-122.405,2020,6122,590000,17,2,2015,0,66,3940,4102,0,1,1
4,2.25,2270,11997,1.0,0,2,4,7,1540,730,1959,0,98198,47.4095,-122.296,1920,9634,287000,22,9,2014,0,55,9727,7714,0,1,1
5,2.75,3550,9600,2.0,0,0,3,7,3550,0,1960,0,98033,47.6766,-122.186,3370,9600,580000,17,7,2014,0,54,6050,6230,0,0,0
3,2.0,1330,5632,1.0,0,0,3,8,1330,0,1988,0,98029,47.5745,-122.017,1900,4842,424000,28,10,2014,0,26,4302,2942,0,0,0
4,2.5,2110,6360,2.0,0,0,3,8,2110,0,1988,0,98029,47.5641,-122.012,2050,7000,610000,9,3,2015,0,27,4250,4950,0,0,0
4,3.25,3470,11843,1.0,0,3,3,11,2270,1200,1989,0,98006,47.5513,-122.135,3910,13247,1320000,29,7,2014,0,25,8373,9337,0,1,0
4,3.0,1550,3350,1.0,0,0,3,7,860,690,1918,2014,98107,47.6583,-122.362,1310,5000,623500,18,12,2014,96,96,1800,3690,1,1,1
3,2.5,2030,1800,3.0,0,0,3,9,2030,0,2013,0,98112,47.6199,-122.3,1450,1441,906000,11,3,2015,0,2,-230,-9,0,0,1
3,2.0,1500,11233,1.0,0,0,3,7,1500,0,1987,0,98019,47.7279,-121.967,1580,14013,330000,6,4,2015,0,28,9733,12433,0,0,0
2,1.0,920,7688,1.0,0,0,3,6,920,0,1955,0,98106,47.5281,-122.362,1040,7440,275000,4,3,2015,0,60,6768,6400,0,0,1
3,1.0,1470,8200,1.0,0,0,3,7,1040,430,1953,0,98155,47.7347,-122.302,1420,8200,290000,19,11,2014,0,61,6730,6780,0,1,1
2,1.0,1150,3775,1.0,0,0,3,7,1150,0,1917,0,98103,47.6539,-122.329,2240,3753,599950,17,9,2014,0,97,2625,1513,0,0,1
3,1.75,1690,3449,1.0,0,0,3,7,1690,0,1987,0,98055,47.4719,-122.191,1530,4093,289000,22,7,2014,0,27,1759,2563,0,0,0
4,2.75,2150,9915,1.0,0,0,5,8,1240,910,1976,0,98056,47.5378,-122.17,1980,9325,411000,2,6,2014,0,38,7765,7345,0,1,0
3,3.25,2330,4000,1.0,0,2,3,10,1730,600,1964,2000,98144,47.5882,-122.295,2080,4000,826000,25,3,2015,36,51,1670,1920,1,1,1
4,2.0,2680,13680,2.0,0,2,4,7,2350,330,1943,1965,98056,47.4887,-122.192,1430,11000,400000,10,7,2014,22,71,11000,9570,1,1,0
3,2.5,1740,2226,2.0,0,0,3,8,1320,420,2008,0,98106,47.525,-122.366,1740,1789,342000,14,8,2014,0,6,486,49,0,1,1
2,1.75,1320,3420,1.0,0,1,3,7,1080,240,1955,0,98199,47.6639,-122.399,2070,6000,475000,10,10,2014,0,59,2100,3930,0,1,1
4,3.5,3150,5500,2.0,0,0,3,9,3150,0,2014,0,98105,47.6644,-122.293,1550,4200,1210000,8,7,2014,0,0,2350,2650,0,0,1
4,3.0,2480,9238,1.0,0,0,5,7,2050,430,1913,0,98166,47.4701,-122.364,1820,12214,455000,23,7,2014,0,101,6758,10394,0,1,1
4,3.0,3330,4000,1.0,0,0,3,8,1790,1540,1958,0,98103,47.6559,-122.344,1610,4000,850000,24,6,2014,0,56,670,2390,0,1,1
3,1.0,1010,6400,1.0,0,0,3,7,1010,0,1971,0,98023,47.3027,-122.376,1820,6500,185000,8,1,2015,0,44,5390,4680,0,0,0
5,3.75,3580,14275,2.0,0,0,3,10,3190,390,1999,0,98027,47.5322,-122.056,2740,14300,765000,15,5,2014,0,15,10695,11560,0,1,0
3,1.75,2220,17568,1.0,0,0,4,8,2220,0,1967,0,98072,47.749,-122.083,2070,11745,437000,7,7,2014,0,47,15348,9675,0,0,0
3,1.5,1010,10350,1.0,0,0,3,7,1010,0,1969,0,98032,47.379,-122.29,1640,7700,240000,14,7,2014,0,45,9340,6060,0,0,0
2,1.0,1440,7808,1.0,0,0,4,7,860,580,1949,0,98133,47.7431,-122.336,1550,7682,395000,28,4,2015,0,66,6368,6132,0,1,1
3,1.0,1230,7492,1.0,0,0,3,7,1230,0,1955,0,98155,47.7633,-122.315,1710,7238,320000,6,1,2015,0,60,6262,5528,0,0,1
3,1.75,1710,7350,1.0,0,0,3,8,1280,430,1981,0,98033,47.699,-122.167,2100,7560,525000,22,10,2014,0,33,5640,5460,0,1,0
3,3.0,2390,8993,2.0,0,0,3,8,1680,710,1988,0,98003,47.3532,-122.306,1820,10362,260000,22,4,2015,0,27,6603,8542,0,1,0
4,2.5,2300,7989,2.0,0,0,3,9,2300,0,1990,0,98074,47.6273,-122.034,2280,8835,560000,23,6,2014,0,24,5689,6555,0,0,0
5,3.0,2270,5001,1.0,0,0,3,7,1360,910,1989,0,98108,47.5539,-122.3,1950,5500,310000,14,4,2015,0,26,2731,3550,0,1,1
3,2.5,2290,6302,2.0,0,0,3,9,2290,0,1997,0,98058,47.435,-122.107,2700,7500,440000,13,4,2015,0,18,4012,4800,0,0,0
4,1.0,1330,9715,1.0,0,0,4,7,970,360,1957,0,98008,47.6038,-122.122,1590,8400,458450,8,12,2014,0,57,8385,6810,0,1,0
3,1.0,1200,10703,1.5,0,0,2,7,1200,0,1918,0,98118,47.5209,-122.28,1380,8068,200000,26,3,2015,0,97,9503,6688,0,0,1
3,2.25,2160,6527,2.0,0,0,4,7,1580,580,1987,0,98034,47.7292,-122.212,1950,9675,430000,6,12,2014,0,27,4367,7725,0,1,0
3,1.0,1120,10500,1.0,0,0,4,7,1120,0,1966,0,98034,47.7267,-122.226,1320,10500,360000,26,2,2015,0,49,9380,9180,0,0,0
4,2.5,2090,11645,1.0,0,0,3,7,1200,890,1962,0,98168,47.4759,-122.299,1450,9481,311000,9,1,2015,0,53,9555,8031,0,1,1
3,3.25,1470,1152,3.0,0,0,3,8,1470,0,2003,0,98103,47.6516,-122.337,1470,1506,615000,22,7,2014,0,11,-318,36,0,0,1
3,1.75,2270,10136,2.0,0,0,3,8,2270,0,1979,0,98027,47.535,-122.056,2260,9600,575000,26,11,2014,0,35,7866,7340,0,0,0
3,1.75,1440,4025,1.0,0,0,4,6,720,720,1917,0,98126,47.567,-122.38,1500,5750,430000,22,9,2014,0,97,2585,4250,0,1,1
3,1.5,1200,4800,1.0,0,0,4,7,1200,0,1962,0,98007,47.6084,-122.136,1510,7668,400000,3,6,2014,0,52,3600,6158,0,0,0
3,1.75,1720,10710,1.0,0,0,3,7,860,860,1957,0,98146,47.5092,-122.362,1480,10359,340000,28,8,2014,0,57,8990,8879,0,1,1
1,0.75,930,6600,1.0,0,0,3,6,930,0,1924,0,98125,47.7127,-122.296,1590,6600,351000,4,5,2015,0,91,5670,5010,0,0,1
4,2.5,2400,8038,2.0,0,0,3,8,2400,0,2002,0,98059,47.4881,-122.143,2040,7756,440000,12,9,2014,0,12,5638,5716,0,0,0
4,2.5,1960,11798,2.0,0,0,3,8,1960,0,1999,0,98092,47.3293,-122.205,2360,11785,298000,22,4,2015,0,16,9838,9425,0,0,0
4,1.75,1890,9205,1.0,0,0,3,8,1260,630,1964,0,98133,47.774,-122.348,1430,6775,300000,14,1,2015,0,51,7315,5345,0,1,1
3,2.25,1590,3056,2.0,0,0,3,7,1590,0,2001,0,98108,47.5432,-122.293,1540,2890,310000,23,10,2014,0,13,1466,1350,0,0,1
4,2.5,2590,9354,2.0,0,0,4,9,2590,0,1993,0,98011,47.7703,-122.193,2730,9264,500000,8,8,2014,0,21,6764,6534,0,0,0
3,1.0,860,1664,1.5,0,0,3,7,860,0,1927,0,98117,47.6761,-122.384,1540,4080,399900,5,5,2015,0,88,804,2540,0,0,1
3,2.5,1270,2509,2.0,0,0,3,8,1270,0,2004,0,98106,47.5357,-122.365,1420,2206,343000,17,6,2014,0,10,1239,786,0,0,1
2,2.25,1130,2191,2.0,0,0,3,8,1130,0,2010,0,98052,47.6861,-122.103,1140,1710,415000,29,12,2014,0,4,1061,570,0,0,0
3,2.5,1860,15457,2.0,0,0,3,8,1860,0,1997,0,98019,47.7383,-121.955,2040,14055,410000,7,10,2014,0,17,13597,12015,0,0,0
2,1.0,1802,11225,1.0,0,0,3,7,1802,0,1961,0,98125,47.7205,-122.323,1810,7332,320000,8,1,2015,0,54,9423,5522,0,0,1
5,3.0,4480,5000,2.5,0,0,5,12,3420,1060,1902,0,98112,47.6275,-122.315,3220,5600,1990000,26,6,2014,0,112,520,2380,0,1,1
2,1.0,1310,7128,1.0,0,0,4,7,940,370,1980,0,98031,47.3958,-122.189,1400,7161,253000,2,7,2014,0,34,5818,5761,0,1,0
2,1.0,1130,12500,1.0,0,0,4,7,1130,0,1953,0,98055,47.4514,-122.187,1270,10798,216000,6,1,2015,0,62,11370,9528,0,0,0
3,2.5,2180,11100,1.0,0,0,3,8,1230,950,1983,0,98052,47.717,-122.101,1930,12000,540000,27,4,2015,0,32,8920,10070,0,1,0
3,1.5,1830,12233,1.5,0,0,4,5,1830,0,1930,0,98022,47.2057,-122.003,1520,12233,212000,30,9,2014,0,84,10403,10713,0,0,0
3,2.75,2340,12282,1.0,0,2,3,8,1470,870,1978,0,98155,47.7379,-122.289,2640,8887,300000,29,1,2015,0,37,9942,6247,0,1,1
3,2.5,2830,3750,3.0,0,0,3,10,2830,0,2014,0,98117,47.6798,-122.385,1780,5100,969950,27,8,2014,0,0,920,3320,0,0,1
3,1.0,1610,7680,1.0,0,0,3,6,900,710,1956,0,98122,47.6038,-122.303,1940,2880,715000,8,8,2014,0,58,6070,940,0,1,1
4,2.75,2660,9547,1.0,0,1,3,8,1930,730,1968,2006,98004,47.616,-122.218,2410,10001,1440000,1,12,2014,38,46,6887,7591,1,1,0
3,1.0,1030,5350,1.0,0,0,3,7,1030,0,1924,2009,98055,47.4905,-122.206,1030,5250,305000,15,7,2014,85,90,4320,4220,1,0,0
3,4.0,1390,1569,2.0,0,0,3,9,1150,240,2006,0,98105,47.671,-122.269,1620,1855,458000,4,12,2014,0,8,179,235,0,1,1
3,1.75,1580,8775,1.0,0,0,3,6,1220,360,1942,0,98146,47.4845,-122.335,1180,8775,275000,14,4,2015,0,73,7195,7595,0,1,1
3,2.75,2330,4780,2.0,0,3,3,8,1730,600,1930,1988,98198,47.3459,-122.326,1100,5336,550000,14,10,2014,58,84,2450,4236,1,1,1
3,3.25,1540,704,3.0,0,0,3,9,1540,0,2011,0,98122,47.6177,-122.308,1540,1456,742000,4,6,2014,0,3,-836,-84,0,0,1
3,1.0,1570,4000,2.0,0,0,5,8,1570,0,1908,0,98103,47.6575,-122.346,1640,4000,700000,25,7,2014,0,106,2430,2360,0,0,1
4,3.0,2940,5763,1.0,0,0,5,8,1640,1300,1955,0,98108,47.5589,-122.295,2020,7320,640000,12,11,2014,0,59,2823,5300,0,1,1
3,0.75,1240,7200,1.0,0,0,3,7,1240,0,1947,0,98133,47.7298,-122.342,1210,7200,352000,10,4,2015,0,68,5960,5990,0,0,1
3,1.0,1410,7419,1.0,0,0,3,7,1050,360,1969,0,98056,47.534,-122.173,1800,8000,301500,1,2,2015,0,46,6009,6200,0,1,0
4,2.5,2190,9880,1.0,0,0,4,8,1410,780,1979,0,98033,47.6926,-122.186,2190,9198,630000,2,7,2014,0,35,7690,7008,0,1,0
3,2.5,3040,6255,2.0,0,0,3,7,3040,0,1999,0,98030,47.3817,-122.206,2670,6259,340000,23,2,2015,0,16,3215,3589,0,0,0
4,1.75,1860,9364,1.0,0,0,3,7,1080,780,1953,0,98125,47.731,-122.301,1800,9364,477500,10,3,2015,0,62,7504,7564,0,1,1
3,2.5,1690,7460,1.0,0,0,3,7,870,820,1997,0,98146,47.4964,-122.353,1900,7302,285000,13,8,2014,0,17,5770,5402,0,1,1
3,2.5,1600,7982,2.0,0,0,3,8,1600,0,1993,0,98001,47.3397,-122.266,1890,9830,315000,28,7,2014,0,21,6382,7940,0,0,0
6,3.0,2530,9000,1.0,0,0,3,6,2530,0,1978,0,98033,47.6716,-122.199,1886,6000,830000,17,12,2014,0,36,6470,4114,0,0,0
3,2.25,1860,1558,3.0,0,0,3,8,1860,0,2014,0,98103,47.7006,-122.339,1760,2456,539950,10,2,2015,0,1,-302,696,0,0,1
3,2.25,2390,4590,2.0,0,0,3,8,2090,300,1941,1998,98105,47.6615,-122.276,2280,5179,980000,14,8,2014,57,73,2200,2899,1,1,1
4,2.5,3100,8529,2.0,0,0,3,9,3100,0,1990,0,98074,47.6252,-122.029,2710,8344,735000,18,7,2014,0,24,5429,5634,0,0,0
5,2.25,2650,9140,1.0,0,1,3,8,1350,1300,1965,0,98177,47.7772,-122.387,2700,7800,536000,22,1,2015,0,50,6490,5100,0,1,1
3,2.0,1520,5000,1.5,0,0,3,7,1140,380,1945,0,98107,47.6733,-122.389,1530,4650,575000,23,2,2015,0,70,3480,3120,0,1,1
2,1.0,1510,4000,1.0,0,0,3,6,930,580,1924,0,98117,47.6917,-122.38,1300,4000,500000,25,9,2014,0,90,2490,2700,0,1,1
4,1.75,1960,7950,1.0,0,0,4,8,1960,0,1967,0,98023,47.3109,-122.377,1960,8400,285500,16,6,2014,0,47,5990,6440,0,0,0
4,2.75,2270,7375,1.0,0,0,4,7,1290,980,1973,0,98034,47.7222,-122.168,1750,7760,498000,14,5,2014,0,41,5105,6010,0,1,0
2,1.0,910,6282,1.0,0,0,4,7,910,0,1939,0,98103,47.6967,-122.354,970,6281,412000,21,8,2014,0,75,5372,5311,0,0,1
4,2.5,2100,8220,1.0,0,0,4,8,1300,800,1975,0,98052,47.6733,-122.145,2160,8348,607000,23,3,2015,0,40,6120,6188,0,1,0
3,1.0,1000,8512,1.0,0,0,3,6,1000,0,1991,0,98022,47.2151,-121.993,1490,10395,199000,24,6,2014,0,23,7512,8905,0,0,0
4,2.75,2760,18306,1.0,0,0,3,7,1630,1130,1978,0,98034,47.7302,-122.215,2470,9856,492500,21,7,2014,0,36,15546,7386,0,1,0
4,2.5,2840,11044,2.0,0,0,3,8,2840,0,2001,0,98034,47.7134,-122.237,1934,9605,585000,19,6,2014,0,13,8204,7671,0,0,0
3,2.5,1860,5321,2.0,0,0,3,7,1860,0,2000,0,98038,47.3848,-122.033,1940,5205,326995,8,12,2014,0,14,3461,3265,0,0,0
4,2.25,1920,9660,1.0,0,0,4,8,1920,0,1968,0,98058,47.4544,-122.143,1890,7800,372500,13,8,2014,0,46,7740,5910,0,0,0
4,2.5,2100,8501,2.0,0,0,5,7,2100,0,1993,0,98022,47.1951,-122.01,2130,8560,344000,29,10,2014,0,21,6401,6430,0,0,0
4,3.0,2430,7163,2.0,0,0,3,8,2430,0,2003,0,98038,47.3558,-122.013,2430,6028,409950,2,9,2014,0,11,4733,3598,0,0,0
3,2.0,1880,4000,1.0,0,2,3,8,1280,600,1950,0,98199,47.6375,-122.391,1920,4000,625000,15,7,2014,0,64,2120,2080,0,1,1
3,1.75,1350,9000,1.0,0,0,3,7,1350,0,1987,0,98045,47.4487,-121.773,1370,9500,304950,12,5,2015,0,28,7650,8130,0,0,0
3,1.75,1430,13399,1.0,0,0,4,7,900,530,1946,0,98168,47.4787,-122.275,1720,6415,215000,23,7,2014,0,68,11969,4695,0,1,1
5,1.75,2840,12870,2.0,0,2,4,7,2840,0,1925,0,98178,47.4961,-122.235,2170,9612,345000,27,4,2015,0,90,10030,7442,0,0,1
2,2.0,1930,5479,1.0,0,0,3,8,1930,0,2005,0,98053,47.7054,-122.011,1900,5479,548050,4,2,2015,0,10,3549,3579,0,0,0
2,1.0,720,4920,1.0,0,0,3,6,720,0,1941,0,98126,47.5352,-122.371,670,4920,314000,27,10,2014,0,73,4200,4250,0,0,1
5,1.75,2300,6720,2.0,0,0,3,7,2300,0,1905,0,98108,47.528,-122.32,1200,6000,400000,15,7,2014,0,109,4420,4800,0,0,1
1,1.0,460,4120,1.0,0,0,3,4,460,0,1937,0,98055,47.4868,-122.199,990,4120,247000,14,11,2014,0,77,3660,3130,0,0,0
2,1.75,1240,4120,1.0,0,0,4,7,890,350,1906,0,98105,47.6689,-122.314,1640,3740,540000,1,4,2015,0,109,2880,2100,0,1,1
3,1.75,2120,9146,1.0,0,0,3,8,1260,860,1981,0,98074,47.6475,-122.064,2040,10485,525000,2,10,2014,0,33,7026,8445,0,1,0
4,2.5,2440,5737,2.0,0,0,4,8,1700,740,1929,0,98119,47.6472,-122.367,2020,5543,820000,10,4,2015,0,86,3297,3523,0,1,1
2,1.0,1180,10200,1.0,0,0,4,7,1180,0,1955,0,98148,47.4358,-122.336,1330,10200,244000,18,12,2014,0,59,9020,8870,0,0,1
1,1.0,520,4800,1.0,0,0,3,5,520,0,1930,0,98106,47.5533,-122.363,800,4960,275000,18,12,2014,0,84,4280,4160,0,0,1
5,2.5,2250,7945,1.0,0,0,4,7,1360,890,1977,0,98034,47.7316,-122.221,1820,7866,446950,2,12,2014,0,37,5695,6046,0,1,0
3,2.5,2050,5694,2.0,0,2,3,8,2050,0,2004,0,98065,47.5331,-121.855,2680,7187,457000,29,7,2014,0,10,3644,4507,0,0,0
3,1.5,1250,9484,1.0,0,0,4,7,1250,0,1969,0,98042,47.3675,-122.147,1320,9600,210000,5,9,2014,0,45,8234,8280,0,0,0
4,2.5,2130,9100,1.0,0,0,3,8,1290,840,1978,0,98030,47.3815,-122.169,1770,7700,220000,22,9,2014,0,36,6970,5930,0,1,0
3,2.0,2250,8800,1.0,0,0,4,7,1250,1000,1925,0,98116,47.5737,-122.409,2250,4800,589000,13,6,2014,0,89,6550,2550,0,1,1
4,2.0,1880,3840,1.0,0,0,3,7,970,910,1904,0,98144,47.5929,-122.303,1670,1820,435000,30,6,2014,0,110,1960,150,0,1,1
3,1.0,1520,10798,1.0,0,0,3,7,1520,0,1953,0,98028,47.7635,-122.262,1670,9876,375000,16,7,2014,0,61,9278,8206,0,0,0
4,3.5,4010,9654,2.0,0,0,3,10,4010,0,2007,0,98004,47.5891,-122.2,1870,9873,1740000,17,10,2014,0,7,5644,8003,0,0,0
2,1.75,1660,5581,1.0,0,0,3,8,1660,0,2005,0,98053,47.713,-122.033,1670,4871,545000,11,12,2014,0,9,3921,3201,0,0,0
3,2.25,3400,10000,2.0,0,0,3,10,3400,0,1983,0,98115,47.6846,-122.284,1860,5100,970000,22,10,2014,0,31,6600,3240,0,0,1
2,1.75,2320,6755,1.0,0,0,5,8,1380,940,1946,0,98199,47.6398,-122.403,1990,5000,705000,18,7,2014,0,68,4435,3010,0,1,1
5,3.25,3740,11536,2.0,0,0,4,9,2540,1200,1984,0,98006,47.5599,-122.108,2920,11258,915557,16,3,2015,0,31,7796,8338,0,1,0
4,1.5,1810,9000,1.5,0,0,3,7,1810,0,1960,0,98168,47.4911,-122.322,1520,9780,259000,9,2,2015,0,55,7190,8260,0,0,1
2,2.25,3170,3000,2.0,0,2,5,10,1990,1180,1900,0,98109,47.6291,-122.351,2980,5061,1700000,13,6,2014,0,114,-170,2081,0,1,1
3,1.75,1680,8610,1.0,0,0,4,7,1290,390,1969,0,98034,47.7246,-122.173,1640,8809,427000,1,12,2014,0,45,6930,7169,0,1,0
2,1.0,930,3100,1.0,0,0,3,6,930,0,1911,0,98144,47.5943,-122.302,1670,3800,390000,11,8,2014,0,103,2170,2130,0,0,1
3,2.5,2390,8000,2.0,0,0,3,8,2390,0,1995,0,98042,47.3895,-122.154,2070,7585,363000,12,2,2015,0,20,5610,5515,0,0,0
4,2.5,2680,3626,1.5,0,3,4,7,1680,1000,1928,0,98107,47.6727,-122.361,1950,4500,612000,7,8,2014,0,86,946,2550,0,1,1
4,1.75,1790,10186,1.0,0,0,4,8,1790,0,1965,0,98177,47.7769,-122.376,1790,9142,380000,16,9,2014,0,49,8396,7352,0,0,1
4,3.0,1680,6003,1.0,0,0,3,7,1150,530,1997,0,98002,47.2885,-122.218,1820,6207,230000,18,8,2014,0,17,4323,4387,0,1,0
3,1.75,1570,2600,1.5,0,0,4,8,1570,0,1931,0,98117,47.6867,-122.37,1490,4000,580000,14,4,2015,0,84,1030,2510,0,0,1
3,1.0,2230,3200,2.0,0,2,3,8,1630,600,1918,0,98109,47.6334,-122.356,2280,5400,770000,19,11,2014,0,96,970,3120,0,1,1
4,2.0,1260,8400,1.0,0,0,3,6,1260,0,1991,0,98022,47.1946,-122.0,1120,8400,207200,24,9,2014,0,23,7140,7280,0,0,0
3,2.0,1790,11430,1.0,0,0,3,7,1190,600,1985,0,98074,47.6319,-122.035,1700,12114,525000,5,3,2015,0,30,9640,10414,0,1,0
3,2.5,2440,7419,1.0,0,0,3,7,1520,920,1961,0,98103,47.6857,-122.334,2440,4880,925000,9,2,2015,0,54,4979,2440,0,1,1
4,2.25,2410,4000,2.0,0,0,5,8,1650,760,1910,0,98115,47.6727,-122.316,1820,4000,883000,2,9,2014,0,104,1590,2180,0,1,1
4,2.5,1780,2992,2.0,0,0,3,7,1780,0,2003,0,98072,47.7633,-122.149,1610,2961,455000,8,5,2015,0,12,1212,1351,0,0,0
3,2.5,1900,5194,2.0,0,0,3,7,1900,0,2004,0,98058,47.4391,-122.117,2230,5194,343500,22,9,2014,0,10,3294,2964,0,0,0
2,1.0,960,8450,1.0,0,0,5,6,960,0,1950,0,98155,47.755,-122.316,1090,8450,244000,14,11,2014,0,64,7490,7360,0,0,1
3,1.75,1640,11730,1.0,0,0,5,7,1640,0,1967,0,98034,47.7351,-122.189,1640,7770,397000,19,11,2014,0,47,10090,6130,0,0,0
2,1.0,850,5000,1.0,0,0,3,6,850,0,1976,0,98198,47.3817,-122.314,1160,5000,180500,16,3,2015,0,39,4150,3840,0,0,1
3,2.75,2150,6576,1.0,0,0,4,7,1900,250,1926,0,98155,47.7539,-122.308,2150,9071,310000,4,3,2015,0,89,4426,6921,0,1,1
4,2.5,2780,3969,2.0,0,0,3,7,2780,0,2005,0,98042,47.3992,-122.164,2260,4160,315000,28,1,2015,0,10,1189,1900,0,0,0
3,1.0,1030,4958,1.0,0,0,5,7,1030,0,1952,0,98105,47.6647,-122.277,2230,6987,718000,3,6,2014,0,62,3928,4757,0,0,1
3,1.75,1930,7267,1.0,0,0,4,7,1330,600,1977,0,98002,47.3217,-122.205,1600,7698,279950,9,10,2014,0,37,5337,6098,0,1,0
3,2.5,2080,9612,1.0,0,3,4,8,1700,380,1940,0,98125,47.7293,-122.283,2560,10202,689000,21,10,2014,0,74,7532,7642,0,1,1
4,2.5,3520,9901,2.0,0,0,3,10,3520,0,1998,0,98074,47.6084,-122.011,3490,9667,828000,18,8,2014,0,16,6381,6177,0,0,0
2,1.0,890,8100,1.0,0,0,3,6,890,0,1942,0,98146,47.4839,-122.34,1260,8100,150000,25,6,2014,0,72,7210,6840,0,0,1
3,1.75,1640,3400,1.0,0,0,4,7,930,710,1926,0,98105,47.6694,-122.3,1380,3750,505400,1,3,2015,0,89,1760,2370,0,1,1
3,1.0,1040,5000,1.0,0,0,3,7,1040,0,1959,0,98146,47.5122,-122.358,1440,5000,217450,15,5,2014,0,55,3960,3560,0,0,1
4,2.5,2820,4174,2.0,0,0,3,9,2820,0,2004,0,98034,47.7112,-122.226,2560,4853,677000,18,12,2014,0,10,1354,2293,0,0,0
3,2.5,2590,7237,2.0,0,0,3,8,2590,0,2004,0,98125,47.7113,-122.309,1670,7648,620000,9,6,2014,0,10,4647,5978,0,0,1
3,2.25,1540,5449,1.0,0,0,2,7,1180,360,1989,0,98023,47.29,-122.358,1460,6740,176000,10,12,2014,0,25,3909,5280,0,1,0
3,1.0,960,7218,1.0,0,0,4,7,960,0,1969,0,98034,47.7278,-122.226,1580,9104,330000,14,4,2015,0,46,6258,7524,0,0,0
3,2.5,1190,8175,1.0,0,0,3,7,1190,0,1986,0,98055,47.4556,-122.203,2230,9520,290000,29,10,2014,0,28,6985,7290,0,0,0
4,2.5,2770,9532,2.0,0,0,4,9,2770,0,1988,0,98029,47.5688,-122.012,2770,9219,711000,15,7,2014,0,26,6762,6449,0,0,0
3,1.75,1060,8100,2.0,0,0,4,7,1060,0,1983,0,98038,47.3617,-122.047,1410,8100,295000,22,4,2015,0,32,7040,6690,0,0,0
5,3.25,4010,12110,2.0,0,0,3,11,4010,0,2003,0,98059,47.5228,-122.151,4010,12334,1100000,11,11,2014,0,11,8100,8324,0,0,0
3,2.0,1140,7078,1.0,0,0,4,7,1140,0,1991,0,98031,47.4057,-122.185,1460,7078,257500,25,9,2014,0,23,5938,5618,0,0,0
4,1.0,1910,16320,1.5,0,0,3,6,1910,0,1934,0,98106,47.5151,-122.366,1380,9000,240000,9,6,2014,0,80,14410,7620,0,0,1
4,2.5,2340,8955,2.0,0,0,3,9,2340,0,1990,0,98074,47.6283,-122.026,2340,8955,645000,12,12,2014,0,24,6615,6615,0,0,0
2,1.75,1170,2400,1.0,0,0,4,7,740,430,1903,0,98103,47.6653,-122.333,1570,3919,499000,6,5,2014,0,111,1230,2349,0,1,1
3,1.0,1290,9526,1.5,0,0,3,7,1290,0,1961,0,98034,47.7111,-122.213,1290,9508,321000,20,10,2014,0,53,8236,8218,0,0,0
3,2.5,1810,1658,3.0,0,0,3,8,1810,0,1998,0,98117,47.6955,-122.376,1470,1585,449000,22,8,2014,0,16,-152,115,0,0,1
3,2.5,1820,5280,1.0,0,0,4,7,910,910,1949,0,98117,47.6892,-122.375,1600,4820,515000,7,1,2015,0,66,3460,3220,0,1,1
4,1.5,2220,12385,1.0,0,0,3,8,1270,950,1978,0,98033,47.6734,-122.185,2030,8831,456000,2,10,2014,0,36,10165,6801,0,1,0
4,2.5,2920,7700,2.0,0,0,3,9,2920,0,2003,0,98019,47.7351,-121.975,2920,8943,515500,18,6,2014,0,11,4780,6023,0,0,0
4,2.5,2630,6100,2.0,0,0,3,8,2630,0,2004,0,98072,47.7735,-122.167,2360,5765,576925,19,11,2014,0,10,3470,3405,0,0,0
3,1.75,1320,10416,1.0,0,0,3,7,1320,0,1996,0,98031,47.3902,-122.208,1670,7991,243000,2,1,2015,0,19,9096,6321,0,0,0
3,2.0,1400,8640,1.0,0,0,5,7,1400,0,1968,0,98003,47.3182,-122.319,1270,9375,253400,28,5,2014,0,46,7240,8105,0,0,0
3,2.5,1600,3580,2.0,0,0,3,7,1600,0,2000,0,98178,47.4939,-122.261,2020,4327,292000,13,4,2015,0,15,1980,2307,0,0,1
3,2.5,1490,8005,1.0,0,0,3,7,1090,400,1976,0,98058,47.4359,-122.165,1880,7905,271500,3,12,2014,0,38,6515,6025,0,1,0
2,2.5,2170,6750,1.0,0,0,3,8,2170,0,2012,0,98053,47.7115,-122.014,2150,6074,765000,27,8,2014,0,2,4580,3924,0,0,0
3,3.25,1280,1730,2.0,0,0,3,8,1090,190,2005,0,98177,47.7032,-122.36,1280,2121,375000,12,3,2015,0,10,450,841,0,1,1
3,2.0,1620,9566,1.0,0,0,4,7,1620,0,1968,0,98059,47.474,-122.146,1660,10011,382880,11,5,2015,0,47,7946,8351,0,0,0
3,2.5,2630,10100,1.0,0,0,4,9,1580,1050,1967,0,98006,47.5638,-122.153,2400,9700,852500,9,6,2014,0,47,7470,7300,0,1,0
3,1.5,1240,8738,1.0,0,0,3,7,1240,0,1959,0,98005,47.5849,-122.17,1440,9344,475000,24,11,2014,0,55,7498,7904,0,0,0
3,1.75,1300,2580,1.0,0,0,5,7,820,480,1919,0,98115,47.674,-122.319,1180,2820,462000,23,5,2014,0,95,1280,1640,0,1,1
4,1.5,1890,7540,1.0,0,0,4,7,1890,0,1967,0,98155,47.7534,-122.318,1890,8515,330000,30,1,2015,0,48,5650,6625,0,0,1
3,2.25,1890,12236,1.0,0,0,3,8,1890,0,1978,0,98074,47.6232,-122.047,2390,12323,473000,25,7,2014,0,36,10346,9933,0,0,0
3,1.5,2440,7200,1.0,0,0,3,7,2440,0,1949,0,98118,47.5604,-122.274,1920,6900,550000,21,11,2014,0,65,4760,4980,0,0,1
3,2.25,1780,7280,1.0,0,2,3,7,1340,440,1972,0,98034,47.723,-122.215,2060,7280,449500,23,6,2014,0,42,5500,5220,0,1,0
4,2.75,2830,13059,2.0,0,0,3,10,2830,0,1998,0,98075,47.595,-121.986,3840,11596,744000,21,5,2014,0,16,10229,7756,0,0,0
4,2.0,2490,4700,1.0,0,0,4,7,1690,800,1952,0,98136,47.5254,-122.392,2240,5000,700000,7,5,2015,0,63,2210,2760,0,1,1
4,2.5,1560,12220,1.5,0,0,4,7,1560,0,1965,0,98027,47.5287,-122.053,1920,12220,511100,30,9,2014,0,49,10660,10300,0,0,0
3,2.5,1980,4500,2.0,0,0,3,7,1980,0,2012,0,98042,47.3671,-122.113,2200,4500,317950,16,9,2014,0,2,2520,2300,0,0,0
3,1.75,1490,11360,1.0,0,0,3,8,1490,0,1975,0,98008,47.5896,-122.12,2350,10320,490000,15,8,2014,0,39,9870,7970,0,0,0
4,3.5,3090,4060,2.0,0,0,3,8,2420,670,1992,0,98144,47.5733,-122.287,1720,4080,760000,19,2,2015,0,23,970,2360,0,1,1
3,2.25,1580,8659,1.0,0,0,4,7,1220,360,1961,0,98011,47.7599,-122.215,1970,9650,475000,21,4,2015,0,54,7079,7680,0,1,0
3,2.75,2692,6197,2.0,0,0,3,9,2692,0,2007,0,98030,47.3569,-122.202,2336,5700,435000,26,3,2015,0,8,3505,3364,0,0,0
3,2.5,1740,3690,2.0,0,0,3,8,1740,0,2000,0,98065,47.5345,-121.867,2100,4944,399000,1,11,2014,0,14,1950,2844,0,0,0
3,2.0,1940,3800,1.0,0,0,4,7,1050,890,1927,0,98115,47.6842,-122.309,1700,3800,627000,26,8,2014,0,87,1860,2100,0,1,1
4,2.5,2150,5100,1.5,0,0,3,7,1290,860,1991,0,98106,47.5338,-122.36,1920,5100,346500,2,10,2014,0,23,2950,3180,0,1,1
3,1.5,1320,8000,1.0,0,0,3,7,1320,0,1957,0,98008,47.6027,-122.122,1720,8100,412000,14,4,2015,0,58,6680,6380,0,0,0
3,1.75,1850,9655,1.0,0,0,3,7,1100,750,1959,0,98155,47.7358,-122.319,1480,8683,373000,5,11,2014,0,55,7805,7203,0,1,1
4,2.25,2880,8882,2.0,0,0,4,8,2480,400,1965,0,98115,47.6999,-122.284,2460,9610,725000,8,8,2014,0,49,6002,7150,0,1,1
6,2.5,2420,11662,1.0,0,2,4,7,1420,1000,1965,0,98188,47.4459,-122.278,1630,11662,376000,13,8,2014,0,49,9242,10032,0,1,1
3,1.0,2020,4120,1.5,0,0,4,7,1520,500,1929,0,98118,47.5514,-122.271,1200,4635,552500,5,8,2014,0,85,2100,3435,0,1,1
5,2.0,2280,19000,1.5,0,0,3,6,2280,0,1924,0,98166,47.4683,-122.359,1790,11800,365000,26,6,2014,0,90,16720,10010,0,0,1
4,2.25,2550,9736,1.0,0,0,4,8,2550,0,1967,0,98002,47.3193,-122.212,1770,9686,315000,5,3,2015,0,48,7186,7916,0,0,0
4,2.0,1540,5110,1.0,0,0,3,7,1540,0,1957,0,98118,47.5164,-122.268,1540,5110,262500,31,3,2015,0,58,3570,3570,0,0,1
3,2.25,2280,6150,2.0,0,2,3,8,2280,0,1984,0,98136,47.5423,-122.385,1920,6150,660000,4,11,2014,0,30,3870,4230,0,0,1
4,2.5,2450,6941,2.0,0,0,3,7,2450,0,2006,0,98042,47.4006,-122.162,3300,6941,340000,13,4,2015,0,9,4491,3641,0,0,0
5,2.5,2950,5500,1.5,0,0,5,7,1720,1230,1918,0,98144,47.5785,-122.293,2200,5000,660500,2,7,2014,0,96,2550,2800,0,1,1
1,1.0,690,1950,1.0,0,0,3,6,690,0,1928,0,98117,47.6849,-122.374,1650,4864,280000,27,6,2014,0,86,1260,3214,0,0,1
1,1.0,800,2480,1.0,0,0,4,6,800,0,1919,0,98108,47.5581,-122.316,1490,4650,267000,25,8,2014,0,95,1680,3160,0,0,1
3,2.25,1840,11403,2.0,0,0,3,8,1840,0,1993,0,98045,47.4862,-121.797,2150,11403,417000,22,9,2014,0,21,9563,9253,0,0,0
3,1.0,1170,9730,1.0,0,0,3,7,1170,0,1968,1986,98055,47.4562,-122.196,1680,10125,252000,14,7,2014,18,46,8560,8445,1,0,0
5,1.75,2344,4800,1.5,0,0,4,7,1544,800,1921,0,98103,47.6537,-122.335,1770,4200,791000,20,3,2015,0,94,2456,2430,0,1,1
1,1.0,1230,3774,1.0,0,0,4,6,830,400,1924,0,98103,47.6886,-122.354,1300,3774,415000,10,9,2014,0,90,2544,2474,0,1,1
3,1.75,1150,13278,1.0,0,0,5,7,1150,0,1966,0,98053,47.6384,-121.969,1560,12400,339000,24,7,2014,0,48,12128,10840,0,0,0
3,1.0,1140,10477,1.0,0,0,3,6,1140,0,1942,0,98168,47.4874,-122.306,1190,9750,158000,4,5,2015,0,73,9337,8560,0,0,1
3,1.0,1660,5100,1.0,0,0,3,7,1260,400,1957,0,98136,47.5323,-122.383,1230,5100,535000,11,8,2014,0,57,3440,3870,0,1,1
3,1.0,1080,4120,1.0,0,0,3,7,980,100,1919,0,98115,47.6771,-122.319,1280,3090,818900,4,3,2015,0,96,3040,1810,0,1,1
4,2.0,1720,4000,1.0,0,0,3,7,1420,300,1950,0,98105,47.6651,-122.285,1350,1281,550000,22,4,2015,0,65,2280,-69,0,1,1
2,1.0,590,8717,1.0,0,0,3,6,590,0,1953,0,98133,47.7343,-122.335,1370,6760,240000,6,3,2015,0,62,8127,5390,0,0,1
3,3.25,1290,1230,2.0,0,2,3,9,1090,200,2008,0,98119,47.6367,-122.37,1710,1797,590000,17,9,2014,0,6,-60,87,0,1,1
3,2.5,2040,10086,2.0,0,0,3,8,2040,0,1987,0,98052,47.679,-122.113,1940,10272,542500,7,7,2014,0,27,8046,8332,0,0,0
3,1.0,970,7854,1.0,0,0,4,7,970,0,1980,0,98056,47.4899,-122.185,1480,7800,262500,2,1,2015,0,35,6884,6320,0,0,0
6,3.0,2620,4350,1.0,0,0,3,7,1760,860,1957,0,98117,47.678,-122.373,1760,4300,900000,11,2,2015,0,58,1730,2540,0,1,1
3,1.75,1750,14400,1.0,0,0,4,7,1750,0,1951,0,98166,47.4535,-122.361,2030,14400,368000,13,8,2014,0,63,12650,12370,0,0,1
4,3.5,3620,6499,2.5,0,0,3,9,3620,0,2003,2009,98177,47.7326,-122.36,2330,7200,825000,22,10,2014,6,11,2879,4870,1,0,1
3,2.0,1660,7509,1.0,0,0,3,7,1660,0,2002,0,98059,47.4872,-122.144,2380,8598,343500,14,1,2015,0,13,5849,6218,0,0,0
4,1.0,1360,6000,1.0,0,0,4,6,1020,340,1944,0,98168,47.4783,-122.285,1230,6000,273500,4,12,2014,0,70,4640,4770,0,1,1
3,2.5,2044,5610,2.0,0,0,4,9,2044,0,1996,0,98033,47.6791,-122.209,2440,5610,1000000,20,1,2015,0,19,3566,3170,0,0,0
5,3.0,2370,6000,1.5,0,2,3,8,1340,1030,1926,2003,98107,47.6645,-122.358,1350,4500,770000,29,10,2014,77,88,3630,3150,1,1,1
3,2.0,1170,3868,1.5,0,0,4,7,1170,0,1925,0,98118,47.5543,-122.29,1400,3800,400000,4,3,2015,0,90,2698,2400,0,0,1
3,1.0,1660,7210,1.0,0,0,3,7,1100,560,1963,0,98001,47.3394,-122.281,1660,7245,225000,13,5,2014,0,51,5550,5585,0,1,0
4,1.0,2020,18150,1.0,0,0,4,7,2020,0,1955,0,98028,47.739,-122.249,1530,11970,345000,5,3,2015,0,60,16130,10440,0,0,0
3,2.5,2530,8116,2.0,0,0,3,8,2530,0,2001,0,98011,47.7597,-122.167,2280,8791,450000,1,10,2014,0,13,5586,6511,0,0,0
2,1.0,870,5635,1.0,0,0,3,7,870,0,1948,0,98116,47.5676,-122.398,1310,5750,334850,18,7,2014,0,66,4765,4440,0,0,1
5,3.0,3670,9600,1.0,0,1,3,8,1980,1690,1955,0,98108,47.5648,-122.316,1730,4933,605000,7,1,2015,0,60,5930,3203,0,1,1
5,3.5,3180,14000,2.0,0,0,5,10,3180,0,1997,0,98006,47.5501,-122.128,3670,14450,760000,21,11,2014,0,17,10820,10780,0,0,0
2,1.5,1870,12960,1.5,0,0,4,6,1350,520,1926,0,98118,47.5234,-122.288,1380,7800,390000,6,10,2014,0,88,11090,6420,0,1,1
3,2.5,1940,5660,2.0,0,0,3,8,1940,0,2001,0,98072,47.7511,-122.17,2110,4581,488000,4,8,2014,0,13,3720,2471,0,0,0
5,4.5,4820,13165,2.0,0,0,4,11,3950,870,1990,0,98077,47.7295,-122.057,3880,13810,1060000,22,2,2015,0,25,8345,9930,0,1,0
3,2.25,2930,6000,2.0,0,2,3,11,1920,1010,2000,0,98112,47.6301,-122.301,1870,5040,1390000,22,8,2014,0,14,3070,3170,0,1,1
2,1.0,800,3000,1.0,0,0,3,6,800,0,1904,0,98118,47.5602,-122.292,1640,3400,299950,15,9,2014,0,110,2200,1760,0,0,1
3,3.25,2200,4800,2.0,0,2,3,7,1910,290,1943,1996,98103,47.6551,-122.353,1410,4800,818000,28,4,2015,53,72,2600,3390,1,1,1
3,2.5,2400,9701,1.0,0,0,3,9,2400,0,1990,0,98023,47.3081,-122.392,2400,8258,355000,28,5,2014,0,24,7301,5858,0,0,0
5,3.25,5570,9600,2.0,0,0,5,9,3860,1710,1952,0,98105,47.6708,-122.262,3170,10400,1860000,15,10,2014,0,62,4030,7230,0,1,1
3,3.25,1980,2850,3.0,0,0,3,7,1980,0,1987,0,98103,47.6597,-122.331,1630,4560,660000,23,6,2014,0,27,870,2930,0,0,1
3,2.5,1720,3676,2.0,0,0,3,7,1720,0,1992,0,98031,47.4039,-122.188,1720,3510,255950,25,6,2014,0,22,1956,1790,0,0,0
3,1.5,1930,11092,1.0,0,0,3,7,1500,430,1983,0,98074,47.634,-122.033,1230,10964,475000,21,8,2014,0,31,9162,9734,0,1,0
3,1.75,1110,9012,1.0,0,0,4,7,1110,0,1966,0,98052,47.6563,-122.131,1800,8679,452000,1,7,2014,0,48,7902,6879,0,0,0
3,1.75,1970,8200,1.0,0,0,3,7,1270,700,1964,0,98168,47.4731,-122.327,1890,8348,315000,4,8,2014,0,50,6230,6458,0,1,1
3,2.5,1630,2844,2.0,0,0,3,7,1630,0,2003,0,98118,47.5413,-122.288,1610,2582,330950,29,1,2015,0,12,1214,972,0,0,1
4,2.25,2270,9464,1.5,0,0,4,7,1520,750,1940,0,98146,47.5007,-122.359,1770,9464,479000,25,2,2015,0,75,7194,7694,0,1,1
3,2.5,1212,1174,3.0,0,0,3,7,1212,0,2004,0,98125,47.7145,-122.311,1256,1226,340000,16,6,2014,0,10,-38,-30,0,0,1
4,2.0,1890,8362,1.0,0,0,3,7,1890,0,1966,0,98188,47.4377,-122.279,1600,9257,312000,16,9,2014,0,48,6472,7657,0,0,1
3,2.25,1370,6600,2.0,0,0,4,7,1370,0,1993,0,98038,47.3504,-122.035,1370,6600,305000,18,3,2015,0,22,5230,5230,0,0,0
3,2.5,1770,7336,2.0,0,0,3,7,1770,0,1996,0,98030,47.3639,-122.185,1770,7349,270000,2,12,2014,0,18,5566,5579,0,0,0
3,2.5,1710,1664,2.0,0,0,5,8,1300,410,2003,0,98199,47.6456,-122.383,1470,5400,529999,5,6,2014,0,11,-46,3930,0,1,1
2,1.0,1190,6967,1.0,0,0,3,7,1190,0,1946,0,98040,47.5896,-122.243,1700,6968,587100,23,7,2014,0,68,5777,5268,0,0,0
3,2.0,1690,16061,1.0,0,0,3,7,1690,0,1984,0,98074,47.6359,-122.035,1280,12436,459800,18,11,2014,0,30,14371,11156,0,0,0
4,1.75,1680,7800,1.0,0,0,3,7,1330,350,1966,0,98008,47.6286,-122.118,1680,7210,451000,12,12,2014,0,48,6120,5530,0,1,0
3,3.25,4340,4947,2.0,0,3,3,11,3060,1280,1993,0,98107,47.6709,-122.406,1680,5250,2480000,17,6,2014,0,21,607,3570,0,1,1
5,2.0,2040,6180,2.0,0,0,4,7,2040,0,1908,0,98118,47.5503,-122.28,1870,4365,475000,17,11,2014,0,106,4140,2495,0,0,1
4,1.5,1920,11595,1.0,0,0,4,7,1920,0,1962,0,98002,47.2858,-122.212,1400,10550,235000,12,3,2015,0,53,9675,9150,0,0,0
3,1.5,1330,9548,1.0,0,0,5,7,1330,0,1967,0,98042,47.3675,-122.11,1420,9548,230000,11,7,2014,0,47,8218,8128,0,0,0
4,1.0,1630,2566,1.5,0,0,3,7,1630,0,1921,0,98122,47.6183,-122.3,1220,2314,581000,1,7,2014,0,93,936,1094,0,0,1
3,1.0,1520,9030,1.0,0,0,3,7,1520,0,1956,0,98007,47.587,-122.134,1470,8712,415000,2,7,2014,0,58,7510,7242,0,0,0
3,1.0,1520,9030,1.0,0,0,3,7,1520,0,1956,0,98007,47.587,-122.134,1470,8712,522500,16,10,2014,0,58,7510,7242,0,0,0
3,1.5,1340,7725,1.0,0,0,4,8,1340,0,1967,0,98056,47.5389,-122.173,1990,7725,383000,5,1,2015,0,48,6385,5735,0,0,0
3,1.75,2500,8289,1.0,0,0,4,7,1250,1250,1958,0,98056,47.4973,-122.177,1710,8205,315000,30,10,2014,0,56,5789,6495,0,1,0
3,2.0,1460,3600,2.0,0,0,3,7,1460,0,1902,0,98122,47.6123,-122.314,1590,1210,591000,22,9,2014,0,112,2140,-380,0,0,1
4,2.25,3140,12150,2.0,0,0,3,9,3140,0,1979,0,98074,47.6361,-122.047,2370,12054,750000,19,12,2014,0,35,9010,9684,0,0,0
3,1.75,2150,4333,1.0,0,0,3,7,1200,950,1956,0,98136,47.5537,-122.388,1480,6500,430000,16,5,2014,0,58,2183,5020,0,1,1
2,1.0,710,4800,1.0,0,0,2,6,710,0,1950,0,98112,47.6212,-122.298,1480,1721,480000,23,1,2015,0,65,4090,241,0,0,1
3,1.0,1460,7200,1.0,0,0,3,7,1260,200,1906,0,98103,47.6875,-122.336,1430,4650,538000,13,6,2014,0,108,5740,3220,0,1,1
2,2.75,730,5000,1.0,0,0,3,7,730,0,1929,0,98126,47.5381,-122.374,980,5000,464000,5,12,2014,0,85,4270,4020,0,0,1
3,2.5,1440,3840,2.0,0,0,3,7,1440,0,2001,0,98053,47.6873,-122.043,1600,3131,476000,2,1,2015,0,14,2400,1531,0,0,0
3,2.0,1130,16875,1.0,0,0,4,7,1130,0,1947,0,98155,47.7489,-122.3,1600,14300,349500,26,3,2015,0,68,15745,12700,0,0,1
3,2.25,1810,8262,2.0,0,0,4,8,1810,0,1981,0,98023,47.2994,-122.37,1820,8262,270000,7,2,2015,0,34,6452,6442,0,0,0
4,2.5,2740,8336,2.0,0,0,4,9,2740,0,1990,0,98031,47.3904,-122.176,2460,9189,395000,13,10,2014,0,24,5596,6729,0,0,0
3,2.5,1690,4088,2.0,0,0,3,7,1690,0,2004,0,98053,47.6779,-122.034,1950,4088,498000,10,4,2015,0,11,2398,2138,0,0,0
3,2.5,1470,4675,2.0,0,0,3,7,1470,0,1999,0,98065,47.5261,-121.827,1500,4385,339900,30,1,2015,0,16,3205,2885,0,0,0
3,2.5,2830,9972,2.0,0,0,3,9,2830,0,2006,0,98019,47.7382,-121.975,3557,9159,539000,2,9,2014,0,8,7142,5602,0,0,0
3,1.0,1410,9704,1.0,0,0,3,8,1140,270,1983,0,98074,47.6203,-122.036,1910,13639,400000,26,2,2015,0,32,8294,11729,0,1,0
3,2.5,2170,11745,1.0,0,0,4,7,1410,760,1967,0,98058,47.4342,-122.17,1860,8643,225000,18,2,2015,0,48,9575,6783,0,1,0
3,2.25,1340,4080,1.5,0,0,3,6,1170,170,1907,0,98144,47.5722,-122.291,1670,4080,330000,10,9,2014,0,107,2740,2410,0,1,1
3,3.0,2480,5500,2.0,0,3,3,10,1730,750,1950,2005,98199,47.6466,-122.404,2950,5670,1390000,26,6,2014,55,64,3020,2720,1,1,1
4,2.75,2240,7200,1.0,0,0,3,7,1140,1100,1967,0,98001,47.3357,-122.275,1580,7416,260000,20,12,2014,0,47,4960,5836,0,1,0
4,2.5,2990,8913,2.0,0,0,4,9,2990,0,1991,0,98058,47.4353,-122.159,2740,8030,469900,27,6,2014,0,23,5923,5290,0,0,0
6,1.75,2120,3801,1.5,0,0,4,7,1220,900,1925,0,98115,47.6832,-122.311,1850,4181,493000,12,11,2014,0,89,1681,2331,0,1,1
4,1.75,1700,6000,1.0,0,0,3,7,1700,0,1967,0,98002,47.3252,-122.208,1280,6000,148900,11,12,2014,0,47,4300,4720,0,0,0
2,2.5,1620,14467,2.0,0,0,3,7,1620,0,1981,0,98074,47.6306,-122.035,1470,13615,475000,18,11,2014,0,33,12847,12145,0,0,0
2,1.0,760,4000,1.0,0,0,3,7,760,0,1944,0,98117,47.6896,-122.396,1520,4000,415000,23,12,2014,0,70,3240,2480,0,0,1
3,1.0,1230,6000,1.0,0,0,4,7,1230,0,1967,0,98002,47.3256,-122.209,1240,6000,229500,7,7,2014,0,47,4770,4760,0,0,0
4,2.5,2030,11375,1.0,0,0,3,7,1330,700,1969,0,98028,47.7765,-122.261,1500,9160,385000,10,12,2014,0,45,9345,7660,0,1,0
2,1.0,970,2700,1.0,0,0,4,7,770,200,1926,0,98115,47.6852,-122.312,1570,3348,425000,8,8,2014,0,88,1730,1778,0,1,1
2,1.0,1000,4179,1.0,0,0,5,5,1000,0,1914,0,98002,47.297,-122.227,1010,6327,189900,22,7,2014,0,100,3179,5317,0,0,0
2,1.0,750,6480,1.0,0,0,3,6,750,0,1943,0,98106,47.5195,-122.35,1050,6390,238000,2,1,2015,0,72,5730,5340,0,0,1
4,2.5,2620,16200,1.0,0,2,4,7,1570,1050,1950,1993,98033,47.6623,-122.196,3050,11875,968060,19,8,2014,43,64,13580,8825,1,1,0
4,1.5,2220,9496,1.0,0,0,4,7,1490,730,1954,0,98004,47.6233,-122.206,1800,8286,921000,16,6,2014,0,60,7276,6486,0,1,0
5,1.75,3000,6000,1.0,0,0,5,7,1500,1500,1958,0,98178,47.492,-122.225,2230,7125,380000,7,5,2014,0,56,3000,4895,0,1,1
4,2.5,1980,5400,2.0,0,0,3,8,1980,0,1998,0,98056,47.5182,-122.207,1980,5400,449000,22,10,2014,0,16,3420,3420,0,0,0
4,1.0,1600,5500,1.5,0,0,4,7,1600,0,1946,0,98117,47.6983,-122.393,1900,5500,625000,9,7,2014,0,68,3900,3600,0,0,1
4,2.25,2000,9000,1.0,0,0,4,8,2000,0,1978,0,98023,47.3125,-122.387,2190,8374,318989,21,5,2014,0,36,7000,6184,0,0,0
3,1.5,1310,1266,2.0,0,0,3,8,1120,190,2002,0,98116,47.5663,-122.408,1310,1378,445000,10,10,2014,0,12,-44,68,0,1,1
3,1.0,1120,8549,1.0,0,0,3,7,1120,0,1952,0,98004,47.6294,-122.205,1440,8640,750000,5,2,2015,0,63,7429,7200,0,0,0
3,2.5,3320,11875,1.0,0,0,5,10,3320,0,1979,0,98034,47.7212,-122.26,3730,11875,959000,6,3,2015,0,36,8555,8145,0,0,0
3,2.5,2370,9102,2.0,0,0,3,9,2370,0,1990,0,98023,47.3067,-122.394,2530,9883,330000,2,12,2014,0,24,6732,7353,0,0,0
2,1.5,830,1241,2.0,0,0,3,7,830,0,2005,0,98119,47.6363,-122.368,1610,2666,425000,16,2,2015,0,10,411,1056,0,0,1
3,1.0,940,7913,1.0,0,0,3,6,940,0,1948,0,98155,47.7657,-122.321,940,7913,280000,2,12,2014,0,66,6973,6973,0,0,1
3,2.25,2020,3600,2.0,0,0,3,8,2020,0,1998,0,98033,47.6678,-122.165,2070,3699,556000,21,5,2014,0,16,1580,1629,0,0,0
3,2.0,1450,6081,1.0,0,0,4,7,1450,0,1969,0,98155,47.7522,-122.278,1880,6000,405000,4,12,2014,0,45,4631,4120,0,0,1
5,1.0,1170,6757,1.0,0,0,4,6,800,370,1944,0,98125,47.7332,-122.304,1590,6794,397000,27,6,2014,0,70,5587,5204,0,1,1
4,2.75,3555,6565,2.0,0,0,3,9,3555,0,2014,0,98053,47.6847,-122.017,3625,5637,895990,24,7,2014,0,0,3010,2012,0,0,0
3,2.0,1610,14046,2.0,0,0,3,7,1610,0,1933,1988,98028,47.7704,-122.264,2410,9000,259000,28,8,2014,55,81,12436,6590,1,0,0
3,2.5,1680,2096,2.0,0,0,3,8,1380,300,2008,0,98117,47.6904,-122.37,1360,2096,518000,19,5,2014,0,6,416,736,0,1,1
3,1.75,1380,8182,1.0,0,0,5,7,1380,0,1942,0,98133,47.7513,-122.349,1300,8188,425000,22,7,2014,0,72,6802,6888,0,0,1
2,1.0,1040,13920,1.0,0,0,3,6,1040,0,1973,0,98198,47.3756,-122.306,1100,7575,182500,8,8,2014,0,41,12880,6475,0,0,1
3,1.5,1380,3031,1.5,0,0,4,7,1380,0,1929,0,98117,47.6889,-122.38,1440,4005,549900,16,7,2014,0,85,1651,2565,0,0,1
3,1.75,1850,16863,1.0,0,0,4,7,1280,570,1980,0,98034,47.7166,-122.225,1790,9000,445000,16,9,2014,0,34,15013,7210,0,1,0
2,1.75,1740,5400,1.0,0,0,4,7,990,750,1946,0,98115,47.6971,-122.282,1980,5400,452000,6,6,2014,0,68,3660,3420,0,1,1
5,1.75,1920,6500,1.0,0,0,3,7,1260,660,1951,0,98112,47.6394,-122.308,1970,5500,715000,4,11,2014,0,63,4580,3530,0,1,1
3,2.5,2010,5200,2.0,0,0,3,8,2010,0,1989,0,98034,47.7142,-122.203,1860,4400,559000,11,9,2014,0,25,3190,2540,0,0,0
4,1.75,1860,7350,1.0,0,0,4,7,1090,770,1977,0,98031,47.3979,-122.174,1710,7350,250000,15,10,2014,0,37,5490,5640,0,1,0
5,4.0,4390,6656,2.0,0,0,3,9,2930,1460,2008,0,98199,47.648,-122.397,1560,6656,1230000,23,9,2014,0,6,2266,5096,0,1,1
4,2.5,2880,7386,2.0,0,0,4,9,2880,0,1987,0,98058,47.4397,-122.15,2420,7663,440000,14,11,2014,0,27,4506,5243,0,0,0
6,2.25,2820,15600,1.5,0,2,5,7,1970,850,1940,0,98166,47.4635,-122.362,2520,7797,543200,8,5,2014,0,74,12780,5277,0,1,1
1,1.0,750,4000,1.0,0,0,3,6,750,0,1918,0,98136,47.5243,-122.39,1770,4850,250000,1,6,2014,0,96,3250,3080,0,0,1
4,2.5,1750,9000,1.0,0,0,3,8,1410,340,1977,2003,98052,47.6403,-122.105,2120,9600,625000,28,7,2014,26,37,7250,7480,1,1,0
3,1.0,1540,3399,1.5,0,0,3,7,1200,340,1926,0,98117,47.6853,-122.359,1500,3914,530100,13,6,2014,0,88,1859,2414,0,1,1
2,1.75,1140,936,2.0,0,0,3,8,940,200,2014,0,98105,47.6647,-122.284,1160,1327,549900,21,7,2014,0,0,-204,167,0,1,1
4,1.5,1560,6534,1.0,0,0,4,7,1560,0,1962,0,98007,47.6012,-122.152,1560,6969,430000,11,3,2015,0,53,4974,5409,0,0,0
3,2.5,2960,6856,2.0,0,0,3,10,2960,0,2009,0,98074,47.5906,-122.057,3320,6856,835000,10,12,2014,0,5,3896,3536,0,0,0
4,2.75,2140,13000,1.0,0,0,3,7,1320,820,1968,0,98028,47.7683,-122.252,2360,11000,409500,7,5,2014,0,46,10860,8640,0,1,0
4,2.5,1600,6765,1.0,0,0,3,7,830,770,1947,2011,98106,47.5469,-122.365,1600,8942,329000,20,5,2014,64,67,5165,7342,1,1,1
4,2.75,2080,4000,1.5,0,0,3,8,2080,0,1912,2000,98107,47.6737,-122.358,1730,5000,940000,22,5,2014,88,102,1920,3270,1,0,1
3,2.0,1560,3200,1.5,0,0,3,7,1560,0,1910,2007,98109,47.6398,-122.356,1240,3600,539950,13,8,2014,97,104,1640,2360,1,0,1
5,3.0,2510,4125,1.5,0,3,5,8,1590,920,1925,0,98144,47.5968,-122.29,2190,5415,881000,11,6,2014,0,89,1615,3225,0,1,1
3,1.0,960,5424,1.5,0,0,3,6,960,0,1916,0,98115,47.6997,-122.32,1550,5687,362500,4,8,2014,0,98,4464,4137,0,0,1
4,2.75,3310,6166,2.0,0,0,3,9,3310,0,2008,0,98065,47.521,-121.877,3200,7027,658000,29,5,2014,0,6,2856,3827,0,0,0
3,1.5,1080,9774,1.0,0,0,3,7,1080,0,1968,0,98023,47.3155,-122.401,1190,9611,218250,24,11,2014,0,46,8694,8421,0,0,0
4,2.5,2860,12394,2.0,0,0,3,10,2860,0,1999,0,98075,47.5832,-122.026,3070,8515,655000,22,5,2014,0,15,9534,5445,0,0,0
3,2.0,1490,7599,1.0,0,0,3,7,1490,0,1990,0,98042,47.3687,-122.088,1560,7710,255000,5,3,2015,0,25,6109,6150,0,0,0
3,1.0,1210,7175,1.0,0,0,3,7,1210,0,1918,0,98106,47.5339,-122.356,1640,5850,215000,15,1,2015,0,97,5965,4210,0,0,1
3,1.75,2240,5657,1.5,0,2,4,8,1910,330,1941,0,98105,47.6621,-122.27,2970,5657,1270000,23,2,2015,0,74,3417,2687,0,1,1
3,2.5,1600,5960,2.0,0,2,5,8,1600,0,1910,0,98168,47.4758,-122.265,1410,13056,424305,2,4,2015,0,105,4360,11646,0,0,1
4,1.75,2090,4300,1.5,0,0,4,7,1250,840,1925,0,98136,47.5555,-122.397,1670,5000,494000,20,5,2014,0,89,2210,3330,0,1,1
4,2.5,2260,3713,2.0,0,0,3,9,2260,0,2003,0,98034,47.7247,-122.165,2260,3713,560000,5,6,2014,0,11,1453,1453,0,0,0
3,1.0,1200,7000,2.0,0,0,1,7,1200,0,1908,0,98116,47.5883,-122.384,3290,6000,130000,24,9,2014,0,106,5800,2710,0,0,1
5,3.0,2240,15435,1.0,0,1,5,7,1390,850,1952,0,98155,47.7426,-122.288,2240,10750,480000,9,12,2014,0,62,13195,8510,0,1,1
3,1.75,1550,4054,1.5,0,0,4,7,1550,0,1926,0,98115,47.6743,-122.301,1510,3889,475000,11,8,2014,0,88,2504,2379,0,0,1
4,1.75,2130,8151,1.0,0,0,4,7,1330,800,1967,0,98031,47.3932,-122.201,1600,8587,285000,25,2,2015,0,48,6021,6987,0,1,0
5,3.0,2870,5700,1.0,0,0,3,7,1950,920,1964,0,98103,47.6621,-122.33,1730,5529,765000,30,6,2014,0,50,2830,3799,0,1,1
2,1.0,1160,5750,1.0,0,0,4,6,1160,0,1924,0,98065,47.5322,-121.829,1160,8250,208000,27,3,2015,0,91,4590,7090,0,0,0
3,2.5,2430,5000,2.0,0,0,3,8,2430,0,2001,0,98042,47.3786,-122.127,2910,5620,372000,3,10,2014,0,13,2570,2710,0,0,0
2,1.0,900,5512,1.0,0,0,3,7,900,0,1947,0,98115,47.6877,-122.289,1270,5512,470000,9,12,2014,0,67,4612,4242,0,0,1
5,2.75,2830,8925,1.5,0,0,3,7,2830,0,1967,0,98034,47.731,-122.179,1700,8539,451000,26,6,2014,0,47,6095,6839,0,0,0
4,1.75,1620,8132,1.0,0,0,3,8,1620,0,1974,0,98052,47.6788,-122.11,1920,8400,442200,27,8,2014,0,40,6512,6480,0,0,0
4,2.5,2510,8580,2.0,0,0,4,8,2510,0,1991,2012,98023,47.295,-122.37,2290,7809,330000,25,8,2014,21,23,6070,5519,1,0,0
3,1.75,1790,5120,1.0,0,0,4,6,940,850,1949,0,98106,47.5277,-122.355,1160,5120,335000,24,9,2014,0,65,3330,3960,0,1,1
3,2.0,1640,13249,1.0,0,0,3,7,1640,0,1995,0,98032,47.3589,-122.281,1640,9240,280000,14,11,2014,0,19,11609,7600,0,0,0
3,1.75,2240,6050,1.0,0,0,4,8,1250,990,1950,0,98116,47.5658,-122.4,1720,6050,625000,22,8,2014,0,64,3810,4330,0,1,1
3,2.5,1870,3584,2.0,0,0,3,8,1870,0,2003,0,98058,47.4521,-122.121,1900,3920,345000,3,9,2014,0,11,1714,2020,0,0,0
4,1.0,1490,6000,1.5,0,0,3,7,1490,0,1918,0,98136,47.5518,-122.385,1700,6000,570000,5,1,2015,0,97,4510,4300,0,0,1
3,1.5,2230,8558,2.0,0,0,3,8,2230,0,1960,0,98040,47.5833,-122.219,2200,8558,685000,31,3,2015,0,55,6328,6358,0,0,0
3,1.75,1710,7210,1.0,0,0,4,7,1240,470,1974,0,98031,47.4094,-122.175,1840,7245,273148,2,9,2014,0,40,5500,5405,0,1,0
3,2.5,1620,7686,2.0,0,0,3,7,1620,0,1989,0,98038,47.3613,-122.053,1370,7686,246500,25,6,2014,0,25,6066,6316,0,0,0
5,2.5,2250,7176,1.0,0,0,3,7,1310,940,1983,0,98055,47.4486,-122.194,1550,9081,349950,6,4,2015,0,32,4926,7531,0,1,0
4,2.0,1700,2350,1.0,0,0,3,6,850,850,1926,2014,98117,47.6865,-122.366,1600,4160,545000,10,2,2015,88,89,650,2560,1,1,1
3,2.5,1502,1400,3.0,0,0,3,7,1502,0,2005,0,98115,47.6951,-122.305,1377,1466,403000,27,2,2015,0,10,-102,89,0,0,1
4,2.5,1900,4054,2.0,0,0,3,7,1900,0,2003,0,98042,47.3767,-122.124,2520,4085,299950,11,2,2015,0,12,2154,1565,0,0,0
3,2.5,3320,12840,1.0,0,0,3,10,2600,720,1990,0,98075,47.5783,-121.994,3230,14933,792000,1,5,2015,0,25,9520,11703,0,1,0
5,2.5,1980,10205,1.0,0,0,4,7,1080,900,1929,0,98115,47.699,-122.307,1310,5413,418000,2,10,2014,0,85,8225,4103,0,1,1
4,1.0,1670,8102,1.5,0,0,3,6,1670,0,1944,0,98166,47.4692,-122.355,1310,7906,332500,27,4,2015,0,71,6432,6596,0,0,1
2,1.0,1070,7386,1.0,0,0,3,6,1070,0,1949,0,98108,47.5434,-122.298,1330,6351,212000,21,1,2015,0,66,6316,5021,0,0,1
2,2.25,1800,2819,2.0,0,2,4,9,1800,0,1979,0,98008,47.6104,-122.113,1800,2755,542000,10,3,2015,0,36,1019,955,0,0,0
4,2.5,2980,8107,2.0,0,0,3,9,2980,0,2000,0,98065,47.5389,-121.876,2750,7760,622500,22,5,2014,0,14,5127,5010,0,0,0
3,1.75,1670,8511,1.0,0,0,3,7,1340,330,1985,0,98001,47.3257,-122.276,1580,7218,260000,29,8,2014,0,29,6841,5638,0,1,0
4,1.75,3080,6500,1.0,0,0,4,9,1700,1380,1941,0,98199,47.6353,-122.402,2960,5711,1140000,9,9,2014,0,73,3420,2751,0,1,1
3,1.0,940,10360,1.0,0,0,4,7,940,0,1964,0,98033,47.688,-122.19,2019,10360,500000,3,3,2015,0,51,9420,8341,0,0,0
5,2.25,1870,11411,1.0,0,0,4,8,1170,700,1961,0,98155,47.7445,-122.289,2420,10793,554000,18,6,2014,0,53,9541,8373,0,1,1
4,2.5,2070,4500,2.0,0,0,3,7,2070,0,2004,0,98038,47.3497,-122.026,2760,5173,343000,5,6,2014,0,10,2430,2413,0,0,0
2,1.75,950,15219,1.0,0,0,3,8,950,0,2009,0,98028,47.7723,-122.262,1560,12416,515000,24,4,2015,0,6,14269,10856,0,0,0
2,1.0,1290,6272,1.0,0,0,4,6,890,400,1922,0,98115,47.6777,-122.305,1260,5376,492000,12,7,2014,0,92,4982,4116,0,1,1
4,3.0,2570,8022,1.0,0,0,4,8,1370,1200,1984,0,98052,47.6956,-122.099,2090,8022,655000,13,2,2015,0,31,5452,5932,0,1,0
3,2.5,1600,6848,2.0,0,0,3,7,1600,0,2000,0,98001,47.3303,-122.271,1700,7210,290000,6,5,2015,0,15,5248,5510,0,0,0
4,1.5,2550,5055,2.0,0,0,4,10,2550,0,1910,0,98112,47.636,-122.301,1970,4431,952500,1,7,2014,0,104,2505,2461,0,0,1
2,1.0,1010,7500,1.0,0,0,3,7,1010,0,1941,0,98108,47.5283,-122.32,1220,6000,235000,22,8,2014,0,73,6490,4780,0,0,1
3,1.5,1720,7110,1.0,0,0,3,8,1720,0,1955,0,98106,47.5417,-122.355,1730,6840,323000,1,4,2015,0,60,5390,5110,0,0,1
3,2.5,2200,1970,2.0,0,0,3,9,1610,590,2008,0,98102,47.6426,-122.327,1890,3505,1050000,6,5,2014,0,6,-230,1615,0,1,1
2,1.0,1400,9600,1.5,0,0,4,6,1400,0,1941,0,98022,47.2113,-121.993,1230,9600,200000,29,1,2015,0,74,8200,8370,0,0,0
3,2.25,1830,7500,1.0,0,0,4,7,1330,500,1968,0,98155,47.7574,-122.31,1830,8720,419995,4,12,2014,0,46,5670,6890,0,1,1
3,3.0,3110,9015,1.0,0,4,4,10,1590,1520,1980,0,98033,47.6624,-122.202,3150,11447,1500000,10,3,2015,0,35,5905,8297,0,1,0
3,2.5,1600,7829,2.0,0,0,3,7,1600,0,1987,0,98034,47.7288,-122.227,1580,9104,455000,12,8,2014,0,27,6229,7524,0,0,0
3,1.0,1390,12823,1.0,0,0,4,7,1390,0,1968,0,98077,47.7438,-122.075,1390,10095,319000,13,5,2014,0,46,11433,8705,0,0,0
3,1.5,1200,6240,1.0,0,0,3,8,1030,170,1952,0,98112,47.6222,-122.287,2810,6240,718500,27,6,2014,0,62,5040,3430,0,1,1
2,1.0,1090,3160,1.0,0,0,3,7,840,250,1926,0,98109,47.6385,-122.344,1070,3160,474000,3,12,2014,0,88,2070,2090,0,1,1
4,2.0,2140,6360,2.0,0,0,3,7,1840,300,1945,0,98115,47.687,-122.286,1690,6360,615750,25,8,2014,0,69,4220,4670,0,1,1
3,2.5,2010,17362,2.0,0,0,3,8,2010,0,1994,0,98033,47.6904,-122.176,1920,7200,551000,14,11,2014,0,20,15352,5280,0,0,0
3,2.25,1500,7210,1.0,0,0,3,7,1150,350,1984,0,98023,47.3124,-122.352,1500,7210,230000,11,2,2015,0,31,5710,5710,0,1,0
4,2.5,3500,9198,2.0,0,0,3,9,3500,0,2004,0,98053,47.6785,-122.025,3990,8598,790000,11,7,2014,0,10,5698,4608,0,0,0
3,2.5,2660,1967,3.0,0,3,3,9,1870,790,2007,0,98119,47.6264,-122.363,1640,1369,1230000,26,3,2015,0,8,-693,-271,0,1,1
3,2.25,1440,6443,2.0,0,0,3,7,1440,0,1995,0,98019,47.7471,-121.979,1700,6749,325000,23,12,2014,0,19,5003,5049,0,0,0
4,2.75,2780,6207,2.0,0,0,3,8,2780,0,2001,0,98053,47.6867,-122.038,2660,5592,705000,1,8,2014,0,13,3427,2932,0,0,0
4,1.75,1580,8856,2.0,0,0,3,7,1580,0,1979,0,98045,47.4694,-121.745,1390,9490,259000,11,12,2014,0,35,7276,8100,0,0,0
3,1.5,1250,8700,1.0,0,0,4,7,1250,0,1959,0,98168,47.4744,-122.328,1300,8700,306000,4,12,2014,0,55,7450,7400,0,0,1
3,1.0,970,6828,1.0,0,0,3,6,970,0,1928,0,98106,47.5476,-122.36,1160,11666,315000,15,12,2014,0,86,5858,10506,0,0,1
3,1.0,1100,7650,1.0,0,0,3,7,1100,0,1952,0,98133,47.7219,-122.354,1430,7650,392500,13,4,2015,0,63,6550,6220,0,0,1
4,2.25,3240,12930,2.0,0,0,4,9,2730,510,1968,0,98040,47.5373,-122.22,2610,12884,1070000,12,11,2014,0,46,9690,10274,0,1,0
2,2.5,1290,1445,3.0,0,0,3,8,1290,0,1999,0,98117,47.6955,-122.376,1470,1503,350500,16,7,2014,0,15,155,33,0,0,1
4,3.5,3810,9792,2.0,0,0,3,9,3810,0,1938,2013,98146,47.5018,-122.38,1950,9792,825000,18,6,2014,75,76,5982,7842,1,0,1
4,1.0,1500,6360,1.5,0,0,3,6,1500,0,1944,0,98178,47.4979,-122.24,1190,6360,235000,8,8,2014,0,70,4860,5170,0,0,1
4,3.0,2400,3340,1.0,0,0,4,7,1200,1200,1964,0,98107,47.6646,-122.365,1520,3758,675000,12,5,2014,0,50,940,2238,0,1,1
4,1.0,1860,8505,1.0,0,0,4,7,1860,0,1955,0,98055,47.4406,-122.194,1560,8505,265000,1,10,2014,0,59,6645,6945,0,0,0
2,1.0,1450,7098,1.0,0,4,3,7,1450,0,1924,0,98109,47.63,-122.349,2390,6098,822500,12,8,2014,0,90,5648,3708,0,0,1
3,2.75,2260,4000,2.0,0,0,4,8,1540,720,1956,0,98109,47.6435,-122.353,2120,4000,705000,28,4,2015,0,59,1740,1880,0,1,1
6,4.75,5540,7200,2.5,0,2,4,11,3950,1590,1909,0,98119,47.6361,-122.366,2930,7200,2630000,8,12,2014,0,105,1660,4270,0,1,1
2,1.5,1300,1676,1.0,0,2,3,7,1300,0,1943,0,98122,47.6133,-122.308,1260,1740,685000,23,6,2014,0,71,376,480,0,0,1
4,2.0,1610,5000,2.0,0,0,5,7,1610,0,1946,0,98117,47.6775,-122.398,1300,4950,630000,20,10,2014,0,68,3390,3650,0,0,1
4,2.5,1820,11325,1.0,0,0,3,8,1390,430,1976,0,98166,47.4574,-122.361,1990,10802,359000,12,1,2015,0,39,9505,8812,0,1,1
4,5.0,5820,13906,2.0,0,0,3,11,3750,2070,1993,0,98042,47.3814,-122.164,2980,13000,784500,16,3,2015,0,22,8086,10020,0,1,0
3,2.0,2470,8800,2.0,0,0,3,9,2470,0,1961,2004,98040,47.5753,-122.222,2340,10980,850000,3,7,2014,43,53,6330,8640,1,0,0
3,2.5,3040,6054,2.0,0,0,3,9,3040,0,2005,0,98042,47.3508,-122.163,2650,6054,410000,3,9,2014,0,9,3014,3404,0,0,0
4,1.75,1120,8250,1.0,0,0,4,7,1120,0,1966,0,98058,47.4555,-122.177,1330,7975,252000,9,7,2014,0,48,7130,6645,0,0,0
3,1.0,1070,4800,1.0,0,0,3,6,970,100,1947,0,98126,47.5187,-122.377,1120,1198,265000,2,10,2014,0,67,3730,78,0,1,1
3,2.0,1560,8509,1.0,0,0,3,8,790,770,1969,0,98034,47.7261,-122.22,1410,7428,465000,18,9,2014,0,45,6949,6018,0,1,0
2,1.0,870,6552,1.0,0,0,3,6,870,0,1947,0,98133,47.7188,-122.353,1500,6678,240000,4,2,2015,0,68,5682,5178,0,0,1
3,1.0,1000,12000,1.0,0,0,3,7,1000,0,1959,0,98023,47.3321,-122.346,1490,14940,217000,31,7,2014,0,55,11000,13450,0,0,0
4,2.25,2520,4200,1.5,0,0,4,7,1510,1010,1909,0,98144,47.5814,-122.312,1460,4200,415000,6,8,2014,0,105,1680,2740,0,1,1
2,2.0,1700,7992,1.0,0,0,4,7,950,750,1980,0,98023,47.3031,-122.385,1700,8030,274000,22,12,2014,0,34,6292,6330,0,1,0
5,3.0,2150,6117,1.0,0,0,3,7,1370,780,2003,0,98106,47.538,-122.356,1990,6064,420000,23,2,2015,0,12,3967,4074,0,1,1
4,2.75,1590,6000,1.5,0,0,4,8,1590,0,1925,0,98112,47.6401,-122.299,1590,4000,1060000,18,3,2015,0,90,4410,2410,0,0,1
3,2.0,1800,5000,1.0,0,0,4,7,1080,720,1942,0,98115,47.6738,-122.297,1800,5000,618500,5,5,2014,0,72,3200,3200,0,1,1
3,1.5,1670,10800,1.0,0,0,4,8,1670,0,1956,0,98022,47.2004,-122.003,1670,9169,295000,9,1,2015,0,59,9130,7499,0,0,0
3,2.0,1010,12252,1.0,0,0,3,8,1010,0,1980,0,98074,47.6224,-122.045,1840,11497,400000,16,3,2015,0,35,11242,9657,0,0,0
3,2.5,2550,6677,2.0,0,0,3,8,2550,0,2002,0,98028,47.7336,-122.232,1930,7217,595000,26,3,2015,0,13,4127,5287,0,0,0
3,1.75,1350,7686,1.0,0,0,3,7,1350,0,1987,0,98038,47.3617,-122.052,1370,7686,261000,31,12,2014,0,27,6336,6316,0,0,0
5,2.5,1660,4000,1.5,0,0,5,8,1660,0,1929,0,98109,47.6452,-122.352,1210,4000,780000,16,10,2014,0,85,2340,2790,0,0,1
3,1.5,1390,5040,1.0,0,0,3,7,1090,300,1947,0,98105,47.6611,-122.282,1910,4800,589000,18,11,2014,0,67,3650,2890,0,1,1
3,1.75,1720,9125,1.0,0,0,4,7,1140,580,1981,0,98092,47.3173,-122.181,1120,7506,230000,5,3,2015,0,34,7405,6386,0,1,0
4,3.5,2980,2147,2.5,0,0,3,10,2490,490,2006,0,98029,47.5463,-121.995,2880,2428,690000,18,10,2014,0,8,-833,-452,0,1,0
4,2.25,2190,15491,2.0,0,0,3,8,2190,0,1981,0,98074,47.6299,-122.039,2090,15039,524000,29,1,2015,0,34,13301,12949,0,0,0
2,2.5,1230,987,2.0,0,0,3,7,1060,170,2011,0,98144,47.6007,-122.305,1290,1328,380000,22,5,2014,0,3,-243,38,0,1,1
3,1.0,1000,4080,1.0,0,0,4,7,740,260,1945,0,98126,47.5351,-122.381,1480,4080,357500,12,11,2014,0,69,3080,2600,0,1,1
3,2.0,2500,10697,1.0,0,0,3,8,2500,0,1994,0,98022,47.1927,-122.01,2560,9772,330000,27,10,2014,0,20,8197,7212,0,0,0
5,1.75,2240,4750,1.0,0,0,4,7,1120,1120,1920,0,98115,47.6727,-122.293,1980,4750,635000,9,3,2015,0,95,2510,2770,0,1,1
9,3.0,2820,4480,2.0,0,0,3,7,1880,940,1918,0,98105,47.6654,-122.307,2460,4400,934000,13,3,2015,0,97,1660,1940,0,1,1
2,1.75,1400,865,2.0,0,0,3,8,1110,290,2005,0,98029,47.5478,-121.999,1380,1107,358500,28,1,2015,0,10,-535,-273,0,1,0
3,1.5,1470,6867,1.0,0,0,3,8,1470,0,1955,0,98155,47.7495,-122.327,1470,6523,401000,6,10,2014,0,59,5397,5053,0,0,1
3,2.0,1820,7750,1.0,0,0,3,8,1820,0,1992,0,98023,47.3169,-122.352,2080,8084,270000,9,1,2015,0,23,5930,6004,0,0,0
4,2.0,2060,6000,1.0,0,1,4,8,1370,690,1954,0,98136,47.5237,-122.383,2060,6600,705000,14,10,2014,0,60,3940,4540,0,1,1
3,1.0,1540,7740,1.0,0,0,4,7,1540,0,1909,0,98126,47.522,-122.375,1220,7740,384950,2,9,2014,0,105,6200,6520,0,0,1
3,1.0,1210,9730,1.0,0,0,4,7,1210,0,1953,0,98133,47.762,-122.355,1470,9730,310000,15,7,2014,0,61,8520,8260,0,0,1
3,2.5,2550,6021,2.0,0,0,3,7,2550,0,2002,0,98030,47.3828,-122.211,2080,6021,353000,30,3,2015,0,13,3471,3941,0,0,0
2,1.0,1060,7700,1.0,0,0,3,7,820,240,1981,0,98055,47.4599,-122.205,1370,8833,170500,7,7,2014,0,33,6640,7463,0,1,0
4,3.25,4420,7850,2.0,1,4,3,11,3150,1270,2001,0,98008,47.572,-122.102,2760,8525,2700000,8,6,2014,0,13,3430,5765,0,1,0
3,1.5,1550,9126,1.0,0,0,5,7,1550,0,1957,0,98022,47.2012,-122.0,1450,9282,245000,25,9,2014,0,57,7576,7832,0,0,0
3,2.5,1190,1290,3.0,0,0,3,8,1190,0,2008,0,98107,47.6762,-122.378,1410,1923,469000,17,10,2014,0,6,100,513,0,0,1
3,1.0,1300,3550,1.5,0,0,3,7,1300,0,1927,0,98105,47.6696,-122.32,1410,4080,455000,8,6,2014,0,87,2250,2670,0,0,1
4,2.5,2430,5959,2.0,0,0,3,8,2430,0,2002,0,98092,47.3348,-122.19,2100,5414,305000,21,11,2014,0,12,3529,3314,0,0,0
5,3.5,3500,10155,2.0,0,0,3,10,2570,930,1996,0,98006,47.5415,-122.133,2940,10753,905000,23,6,2014,0,18,6655,7813,0,1,0
3,2.0,1680,7000,1.5,0,0,4,7,1680,0,1968,0,98002,47.2775,-122.203,1540,7480,219200,31,12,2014,0,46,5320,5940,0,0,0
3,1.5,1250,8004,1.0,0,0,3,7,1250,0,1965,0,98008,47.6285,-122.117,1450,7931,455000,23,2,2015,0,50,6754,6481,0,0,0
2,1.0,1020,8100,1.0,0,0,3,6,1020,0,1940,0,98168,47.4971,-122.334,1200,12500,195000,27,6,2014,0,74,7080,11300,0,0,1
3,1.0,1510,4178,2.0,0,0,3,8,1510,0,1902,1979,98103,47.6849,-122.335,2140,4916,799000,13,11,2014,77,112,2668,2776,1,0,1
2,1.0,910,8155,1.0,0,0,4,6,910,0,1948,0,98155,47.7399,-122.3,1240,8155,285000,27,6,2014,0,66,7245,6915,0,0,1
3,1.5,1320,15053,1.0,0,0,3,7,1320,0,1979,0,98072,47.7405,-122.095,1250,13368,300000,22,9,2014,0,35,13733,12118,0,0,0
2,1.0,900,8580,1.0,0,0,3,5,900,0,1918,0,98168,47.4727,-122.27,2060,6533,83000,29,5,2014,0,96,7680,4473,0,0,1
2,1.0,890,4804,1.0,0,0,4,7,890,0,1928,0,98133,47.7027,-122.346,1010,3844,220000,14,4,2015,0,87,3914,2834,0,0,1
2,2.5,1240,2689,2.0,0,0,3,7,1240,0,1986,0,98003,47.3236,-122.323,1430,3609,174500,3,6,2014,0,28,1449,2179,0,0,0
4,2.5,2960,10760,2.0,0,0,3,9,2960,0,1987,0,98029,47.5677,-122.013,2480,9528,695000,27,4,2015,0,28,7800,7048,0,0,0
3,1.5,1020,11410,1.0,0,0,3,7,1020,0,1959,0,98059,47.4811,-122.162,1290,8400,255000,4,12,2014,0,55,10390,7110,0,0,0
5,2.25,2590,7245,1.0,0,0,3,8,1510,1080,1973,0,98008,47.6398,-122.111,1930,7245,539000,25,2,2015,0,42,4655,5315,0,1,0
2,1.0,1100,2800,1.0,0,0,3,7,1100,0,1925,0,98119,47.6361,-122.371,1110,1673,552700,17,3,2015,0,90,1700,563,0,0,1
3,1.0,1300,6710,1.0,0,0,4,6,1300,0,1952,0,98040,47.5851,-122.242,1630,9946,571500,3,6,2014,0,62,5410,8316,0,0,0
3,1.0,1200,6561,1.0,0,0,3,6,1200,0,1950,1968,98177,47.7763,-122.36,1340,9450,263700,13,3,2015,18,65,5361,8110,1,0,1
8,4.0,7710,11750,3.5,0,0,5,12,6090,1620,1904,0,98112,47.6263,-122.314,4210,8325,3300000,20,10,2014,0,110,4040,4115,0,1,1
2,2.0,1390,1302,2.0,0,0,3,7,1390,0,1986,0,98003,47.3089,-122.33,1390,1302,186950,28,5,2014,0,28,-88,-88,0,0,0
3,1.5,1250,7194,1.0,0,0,4,7,1250,0,1969,0,98034,47.7298,-122.231,1340,7242,358000,30,7,2014,0,45,5944,5902,0,0,0
5,3.75,5020,8694,2.0,0,1,3,12,3970,1050,2007,0,98004,47.6146,-122.213,4190,11275,3650000,11,5,2015,0,8,3674,7085,0,1,0
4,2.25,2060,8767,2.0,0,0,3,8,2060,0,1983,0,98052,47.7228,-122.103,1610,8062,543000,11,8,2014,0,31,6707,6452,0,0,0
4,2.25,2000,10679,1.0,0,0,3,7,1350,650,1960,0,98148,47.4238,-122.329,1650,8875,330000,23,4,2015,0,55,8679,7225,0,1,1
3,2.0,1530,3400,1.0,0,0,3,7,990,540,1907,2014,98112,47.6204,-122.296,1880,4212,529000,6,8,2014,107,107,1870,2332,1,1,1
1,1.0,700,2500,1.0,0,0,4,7,700,0,1907,0,98106,47.5662,-122.364,1340,5000,295000,27,6,2014,0,107,1800,3660,0,0,1
3,1.0,950,8450,1.0,0,0,3,7,950,0,1962,0,98033,47.6884,-122.186,1610,10080,365000,22,9,2014,0,52,7500,8470,0,0,0
3,3.0,1380,1081,3.0,0,0,3,8,1380,0,2005,0,98107,47.6692,-122.39,1390,1140,473000,15,10,2014,0,9,-299,-250,0,0,1
3,1.0,1830,8004,1.0,0,0,3,8,1200,630,1960,0,98125,47.7259,-122.297,1860,7971,403500,23,6,2014,0,54,6174,6111,0,1,1
3,1.5,1790,8203,1.5,0,1,3,7,1790,0,1910,0,98116,47.5768,-122.403,1960,6047,544000,2,6,2014,0,104,6413,4087,0,0,1
3,1.0,1340,4000,1.5,0,0,4,7,1340,0,1927,0,98105,47.6652,-122.288,1510,4000,621000,23,10,2014,0,87,2660,2490,0,0,1
3,2.25,1520,5750,2.0,0,0,3,8,1400,120,1908,2006,98116,47.5787,-122.388,1420,5650,672600,1,8,2014,98,106,4230,4230,1,1,1
2,1.75,1370,3125,1.0,0,0,3,7,1090,280,1950,0,98199,47.6492,-122.391,1730,5966,689800,7,4,2015,0,65,1755,4236,0,1,1
3,1.5,1470,4480,1.0,0,0,4,7,1130,340,1918,0,98105,47.6693,-122.291,2120,4480,613000,7,5,2015,0,97,3010,2360,0,1,1
4,2.25,2500,8866,2.0,0,0,4,9,2500,0,1987,0,98007,47.6604,-122.146,2630,8847,808000,1,7,2014,0,27,6366,6217,0,0,0
3,1.0,1060,9241,1.0,0,0,4,7,1060,0,1956,0,98133,47.7465,-122.339,1900,6484,301000,25,7,2014,0,58,8181,4584,0,0,1
3,1.75,1210,9635,1.0,0,0,4,7,1210,0,1987,0,98019,47.7382,-121.98,1550,10707,340000,25,9,2014,0,27,8425,9157,0,0,0
3,1.0,920,8400,1.0,0,0,3,7,920,0,1963,0,98032,47.3771,-122.287,1260,8400,206000,23,12,2014,0,51,7480,7140,0,0,0
3,1.5,1340,6000,1.0,0,0,4,7,1340,0,1960,0,98040,47.5866,-122.25,1590,9000,550000,3,11,2014,0,54,4660,7410,0,0,0
2,1.0,960,4800,1.5,0,0,2,6,960,0,1912,0,98116,47.5752,-122.411,1440,4800,325000,24,12,2014,0,102,3840,3360,0,0,1
3,2.5,1630,7586,2.0,0,0,3,8,1630,0,1986,0,98029,47.5689,-122.023,2090,7330,475000,12,10,2014,0,28,5956,5240,0,0,0
3,1.75,1840,7350,1.0,0,0,3,8,1310,530,1976,0,98034,47.7089,-122.23,1860,7000,432100,30,7,2014,0,38,5510,5140,0,1,0
3,2.0,3085,7280,1.0,0,0,4,7,1560,1525,1959,0,98056,47.4956,-122.181,1480,7900,359000,3,3,2015,0,56,4195,6420,0,1,0
3,1.0,920,4800,1.0,0,0,4,6,780,140,1926,0,98117,47.6937,-122.362,1370,4800,490000,5,1,2015,0,89,3880,3430,0,1,1
4,1.75,2260,7005,1.0,0,1,4,7,1130,1130,1947,0,98033,47.6895,-122.207,2330,9180,648360,22,5,2014,0,67,4745,6850,0,1,0
3,1.75,1730,11986,1.0,0,3,5,6,1730,0,1918,0,98198,47.3595,-122.323,2490,9264,340000,7,10,2014,0,96,10256,6774,0,0,1
3,2.0,1610,8069,1.0,0,0,5,7,1090,520,1955,0,98006,47.5754,-122.15,1510,8803,545000,3,4,2015,0,60,6459,7293,0,1,0
2,0.75,550,7980,1.0,0,0,3,5,550,0,1952,0,98146,47.511,-122.348,1330,7980,115000,15,7,2014,0,62,7430,6650,0,0,1
3,2.25,2400,12350,1.0,0,0,4,8,1420,980,1968,0,98033,47.6533,-122.192,2615,12043,705640,19,2,2015,0,47,9950,9428,0,1,0
3,2.25,1960,1585,2.0,0,0,3,7,1750,210,2003,0,98118,47.5414,-122.288,1760,1958,300000,30,7,2014,0,11,-375,198,0,1,1
4,2.75,3190,14904,1.0,0,3,4,9,1940,1250,1949,1992,98004,47.6178,-122.214,2600,11195,1650000,31,7,2014,43,65,11714,8595,1,1,0
4,3.5,3160,4200,2.0,0,4,3,8,2180,980,1999,0,98144,47.5963,-122.292,2180,5200,1140000,17,4,2015,0,16,1040,3020,0,1,1
3,1.75,1550,7410,1.5,0,0,5,7,1550,0,1944,0,98178,47.4951,-122.237,1250,7467,280000,18,8,2014,0,70,5860,6217,0,0,1
4,1.75,1930,7650,1.0,0,0,4,8,1280,650,1981,0,98023,47.3078,-122.386,1860,8800,245000,19,12,2014,0,33,5720,6940,0,1,0
4,1.0,1170,4590,1.5,0,0,4,7,1170,0,1925,0,98115,47.6804,-122.311,1430,4080,564000,30,10,2014,0,89,3420,2650,0,0,1
3,1.75,2520,4534,1.0,0,0,5,9,1460,1060,1954,0,98199,47.6381,-122.401,1870,5023,849000,19,9,2014,0,60,2014,3153,0,1,1
3,1.75,1220,7447,1.0,0,0,4,7,1220,0,1964,0,98033,47.6886,-122.211,1340,7200,698000,9,4,2015,0,51,6227,5860,0,0,0
3,1.0,960,8556,1.0,0,0,3,7,960,0,1971,0,98034,47.7245,-122.22,1320,7528,319000,25,9,2014,0,43,7596,6208,0,0,0
4,2.75,2220,5310,1.0,0,0,5,7,1170,1050,1951,0,98144,47.5801,-122.294,1540,4200,680000,30,3,2015,0,64,3090,2660,0,1,1
4,2.25,2250,12000,2.0,0,0,3,8,2250,0,1985,0,98032,47.3715,-122.274,2140,11871,287500,27,10,2014,0,29,9750,9731,0,0,0
3,3.25,1510,1850,2.0,0,2,3,8,1230,280,2001,0,98107,47.6683,-122.362,1540,1840,465000,12,11,2014,0,13,340,300,0,1,1
3,1.0,1350,14212,1.0,0,0,4,6,1350,0,1981,0,98053,47.6606,-122.06,1520,14404,335000,25,9,2014,0,33,12862,12884,0,0,0
3,2.5,2950,6545,2.0,0,0,3,8,2950,0,2003,0,98059,47.4828,-122.139,2400,6550,482000,25,2,2015,0,12,3595,4150,0,0,0
5,1.0,1260,8382,1.5,0,0,3,7,1260,0,1918,0,98146,47.5058,-122.355,910,8382,220000,9,9,2014,0,96,7122,7472,0,0,1
4,2.0,1700,6025,1.0,0,0,3,6,1700,0,1978,0,98002,47.3029,-122.221,1320,5956,206000,20,5,2014,0,36,4325,4636,0,0,0
4,3.0,3320,5760,2.0,0,0,3,9,2120,1200,1954,2007,98199,47.6474,-122.389,2400,6144,1100000,24,3,2015,53,61,2440,3744,1,1,1
3,2.5,1470,3971,2.0,0,0,3,7,1470,0,2003,0,98053,47.6816,-122.035,1650,3148,491150,20,3,2015,0,12,2501,1498,0,0,0
4,2.75,2500,12848,1.0,0,1,3,8,2120,380,1975,0,98003,47.3364,-122.321,2370,12497,390000,12,8,2014,0,39,10348,10127,0,1,0
4,2.5,2641,8091,2.0,0,0,3,7,2641,0,1998,0,98031,47.4043,-122.213,2641,8535,393000,7,5,2015,0,17,5450,5894,0,0,0
4,2.0,2260,8457,2.0,0,0,3,9,2260,0,1992,0,98074,47.6251,-122.03,2410,7713,635000,17,7,2014,0,22,6197,5303,0,0,0
2,1.0,1160,5000,1.0,0,0,4,8,1160,0,1937,0,98117,47.6865,-122.399,1750,5000,490000,16,5,2014,0,77,3840,3250,0,0,1
4,3.5,3680,2242,2.5,0,0,3,9,2670,1010,1930,2007,98112,47.6192,-122.307,1350,1288,770000,25,9,2014,77,84,-1438,-62,1,1,1
2,2.0,1615,4590,1.5,0,0,5,8,1615,0,1906,0,98103,47.6886,-122.348,1470,4590,665000,4,12,2014,0,108,2975,3120,0,0,1
3,1.0,1230,7020,1.0,0,0,3,7,1090,140,1924,0,98116,47.5719,-122.39,1390,5850,410000,21,10,2014,0,90,5790,4460,0,1,1
3,2.0,2510,5200,1.0,0,0,5,8,1470,1040,1925,0,98106,47.5631,-122.366,990,5400,562000,25,2,2015,0,90,2690,4410,0,1,1
3,3.25,1860,2218,3.0,0,0,3,8,1860,0,2001,0,98125,47.7185,-122.313,1860,2218,387500,14,10,2014,0,13,358,358,0,0,1
5,2.0,2700,10875,1.0,0,0,4,7,1540,1160,1962,0,98007,47.6163,-122.138,2040,7464,580000,17,6,2014,0,52,8175,5424,0,1,0
3,2.5,3290,6830,2.0,0,0,3,10,3290,0,2000,0,98052,47.6702,-122.142,3200,6227,930000,21,6,2014,0,14,3540,3027,0,0,0
3,2.0,1570,5600,1.0,0,0,3,8,1570,0,1999,0,98058,47.4286,-122.185,2010,5600,325000,3,12,2014,0,15,4030,3590,0,0,0
3,1.75,1950,8712,1.0,0,0,3,7,1950,0,1960,0,98055,47.4391,-122.189,1820,11520,235000,27,6,2014,0,54,6762,9700,0,0,0
2,1.0,1380,4390,1.0,0,0,4,8,880,500,1931,0,98115,47.6947,-122.323,1390,5234,450000,25,6,2014,0,83,3010,3844,0,1,1
4,2.75,2410,5650,1.5,0,0,5,8,2070,340,1909,0,98116,47.5651,-122.391,1960,5650,745000,12,3,2015,0,106,3240,3690,0,1,1
4,2.0,1200,8470,1.0,0,0,4,7,1200,0,1961,0,98023,47.3262,-122.338,1110,8400,223000,23,7,2014,0,53,7270,7290,0,0,0
4,1.75,1770,12278,1.0,0,0,3,7,1350,420,1937,0,98115,47.7004,-122.295,1670,9336,630000,28,7,2014,0,77,10508,7666,0,1,1
3,2.5,1540,1614,3.0,0,0,3,8,1470,70,2008,0,98103,47.6961,-122.341,1540,1418,413450,8,5,2014,0,6,74,-122,0,1,1
5,2.75,2860,5379,2.0,0,0,3,9,2860,0,2005,0,98052,47.7082,-122.104,2980,6018,720000,11,8,2014,0,9,2519,3038,0,0,0
4,3.5,2830,4000,1.5,0,0,3,7,1840,990,1919,2014,98144,47.5842,-122.292,2340,4000,1120000,5,5,2015,95,96,1170,1660,1,1,1
5,4.0,4280,11307,2.0,0,0,3,10,2710,1570,1996,0,98027,47.5503,-122.081,3080,11307,839000,11,8,2014,0,18,7027,8227,0,1,0
3,2.0,1410,10577,1.0,0,0,3,7,1410,0,1994,0,98030,47.3642,-122.187,1660,6757,269000,6,4,2015,0,21,9167,5097,0,0,0
2,2.0,1350,2560,1.0,0,0,4,8,1350,0,1974,0,98052,47.6338,-122.106,1800,2560,382000,6,4,2015,0,41,1210,760,0,0,0
2,2.25,1100,1114,2.0,0,0,3,8,900,200,2009,0,98122,47.6199,-122.304,1230,1800,574000,13,4,2015,0,6,14,570,0,1,1
3,2.5,2070,4697,2.0,0,0,3,7,2070,0,2002,0,98065,47.5307,-121.875,2230,4437,405000,22,9,2014,0,12,2627,2207,0,0,0
3,2.5,2360,9938,1.0,0,0,3,8,1690,670,1987,0,98027,47.5374,-122.053,2280,9626,572000,28,7,2014,0,27,7578,7346,0,1,0
4,2.25,2760,12100,2.0,0,0,4,9,2760,0,1976,0,98074,47.6285,-122.058,2850,12410,675000,5,12,2014,0,38,9340,9560,0,0,0
4,1.0,1220,7980,1.5,0,0,3,6,1220,0,1944,0,98178,47.4924,-122.237,1210,7920,165000,2,9,2014,0,70,6760,6710,0,0,1
4,1.0,1220,7980,1.5,0,0,3,6,1220,0,1944,0,98178,47.4924,-122.237,1210,7920,260000,4,3,2015,0,71,6760,6710,0,0,1
3,1.0,1220,6719,1.0,0,0,3,6,1220,0,1953,0,98198,47.4187,-122.329,1580,7200,196000,4,3,2015,0,62,5499,5620,0,0,1
3,2.5,3020,12184,2.0,0,0,3,8,3020,0,2003,0,98019,47.744,-121.976,2980,10029,515000,24,2,2015,0,12,9164,7049,0,0,0
4,3.5,3470,7396,2.0,0,3,3,8,2520,950,1979,0,98125,47.7146,-122.279,2360,10541,810000,3,12,2014,0,35,3926,8181,0,1,1
4,2.25,2380,7700,2.0,0,0,4,8,2380,0,1977,0,98055,47.4391,-122.194,2100,7700,365650,11,3,2015,0,38,5320,5600,0,0,0
3,3.0,2260,1834,2.0,0,0,3,8,1660,600,2002,0,98122,47.6111,-122.308,2260,1834,651000,28,7,2014,0,12,-426,-426,0,1,1
2,1.0,720,6345,1.0,0,0,3,6,720,0,1943,0,98106,47.5201,-122.35,720,6345,240000,9,10,2014,0,71,5625,5625,0,0,1
3,2.0,1730,6007,1.0,0,0,3,8,1730,0,2004,0,98030,47.3573,-122.2,2000,6245,299000,29,10,2014,0,10,4277,4245,0,0,0
3,2.5,2660,10928,2.0,0,0,3,9,1830,830,1988,0,98006,47.5442,-122.141,2800,10025,768000,4,8,2014,0,26,8268,7225,0,1,0
2,1.0,1030,5072,1.0,0,0,3,6,1030,0,1924,1958,98115,47.6962,-122.294,1220,6781,397380,28,10,2014,34,90,4042,5561,1,0,1
4,3.0,2890,6885,1.0,0,0,3,7,1590,1300,1945,2015,98115,47.6763,-122.282,2180,6885,476000,1,7,2014,70,69,3995,4705,1,1,1
3,1.0,890,5200,1.0,0,0,3,7,890,0,1957,0,98118,47.559,-122.277,1420,6000,315000,6,1,2015,0,58,4310,4580,0,0,1
3,2.25,1410,7290,1.0,0,0,3,7,940,470,1980,0,98118,47.5396,-122.274,1550,7375,240000,26,9,2014,0,34,5880,5825,0,1,1
2,1.0,810,4080,1.0,0,0,4,6,810,0,1941,0,98126,47.5337,-122.379,1400,4080,325000,8,7,2014,0,73,3270,2680,0,0,1
3,1.75,1370,8006,2.0,0,0,3,7,1370,0,1990,0,98001,47.258,-122.252,1530,8006,160000,8,10,2014,0,24,6636,6476,0,0,0
3,2.5,2260,5100,2.0,0,0,3,8,2260,0,2007,0,98019,47.7341,-121.968,2260,5100,435000,9,1,2015,0,8,2840,2840,0,0,0
3,1.75,1430,16200,1.0,0,0,4,7,1430,0,1967,0,98027,47.5223,-122.043,1690,13125,427500,10,4,2015,0,48,14770,11435,0,0,0
5,2.5,2510,10240,1.0,0,0,4,8,1410,1100,1984,0,98059,47.4732,-122.141,2170,10500,450000,17,4,2015,0,31,7730,8330,0,1,0
3,1.5,1760,4880,1.5,0,3,3,8,1290,470,1928,0,98136,47.5334,-122.388,1840,4998,688000,19,9,2014,0,86,3120,3158,0,1,1
4,1.0,1430,3600,1.0,0,0,3,6,980,450,1947,0,98106,47.5343,-122.355,1170,4000,285000,8,4,2015,0,68,2170,2830,0,1,1
3,3.25,1510,1125,3.0,0,0,3,8,1510,0,2006,0,98107,47.6711,-122.39,1390,1174,530000,20,8,2014,0,8,-385,-216,0,0,1
4,1.75,1320,7694,1.0,0,0,3,7,1320,0,1928,1972,98148,47.4297,-122.325,1620,8468,195000,2,4,2015,44,87,6374,6848,1,0,1
3,1.5,1180,7384,1.0,0,0,5,7,1180,0,1959,0,98032,47.3838,-122.287,1150,7455,250200,28,8,2014,0,55,6204,6305,0,0,0
3,2.25,1560,8570,1.0,0,0,5,7,1080,480,1977,0,98004,47.6155,-122.21,2660,9621,1100000,28,1,2015,0,38,7010,6961,0,1,0
3,2.5,2470,10321,2.0,0,0,3,9,2470,0,1988,0,98052,47.6694,-122.141,2450,8440,732500,12,11,2014,0,26,7851,5990,0,0,0
3,2.25,2190,8834,1.0,0,0,3,7,1390,800,1987,0,98001,47.2633,-122.244,1490,8766,194250,30,10,2014,0,27,6644,7276,0,1,0
4,2.0,1610,8000,1.0,0,0,3,7,1190,420,1966,0,98008,47.6301,-122.118,1560,7896,526000,9,3,2015,0,49,6390,6336,0,1,0
4,2.75,2700,9882,2.0,0,0,3,7,2700,0,1958,1989,98155,47.7671,-122.291,2250,10797,520000,4,5,2015,31,57,7182,8547,1,0,1
3,1.75,1530,6125,1.0,0,0,3,7,1120,410,1958,0,98116,47.5687,-122.397,1360,6125,526000,13,11,2014,0,56,4595,4765,0,1,1
2,1.0,920,7569,1.0,0,0,4,6,920,0,1950,0,98168,47.4951,-122.302,1280,7627,202000,26,6,2014,0,64,6649,6347,0,0,1
4,2.5,2990,8622,2.0,0,0,3,9,2990,0,2000,0,98065,47.5394,-121.875,2980,8622,645500,12,11,2014,0,14,5632,5642,0,0,0
1,1.0,720,7540,1.0,1,4,4,6,720,0,1905,0,98198,47.3509,-122.323,1120,9736,570000,22,4,2015,0,110,6820,8616,0,0,1
3,2.0,1750,9000,1.5,0,0,4,5,1750,0,1936,0,98133,47.7489,-122.35,1830,8100,325000,20,3,2015,0,79,7250,6270,0,0,1
2,1.0,2410,5930,2.0,0,0,3,9,1930,480,2007,0,98116,47.5657,-122.395,1540,5892,725000,16,12,2014,0,7,3520,4352,0,1,1
3,1.75,1240,10361,1.0,0,0,3,6,1240,0,1987,0,98042,47.37,-122.151,1240,8834,192000,26,11,2014,0,27,9121,7594,0,0,0
2,1.0,1010,9219,1.0,0,0,4,7,1010,0,1960,0,98033,47.6886,-122.202,1610,9219,560000,9,7,2014,0,54,8209,7609,0,0,0
5,2.75,2770,6116,1.0,0,0,3,7,1490,1280,1979,0,98168,47.4847,-122.291,1920,6486,283450,1,12,2014,0,35,3346,4566,0,1,1
4,1.75,2800,5400,1.0,0,0,3,9,1400,1400,1924,2006,98115,47.6803,-122.313,1490,5400,863000,5,9,2014,82,90,2600,3910,1,1,1
4,2.0,1400,4800,2.0,0,0,3,7,1400,0,1986,0,98122,47.6168,-122.298,1620,2595,815000,28,10,2014,0,28,3400,975,0,0,1
2,1.0,1020,7679,1.0,0,0,5,6,1020,0,1942,0,98056,47.4915,-122.188,1280,6497,245000,16,4,2015,0,73,6659,5217,0,0,0
4,3.0,2860,10292,1.0,0,0,4,8,2860,0,1953,1999,98004,47.6286,-122.206,1840,10273,1320000,8,12,2014,46,61,7432,8433,1,0,0
4,3.5,4270,12305,2.0,0,2,3,10,4270,0,1994,0,98006,47.5489,-122.118,4190,13137,1160000,7,11,2014,0,20,8035,8947,0,0,0
3,2.5,2270,4488,2.0,0,0,3,7,2270,0,1999,0,98065,47.5329,-121.879,2360,4427,480000,3,9,2014,0,15,2218,2067,0,0,0
4,2.5,2560,5593,2.0,0,0,3,7,2560,0,2001,0,98053,47.6886,-122.037,2800,5890,600000,6,6,2014,0,13,3033,3090,0,0,0
2,1.0,900,5220,1.0,0,0,4,6,900,0,1956,0,98146,47.5105,-122.387,1480,6660,329950,24,6,2014,0,58,4320,5180,0,0,1
4,2.5,2010,12085,2.0,0,0,3,8,2010,0,1986,0,98042,47.3406,-122.057,1910,12133,299500,22,8,2014,0,28,10075,10223,0,0,0
3,2.5,1690,5131,1.0,0,0,3,7,1690,0,1941,1998,98126,47.5234,-122.38,860,5137,460000,18,9,2014,57,73,3441,4277,1,0,1
5,3.5,2310,5249,2.0,0,0,3,8,1560,750,2000,0,98118,47.5463,-122.272,1900,7296,515000,15,4,2015,0,15,2939,5396,0,1,1
3,2.25,1520,1245,3.0,0,0,3,8,1520,0,2004,0,98103,47.6907,-122.34,1520,1470,405000,23,6,2014,0,10,-275,-50,0,0,1
4,1.5,1220,3780,1.5,0,0,3,7,1220,0,1927,0,98107,47.6667,-122.36,1400,3185,483000,27,10,2014,0,87,2560,1785,0,0,1
4,2.5,2170,11511,2.0,0,0,3,8,2170,0,1992,0,98031,47.3886,-122.188,1900,8961,377000,3,2,2015,0,23,9341,7061,0,0,0
2,1.75,1760,4600,1.0,0,0,4,7,850,910,1926,0,98126,47.5654,-122.372,1150,4800,355000,5,11,2014,0,88,2840,3650,0,1,1
4,1.75,2100,3000,1.5,0,0,4,7,1500,600,1911,0,98103,47.6721,-122.329,1690,4000,640000,6,8,2014,0,103,900,2310,0,1,1
4,1.0,1430,5909,1.0,0,0,3,6,1070,360,1947,0,98155,47.7623,-122.313,1460,8433,270000,21,1,2015,0,68,4479,6973,0,1,1
5,3.5,2450,8193,2.0,0,0,3,9,2450,0,2005,0,98028,47.7721,-122.241,2310,8193,559950,14,1,2015,0,10,5743,5883,0,0,0
4,3.0,1820,8261,1.0,0,0,3,7,1420,400,1969,0,98034,47.7197,-122.219,1920,7961,515000,14,10,2014,0,45,6441,6041,0,1,0
4,1.75,1850,5712,1.0,0,0,3,7,1850,0,1954,0,98115,47.6966,-122.324,1510,6038,352000,26,8,2014,0,60,3862,4528,0,0,1
3,1.75,1870,9000,1.0,0,0,5,9,1870,0,1958,0,98177,47.7203,-122.361,2030,8160,595888,25,6,2014,0,56,7130,6130,0,0,1
4,2.25,2580,7344,2.0,0,0,3,8,2580,0,1977,0,98027,47.5647,-122.09,2390,7507,588000,22,7,2014,0,37,4764,5117,0,0,0
4,3.25,3680,8580,1.0,0,3,5,10,1840,1840,1959,0,98136,47.5266,-122.387,2700,9100,1050000,22,1,2015,0,56,4900,6400,0,1,1
3,1.5,1750,7000,2.0,0,0,3,8,1750,0,1983,0,98023,47.3108,-122.346,1840,9305,260000,8,9,2014,0,31,5250,7465,0,0,0
4,3.5,3890,3600,2.0,0,0,3,9,2860,1030,2005,0,98112,47.6342,-122.282,2460,6050,1600000,17,2,2015,0,10,-290,3590,0,1,1
2,1.0,1000,4800,1.0,0,0,3,6,1000,0,1952,0,98117,47.6926,-122.362,1000,4800,380000,14,4,2015,0,63,3800,3800,0,0,1
2,2.5,2210,6327,1.0,0,0,3,8,2210,0,2003,0,98053,47.7114,-122.03,2170,6327,802000,2,6,2014,0,11,4117,4157,0,0,0
4,3.25,2850,4800,2.5,0,0,5,10,2700,150,1905,0,98112,47.6292,-122.312,2850,4800,1330000,11,8,2014,0,109,1950,1950,0,1,1
4,2.75,2460,3600,2.0,0,0,3,8,1640,820,1907,2007,98122,47.6093,-122.297,1890,3600,710000,16,4,2015,100,108,1140,1710,1,1,1
3,1.0,1750,5355,2.0,0,0,4,7,1750,0,1929,0,98115,47.6792,-122.31,2240,4590,707900,2,9,2014,0,85,3605,2350,0,0,1
2,1.0,1100,7323,1.0,0,0,3,7,780,320,1982,0,98023,47.2874,-122.37,1410,7227,179950,20,11,2014,0,32,6223,5817,0,1,0
4,2.5,2620,10489,2.0,0,0,3,9,2620,0,1990,0,98052,47.6732,-122.143,2430,7701,683000,14,9,2014,0,24,7869,5271,0,0,0
3,2.0,1200,9566,1.0,0,0,3,7,1200,0,1995,0,98001,47.2649,-122.252,1590,9518,222400,3,6,2014,0,19,8366,7928,0,0,0
2,1.5,1920,3408,1.0,0,0,4,7,960,960,1912,0,98122,47.6118,-122.299,1130,3408,517000,8,7,2014,0,102,1488,2278,0,1,1
3,2.75,1690,5763,1.0,0,0,5,7,1180,510,1985,0,98011,47.7336,-122.202,1560,7518,410000,29,10,2014,0,29,4073,5958,0,1,0
3,1.75,1680,2552,1.0,0,0,4,7,840,840,1952,0,98117,47.6848,-122.391,1220,3880,480000,6,10,2014,0,62,872,2660,0,1,1
3,1.75,3440,10428,1.5,0,0,5,8,3440,0,1974,0,98058,47.449,-122.128,2160,8400,430000,24,2,2015,0,41,6988,6240,0,0,0
5,1.75,2190,7500,1.0,0,0,3,7,1290,900,1979,0,98133,47.7766,-122.355,1790,8820,439950,27,4,2015,0,36,5310,7030,0,1,1
4,2.5,3270,8223,2.0,0,0,3,10,3270,0,1998,0,98075,47.6018,-122.073,3460,8872,797500,21,4,2015,0,17,4953,5412,0,0,0
4,1.5,1280,5460,1.5,0,0,5,7,1080,200,1920,0,98118,47.5348,-122.268,1470,5934,379000,10,7,2014,0,94,4180,4464,0,1,1
1,1.0,1310,8667,1.5,0,0,1,6,1310,0,1918,0,98122,47.6059,-122.313,1130,4800,575000,16,12,2014,0,96,7357,3670,0,0,1
3,1.0,1660,11060,1.0,0,0,4,7,1110,550,1962,0,98003,47.3311,-122.326,1890,11060,247500,25,3,2015,0,53,9400,9170,0,1,0
4,1.75,1940,6909,1.0,0,0,4,7,970,970,1941,0,98133,47.7108,-122.352,1460,6906,423000,20,5,2014,0,73,4969,5446,0,1,1
3,1.75,1520,5618,1.0,0,0,3,7,1170,350,1953,0,98115,47.68,-122.284,1550,5618,550000,15,12,2014,0,61,4098,4068,0,1,1
4,1.0,1620,4329,1.5,0,0,3,7,1620,0,1927,0,98116,47.5728,-122.388,1220,5520,415000,10,9,2014,0,87,2709,4300,0,0,1
2,1.0,1070,4700,1.0,0,0,5,7,1070,0,1910,0,98117,47.6887,-122.368,1370,4700,543000,27,3,2015,0,105,3630,3330,0,0,1
5,1.75,2000,10246,1.0,0,2,3,7,1200,800,1953,0,98178,47.5084,-122.246,2340,9030,465000,27,3,2015,0,62,8246,6690,0,1,1
3,2.5,1020,2217,2.0,0,0,3,7,720,300,2004,0,98106,47.5343,-122.348,1060,1524,280000,27,4,2015,0,11,1197,464,0,1,1
3,1.25,2400,6653,3.0,0,2,3,11,2400,0,1992,0,98122,47.6019,-122.29,1910,6653,1390000,18,11,2014,0,22,4253,4743,0,0,1
6,3.0,2480,9720,2.0,0,0,3,8,2480,0,1972,0,98007,47.6127,-122.145,2480,9200,665000,30,1,2015,0,43,7240,6720,0,0,0
3,1.75,1310,7314,1.0,0,0,5,6,1310,0,1960,0,98002,47.2888,-122.221,1010,7314,237950,12,3,2015,0,55,6004,6304,0,0,0
4,2.75,2420,10200,1.0,0,0,3,8,1220,1200,1962,0,98034,47.72,-122.236,2240,9750,440000,2,1,2015,0,53,7780,7510,0,1,0
2,1.0,1890,4700,1.0,0,0,4,7,1030,860,1928,0,98107,47.6747,-122.391,2150,4700,618000,12,1,2015,0,87,2810,2550,0,1,1
3,2.25,1860,4000,1.5,0,0,5,7,1020,840,1920,0,98118,47.5539,-122.267,1180,4000,572000,13,11,2014,0,94,2140,2820,0,1,1
3,1.5,2500,4774,1.5,0,2,3,7,1450,1050,1940,0,98107,47.6567,-122.358,1300,4000,725000,27,5,2014,0,74,2274,2700,0,1,1
4,1.0,1660,10656,1.5,0,0,4,7,1180,480,1920,0,98136,47.5391,-122.385,1120,8816,535000,22,1,2015,0,95,8996,7696,0,1,1
3,2.5,1850,7200,1.0,0,0,3,7,1500,350,1979,0,98023,47.3063,-122.384,2140,7500,249000,18,12,2014,0,35,5350,5360,0,1,0
3,2.0,1890,6620,1.0,0,3,4,8,1890,0,1954,0,98125,47.7016,-122.274,2590,7188,690000,31,12,2014,0,60,4730,4598,0,0,1
3,1.5,1310,7236,1.0,0,0,4,7,1170,140,1928,0,98103,47.6944,-122.333,1680,8431,526500,3,10,2014,0,86,5926,6751,0,1,1
4,1.5,1870,7220,2.0,0,0,3,7,1870,0,1956,0,98155,47.77,-122.319,1550,7592,325000,7,8,2014,0,58,5350,6042,0,0,1
3,3.0,1520,4080,2.0,0,0,5,7,1520,0,1948,0,98144,47.572,-122.29,1320,4080,495000,10,2,2015,0,67,2560,2760,0,0,1
5,3.0,3070,8474,2.0,0,0,3,9,3070,0,2011,0,98033,47.6852,-122.184,3070,8527,825000,21,10,2014,0,3,5404,5457,0,0,0
3,1.5,1400,14850,1.5,0,0,4,7,1400,0,1910,0,98070,47.4471,-122.464,1350,14850,383000,23,12,2014,0,104,13450,13500,0,0,0
3,1.75,1960,11931,1.0,0,0,3,7,980,980,1954,0,98118,47.5432,-122.272,1460,4498,320000,28,4,2015,0,61,9971,3038,0,1,1
3,2.5,2030,6326,2.0,0,0,3,7,2030,0,1993,0,98038,47.3491,-122.029,1810,6825,275000,21,5,2014,0,21,4296,5015,0,0,0
2,2.25,2320,9300,1.5,0,4,5,9,1920,400,1937,0,98115,47.681,-122.273,2790,9300,1150000,15,10,2014,0,77,6980,6510,0,1,1
5,1.0,1870,7800,1.0,0,0,3,7,1580,290,1962,0,98168,47.5127,-122.321,1740,7808,262000,2,7,2014,0,52,5930,6068,0,1,1
4,1.0,1280,4840,1.0,0,0,3,7,940,340,1950,0,98136,47.5477,-122.395,1360,4840,390000,15,9,2014,0,64,3560,3480,0,1,1
3,2.25,1730,10030,1.0,0,0,4,8,1730,0,1985,0,98023,47.3108,-122.345,2090,8823,300000,23,10,2014,0,29,8300,6733,0,0,0
3,1.75,2060,5721,1.0,0,2,3,9,1140,920,1964,0,98136,47.5268,-122.388,2060,8124,746300,20,8,2014,0,50,3661,6064,0,1,1
3,1.5,1030,8223,1.0,0,0,4,7,1030,0,1952,0,98148,47.4282,-122.331,1460,9463,267000,8,9,2014,0,62,7193,8003,0,0,1
3,2.5,1720,7950,1.5,0,0,4,7,1720,0,1972,0,98034,47.7178,-122.168,1790,7030,525000,2,4,2015,0,43,6230,5240,0,0,0
3,1.75,1210,7350,1.0,0,0,3,7,1210,0,1977,0,98033,47.7,-122.172,1610,7313,570000,24,4,2015,0,38,6140,5703,0,0,0
4,2.25,2620,8100,1.0,0,0,4,7,1550,1070,1964,0,98166,47.4564,-122.351,1650,8100,360000,27,10,2014,0,50,5480,6450,0,1,1
3,2.5,2510,4106,2.0,0,0,3,9,2510,0,2003,0,98029,47.5494,-121.994,2470,4106,699950,3,11,2014,0,11,1596,1636,0,0,0
4,1.75,2410,6770,1.0,0,0,4,7,1220,1190,1924,0,98103,47.6946,-122.336,1440,6770,625000,15,12,2014,0,90,4360,5330,0,1,1
2,1.0,780,2750,1.0,0,0,4,7,780,0,1928,0,98116,47.5842,-122.388,1320,4440,464050,16,10,2014,0,86,1970,3120,0,0,1
5,2.5,2210,9655,1.0,0,0,3,8,1460,750,1976,0,98011,47.7698,-122.222,2080,8633,470000,2,5,2014,0,38,7445,6553,0,1,0
4,2.0,1590,9100,1.0,0,0,3,7,1040,550,1967,2014,98058,47.4465,-122.156,1670,9100,330000,9,9,2014,47,47,7510,7430,1,1,0
4,1.75,2230,7957,1.0,0,0,4,7,2230,0,1967,0,98008,47.5859,-122.122,2230,8040,537000,15,9,2014,0,47,5727,5810,0,0,0
4,1.0,1480,3750,1.5,0,0,4,7,1480,0,1912,0,98103,47.6737,-122.354,1570,3750,770000,16,3,2015,0,103,2270,2180,0,0,1
4,2.0,2850,4497,1.5,0,1,3,7,1730,1120,1910,0,98144,47.5876,-122.292,2450,6000,650000,18,11,2014,0,104,1647,3550,0,1,1
5,2.75,2060,8906,1.0,0,0,4,7,1220,840,1978,0,98118,47.5358,-122.289,1840,8906,415000,24,7,2014,0,36,6846,7066,0,1,1
4,2.5,2680,8778,2.0,0,0,4,8,2680,0,1977,0,98006,47.5516,-122.161,2680,10020,788000,19,11,2014,0,37,6098,7340,0,0,0
4,2.75,3150,7379,1.5,0,0,4,7,2430,720,1915,0,98115,47.6968,-122.3,1990,7379,640000,14,10,2014,0,99,4229,5389,0,1,1
4,2.5,2440,7155,2.0,0,0,3,8,2440,0,1993,0,98058,47.4501,-122.126,2450,8109,388000,23,5,2014,0,21,4715,5659,0,0,0
6,1.75,2230,10080,1.0,0,0,3,7,1390,840,1969,0,98034,47.7089,-122.201,2110,8475,360000,25,11,2014,0,45,7850,6365,0,1,0
6,1.75,2230,10080,1.0,0,0,3,7,1390,840,1969,0,98034,47.7089,-122.201,2110,8475,692500,24,3,2015,0,46,7850,6365,0,1,0
4,1.5,1600,6180,1.5,0,0,3,6,1600,0,1946,0,98118,47.5681,-122.285,1410,6180,425000,24,6,2014,0,68,4580,4770,0,0,1
4,1.5,1600,6180,1.5,0,0,3,6,1600,0,1946,0,98118,47.5681,-122.285,1410,6180,645000,11,3,2015,0,69,4580,4770,0,0,1
3,1.0,1580,8308,1.5,0,0,3,7,1580,0,1948,0,98146,47.5075,-122.379,1200,8308,340000,14,1,2015,0,67,6728,7108,0,0,1
3,2.75,2550,11160,2.0,0,0,3,8,2550,0,1994,0,98155,47.7351,-122.323,1020,7440,430000,21,5,2014,0,20,8610,6420,0,0,1
3,2.25,1700,7210,1.0,0,0,4,7,1250,450,1974,0,98003,47.3546,-122.318,2070,7300,280000,6,3,2015,0,41,5510,5230,0,1,0
3,2.0,1470,2052,1.5,0,0,3,7,1470,0,1986,0,98003,47.3084,-122.331,1390,2052,215000,26,2,2015,0,29,582,662,0,0,0
3,2.5,1680,11193,2.0,0,0,3,8,1680,0,1984,0,98058,47.4482,-122.125,2080,8084,306000,28,5,2014,0,30,9513,6004,0,0,0
3,1.0,1110,8593,1.0,0,0,3,7,1110,0,1979,0,98155,47.7595,-122.309,1780,8593,299900,25,6,2014,0,35,7483,6813,0,0,1
5,1.75,2120,8625,1.0,0,0,3,7,1200,920,1959,0,98008,47.6118,-122.131,1930,8625,534000,25,8,2014,0,55,6505,6695,0,1,0
3,2.75,2380,5572,2.0,0,4,3,9,1930,450,1939,0,98105,47.6626,-122.271,3370,5500,1160000,28,7,2014,0,75,3192,2130,0,1,1
3,2.5,2670,5000,2.0,0,3,5,9,2000,670,1942,1995,98144,47.5855,-122.292,2320,5000,1170000,16,7,2014,53,72,2330,2680,1,1,1
2,1.0,890,6430,1.0,0,0,3,6,890,0,1935,1997,98022,47.2003,-121.996,1460,6430,199990,11,7,2014,62,79,5540,4970,1,0,0
4,3.0,3140,9058,1.0,0,0,3,9,2140,1000,1989,0,98006,47.5462,-122.154,2760,10018,946000,12,8,2014,0,25,5918,7258,0,1,0
4,1.0,1260,7800,1.5,0,0,3,7,1260,0,1947,2007,98125,47.7334,-122.307,1639,7492,295000,20,2,2015,60,68,6540,5853,1,0,1
2,1.0,920,5157,1.0,0,0,3,6,920,0,1909,0,98118,47.5499,-122.269,1700,5150,475000,18,2,2015,0,106,4237,3450,0,0,1
3,1.0,1010,7520,1.0,0,0,4,6,1010,0,1975,0,98001,47.2699,-122.255,1370,8469,183500,23,3,2015,0,40,6510,7099,0,0,0
2,1.0,1010,3627,1.0,0,2,4,6,1010,0,1924,0,98144,47.5873,-122.294,1630,4040,450000,27,3,2015,0,91,2617,2410,0,0,1
3,1.0,1020,5500,1.5,0,0,3,7,1020,0,1961,0,98118,47.5502,-122.286,1160,5500,180000,8,1,2015,0,54,4480,4340,0,0,1
2,0.75,900,3527,1.0,0,0,3,6,900,0,1939,0,98146,47.5083,-122.336,1220,4080,230000,4,3,2015,0,76,2627,2860,0,0,1
3,1.0,1100,9750,1.0,0,0,4,7,1100,0,1966,0,98023,47.3248,-122.345,1190,9750,192500,9,12,2014,0,48,8650,8560,0,0,0
3,2.5,1990,3614,2.0,0,0,3,7,1990,0,2005,0,98038,47.36,-122.039,1980,3800,309000,17,10,2014,0,9,1624,1820,0,0,0
3,1.5,1980,5800,1.0,0,0,4,8,1520,460,1949,0,98199,47.6499,-122.413,2280,5800,759000,1,10,2014,0,65,3820,3520,0,1,1
4,3.75,4040,14212,2.0,0,0,3,11,4040,0,2002,0,98059,47.5189,-122.147,3940,14212,1120000,27,4,2015,0,13,10172,10272,0,0,0
5,1.75,1250,10530,1.0,0,0,4,7,1250,0,1966,0,98007,47.6101,-122.138,1560,8190,462000,19,5,2014,0,48,9280,6630,0,0,0
2,2.25,1140,1184,2.0,0,0,3,8,1010,130,1999,0,98103,47.659,-122.346,1140,1339,399950,20,10,2014,0,15,44,199,0,1,1
5,2.0,1730,10532,1.0,0,0,4,5,1730,0,1943,0,98056,47.5076,-122.178,1940,8501,325000,3,4,2015,0,72,8802,6561,0,0,0
2,2.25,1170,1313,3.0,0,0,3,8,1170,0,2007,0,98107,47.6712,-122.378,1310,1304,512000,21,7,2014,0,7,143,-6,0,0,1
5,2.75,2910,5802,2.0,0,0,3,7,2910,0,2006,0,98038,47.3591,-122.036,2910,5000,410000,25,7,2014,0,8,2892,2090,0,0,0
2,1.0,970,5500,1.0,0,0,3,7,970,0,1956,0,98118,47.556,-122.291,1180,6000,210000,24,6,2014,0,58,4530,4820,0,0,1
4,2.25,2130,8499,1.0,0,0,4,7,1600,530,1975,0,98030,47.3657,-122.21,1890,11368,325000,25,9,2014,0,39,6369,9478,0,1,0
3,2.5,2520,10175,1.0,0,0,3,8,1630,890,1979,0,98027,47.5652,-122.089,2220,8388,685000,6,4,2015,0,36,7655,6168,0,1,0
2,2.0,1360,4688,1.0,0,0,3,7,780,580,1944,0,98115,47.6874,-122.315,1340,4750,488000,18,5,2014,0,70,3328,3410,0,1,1
3,2.25,1620,6000,1.0,0,0,3,7,1280,340,1998,0,98002,47.2835,-122.2,1710,6318,247500,2,3,2015,0,17,4380,4608,0,1,0
4,2.0,2120,11479,1.0,0,0,4,7,1060,1060,1940,0,98125,47.7084,-122.303,1540,11000,489000,20,6,2014,0,74,9359,9460,0,1,1
4,1.75,2700,6000,1.0,0,0,4,8,1450,1250,1953,0,98199,47.6539,-122.395,2080,6000,725000,25,11,2014,0,61,3300,3920,0,1,1
3,1.5,1370,10317,1.5,0,0,3,6,1370,0,1958,0,98168,47.4731,-122.298,1370,9884,199950,9,4,2015,0,57,8947,8514,0,0,1
5,3.0,2520,13001,2.0,0,1,3,8,2010,510,1973,0,98008,47.6385,-122.114,2170,8215,670000,1,4,2015,0,42,10481,6045,0,1,0
3,2.0,1540,10410,1.0,0,0,4,7,1540,0,1967,0,98198,47.3662,-122.315,1590,7725,275000,29,12,2014,0,47,8870,6135,0,0,1
3,1.75,2610,6360,2.0,0,2,3,8,2130,480,1924,0,98109,47.6287,-122.351,3010,6000,1000000,7,4,2015,0,91,3750,2990,0,1,1
3,2.0,1490,8371,1.5,0,0,3,7,1490,0,1984,0,98031,47.3962,-122.189,1350,7846,255000,23,5,2014,0,30,6881,6496,0,0,0
3,1.75,2760,9137,1.0,0,0,3,7,1380,1380,1960,0,98007,47.6079,-122.132,1980,9137,465000,13,11,2014,0,54,6377,7157,0,1,0
3,1.75,1260,3604,1.0,0,0,3,7,1260,0,2012,0,98042,47.3612,-122.103,1430,3767,259000,11,2,2015,0,3,2344,2337,0,0,0
3,3.5,2630,4713,2.0,0,2,3,9,2030,600,2008,0,98027,47.5473,-122.016,2450,4187,695000,21,11,2014,0,6,2083,1737,0,1,0
3,1.75,1800,7210,1.0,0,0,3,7,1370,430,1976,0,98072,47.7346,-122.17,1820,8100,505000,1,5,2015,0,39,5410,6280,0,1,0
2,1.0,1130,2640,1.0,0,0,4,8,1130,0,1927,0,98109,47.6438,-122.357,1680,3200,631500,24,6,2014,0,87,1510,1520,0,0,1
3,1.0,1180,3600,1.5,0,0,3,7,1180,0,1926,0,98112,47.6337,-122.28,1900,3600,630500,16,10,2014,0,88,2420,1700,0,0,1
3,1.5,1830,4000,1.0,0,0,4,7,1350,480,1910,0,98119,47.6453,-122.371,1570,3672,740000,10,7,2014,0,104,2170,2102,0,1,1
3,2.5,2220,6380,1.5,0,0,4,8,1660,560,1931,0,98115,47.6974,-122.313,950,6380,650000,29,9,2014,0,83,4160,5430,0,1,1
2,2.0,1870,5580,1.0,0,0,3,8,1870,0,2004,0,98053,47.7101,-122.031,1670,4500,554000,5,8,2014,0,10,3710,2830,0,0,0
3,2.0,1660,10000,1.0,0,0,4,7,1010,650,1961,0,98005,47.5852,-122.174,2020,9720,529941,23,2,2015,0,54,8340,7700,0,1,0
3,1.0,1330,3740,1.5,0,0,3,6,1330,0,1903,0,98118,47.5502,-122.274,1330,5053,310000,20,10,2014,0,111,2410,3723,0,0,1
3,1.0,1330,3740,1.5,0,0,3,6,1330,0,1903,0,98118,47.5502,-122.274,1330,5053,389000,22,4,2015,0,112,2410,3723,0,0,1
3,3.0,2630,4972,2.0,0,0,3,9,2630,0,2006,0,98052,47.693,-122.133,2880,4972,731781,9,9,2014,0,8,2342,2092,0,0,0
2,1.0,1100,4750,1.0,0,0,3,7,1100,0,1946,0,98116,47.5772,-122.381,1830,4750,502501,22,4,2015,0,69,3650,2920,0,0,1
3,1.75,1810,7950,1.0,0,0,4,7,1810,0,1968,0,98008,47.6236,-122.117,1680,7725,443000,17,11,2014,0,46,6140,6045,0,0,0
3,2.0,2060,4080,1.0,0,0,5,7,1060,1000,1921,0,98144,47.574,-122.289,1400,4080,607000,15,8,2014,0,93,2020,2680,0,1,1
3,3.5,4660,5500,2.0,0,4,5,10,3040,1620,1909,0,98102,47.6465,-122.319,2980,5500,2150000,2,7,2014,0,105,840,2520,0,1,1
4,2.5,2370,15200,1.0,0,0,3,8,1660,710,1975,0,98052,47.6295,-122.089,2360,13879,585000,10,9,2014,0,39,12830,11519,0,1,0
3,2.5,2430,10500,2.0,0,1,3,9,2430,0,1989,0,98004,47.5818,-122.198,3440,12842,1030000,19,6,2014,0,25,8070,9402,0,0,0
3,2.5,1880,7000,2.0,0,0,3,8,1880,0,1993,0,98031,47.4206,-122.184,1880,7000,315000,12,6,2014,0,21,5120,5120,0,0,0
2,1.0,1150,5695,1.0,0,0,4,6,1150,0,1958,0,98056,47.4989,-122.171,1150,5695,180000,21,10,2014,0,56,4545,4545,0,0,0
3,2.0,1350,14200,1.0,0,0,3,7,1350,0,1989,0,98019,47.7315,-121.972,2100,15101,322500,13,5,2014,0,25,12850,13001,0,0,0
3,2.75,2180,7519,1.0,0,0,4,7,1310,870,1981,0,98052,47.6959,-122.125,1510,7107,568500,2,6,2014,0,33,5339,5597,0,1,0
4,2.75,3370,6675,1.0,0,3,4,8,1920,1450,1948,0,98144,47.5887,-122.291,2250,5550,813000,11,6,2014,0,66,3305,3300,0,1,1
5,2.25,3650,13068,1.0,0,0,4,10,1850,1800,1976,0,98040,47.5458,-122.231,2760,13927,1090000,14,4,2015,0,39,9418,11167,0,1,0
4,2.0,2100,4857,2.0,0,0,3,8,2100,0,1965,1984,98155,47.7521,-122.279,1450,5965,424000,26,6,2014,19,49,2757,4515,1,0,1
2,1.0,670,5600,1.0,0,0,3,6,670,0,1903,0,98108,47.5498,-122.304,1960,7176,235000,17,7,2014,0,111,4930,5216,0,0,1
3,3.5,2420,4000,2.0,0,0,5,9,1820,600,1907,0,98122,47.6054,-122.295,2030,4550,740000,29,9,2014,0,107,1580,2520,0,1,1
1,1.0,760,3000,1.0,0,0,3,7,760,0,1900,0,98122,47.6059,-122.303,1270,3000,415000,13,8,2014,0,114,2240,1730,0,0,1
3,2.75,2200,14925,1.0,0,0,3,6,1100,1100,1982,0,98053,47.6606,-122.059,1520,14212,432000,22,5,2014,0,32,12725,12692,0,1,0
3,1.75,1300,2446,1.0,0,3,3,8,880,420,1961,0,98122,47.6071,-122.285,2440,5051,676500,15,9,2014,0,53,1146,2611,0,1,1
2,1.0,720,4592,1.0,0,0,4,6,720,0,1943,0,98199,47.6534,-122.404,1030,5816,419000,20,11,2014,0,71,3872,4786,0,0,1
4,2.5,2230,4372,2.0,0,0,5,8,1540,690,1935,0,98103,47.6698,-122.334,2020,4372,900000,9,7,2014,0,79,2142,2352,0,1,1
5,1.75,2100,7347,1.0,0,0,3,7,1070,1030,1981,0,98028,47.7751,-122.268,2170,9418,330000,28,4,2015,0,34,5247,7248,0,1,0
4,2.5,3060,6000,2.0,0,0,3,9,3060,0,2012,0,98038,47.3689,-122.058,3040,6000,465000,27,6,2014,0,2,2940,2960,0,0,0
3,2.75,2810,18731,2.0,1,4,4,10,2810,0,1974,0,98052,47.6361,-122.093,3120,14810,1700000,23,6,2014,0,40,15921,11690,0,0,0
3,2.25,2550,8588,1.0,0,4,3,9,2550,0,1989,0,98011,47.7711,-122.195,3050,8588,490000,27,8,2014,0,25,6038,5538,0,0,0
4,2.75,2530,14178,2.0,0,0,3,8,2530,0,1997,0,98019,47.737,-121.955,2530,14055,469950,8,7,2014,0,17,11648,11525,0,0,0
3,1.75,1300,5413,1.5,0,0,3,7,1300,0,1925,1992,98115,47.6988,-122.32,1590,6380,536000,9,5,2014,67,89,4113,4790,1,0,1
3,1.0,1530,2400,1.0,0,0,4,7,890,640,1928,0,98103,47.6543,-122.354,1240,2400,575000,17,4,2015,0,87,870,1160,0,1,1
5,2.75,2380,7500,1.0,0,0,3,7,1300,1080,1984,0,98178,47.5009,-122.235,2400,6000,361000,25,3,2015,0,31,5120,3600,0,1,1
5,2.25,2400,13450,1.0,0,0,5,7,1200,1200,1957,0,98008,47.6007,-122.117,1950,10361,650000,27,3,2015,0,58,11050,8411,0,1,0
2,1.0,1030,6000,1.0,0,0,2,7,830,200,1951,0,98118,47.5291,-122.268,1770,5000,230005,23,3,2015,0,64,4970,3230,0,1,1
4,1.5,1940,6386,1.0,0,0,3,7,1140,800,1954,0,98118,47.5533,-122.285,1340,6165,280000,14,8,2014,0,60,4446,4825,0,1,1
3,2.25,1850,10855,1.0,0,0,3,8,1370,480,1985,0,98029,47.5696,-122.02,1850,8209,520000,16,7,2014,0,29,9005,6359,0,1,0
3,1.75,1440,7200,1.0,0,0,3,7,1440,0,1986,0,98188,47.4473,-122.284,1640,9167,239950,10,4,2015,0,29,5760,7527,0,0,1
3,1.5,2040,6000,1.0,0,0,3,7,1340,700,1957,0,98118,47.5218,-122.286,1190,6000,335000,16,6,2014,0,57,3960,4810,0,1,1
3,2.5,2120,7401,2.0,0,0,3,8,2120,0,1989,0,98029,47.5781,-122.018,2010,7972,612000,17,4,2015,0,26,5281,5962,0,0,0
2,1.0,830,8000,1.0,0,0,3,6,830,0,1954,0,98198,47.4215,-122.318,1300,8000,200000,4,8,2014,0,60,7170,6700,0,0,1
3,1.75,3140,8571,1.0,0,0,4,8,1670,1470,1985,0,98023,47.3074,-122.337,2590,7949,345000,10,7,2014,0,29,5431,5359,0,1,0
4,2.5,2410,6440,1.0,0,0,3,8,1550,860,1974,0,98034,47.7153,-122.191,2330,6938,520000,28,1,2015,0,41,4030,4608,0,1,0
4,2.25,2190,4080,2.0,0,0,3,8,1800,390,1918,0,98119,47.6425,-122.358,2100,4080,855000,18,6,2014,0,96,1890,1980,0,1,1
4,1.75,2190,5060,1.0,0,0,3,7,1190,1000,1950,0,98116,47.5846,-122.387,1510,4600,567500,7,5,2015,0,65,2870,3090,0,1,1
3,1.5,1210,7247,1.0,0,0,4,7,1210,0,1967,0,98003,47.328,-122.321,1370,7869,208000,10,11,2014,0,47,6037,6499,0,0,0
3,1.75,1880,16239,1.0,0,0,3,7,880,1000,1922,0,98115,47.7004,-122.304,1260,7528,452000,21,8,2014,0,92,14359,6268,0,1,1
3,3.0,2410,12183,2.0,0,0,3,9,2410,0,1988,0,98011,47.747,-122.177,2540,9979,555000,28,7,2014,0,26,9773,7439,0,0,0
5,2.75,2620,8861,1.0,0,0,5,8,1350,1270,1979,0,98056,47.5226,-122.183,1940,10800,519000,5,9,2014,0,35,6241,8860,0,1,0
3,2.25,1850,2575,2.0,0,0,3,9,1850,0,2013,0,98118,47.5525,-122.273,1080,4120,474950,3,12,2014,0,1,725,3040,0,0,1
2,1.0,860,1800,1.0,0,0,3,7,860,0,1909,0,98119,47.6334,-122.371,2160,3120,390000,11,9,2014,0,105,940,960,0,0,1
7,2.25,2620,6890,2.0,0,0,4,7,2620,0,1961,0,98007,47.6123,-122.134,2070,7910,539000,20,10,2014,0,53,4270,5840,0,0,0
3,1.0,1850,5000,1.5,0,0,3,7,1850,0,1922,0,98103,47.6727,-122.351,1850,5000,611000,8,12,2014,0,92,3150,3150,0,0,1
3,2.5,3490,8343,2.0,1,4,4,9,2150,1340,1939,1991,98125,47.7265,-122.281,2990,13104,1680000,8,7,2014,52,75,4853,10114,1,1,1
5,2.75,3170,7062,2.0,0,0,3,9,3170,0,2014,0,98074,47.5937,-122.061,3210,6891,919950,3,9,2014,0,0,3892,3681,0,0,0
4,2.5,2530,7563,1.0,0,0,3,7,1440,1090,1978,0,98011,47.7762,-122.21,1960,7811,400000,10,6,2014,0,36,5033,5851,0,1,0
2,1.75,1640,6750,1.0,0,0,4,8,1340,300,1939,0,98125,47.7068,-122.308,1760,7490,640500,11,2,2015,0,76,5110,5730,0,1,1
4,2.5,2130,9013,2.0,0,0,3,8,2130,0,1988,0,98001,47.3208,-122.273,2350,8982,310000,16,3,2015,0,27,6883,6632,0,0,0
4,1.0,1440,7215,1.5,0,0,3,7,1440,0,1969,0,98034,47.7133,-122.212,1150,7215,355000,16,10,2014,0,45,5775,6065,0,0,0
3,1.75,1940,7313,1.0,0,1,4,8,1440,500,1960,0,98136,47.5239,-122.387,2160,7200,685000,29,5,2014,0,54,5373,5040,0,1,1
3,1.0,1120,8576,1.0,0,0,3,6,1120,0,1943,0,98178,47.4896,-122.248,1050,8812,202500,17,10,2014,0,71,7456,7762,0,0,1
3,2.5,2400,5817,2.0,0,0,3,8,2400,0,1998,0,98065,47.5371,-121.87,2420,5817,540000,5,5,2015,0,17,3417,3397,0,0,0
4,2.5,1810,4871,2.0,0,0,3,8,1810,0,1999,0,98031,47.4088,-122.192,1850,5003,295000,17,11,2014,0,15,3061,3153,0,0,0
3,1.0,1270,6612,1.5,0,3,3,7,1270,0,1927,0,98118,47.5433,-122.264,2100,7680,518000,24,4,2015,0,88,5342,5580,0,0,1
2,1.75,1350,4023,1.0,0,0,3,7,1350,0,2005,0,98038,47.3493,-122.023,1370,3570,250000,1,5,2015,0,10,2673,2200,0,0,0
2,1.0,1620,3880,1.0,0,0,4,7,920,700,1924,0,98117,47.6855,-122.391,1330,3880,481000,21,11,2014,0,90,2260,2550,0,1,1
3,2.25,2650,12845,1.0,0,3,3,9,1770,880,1977,0,98034,47.7209,-122.256,2650,12902,898000,23,10,2014,0,37,10195,10252,0,1,0
5,1.75,2510,9750,1.5,0,0,3,8,2510,0,1969,0,98052,47.6635,-122.149,1900,9750,570000,4,8,2014,0,45,7240,7850,0,0,0
3,2.5,1660,5250,2.0,0,0,4,8,1660,0,1988,0,98003,47.3541,-122.3,1630,5505,265000,9,2,2015,0,27,3590,3875,0,0,0
4,2.5,2690,8036,2.0,0,0,4,9,2690,0,1987,0,98007,47.6596,-122.144,2420,8087,790000,19,8,2014,0,27,5346,5667,0,0,0
2,2.25,2910,6110,2.0,0,2,4,9,2910,0,1985,0,98136,47.5279,-122.387,2090,5763,620000,12,3,2015,0,30,3200,3673,0,0,1
4,3.5,2720,9000,2.0,0,0,3,8,2670,50,1997,0,98125,47.7034,-122.297,1960,7772,709050,19,8,2014,0,17,6280,5812,0,1,1
3,1.0,1280,5100,1.0,0,0,3,7,1280,0,1948,0,98126,47.5259,-122.38,1380,7140,296500,6,8,2014,0,66,3820,5760,0,0,1
3,2.25,1760,10835,1.0,0,0,4,8,1290,470,1976,0,98027,47.522,-122.048,2050,10488,440000,22,10,2014,0,38,9075,8438,0,1,0
2,1.0,800,6016,1.0,0,0,3,6,800,0,1942,0,98117,47.6913,-122.369,1470,3734,405000,8,12,2014,0,72,5216,2264,0,0,1
2,1.0,930,4000,1.0,0,0,3,6,730,200,1943,0,98108,47.5321,-122.323,1100,5000,269500,13,5,2015,0,72,3070,3900,0,1,1
5,1.75,2040,5280,1.0,0,0,4,7,1020,1020,1961,0,98007,47.5941,-122.144,1720,7344,520000,19,11,2014,0,53,3240,5624,0,1,0
4,1.75,2000,10890,1.0,0,0,4,7,1390,610,1961,0,98003,47.3203,-122.321,1520,9250,335000,9,10,2014,0,53,8890,7730,0,1,0
4,3.5,3130,3900,2.0,0,0,3,9,2550,580,2008,0,98115,47.6849,-122.327,1830,3900,1390000,13,3,2015,0,7,770,2070,0,1,1
4,2.5,2300,9900,1.0,0,2,3,8,1600,700,1961,0,98136,47.5256,-122.385,2510,7500,740000,15,12,2014,0,53,7600,4990,0,1,1
3,2.25,2140,9990,1.0,0,0,4,8,2140,0,1962,0,98003,47.3484,-122.298,2060,9990,270000,17,3,2015,0,53,7850,7930,0,0,0
4,2.0,2210,5572,1.5,0,3,3,7,1760,450,1911,0,98126,47.5727,-122.376,1760,4713,510000,4,5,2015,0,104,3362,2953,0,1,1
2,1.0,970,13700,1.0,0,0,3,6,970,0,1949,0,98106,47.515,-122.362,1570,10880,300000,21,5,2014,0,65,12730,9310,0,0,1
5,2.25,2690,10800,1.0,0,3,4,8,2020,670,1956,0,98040,47.5821,-122.247,3380,9134,1300000,23,3,2015,0,59,8110,5754,0,1,0
4,2.0,1890,5188,1.5,0,0,4,7,1670,220,1940,0,98105,47.6633,-122.287,1800,4848,675000,19,8,2014,0,74,3298,3048,0,1,1
6,3.25,3140,14923,2.0,0,0,3,10,3140,0,1991,0,98006,47.5411,-122.133,2980,10758,925850,4,11,2014,0,23,11783,7778,0,0,0
4,2.25,2140,8800,2.0,0,0,4,7,2140,0,1963,0,98032,47.3655,-122.291,2060,9790,245000,5,1,2015,0,52,6660,7730,0,0,0
3,1.0,1090,6712,1.0,0,0,4,7,1090,0,1972,0,98034,47.7155,-122.211,1440,7350,344950,17,3,2015,0,43,5622,5910,0,0,0
3,1.75,1330,7216,1.0,0,0,3,7,1330,0,1969,0,98034,47.7199,-122.18,1500,8000,381000,11,8,2014,0,45,5886,6500,0,0,0
4,4.0,4690,6900,2.0,0,0,3,11,3480,1210,2001,0,98004,47.6165,-122.216,2800,11240,1950000,30,12,2014,0,13,2210,8440,0,1,0
3,1.75,1750,11461,2.0,0,0,4,7,1750,0,1976,0,98002,47.3173,-122.21,2140,11276,232603,19,6,2014,0,38,9711,9136,0,0,0
5,2.5,1760,10200,1.5,0,0,3,6,1760,0,1925,0,98106,47.5271,-122.351,1370,7620,220000,12,12,2014,0,89,8440,6250,0,0,1
4,1.75,1810,7700,1.0,0,0,5,8,1390,420,1977,0,98033,47.6976,-122.169,2080,7700,600000,11,8,2014,0,37,5890,5620,0,1,0
3,2.5,1360,5754,2.0,0,0,3,7,1360,0,1994,0,98030,47.3645,-122.183,1360,7050,239000,5,11,2014,0,20,4394,5690,0,0,0
3,1.75,1730,9211,1.0,0,0,3,8,1730,0,1961,0,98125,47.7149,-122.322,1440,9211,400000,26,8,2014,0,53,7481,7771,0,0,1
6,2.75,4710,11000,2.0,0,3,3,10,3690,1020,1931,0,98105,47.6622,-122.272,2950,5300,2180000,8,7,2014,0,83,6290,2350,0,1,1
3,1.0,1010,8551,1.0,0,0,5,7,1010,0,1953,0,98155,47.7351,-122.295,1310,8504,350000,8,9,2014,0,61,7541,7194,0,0,1
3,1.5,1540,8400,1.0,0,0,5,7,1540,0,1968,0,98056,47.5237,-122.199,1690,7689,380000,10,9,2014,0,46,6860,5999,0,0,0
4,1.75,1480,7875,1.0,0,0,3,7,740,740,1927,0,98199,47.643,-122.397,1680,5851,511200,15,10,2014,0,87,6395,4171,0,1,1
4,2.5,2520,5000,2.0,0,0,3,9,2520,0,2004,0,98029,47.5524,-121.992,2910,5001,680000,14,10,2014,0,10,2480,2091,0,0,0
3,3.25,1210,941,2.0,0,0,3,8,1000,210,2002,0,98133,47.7114,-122.356,1650,1493,350000,26,7,2014,0,12,-269,-157,0,1,1
4,2.5,3030,12590,1.5,0,0,4,10,3030,0,1988,0,98004,47.5806,-122.193,2980,11635,1050000,22,5,2014,0,26,9560,8655,0,0,0
3,2.0,1440,3900,1.0,0,0,3,8,1440,0,2002,0,98053,47.7022,-122.021,1350,3900,391265,28,10,2014,0,12,2460,2550,0,0,0
3,2.0,1750,5750,1.0,0,2,5,7,870,880,1956,0,98116,47.5579,-122.384,1750,5750,575000,28,4,2015,0,59,4000,4000,0,1,1
3,1.0,1050,5156,1.5,0,0,3,7,1050,0,1919,0,98106,47.5169,-122.358,1050,5502,165000,16,4,2015,0,96,4106,4452,0,0,1
3,2.25,1950,3600,1.5,0,0,5,8,1430,520,1911,0,98119,47.637,-122.363,1950,3600,850000,12,8,2014,0,103,1650,1650,0,1,1
3,1.0,1020,6000,1.0,0,0,3,5,1020,0,1900,0,98027,47.5281,-122.031,2070,7200,210000,4,8,2014,0,114,4980,5130,0,0,0
4,2.5,1820,9161,1.0,0,0,4,7,1220,600,1975,0,98058,47.4333,-122.168,1860,7650,325000,24,8,2014,0,39,7341,5790,0,1,0
3,2.5,1400,7508,2.0,0,0,4,7,1400,0,1987,0,98034,47.7233,-122.167,1710,7700,430000,18,7,2014,0,27,6108,5990,0,0,0
3,1.5,1540,8110,1.0,0,0,4,7,1190,350,1959,0,98125,47.7329,-122.291,1290,8110,325500,25,11,2014,0,55,6570,6820,0,1,1
3,1.75,2370,6360,1.0,0,3,3,7,1280,1090,1954,0,98178,47.5039,-122.24,1990,6360,385000,20,7,2014,0,60,3990,4370,0,1,1
1,1.0,670,1800,1.0,0,0,5,6,670,0,1905,0,98103,47.654,-122.35,1330,3360,435000,23,3,2015,0,110,1130,2030,0,0,1
4,1.0,2420,15520,2.0,0,0,4,7,2420,0,1945,0,98006,47.5744,-122.137,1630,9965,550000,21,7,2014,0,69,13100,8335,0,0,0
3,1.0,1000,7800,1.0,0,0,4,6,860,140,1930,0,98125,47.7098,-122.283,1700,7800,400000,9,10,2014,0,84,6800,6100,0,1,1
4,2.75,2100,7350,1.0,0,0,5,7,1240,860,1978,0,98034,47.7194,-122.172,2490,7350,503000,21,7,2014,0,36,5250,4860,0,1,0
4,2.5,2800,5368,2.0,0,0,3,8,2800,0,2003,0,98074,47.6076,-122.053,2790,5368,676000,19,8,2014,0,11,2568,2578,0,0,0
3,1.0,940,11055,1.5,0,0,4,7,940,0,1959,0,98032,47.3732,-122.295,1420,9100,180000,13,11,2014,0,55,10115,7680,0,0,0
3,2.0,1640,5280,1.5,0,0,5,6,1640,0,1910,0,98002,47.3089,-122.213,1160,7875,234000,11,6,2014,0,104,3640,6715,0,0,0
4,2.5,2760,5000,1.5,0,0,5,7,1680,1080,1928,0,98107,47.6726,-122.371,1850,5000,734200,12,5,2014,0,86,2240,3150,0,1,1
3,1.75,1100,10125,1.0,0,0,4,7,1100,0,1969,0,98092,47.3232,-122.103,1520,10125,224000,9,12,2014,0,45,9025,8605,0,0,0
3,1.0,1320,7155,1.0,0,0,4,6,1320,0,1961,0,98002,47.2857,-122.22,1070,8100,185000,19,9,2014,0,53,5835,7030,0,0,0
3,1.75,1470,5000,1.5,0,0,5,7,1470,0,1900,0,98107,47.6755,-122.369,1530,5000,554600,18,8,2014,0,114,3530,3470,0,0,1
3,1.75,1480,8009,1.0,0,0,3,7,980,500,1980,0,98032,47.3657,-122.28,1790,7678,268000,25,8,2014,0,34,6529,5888,0,1,0
4,2.25,2260,8715,1.0,0,0,4,8,1530,730,1976,0,98008,47.6237,-122.106,2220,8650,675000,15,9,2014,0,38,6455,6430,0,1,0
4,2.25,2210,10039,1.0,0,0,4,8,1710,500,1967,0,98052,47.634,-122.101,2070,10965,620000,11,7,2014,0,47,7829,8895,0,1,0
3,1.75,1540,12446,1.0,0,0,5,8,1540,0,1967,0,98027,47.5172,-122.027,1330,11508,396450,21,5,2014,0,47,10906,10178,0,0,0
5,1.75,1910,9720,1.0,0,0,4,7,1390,520,1955,0,98006,47.5772,-122.159,1750,9720,565000,20,8,2014,0,59,7810,7970,0,1,0
3,1.75,1760,3520,1.0,0,0,3,7,1160,600,1966,0,98144,47.5773,-122.303,1840,5000,410000,24,8,2014,0,48,1760,3160,0,1,1
4,3.0,2240,6000,1.5,0,0,4,8,1270,970,1914,0,98109,47.6369,-122.35,2240,4250,1190000,19,5,2014,0,100,3760,2010,0,1,1
3,2.25,2110,7279,1.0,0,0,4,9,2110,0,1984,0,98033,47.6669,-122.17,2130,7279,716125,21,8,2014,0,30,5169,5149,0,0,0
4,2.75,3040,7274,2.0,0,3,3,9,2320,720,1986,0,98125,47.7184,-122.28,2830,10080,640000,11,7,2014,0,28,4234,7250,0,1,1
2,1.0,1140,5650,1.0,0,1,3,6,980,160,1920,0,98116,47.5634,-122.391,1220,5700,374000,10,9,2014,0,94,4510,4480,0,1,1
4,2.0,1780,12161,1.0,0,0,5,7,1160,620,1950,0,98155,47.7746,-122.323,1780,8170,415000,15,4,2015,0,65,10381,6390,0,1,1
3,2.5,1484,1761,3.0,0,0,3,7,1484,0,2003,0,98115,47.6844,-122.317,1484,4320,365000,4,9,2014,0,11,277,2836,0,0,1
4,2.5,2230,12753,1.0,0,0,4,7,1180,1050,1981,0,98074,47.6297,-122.033,1860,12753,600000,14,9,2014,0,33,10523,10893,0,1,0
3,1.0,1580,7560,1.0,0,0,4,7,1000,580,1976,0,98001,47.3318,-122.277,1580,7560,254999,22,4,2015,0,39,5980,5980,0,1,0
4,2.5,2040,8076,2.0,0,0,3,7,2040,0,1994,0,98042,47.3691,-122.074,2040,8408,279000,16,9,2014,0,20,6036,6368,0,0,0
4,2.25,1490,956,2.0,0,0,3,7,1020,470,2005,0,98122,47.6184,-122.301,1510,1350,507000,28,7,2014,0,9,-534,-160,0,1,1
3,1.75,1560,9788,1.0,0,0,3,7,1560,0,1964,0,98178,47.4876,-122.226,1840,11180,291000,20,5,2014,0,50,8228,9340,0,0,1
2,1.5,830,1077,2.0,0,0,3,7,830,0,2006,0,98122,47.6058,-122.319,830,1366,350000,2,12,2014,0,8,247,536,0,0,1
3,1.0,980,2490,2.0,0,0,4,6,980,0,1969,0,98092,47.317,-122.182,980,3154,90000,29,11,2014,0,45,1510,2174,0,0,0
3,1.75,1980,7000,1.0,0,0,4,8,1360,620,1977,0,98058,47.4442,-122.129,1880,7200,329000,6,8,2014,0,37,5020,5320,0,1,0
4,2.5,3680,11648,2.0,0,0,3,10,3680,0,1986,0,98006,47.5604,-122.107,2830,11251,909000,14,8,2014,0,28,7968,8421,0,0,0
2,1.0,860,5400,1.0,0,0,4,5,860,0,1953,0,98056,47.492,-122.171,960,5400,187000,15,10,2014,0,61,4540,4440,0,0,0
3,1.75,1850,5100,1.0,0,0,3,7,1020,830,1909,0,98105,47.6605,-122.326,1850,5100,580000,9,7,2014,0,105,3250,3250,0,1,1
3,2.5,1620,5992,2.0,0,0,3,7,1620,0,2001,0,98019,47.736,-121.965,1620,4644,345000,3,9,2014,0,13,4372,3024,0,0,0
4,2.5,2240,7200,2.0,0,0,3,8,2240,0,1995,0,98118,47.5636,-122.275,1860,6600,497000,15,5,2014,0,19,4960,4740,0,0,1
3,1.0,1010,3060,1.5,0,0,3,6,1010,0,1904,0,98118,47.5657,-122.285,1330,4590,345000,15,8,2014,0,110,2050,3260,0,0,1
3,1.75,1610,7350,1.0,0,0,3,8,1610,0,1974,0,98058,47.4503,-122.131,2120,7350,313500,19,11,2014,0,40,5740,5230,0,0,0
3,2.5,2720,7250,2.0,0,0,3,9,2720,0,1990,0,98033,47.6894,-122.195,2870,7250,910000,2,4,2015,0,25,4530,4380,0,0,0
3,1.5,2080,5244,1.0,0,0,3,7,1190,890,1959,0,98125,47.7144,-122.293,1850,6982,399950,4,6,2014,0,55,3164,5132,0,1,1
4,2.0,1930,6600,1.0,0,0,4,7,1030,900,1967,0,98168,47.482,-122.332,1220,6600,268000,27,5,2014,0,47,4670,5380,0,1,1
4,1.75,2250,8458,1.0,0,0,3,8,1450,800,1954,0,98136,47.5235,-122.383,1950,7198,559000,29,12,2014,0,60,6208,5248,0,1,1
3,2.25,1980,8755,1.0,0,0,4,7,1300,680,1963,0,98198,47.3922,-122.321,2030,8671,309000,9,7,2014,0,51,6775,6641,0,1,1
3,2.5,1960,4400,2.0,0,0,3,7,1960,0,2006,0,98065,47.5384,-121.889,2060,4400,410000,9,6,2014,0,8,2440,2340,0,0,0
3,1.0,1320,8625,1.0,0,0,4,7,1320,0,1957,0,98056,47.4902,-122.179,1370,8295,259000,20,5,2014,0,57,7305,6925,0,0,0
5,2.0,2940,5500,2.0,0,0,4,9,2340,600,1909,0,98102,47.6466,-122.321,2940,5500,950000,24,11,2014,0,105,2560,2560,0,1,1
4,1.0,1460,7200,1.5,0,0,4,7,1460,0,1955,0,98155,47.7602,-122.306,1690,7357,320000,2,12,2014,0,59,5740,5667,0,0,1
3,2.0,2620,10107,1.0,0,3,3,7,2620,0,1982,0,98198,47.4096,-122.329,1730,7812,394250,24,11,2014,0,32,7487,6082,0,0,1
1,1.0,700,3876,1.0,0,0,3,6,700,0,1910,0,98103,47.6886,-122.352,1150,3952,315000,6,11,2014,0,104,3176,2802,0,0,1
2,2.0,1140,12000,1.0,0,0,3,6,1140,0,1943,0,98027,47.5277,-122.031,1880,6125,480000,24,12,2014,0,71,10860,4245,0,0,0
3,2.5,2480,5647,2.0,0,0,3,7,2480,0,2002,0,98065,47.5355,-121.88,2510,5018,450000,27,10,2014,0,12,3167,2508,0,0,0
3,1.5,1130,5413,1.0,0,0,3,7,940,190,1946,0,98125,47.7021,-122.32,1400,7168,420000,1,10,2014,0,68,4283,5768,0,1,1
6,3.75,2770,5000,1.0,0,0,3,8,1870,900,1969,0,98107,47.669,-122.365,1570,2108,890000,17,3,2015,0,46,2230,538,0,1,1
4,2.0,1710,8814,1.0,0,0,5,7,1030,680,1975,0,98031,47.395,-122.174,1710,7272,295000,6,10,2014,0,39,7104,5562,0,1,0
3,2.5,2250,7294,2.0,0,0,3,8,2250,0,1994,0,98092,47.2636,-122.212,2140,7363,308900,11,6,2014,0,20,5044,5223,0,0,0
2,2.5,2300,6984,1.0,0,0,3,8,2300,0,2006,0,98053,47.7087,-122.015,1820,4950,665000,28,1,2015,0,9,4684,3130,0,0,0
3,1.75,1740,5500,1.0,0,0,5,7,970,770,1953,0,98116,47.577,-122.395,1740,7250,577000,3,9,2014,0,61,3760,5510,0,1,1
3,2.5,2830,3750,3.0,0,0,3,10,2830,0,2014,0,98117,47.6799,-122.385,1780,5000,959000,17,9,2014,0,0,920,3220,0,0,1
2,1.75,1240,6417,1.0,0,0,5,7,1240,0,1924,0,98126,47.5439,-122.379,1800,6417,471000,26,6,2014,0,90,5177,4617,0,0,1
3,2.5,2180,7169,2.0,0,0,3,8,2180,0,1990,0,98029,47.5714,-122.002,2150,5914,560000,21,4,2015,0,25,4989,3764,0,0,0
5,2.25,2510,9887,2.0,0,0,3,8,2510,0,1972,0,98040,47.5339,-122.223,2510,10006,955000,14,5,2014,0,42,7377,7496,0,0,0
7,5.5,6630,13782,2.0,0,0,3,10,4930,1700,2004,0,98006,47.5399,-122.118,4470,8639,1240000,20,6,2014,0,10,7152,4169,0,1,0
4,2.25,3220,7889,2.0,0,0,3,8,3220,0,1978,0,98023,47.3112,-122.339,2120,7651,335000,28,4,2015,0,37,4669,5531,0,0,0
3,2.5,2270,7887,2.0,0,2,3,8,2270,0,2004,0,98065,47.5326,-121.855,2550,7133,485000,15,9,2014,0,10,5617,4583,0,0,0
3,2.5,1840,9900,1.0,0,0,3,9,1840,0,1978,0,98007,47.6131,-122.151,2730,9900,552000,2,7,2014,0,36,8060,7170,0,0,0
4,3.25,3820,15293,2.0,0,0,3,10,3820,0,2003,0,98074,47.6097,-122.017,2790,7142,950000,14,7,2014,0,11,11473,4352,0,0,0
3,2.0,1660,7958,1.0,0,0,3,7,1130,530,1983,0,98092,47.3187,-122.171,1550,7647,203700,16,3,2015,0,32,6298,6097,0,1,0
4,3.5,3360,9767,2.0,0,0,3,9,2450,910,1990,0,98023,47.3047,-122.347,2580,8757,412000,9,7,2014,0,24,6407,6177,0,1,0
3,2.0,1350,8960,1.0,0,0,4,7,1350,0,1986,0,98038,47.3614,-122.045,1470,8288,237500,6,1,2015,0,29,7610,6818,0,0,0
4,3.5,2970,5000,2.0,0,2,3,9,2200,770,2001,0,98117,47.6772,-122.399,1470,4560,866800,15,8,2014,0,13,2030,3090,0,1,1
3,1.0,1000,5100,1.0,0,0,3,7,860,140,1946,0,98115,47.6857,-122.293,1000,5100,425000,10,3,2015,0,69,4100,4100,0,1,1
3,2.0,1190,6833,1.0,0,0,3,7,1190,0,1995,0,98092,47.3191,-122.18,1540,8000,200000,25,6,2014,0,19,5643,6460,0,0,0
3,1.75,1670,6034,1.0,0,0,3,7,990,680,1957,0,98118,47.5209,-122.286,1230,6034,280000,29,9,2014,0,57,4364,4804,0,1,1
3,1.5,1200,2002,2.0,0,0,3,8,1200,0,1966,0,98055,47.4659,-122.189,1270,1848,140000,26,11,2014,0,48,802,578,0,0,0
5,2.5,2250,10400,1.0,0,0,3,8,1280,970,1973,0,98058,47.4501,-122.139,2140,9592,370000,14,11,2014,0,41,8150,7452,0,1,0
2,0.75,1040,4000,1.0,0,0,3,7,930,110,1909,0,98119,47.6489,-122.372,1700,4800,550000,16,9,2014,0,105,2960,3100,0,1,1
2,2.5,3180,9400,2.0,0,4,5,10,2610,570,1985,0,98006,47.5617,-122.158,3760,9450,1410000,2,7,2014,0,29,6220,5690,0,1,0
2,2.5,3180,9400,2.0,0,4,5,10,2610,570,1985,0,98006,47.5617,-122.158,3760,9450,1510000,22,3,2015,0,30,6220,5690,0,1,0
4,1.5,2040,8800,1.0,0,0,4,7,1020,1020,1961,0,98007,47.5965,-122.139,1490,8800,510000,28,5,2014,0,53,6760,7310,0,1,0
3,1.0,1160,10518,1.0,0,0,3,7,1160,0,1960,0,98028,47.7343,-122.22,1670,9380,351000,16,7,2014,0,54,9358,7710,0,0,0
3,1.0,880,10800,1.0,0,0,3,6,880,0,1942,0,98146,47.4949,-122.338,1100,8820,210000,25,3,2015,0,73,9920,7720,0,0,1
3,1.0,950,7620,1.0,0,0,3,6,950,0,1954,0,98106,47.5178,-122.346,1260,7620,137000,19,5,2014,0,60,6670,6360,0,0,1
4,1.5,2430,3600,2.5,0,0,3,8,2430,0,1980,0,98112,47.6351,-122.285,2020,4800,940000,9,4,2015,0,35,1170,2780,0,0,1
3,3.0,2090,7634,1.0,0,0,3,8,1450,640,2001,0,98019,47.7408,-121.974,2090,9600,400000,22,8,2014,0,13,5544,7510,0,1,0
3,2.0,2030,8649,1.0,0,0,3,7,2030,0,1998,0,98056,47.5082,-122.166,1760,7200,365000,21,3,2015,0,17,6619,5440,0,0,0
2,1.0,1060,1600,2.0,0,0,3,7,1060,0,1979,0,98144,47.5888,-122.294,1360,3360,353250,22,5,2014,0,35,540,2000,0,0,1
2,1.5,1090,6750,1.0,0,0,3,7,950,140,1942,0,98117,47.6836,-122.397,1640,6750,455000,29,4,2015,0,73,5660,5110,0,1,1
4,1.75,1920,7455,1.0,0,0,4,7,960,960,1939,1964,98125,47.7106,-122.286,1920,7455,571500,24,11,2014,25,75,5535,5535,1,1,1
2,1.0,1150,3000,1.0,0,0,3,6,780,370,1915,0,98118,47.5624,-122.291,1150,5000,441000,28,3,2015,0,100,1850,3850,0,1,1
6,2.75,3970,9500,1.0,0,0,4,10,2180,1790,1970,0,98005,47.5956,-122.178,2490,9775,810000,13,2,2015,0,45,5530,7285,0,1,0
3,2.25,1880,11556,2.0,0,0,3,8,1880,0,1987,0,98074,47.6283,-122.032,1880,12000,550000,9,4,2015,0,28,9676,10120,0,0,0
2,1.0,1500,4000,1.0,0,0,3,8,1100,400,1933,0,98109,47.6409,-122.353,1980,4000,736000,2,7,2014,0,81,2500,2020,0,1,1
3,2.5,2530,9932,2.0,0,0,3,8,2530,0,1995,0,98052,47.6853,-122.16,2140,7950,717500,5,2,2015,0,20,7402,5810,0,0,0
2,1.75,1930,11200,1.0,0,2,3,8,1430,500,1951,0,98177,47.7576,-122.37,2840,12408,581000,21,11,2014,0,63,9270,9568,0,1,1
3,2.0,1510,4560,2.0,0,0,4,7,1510,0,1909,1995,98116,47.5689,-122.408,1990,5000,629000,25,7,2014,86,105,3050,3010,1,0,1
3,2.0,1100,5200,1.0,0,0,3,6,1100,0,1969,2014,98042,47.3606,-122.083,1050,5330,225000,8,12,2014,45,45,4100,4280,1,0,0
3,2.5,1730,6368,2.0,0,0,3,7,1730,0,1993,0,98038,47.3505,-122.032,1780,6597,315000,18,6,2014,0,21,4638,4817,0,0,0
3,2.5,1480,1386,3.0,0,0,3,8,1480,0,2005,0,98029,47.5468,-121.998,1470,1593,425000,10,3,2015,0,10,-94,123,0,0,0
3,1.0,1150,11802,1.0,0,0,4,7,1150,0,1932,1958,98106,47.5624,-122.361,1880,6082,346500,25,6,2014,26,82,10652,4202,1,0,1
3,1.75,2380,10450,1.0,0,0,3,8,1400,980,1977,0,98052,47.6409,-122.111,2150,9600,565000,9,2,2015,0,38,8070,7450,0,1,0
4,2.0,3100,8000,1.5,0,0,5,7,2040,1060,1939,0,98103,47.6852,-122.329,1650,4000,1000000,24,12,2014,0,75,4900,2350,0,1,1
2,2.0,2010,3797,1.5,0,0,3,7,1450,560,1922,2004,98108,47.5596,-122.315,1660,4650,400000,5,8,2014,82,92,1787,2990,1,1,1
4,2.0,2270,5760,2.0,0,0,4,8,2270,0,1909,0,98116,47.5809,-122.39,1420,5760,724950,21,11,2014,0,105,3490,4340,0,0,1
3,1.75,2050,16313,1.0,0,0,2,8,2050,0,1973,0,98040,47.5743,-122.212,3180,10264,623000,8,7,2014,0,41,14263,7084,0,0,0
2,1.0,650,5400,1.0,0,0,3,6,650,0,1950,0,98122,47.6185,-122.295,1310,4906,295000,24,6,2014,0,64,4750,3596,0,0,1
4,3.25,2780,7875,2.0,0,0,3,9,2780,0,2006,0,98133,47.7294,-122.352,1000,7500,700000,21,5,2014,0,8,5095,6500,0,0,1
2,1.5,1300,1229,2.0,0,0,3,8,1160,140,2000,0,98107,47.6727,-122.375,1430,1255,482000,8,4,2015,0,15,-71,-175,0,1,1
3,2.5,2730,11380,2.0,0,0,3,10,2730,0,1995,0,98075,47.58,-122.057,2800,10070,770000,21,8,2014,0,19,8650,7270,0,0,0
4,2.25,2410,8400,2.0,0,0,5,8,2410,0,1965,0,98008,47.626,-122.119,1910,8056,720000,8,7,2014,0,49,5990,6146,0,0,0
3,1.0,1180,5965,1.5,0,0,4,6,1180,0,1928,0,98125,47.7281,-122.299,1270,7710,355000,19,3,2015,0,87,4785,6440,0,0,1
4,2.5,2600,4506,2.0,0,0,3,9,2600,0,2005,0,98056,47.5146,-122.188,2470,6041,512000,29,7,2014,0,9,1906,3571,0,0,0
2,1.5,1400,1650,3.0,0,0,3,7,1400,0,1999,0,98125,47.7222,-122.29,1430,1650,303000,16,12,2014,0,15,250,220,0,0,1
5,2.5,2220,9360,1.0,0,0,4,7,1110,1110,1968,0,98058,47.4341,-122.169,1780,7704,299000,18,6,2014,0,46,7140,5924,0,1,0
3,2.5,1660,6263,2.0,0,0,3,8,1660,0,2003,0,98042,47.3507,-122.141,2190,6192,285000,23,6,2014,0,11,4603,4002,0,0,0
3,1.75,2330,9652,1.0,0,0,4,8,1590,740,1968,0,98040,47.5714,-122.211,2420,9631,680000,24,9,2014,0,46,7322,7211,0,1,0
4,1.75,1440,6720,1.0,0,0,5,6,720,720,1954,0,98166,47.4571,-122.345,1820,6784,285000,2,9,2014,0,60,5280,4964,0,1,1
4,2.25,2920,17023,1.0,0,0,4,9,1690,1230,1977,0,98006,47.5585,-122.134,2710,10681,707000,25,11,2014,0,37,14103,7971,0,1,0
3,2.0,1760,6428,1.0,0,0,4,7,980,780,1942,0,98199,47.6388,-122.397,1760,6004,690000,7,5,2014,0,72,4668,4244,0,1,1
4,1.75,2090,12750,1.0,0,0,3,8,1360,730,1967,0,98166,47.4792,-122.357,2040,12300,290000,4,11,2014,0,47,10660,10260,0,1,1
4,1.75,1910,16785,1.0,0,0,4,7,1110,800,1981,0,98028,47.7474,-122.235,1590,9900,425000,17,4,2015,0,34,14875,8310,0,1,0
3,2.75,3280,10558,1.0,0,2,4,9,2040,1240,1979,0,98006,47.5606,-122.133,3150,9998,925000,26,1,2015,0,36,7278,6848,0,1,0
3,1.0,1770,12458,1.0,0,0,3,7,1770,0,1957,0,98155,47.7715,-122.27,2000,8225,340500,19,12,2014,0,57,10688,6225,0,0,1
2,1.0,920,6600,1.0,0,0,4,6,920,0,1910,0,98118,47.5572,-122.282,1370,5500,365000,21,11,2014,0,104,5680,4130,0,0,1
3,1.75,1690,8489,1.0,0,0,4,7,1690,0,1959,0,98004,47.6079,-122.192,1850,8536,725000,10,7,2014,0,55,6799,6686,0,0,0
3,3.0,2470,7410,2.0,0,0,5,8,1860,610,1977,0,98117,47.6937,-122.392,2390,7800,811000,2,7,2014,0,37,4940,5410,0,1,1
3,1.0,1040,9514,1.0,0,0,4,7,1040,0,1969,0,98059,47.4936,-122.102,1040,9514,299000,10,12,2014,0,45,8474,8474,0,0,0
4,2.0,1220,9147,1.0,0,0,5,7,1220,0,1953,0,98146,47.5011,-122.336,1220,8576,287500,21,4,2015,0,62,7927,7356,0,0,1
4,2.25,3500,13875,1.0,0,4,4,9,1830,1670,1938,0,98146,47.5083,-122.388,2960,15000,879950,20,5,2014,0,76,10375,12040,0,1,1
2,1.0,760,3800,1.0,0,0,3,6,760,0,1950,0,98178,47.5019,-122.269,1220,7410,135900,10,11,2014,0,64,3040,6190,0,0,1
4,1.75,2100,6480,1.0,0,0,5,7,1300,800,1947,0,98177,47.7049,-122.359,1840,7500,522500,17,10,2014,0,67,4380,5660,0,1,1
4,1.5,1660,6617,1.0,0,0,5,7,1660,0,1947,0,98155,47.739,-122.323,950,7440,399500,12,3,2015,0,68,4957,6490,0,0,1
3,1.0,1430,5960,1.5,0,0,4,7,1430,0,1917,0,98118,47.562,-122.289,1140,3960,450000,4,5,2015,0,98,4530,2820,0,0,1
3,2.0,1490,9285,1.0,0,0,3,8,1490,0,1995,0,98092,47.3248,-122.169,2040,6681,289999,27,3,2015,0,20,7795,4641,0,0,0
2,1.0,1170,4750,1.0,0,0,3,6,1170,0,1903,0,98107,47.6729,-122.378,1170,2023,540000,24,2,2015,0,112,3580,853,0,0,1
3,1.0,1240,7500,1.0,0,0,4,7,1240,0,1976,0,98074,47.6199,-122.062,1240,9750,324950,25,7,2014,0,38,6260,8510,0,0,0
3,2.0,2910,6600,2.0,0,0,4,7,1920,990,1900,1988,98118,47.5576,-122.281,1370,5500,718500,13,6,2014,88,114,3690,4130,1,1,1
6,2.0,2220,8797,1.0,0,0,3,7,2220,0,1977,0,98002,47.2977,-122.227,1170,5123,260000,21,5,2014,0,37,6577,3953,0,0,0
4,1.5,1920,10000,1.0,0,0,4,7,1070,850,1954,0,98006,47.5725,-122.133,1450,10836,430000,2,5,2014,0,60,8080,9386,0,1,0
3,3.25,2780,4002,2.0,0,0,3,8,2780,0,2009,0,98019,47.7348,-121.966,1890,4090,402500,3,6,2014,0,5,1222,2200,0,0,0
4,3.0,3110,4408,2.5,0,3,4,10,2510,600,1931,0,98105,47.6583,-122.27,3250,5669,1420000,11,8,2014,0,83,1298,2419,0,1,1
3,2.25,1820,9766,1.0,0,0,4,7,1450,370,1987,0,98031,47.397,-122.203,1860,8236,275000,28,10,2014,0,27,7946,6376,0,1,0
3,2.25,1765,7652,2.0,0,0,3,7,1765,0,1996,0,98003,47.3072,-122.328,1765,7719,250000,3,6,2014,0,18,5887,5954,0,0,0
3,2.75,1800,9550,1.0,0,0,4,7,1320,480,1966,0,98006,47.5679,-122.178,1890,9902,665000,23,5,2014,0,48,7750,8012,0,1,0
2,1.0,1410,3600,1.5,0,0,4,7,1310,100,1925,0,98103,47.6695,-122.338,1740,4200,760000,22,7,2014,0,89,2190,2460,0,1,1
3,2.5,1650,3076,2.0,0,0,3,7,1650,0,2003,0,98053,47.682,-122.035,1560,3064,447000,14,8,2014,0,11,1426,1504,0,0,0
3,1.0,1180,8240,1.0,0,0,4,7,1180,0,1967,0,98003,47.3325,-122.321,1180,7840,205000,8,7,2014,0,47,7060,6660,0,0,0
3,1.5,800,8850,1.0,0,0,4,6,800,0,1959,0,98023,47.3266,-122.348,820,8775,191000,6,5,2014,0,55,8050,7955,0,0,0
2,1.75,1430,7921,1.0,0,0,3,7,1430,0,1983,0,98146,47.5088,-122.371,1290,8040,350000,16,3,2015,0,32,6491,6750,0,0,1
5,3.5,3300,7860,2.0,0,0,3,9,2410,890,2001,0,98006,47.5463,-122.192,2540,9920,789888,30,3,2015,0,14,4560,7380,0,1,0
2,1.0,1220,10170,1.0,0,0,3,7,980,240,1948,0,98125,47.7297,-122.327,1990,9064,443000,23,3,2015,0,67,8950,7074,0,1,1
4,3.5,3530,7202,2.0,0,0,3,9,2660,870,2000,0,98177,47.7339,-122.36,2810,8100,695000,29,9,2014,0,14,3672,5290,0,1,1
4,2.0,1380,4048,1.5,0,0,4,7,1380,0,1906,0,98103,47.6583,-122.344,1440,3956,560000,13,2,2015,0,109,2668,2516,0,0,1
3,1.75,1410,5000,1.0,0,0,4,7,810,600,1923,0,98107,47.6727,-122.395,1760,5000,550000,14,7,2014,0,91,3590,3240,0,1,1
2,2.5,3360,6750,2.0,0,0,3,9,3360,0,2004,0,98053,47.7112,-122.033,2510,6750,850000,24,7,2014,0,10,3390,4240,0,0,0
4,2.5,2890,9045,2.0,0,0,3,8,2890,0,2001,0,98019,47.7385,-121.965,2840,10114,550000,18,8,2014,0,13,6155,7274,0,0,0
5,1.0,1750,3861,1.5,0,0,3,7,1750,0,1903,0,98122,47.6075,-122.295,1700,4255,774900,18,11,2014,0,111,2111,2555,0,0,1
3,1.0,1010,8711,1.0,0,0,5,6,1010,0,1944,0,98056,47.4914,-122.186,1250,8053,250000,10,7,2014,0,70,7701,6803,0,0,0
2,1.0,800,5220,1.0,0,0,3,6,800,0,1943,0,98125,47.7037,-122.32,1910,5376,250000,3,11,2014,0,71,4420,3466,0,0,1
5,2.25,1980,13132,1.0,0,0,4,7,1260,720,1962,0,98198,47.3984,-122.301,1880,11325,307700,26,8,2014,0,52,11152,9445,0,1,1
3,1.0,1650,5102,1.0,0,0,4,8,1300,350,1953,0,98199,47.6524,-122.404,1440,5102,665000,11,12,2014,0,61,3452,3662,0,1,1
3,2.75,1890,3930,2.0,0,0,3,8,1890,0,1999,0,98065,47.5337,-121.867,2100,4259,375000,24,7,2014,0,15,2040,2159,0,0,0
4,2.5,3360,11637,2.0,0,0,3,11,3360,0,1990,0,98023,47.3018,-122.342,3530,11205,420000,3,3,2015,0,25,8277,7675,0,0,0
2,1.0,630,4200,1.0,0,0,3,6,630,0,1930,0,98106,47.5329,-122.348,970,4200,148000,8,7,2014,0,84,3570,3230,0,0,1
3,1.5,1980,4000,2.0,0,0,3,8,1980,0,1919,0,98109,47.6364,-122.351,1980,3600,707000,29,7,2014,0,95,2020,1620,0,0,1
3,1.0,990,4250,1.0,0,0,4,7,840,150,1924,0,98136,47.5392,-122.39,990,4500,399000,12,11,2014,0,90,3260,3510,0,1,1
3,1.0,1300,14138,1.0,0,0,4,7,1300,0,1943,0,98005,47.593,-122.165,2440,12196,400000,22,12,2014,0,71,12838,9756,0,0,0
3,1.0,1250,7700,1.0,0,0,4,7,1250,0,1955,0,98007,47.5974,-122.149,1520,7700,463000,6,1,2015,0,60,6450,6180,0,0,0
4,2.5,1960,14242,1.0,0,1,4,8,1290,670,1958,0,98146,47.4947,-122.369,2490,10907,600000,3,6,2014,0,56,12282,8417,0,1,1
5,2.5,2720,8120,1.0,0,0,3,7,1360,1360,1970,0,98108,47.557,-122.308,2020,8120,429000,28,10,2014,0,44,5400,6100,0,1,1
4,4.25,3250,11780,2.0,0,0,3,8,2360,890,1944,2001,98004,47.6322,-122.203,1800,9000,980000,4,9,2014,57,70,8530,7200,1,1,0
6,3.75,3190,4700,2.0,0,0,3,8,3190,0,2003,0,98042,47.3724,-122.105,2680,5640,359500,21,4,2015,0,12,1510,2960,0,0,0
4,2.5,2570,7980,2.0,0,0,3,9,2570,0,1998,0,98074,47.6378,-122.065,2760,6866,715000,7,11,2014,0,16,5410,4106,0,0,0
3,1.75,1420,6984,1.0,0,0,4,7,980,440,1980,0,98030,47.3748,-122.18,1430,7875,240000,25,3,2015,0,35,5564,6445,0,1,0
4,2.0,2120,9442,1.0,0,0,5,7,1060,1060,1968,0,98011,47.7675,-122.226,1290,9600,455000,15,12,2014,0,46,7322,8310,0,1,0
3,2.75,2740,5735,2.0,0,0,3,9,2740,0,2004,0,98052,47.6862,-122.093,2210,5026,675000,11,3,2015,0,11,2995,2816,0,0,0
3,1.75,1250,5375,1.0,0,0,3,7,1250,0,1985,0,98198,47.3787,-122.323,1320,6258,283500,29,1,2015,0,30,4125,4938,0,0,1
2,1.0,2150,4500,1.5,0,0,3,7,1260,890,1917,0,98118,47.5158,-122.267,1590,5010,235000,26,8,2014,0,97,2350,3420,0,1,1
4,2.5,3230,12100,1.0,0,0,3,9,1870,1360,1977,0,98006,47.562,-122.146,2670,10200,827000,26,6,2014,0,37,8870,7530,0,1,0
2,1.0,860,8511,1.0,0,0,3,7,860,0,1949,0,98125,47.7312,-122.3,1554,8499,353000,10,9,2014,0,65,7651,6945,0,0,1
4,2.5,2810,11902,2.0,0,0,4,9,2810,0,1993,0,98059,47.5303,-122.143,2990,10754,747500,23,9,2014,0,21,9092,7764,0,0,0
2,1.0,1040,4000,1.0,0,0,3,6,1040,0,1914,0,98144,47.5753,-122.303,1740,4000,341000,12,4,2015,0,101,2960,2260,0,0,1
3,1.0,1160,18055,1.0,0,0,2,5,1160,0,1950,0,98168,47.4772,-122.269,1340,10324,182000,24,11,2014,0,64,16895,8984,0,0,1
3,2.0,1470,2781,2.0,0,0,3,6,1470,0,2003,0,98038,47.349,-122.024,1360,3008,250000,2,12,2014,0,11,1311,1648,0,0,0
4,3.5,2350,13402,2.0,0,3,3,8,1670,680,1994,0,98033,47.6947,-122.19,2250,9474,655000,21,5,2014,0,20,11052,7224,0,1,0
3,2.25,1660,8307,1.0,0,0,4,8,1660,0,1961,0,98133,47.7575,-122.352,2510,7800,405000,7,5,2014,0,53,6647,5290,0,0,1
4,1.75,2020,9750,1.0,0,0,3,7,1100,920,1975,0,98074,47.6192,-122.055,1670,9600,390000,18,8,2014,0,39,7730,7930,0,1,0
2,1.0,890,8180,1.0,0,0,3,7,890,0,1947,0,98155,47.737,-122.3,1130,8180,275400,8,10,2014,0,67,7290,7050,0,0,1
3,2.25,2430,5500,2.0,0,0,3,8,1810,620,1989,0,98033,47.6812,-122.196,2040,5500,791000,4,6,2014,0,25,3070,3460,0,1,0
3,1.75,1460,7700,1.0,0,0,3,7,1460,0,1979,0,98052,47.6981,-122.127,1720,7280,424500,8,5,2014,0,35,6240,5560,0,0,0
3,1.0,980,7200,1.0,0,0,4,7,980,0,1950,0,98116,47.5718,-122.395,1180,6572,430000,17,6,2014,0,64,6220,5392,0,0,1
4,2.5,2580,10631,2.0,0,2,4,9,2580,0,1992,0,98033,47.6993,-122.206,4220,10631,865000,5,5,2015,0,23,8051,6411,0,0,0
2,2.0,1250,7543,1.0,0,0,3,7,1250,0,1962,0,98198,47.4051,-122.296,1250,7506,163000,4,3,2015,0,53,6293,6256,0,0,1
4,2.75,3140,9085,1.0,0,2,5,8,1570,1570,1961,0,98006,47.5675,-122.16,2430,9350,920000,8,9,2014,0,53,5945,6920,0,1,0
5,3.25,2680,3011,2.0,0,0,3,9,1870,810,1910,2014,98122,47.6115,-122.287,3440,5165,1030000,11,12,2014,104,104,331,1725,1,1,1
3,1.75,1810,8048,1.0,0,0,4,7,1290,520,1983,0,98055,47.4484,-122.194,1550,9081,325000,24,7,2014,0,31,6238,7531,0,1,0
5,2.5,2090,4698,2.0,0,0,3,7,2090,0,1998,0,98038,47.3538,-122.025,2070,4698,315000,3,6,2014,0,16,2608,2628,0,0,0
4,1.0,1120,8763,1.0,0,0,3,6,1120,0,1971,0,98146,47.508,-122.358,1120,8636,227000,11,9,2014,0,43,7643,7516,0,0,1
4,1.75,1790,7175,1.5,0,0,3,6,1410,380,1900,0,98168,47.4963,-122.318,1790,8417,179000,29,7,2014,0,114,5385,6627,0,1,1
2,1.0,870,2676,1.0,0,0,3,7,820,50,2004,0,98144,47.5702,-122.287,1500,1719,276000,9,10,2014,0,10,1806,219,0,1,1
3,2.0,2350,12480,1.0,0,0,3,7,1600,750,1981,0,98028,47.7661,-122.262,2160,12000,430000,14,11,2014,0,33,10130,9840,0,1,0
3,2.5,1810,4113,2.0,0,0,3,7,1810,0,2004,0,98042,47.3715,-122.126,1880,4465,266490,18,11,2014,0,10,2303,2585,0,0,0
4,2.75,3160,8197,1.0,0,0,3,8,1580,1580,1962,0,98115,47.7004,-122.287,2050,8197,655000,6,8,2014,0,52,5037,6147,0,1,1
3,2.0,1660,3600,1.0,0,0,3,7,1000,660,1939,2006,98103,47.6789,-122.351,1700,4356,635500,14,11,2014,67,75,1940,2656,1,1,1
3,2.5,2880,11443,2.0,0,0,4,9,2880,0,1986,0,98006,47.5633,-122.111,2840,12530,885000,27,4,2015,0,29,8563,9690,0,0,0
3,1.0,1470,8400,1.0,0,0,4,7,1470,0,1953,0,98133,47.7628,-122.354,1470,8400,352500,18,8,2014,0,61,6930,6930,0,0,1
3,2.5,1460,7573,2.0,0,0,3,8,1460,0,1983,0,98007,47.6012,-122.141,1910,7668,450000,9,7,2014,0,31,6113,5758,0,0,0
3,2.25,2480,15022,1.0,0,4,3,9,1330,1150,1967,2003,98136,47.5497,-122.396,2500,8178,1050000,19,9,2014,36,47,12542,5678,1,1,1
2,2.25,1140,1332,3.0,0,0,3,8,1140,0,1999,0,98103,47.6543,-122.356,1140,1267,476000,21,11,2014,0,15,192,127,0,0,1
3,2.5,1830,13042,2.0,0,0,3,8,1830,0,1990,0,98038,47.3738,-122.042,1940,6996,375000,7,5,2014,0,24,11212,5056,0,0,0
4,3.5,3110,6829,2.0,0,0,3,8,3110,0,2014,0,98148,47.4349,-122.328,2910,7425,600600,9,9,2014,0,0,3719,4515,0,0,1
4,1.75,2630,11213,1.0,0,2,4,8,1430,1200,1948,0,98177,47.7158,-122.366,2240,15186,567000,17,11,2014,0,66,8583,12946,0,1,1
4,1.75,2390,12000,1.0,0,0,3,8,1470,920,1979,0,98052,47.7061,-122.163,2110,12000,650000,25,7,2014,0,35,9610,9890,0,1,0
5,2.0,1750,10284,1.0,0,0,4,5,1750,0,1943,0,98056,47.5094,-122.182,1560,9010,190000,4,6,2014,0,71,8534,7450,0,0,0
1,1.75,1020,4512,1.0,0,0,3,7,770,250,1937,0,98115,47.6724,-122.266,1230,5029,435500,15,1,2015,0,78,3492,3799,0,1,1
3,2.0,2500,6733,1.0,0,0,3,8,1770,730,1979,0,98107,47.6691,-122.36,1770,6343,685000,11,3,2015,0,36,4233,4573,0,1,1
3,2.0,1540,7210,2.0,0,0,4,7,1540,0,1984,0,98023,47.3128,-122.351,1500,7210,252000,19,11,2014,0,30,5670,5710,0,0,0
4,2.25,2200,6900,2.0,0,0,4,8,2200,0,1975,0,98028,47.7682,-122.261,2400,6900,512500,12,9,2014,0,39,4700,4500,0,0,0
3,2.5,1940,7415,2.0,0,0,3,8,1940,0,1965,0,98006,47.542,-122.176,1940,8425,423800,1,8,2014,0,49,5475,6485,0,0,0
3,2.25,1453,2225,2.0,0,0,4,8,1453,0,1986,0,98006,47.5429,-122.188,1860,2526,460000,4,5,2015,0,29,772,666,0,0,0
3,2.75,1830,3200,2.0,0,0,3,8,1830,0,1991,0,98034,47.7155,-122.218,2030,3331,434000,22,7,2014,0,23,1370,1301,0,0,0
3,1.0,2000,15900,1.0,0,0,3,6,1000,1000,1948,0,98178,47.4816,-122.233,1760,10500,244000,14,4,2015,0,67,13900,8740,0,1,1
3,1.0,1400,8451,1.5,0,0,3,7,1400,0,1953,0,98133,47.7719,-122.337,1590,8433,348125,17,2,2015,0,62,7051,6843,0,0,1
3,1.0,1390,16000,1.0,0,0,4,6,1390,0,1960,0,98001,47.2898,-122.251,1420,10000,230000,8,5,2014,0,54,14610,8580,0,0,0
3,2.0,1680,11250,1.0,0,0,4,8,1680,0,1967,0,98045,47.4861,-121.786,1760,12160,450000,5,8,2014,0,47,9570,10400,0,0,0
5,2.0,1820,5054,1.0,0,0,4,7,910,910,1970,0,98108,47.5547,-122.299,1180,5628,393000,23,3,2015,0,45,3234,4448,0,1,1
2,1.0,1140,3750,1.0,0,0,4,7,1140,0,1925,0,98103,47.6619,-122.343,1660,4000,517000,21,12,2014,0,89,2610,2340,0,0,1
3,1.0,1060,12690,1.0,0,0,3,7,1060,0,1969,0,98033,47.6736,-122.167,1920,10200,400000,15,9,2014,0,45,11630,8280,0,0,0
3,1.0,970,11963,1.0,0,0,4,6,970,0,1970,0,98198,47.3776,-122.315,1210,11963,205950,10,3,2015,0,45,10993,10753,0,0,1
3,1.0,1320,3954,1.5,0,0,3,6,1320,0,1912,2014,98022,47.202,-121.994,1270,5184,209000,3,12,2014,102,102,2634,3914,1,0,0
4,1.75,1890,6000,1.0,0,0,4,6,1110,780,1947,0,98125,47.7274,-122.305,1560,6356,430000,12,6,2014,0,67,4110,4796,0,1,1
4,1.75,2040,2750,1.5,0,0,4,6,1260,780,1926,0,98105,47.6698,-122.3,1940,3750,534000,1,3,2015,0,89,710,1810,0,1,1
4,3.0,2370,3672,1.5,0,0,5,7,1650,720,1916,0,98115,47.678,-122.311,2140,4182,735000,27,6,2014,0,98,1302,2042,0,1,1
4,2.25,1970,7532,1.0,0,0,3,8,1390,580,1983,0,98052,47.7219,-122.109,1970,8248,475000,18,11,2014,0,31,5562,6278,0,1,0
3,1.75,2180,10230,1.0,0,0,4,7,1090,1090,1961,0,98118,47.5158,-122.281,2130,7200,325000,30,5,2014,0,53,8050,5070,0,1,1
4,2.75,2180,8475,1.0,0,0,4,7,1330,850,1987,0,98031,47.4045,-122.174,1500,7140,279000,20,1,2015,0,28,6295,5640,0,1,0
3,2.0,1440,5469,1.0,0,0,3,8,1440,0,1988,0,98029,47.5753,-122.017,1980,6198,350000,14,4,2015,0,27,4029,4218,0,0,0
4,2.25,3180,13653,2.0,0,0,3,9,3180,0,1978,0,98074,47.6316,-122.05,2910,12350,660000,21,4,2015,0,37,10473,9440,0,0,0
2,1.5,1643,14616,1.0,0,1,4,7,1643,0,1954,0,98198,47.3973,-122.312,2270,9940,324950,18,2,2015,0,61,12973,7670,0,0,1
4,2.0,1530,7816,1.0,0,0,3,7,1530,0,1955,0,98133,47.7309,-122.332,1480,7816,500000,27,1,2015,0,60,6286,6336,0,0,1
2,1.0,1310,7697,1.0,0,0,3,6,850,460,1950,0,98146,47.4982,-122.348,1270,6410,187300,18,7,2014,0,64,6387,5140,0,1,1
5,3.5,2800,5120,2.5,0,0,3,9,2800,0,1903,2005,98122,47.6059,-122.31,1780,5120,345600,20,5,2014,102,111,2320,3340,1,0,1
3,1.5,1510,7642,1.0,0,0,3,7,1510,0,1959,0,98008,47.5978,-122.116,2180,8357,400000,24,11,2014,0,55,6132,6177,0,0,0
5,3.0,2700,5001,2.0,0,0,3,10,2700,0,2009,0,98115,47.6811,-122.288,1610,5191,935000,22,1,2015,0,6,2301,3581,0,0,1
4,1.75,2220,15600,1.0,0,0,5,7,1140,1080,1963,0,98056,47.492,-122.166,1670,4800,374000,15,7,2014,0,51,13380,3130,0,1,0
3,2.0,1300,9334,1.0,0,0,5,7,1300,0,1981,0,98178,47.4865,-122.238,2210,9636,257500,26,8,2014,0,33,8034,7426,0,0,1
4,2.5,2230,3600,2.0,0,0,5,8,1630,600,1906,0,98112,47.6304,-122.309,2410,4800,1000000,8,9,2014,0,108,1370,2390,0,1,1
2,1.75,1390,4482,1.0,0,0,4,8,1390,0,1980,0,98198,47.3785,-122.32,1390,4680,216500,26,6,2014,0,34,3092,3290,0,0,1
4,2.5,3200,7282,2.0,0,0,3,9,3200,0,2007,0,98188,47.4318,-122.286,3030,7290,360000,30,7,2014,0,7,4082,4260,0,0,1
3,0.75,1240,4000,1.0,0,0,4,7,1240,0,1968,0,98112,47.6239,-122.297,1460,4000,699999,22,1,2015,0,47,2760,2540,0,0,1
4,2.5,3540,18168,2.0,0,0,3,10,3540,0,1996,0,98006,47.5441,-122.131,4130,11180,925000,2,12,2014,0,18,14628,7050,0,0,0
3,3.25,2640,4080,2.0,0,0,3,9,1840,800,1912,2000,98105,47.6636,-122.326,1990,4080,930000,8,5,2014,88,102,1440,2090,1,1,1
3,2.0,2660,5000,1.5,0,3,3,8,1940,720,1910,0,98116,47.5829,-122.382,2270,5000,727500,22,9,2014,0,104,2340,2730,0,1,1
4,1.75,1670,9500,1.0,0,0,3,7,1670,0,1976,0,98125,47.7254,-122.31,1620,9500,325000,12,3,2015,0,39,7830,7880,0,0,1
3,3.25,3080,12100,2.0,0,0,3,8,2080,1000,1984,0,98117,47.695,-122.399,2100,6581,695000,5,9,2014,0,30,9020,4481,0,1,1
4,2.75,2890,6825,1.0,0,0,3,8,1560,1330,1973,0,98034,47.734,-122.182,1900,10120,585000,25,6,2014,0,41,3935,8220,0,1,0
3,2.25,1800,9597,1.0,0,2,3,7,1200,600,1963,0,98188,47.4516,-122.267,1700,13502,319000,26,9,2014,0,51,7797,11802,0,1,1
6,2.5,2000,7650,1.5,0,0,4,7,1790,210,1960,0,98032,47.3841,-122.288,1710,7650,265000,6,1,2015,0,55,5650,5940,0,1,0
5,1.75,1940,6654,1.5,0,0,4,7,1940,0,1953,0,98166,47.4663,-122.359,2300,9500,359000,26,6,2014,0,61,4714,7200,0,0,1
5,1.75,1940,6654,1.5,0,0,4,7,1940,0,1953,0,98166,47.4663,-122.359,2300,9500,390000,26,4,2015,0,62,4714,7200,0,0,1
3,1.0,960,9531,1.0,0,0,5,7,960,0,1969,0,98072,47.7619,-122.162,1670,9250,374500,28,1,2015,0,46,8571,7580,0,0,0
3,2.5,2320,5000,2.0,0,0,3,8,1620,700,1907,1993,98112,47.6278,-122.292,2160,5000,900000,3,12,2014,86,107,2680,2840,1,1,1
5,2.5,2380,8204,1.0,0,0,3,8,1540,840,1957,0,98115,47.7,-122.287,2270,8204,600000,13,4,2015,0,58,5824,5934,0,1,1
5,4.25,6490,10862,2.0,0,3,4,11,3940,2550,1991,0,98040,47.5728,-122.205,3290,14080,2000000,16,5,2014,0,23,4372,10790,0,1,0
4,1.75,1620,4240,1.5,0,0,5,7,1620,0,1916,0,98144,47.5746,-122.311,1450,4240,512500,8,5,2015,0,99,2620,2790,0,0,1
3,2.5,2320,5663,2.0,0,0,3,8,2320,0,2003,0,98027,47.539,-122.07,2500,4500,589000,31,7,2014,0,11,3343,2000,0,0,0
3,2.5,1330,2183,3.0,0,0,3,8,1330,0,2014,0,98117,47.6987,-122.365,1310,5000,539950,23,3,2015,0,1,853,3690,0,0,1
3,1.0,1270,7344,1.0,0,0,3,7,970,300,1967,0,98023,47.305,-122.371,1290,7300,218250,8,1,2015,0,48,6074,6010,0,1,0
4,3.5,2550,3600,2.0,0,2,3,8,1880,670,1997,0,98177,47.7709,-122.39,2090,6000,675000,25,2,2015,0,18,1050,3910,0,1,1
5,2.0,1860,9000,2.0,0,0,3,7,1860,0,1980,0,98045,47.4484,-121.772,1390,9752,338000,17,7,2014,0,34,7140,8362,0,0,0
3,1.0,1020,7615,1.0,0,0,3,7,1020,0,1981,0,98058,47.4292,-122.152,1470,9515,231750,31,3,2015,0,34,6595,8045,0,0,0
1,1.0,720,7140,1.0,0,0,3,6,720,0,1930,0,98146,47.5119,-122.339,1140,7577,199900,14,11,2014,0,84,6420,6437,0,0,1
4,2.75,1830,7315,1.0,0,0,5,7,1250,580,1979,0,98023,47.2989,-122.38,1730,7208,263000,2,10,2014,0,35,5485,5478,0,1,0
3,1.5,1520,7200,1.0,0,0,4,7,1160,360,1990,0,98198,47.3855,-122.302,1460,7200,279950,20,8,2014,0,24,5680,5740,0,1,1
3,1.5,1080,2940,1.5,0,0,4,7,1080,0,1920,0,98115,47.6832,-122.304,1400,4930,395000,20,5,2014,0,94,1860,3530,0,0,1
3,2.0,1900,8002,1.0,0,0,3,7,1900,0,1991,0,98023,47.2909,-122.352,1900,6086,252500,26,6,2014,0,23,6102,4186,0,0,0
3,1.0,1370,10708,1.0,0,0,3,7,1370,0,1969,0,98001,47.2769,-122.264,1770,14482,205000,26,8,2014,0,45,9338,12712,0,0,0
5,2.5,2960,8968,1.0,0,0,4,8,1640,1320,1965,0,98008,47.6233,-122.102,1890,9077,654000,28,8,2014,0,49,6008,7187,0,1,0
3,2.5,2190,7982,2.0,0,0,3,8,2190,0,2004,0,98033,47.6869,-122.187,2090,8888,700000,22,7,2014,0,10,5792,6798,0,0,0
2,1.75,1200,2622,1.0,0,0,5,7,800,400,1956,0,98125,47.7175,-122.292,1310,1926,306000,9,12,2014,0,58,1422,616,0,1,1
3,2.5,1780,5015,2.0,0,0,3,7,1780,0,2010,0,98042,47.3352,-122.052,2010,5250,270000,6,4,2015,0,5,3235,3240,0,0,0
3,2.25,2630,9916,2.0,0,0,4,9,2630,0,1988,0,98092,47.3314,-122.202,2470,10810,340000,29,10,2014,0,26,7286,8340,0,0,0
4,2.75,3210,6825,1.0,0,0,5,7,1810,1400,1975,0,98034,47.7338,-122.169,1840,8000,580000,24,7,2014,0,39,3615,6160,0,1,0
4,1.75,2290,4400,1.0,0,3,3,7,1290,1000,1959,0,98126,47.5698,-122.375,1820,4000,435000,3,11,2014,0,55,2110,2180,0,1,1
4,2.5,2780,4688,2.0,0,0,3,9,2780,0,2003,0,98059,47.5225,-122.156,3000,6029,690000,18,8,2014,0,11,1908,3029,0,0,0
4,2.5,2650,11520,2.0,0,0,3,8,2110,540,1988,0,98033,47.683,-122.187,2000,7680,720000,17,6,2014,0,26,8870,5680,0,1,0
3,2.25,1840,13020,1.0,0,0,3,8,1390,450,1980,0,98052,47.6923,-122.095,2210,13020,403000,17,2,2015,0,35,11180,10810,0,1,0
3,2.75,1560,7392,1.0,0,0,5,7,1030,530,1972,0,98011,47.7382,-122.182,1870,7520,440000,12,6,2014,0,42,5832,5650,0,1,0
3,1.0,1200,8470,1.0,0,0,5,7,1200,0,1961,0,98032,47.3864,-122.287,1200,7952,178500,23,10,2014,0,53,7270,6752,0,0,0
4,2.5,1900,8282,1.0,0,0,3,7,1900,0,1968,1997,98022,47.2089,-122.003,1420,8350,270000,2,10,2014,29,46,6382,6930,1,0,0
2,1.0,710,9900,1.0,0,0,3,6,710,0,1943,0,98166,47.479,-122.339,1070,9900,129888,12,11,2014,0,71,9190,8830,0,0,1
3,1.75,1360,15210,1.0,0,0,3,7,1360,0,1987,0,98038,47.3657,-122.047,1610,7800,260000,18,2,2015,0,28,13850,6190,0,0,0
5,2.5,2990,7292,2.0,0,0,4,8,2990,0,1990,0,98042,47.3604,-122.091,2150,8190,339950,29,8,2014,0,24,4302,6040,0,0,0
10,3.0,2920,3745,2.0,0,0,4,7,1860,1060,1913,0,98105,47.6635,-122.32,1810,3745,660000,29,12,2014,0,101,825,1935,0,1,1
3,3.5,3680,11491,2.0,0,2,3,11,3680,0,1999,0,98007,47.5647,-122.128,3710,10030,1230000,16,7,2014,0,15,7811,6320,0,0,0
3,2.0,1830,9152,1.0,0,0,5,8,1830,0,1959,0,98006,47.5531,-122.181,1770,9220,550000,23,5,2014,0,55,7322,7450,0,0,0
5,2.75,2570,12906,2.0,0,0,3,8,2570,0,1987,0,98075,47.5814,-122.05,2580,12927,675000,2,1,2015,0,28,10336,10347,0,0,0
3,3.25,2730,9588,2.0,0,1,3,10,1900,830,1984,0,98052,47.6339,-122.09,2730,12736,981000,10,4,2015,0,31,6858,10006,0,1,0
3,1.0,1150,8000,1.5,0,0,4,6,1150,0,1913,1957,98001,47.2749,-122.252,1170,9600,168000,25,3,2015,44,102,6850,8430,1,0,0
3,1.0,1260,9600,1.0,0,0,3,7,1260,0,1970,1995,98045,47.4444,-121.762,1530,9790,320000,1,4,2015,25,45,8340,8260,1,0,0
6,3.25,4440,17424,1.0,0,1,4,9,2220,2220,1959,0,98040,47.5791,-122.23,2660,10768,959000,4,2,2015,0,56,12984,8108,0,1,0
4,1.0,2300,7680,1.0,0,0,3,7,1270,1030,1959,0,98106,47.524,-122.359,1840,5120,372000,9,4,2015,0,56,5380,3280,0,1,1
3,2.5,1920,9625,2.0,0,0,3,8,1920,0,1993,0,98045,47.4876,-121.8,1920,10343,391500,7,7,2014,0,21,7705,8423,0,0,0
2,1.0,1080,4725,1.5,0,0,3,7,1080,0,1944,0,98126,47.5275,-122.381,1520,4961,390000,27,3,2015,0,71,3645,3441,0,0,1
2,1.0,890,5000,1.0,0,0,4,6,890,0,1947,0,98118,47.5526,-122.287,1160,5000,302000,6,11,2014,0,67,4110,3840,0,0,1
3,3.5,1650,1577,2.0,0,0,3,7,1100,550,2012,0,98109,47.6302,-122.344,1580,1280,495000,3,11,2014,0,2,-73,-300,0,1,1
3,2.5,1820,1545,3.0,0,2,3,8,1640,180,1998,0,98103,47.6523,-122.346,1440,1290,504500,4,9,2014,0,16,-275,-150,0,1,1
4,1.75,2320,4800,1.5,0,0,3,7,2170,150,1918,0,98117,47.6893,-122.365,1390,4800,555000,18,3,2015,0,97,2480,3410,0,1,1
4,3.5,3260,5000,2.0,0,0,5,9,2630,630,1937,0,98105,47.6598,-122.273,2600,5000,1550000,17,3,2015,0,78,1740,2400,0,1,1
3,1.5,1730,5750,1.0,0,0,3,7,1250,480,1947,0,98116,47.5645,-122.397,1370,5750,550000,9,9,2014,0,67,4020,4380,0,1,1
4,2.5,3320,8325,2.5,0,0,5,10,3320,0,1905,0,98112,47.6263,-122.314,3680,6050,1800000,21,7,2014,0,109,5005,2370,0,0,1
1,1.0,1660,5422,1.0,0,0,4,7,830,830,1908,0,98117,47.6821,-122.388,1100,5356,655000,29,4,2015,0,107,3762,4256,0,1,1
4,2.0,2280,8339,1.0,0,0,4,7,1220,1060,1954,0,98115,47.6986,-122.297,1970,8340,721000,1,5,2015,0,61,6059,6370,0,1,1
4,4.25,3650,5328,1.5,0,0,3,9,2330,1320,1907,2014,98119,47.638,-122.362,1710,3600,1520000,14,7,2014,107,107,1678,1890,1,1,1
3,2.0,2020,8555,1.0,0,0,4,7,1220,800,1957,0,98125,47.7278,-122.287,1600,8148,458000,13,6,2014,0,57,6535,6548,0,1,1
2,1.0,1150,12861,1.0,0,0,3,6,1150,0,1959,0,98058,47.4493,-122.171,1170,7574,280000,9,4,2015,0,56,11711,6404,0,0,0
4,1.75,1940,3060,1.0,0,0,4,7,1000,940,1911,0,98115,47.6786,-122.317,1320,3060,628000,9,4,2015,0,104,1120,1740,0,1,1
4,2.5,3440,6332,2.0,0,0,3,10,3440,0,2001,0,98059,47.5347,-122.155,3310,6528,781500,18,2,2015,0,14,2892,3218,0,0,0
3,1.75,2000,7560,1.0,0,0,4,7,1300,700,1968,0,98058,47.4346,-122.171,1900,8301,295000,24,6,2014,0,46,5560,6401,0,1,0
2,1.0,750,2786,1.0,0,0,5,7,750,0,1947,0,98117,47.6892,-122.393,1700,4653,435000,3,4,2015,0,68,2036,2953,0,0,1
3,1.75,1420,7200,1.0,0,0,3,7,1000,420,1979,0,98146,47.5069,-122.367,1550,8640,300000,22,3,2015,0,36,5780,7090,0,1,1
2,1.0,880,4814,1.0,0,0,4,5,880,0,1906,0,98010,47.3107,-121.999,1010,6160,208500,26,3,2015,0,109,3934,5150,0,0,0
2,2.5,2680,11214,1.0,0,0,3,9,2680,0,2006,0,98053,47.7078,-122.019,2305,6908,930000,3,6,2014,0,8,8534,4603,0,0,0
2,2.0,860,3000,1.0,0,0,3,6,860,0,1906,0,98118,47.5633,-122.288,1290,3500,316000,11,2,2015,0,109,2140,2210,0,0,1
3,2.0,1310,6738,1.0,0,0,4,7,1310,0,1990,0,98042,47.3694,-122.083,1290,8067,249900,23,6,2014,0,24,5428,6777,0,0,0
3,2.25,1780,4252,2.0,0,0,4,8,1540,240,1989,0,98144,47.6004,-122.292,2220,4000,675000,31,7,2014,0,25,2472,1780,0,1,1
3,2.25,1440,4667,2.0,0,0,3,7,1440,0,1985,0,98029,47.5662,-122.017,1610,4756,447000,30,10,2014,0,29,3227,3146,0,0,0
3,2.0,1510,3817,1.5,0,0,3,8,1510,0,1905,1994,98122,47.6088,-122.294,1510,3817,675000,17,4,2015,89,110,2307,2307,1,0,1
4,2.5,2100,1397,3.0,0,0,3,8,1580,520,2008,0,98144,47.5928,-122.295,1490,1201,546000,21,4,2015,0,7,-703,-289,0,1,1
3,2.0,1310,1361,3.0,0,0,3,7,1310,0,2003,0,98133,47.7337,-122.343,1370,1608,310000,31,12,2014,0,11,51,238,0,0,1
3,1.0,1280,5100,1.0,0,0,3,7,880,400,1961,0,98178,47.5035,-122.259,1360,6120,190000,6,1,2015,0,54,3820,4760,0,1,1
3,1.5,1320,8114,1.0,0,0,3,8,1320,0,1951,0,98004,47.5827,-122.195,2110,8114,650000,18,6,2014,0,63,6794,6004,0,0,0
3,2.5,1740,2350,2.0,0,0,3,8,1130,610,1995,0,98112,47.6207,-122.297,1740,3201,585000,2,10,2014,0,19,610,1461,0,1,1
4,2.5,2910,7364,2.0,0,0,3,10,2910,0,2003,0,98033,47.6906,-122.213,2480,8400,1430000,6,11,2014,0,11,4454,5920,0,0,0
4,2.5,2500,12090,1.0,0,0,3,9,2500,0,1983,0,98074,47.6346,-122.045,3380,12760,565000,12,1,2015,0,32,9590,9380,0,0,0
3,1.0,1100,6000,1.5,0,0,2,6,1100,0,1926,0,98108,47.5279,-122.318,960,5880,174900,11,11,2014,0,88,4900,4920,0,0,1
3,2.25,1381,1180,3.0,0,0,3,8,1381,0,2007,0,98125,47.711,-122.32,1381,1180,360000,24,9,2014,0,7,-201,-201,0,0,1
3,1.0,960,9624,1.0,0,0,3,7,960,0,1953,0,98155,47.7758,-122.301,1540,9624,234000,29,4,2015,0,62,8664,8084,0,0,1
8,3.0,3840,15990,1.0,0,0,3,7,2530,1310,1961,0,98034,47.7111,-122.211,1380,8172,575000,25,11,2014,0,53,12150,6792,0,1,0
3,2.5,2200,5954,2.0,0,0,3,7,2200,0,2004,0,98042,47.3709,-122.125,2200,5046,315000,3,3,2015,0,11,3754,2846,0,0,0
3,1.0,1250,7820,1.0,0,0,3,7,1250,0,1967,0,98001,47.3397,-122.291,1300,7920,225000,25,3,2015,0,48,6570,6620,0,0,0
3,1.5,2380,14500,1.0,0,0,4,7,1850,530,1961,0,98028,47.7714,-122.256,1830,13600,370000,26,6,2014,0,53,12120,11770,0,1,0
3,1.0,1500,3920,1.0,0,0,3,7,1000,500,1947,0,98107,47.6718,-122.359,1640,4017,606000,23,5,2014,0,67,2420,2377,0,1,1
3,2.0,1410,7622,1.0,0,0,4,7,1410,0,1983,0,98058,47.4273,-122.147,1830,8330,272500,3,6,2014,0,31,6212,6500,0,0,0
3,1.75,1680,3420,1.0,0,0,3,7,960,720,1992,0,98115,47.6855,-122.291,1680,4080,475000,23,3,2015,0,23,1740,2400,0,1,1
3,1.0,1500,13500,1.0,0,0,4,7,1500,0,1968,0,98059,47.4666,-122.072,1350,13680,270000,5,6,2014,0,46,12000,12330,0,0,0
4,1.75,2710,9216,1.0,0,0,3,8,1440,1270,1961,0,98126,47.5523,-122.379,1960,6350,624000,18,8,2014,0,53,6506,4390,0,1,1
3,1.75,1730,7416,1.5,0,0,3,7,1730,0,1954,0,98133,47.76,-122.349,1390,6490,355000,2,7,2014,0,60,5686,5100,0,0,1
3,1.0,960,3844,1.0,0,0,3,7,960,0,1972,0,98133,47.7027,-122.346,1020,3844,345000,4,11,2014,0,42,2884,2824,0,0,1
4,2.5,2380,7792,2.0,0,0,3,8,2380,0,1993,0,98092,47.3273,-122.173,2260,7378,342000,20,11,2014,0,21,5412,5118,0,0,0
3,2.0,1580,6655,1.0,0,0,3,6,790,790,1944,0,98178,47.4927,-122.248,1090,6655,221347,18,2,2015,0,71,5075,5565,0,1,1
3,2.5,1870,4657,2.0,0,0,3,8,1870,0,2000,0,98055,47.4615,-122.214,2290,4795,330000,18,7,2014,0,14,2787,2505,0,0,0
4,2.5,1810,13000,1.0,0,0,4,8,1470,340,1977,0,98022,47.2202,-121.993,1850,13000,279000,18,7,2014,0,37,11190,11150,0,1,0
4,3.0,2550,3784,1.5,0,0,4,8,1750,800,1900,0,98103,47.6559,-122.338,2100,4560,850000,14,10,2014,0,114,1234,2460,0,1,1
3,1.75,1910,12321,1.0,0,0,4,7,1100,810,1952,0,98004,47.5995,-122.198,1910,11761,746000,12,2,2015,0,63,10411,9851,0,1,0
2,2.0,1200,1867,1.0,0,0,3,7,600,600,1924,1998,98109,47.627,-122.345,1790,2221,478000,1,10,2014,74,90,667,431,1,1,1
4,2.75,2420,4635,1.5,0,0,5,7,2420,0,1905,0,98103,47.682,-122.347,1590,3150,820000,16,1,2015,0,110,2215,1560,0,0,1
3,3.5,3080,6495,2.0,0,3,3,11,2530,550,1996,2006,98199,47.6321,-122.393,4120,8620,2160000,20,8,2014,10,18,3415,4500,1,1,1
7,4.25,3670,4000,2.0,0,1,3,8,2800,870,1964,0,98199,47.6375,-122.388,2010,4000,824000,17,6,2014,0,50,330,1990,0,1,1
4,2.5,2270,5000,2.0,0,0,3,9,2270,0,2014,0,98117,47.6916,-122.37,1210,5000,812000,25,9,2014,0,0,2730,3790,0,0,1
4,2.5,1750,11400,2.0,0,0,4,7,1750,0,1975,0,98023,47.3149,-122.386,1890,9024,242000,15,12,2014,0,39,9650,7134,0,0,0
4,2.5,3550,8048,2.0,0,0,3,9,3550,0,2007,0,98065,47.5422,-121.888,3920,7871,625000,20,5,2014,0,7,4498,3951,0,0,0
3,2.25,1670,6600,2.0,0,0,4,7,1670,0,1990,0,98042,47.3604,-122.089,1670,6801,289000,22,9,2014,0,24,4930,5131,0,0,0
2,1.0,1080,4000,1.0,0,0,3,7,1080,0,1940,0,98117,47.6902,-122.387,1530,4240,345000,28,5,2014,0,74,2920,2710,0,0,1
2,1.0,1080,4000,1.0,0,0,3,7,1080,0,1940,0,98117,47.6902,-122.387,1530,4240,874950,7,4,2015,0,75,2920,2710,0,0,1
3,2.75,2280,4280,1.0,0,0,5,7,1280,1000,1917,0,98103,47.6685,-122.335,1650,4280,875000,28,5,2014,0,97,2000,2630,0,1,1
2,3.5,2560,5000,1.0,0,0,4,6,1280,1280,1944,0,98107,47.6681,-122.368,1390,4000,535000,23,7,2014,0,70,2440,2610,0,1,1
4,2.75,2390,9300,1.0,0,0,3,8,1430,960,1979,0,98004,47.6035,-122.206,1910,9348,770126,7,10,2014,0,35,6910,7438,0,1,0
4,2.5,2870,8995,1.0,0,0,5,8,1870,1000,1968,0,98006,47.5678,-122.128,2670,9672,710000,10,7,2014,0,46,6125,7002,0,1,0
3,1.75,1510,4800,1.0,0,2,3,7,860,650,1925,2011,98126,47.5667,-122.372,1510,4800,465000,18,6,2014,86,89,3290,3290,1,1,1
3,1.75,2200,11520,1.0,0,0,4,7,2200,0,1952,0,98133,47.7659,-122.341,1690,8038,359000,14,8,2014,0,62,9320,6348,0,0,1
2,0.75,720,5040,1.0,0,0,3,4,720,0,1949,0,98106,47.5323,-122.347,1290,4120,151000,1,3,2015,0,66,4320,2830,0,0,1
3,2.5,2970,9600,2.0,0,0,3,9,2970,0,1994,0,98006,47.5422,-122.132,2970,9707,820000,15,8,2014,0,20,6630,6737,0,0,0
3,1.5,960,6497,1.0,0,0,4,7,960,0,1970,0,98023,47.3018,-122.378,1160,7080,160000,26,3,2015,0,45,5537,5920,0,0,0
4,1.75,1420,5000,1.5,0,0,4,7,1420,0,1945,0,98117,47.6771,-122.397,1490,5000,535000,1,7,2014,0,69,3580,3510,0,0,1
3,2.25,1800,9010,1.0,0,0,3,7,1300,500,1975,0,98155,47.7722,-122.312,1950,10240,365000,23,4,2015,0,40,7210,8290,0,1,1
4,2.5,3090,5600,2.0,0,0,3,9,3090,0,2005,0,98075,47.597,-121.979,3080,5788,708000,20,2,2015,0,10,2510,2708,0,0,0
3,1.0,1200,7280,1.0,0,0,4,7,1200,0,1967,0,98032,47.3724,-122.277,1200,8400,215000,9,7,2014,0,47,6080,7200,0,0,0
3,2.0,1530,5401,1.0,0,0,4,7,1530,0,1937,0,98115,47.686,-122.304,1640,5467,570000,13,5,2014,0,77,3871,3827,0,0,1
3,1.75,1500,13430,1.0,0,0,3,7,1500,0,1977,0,98072,47.7527,-122.082,1500,13430,383000,25,6,2014,0,37,11930,11930,0,0,0
4,3.0,2490,5706,2.0,0,0,3,9,2490,0,2005,0,98042,47.3509,-122.165,2650,5880,370000,9,4,2015,0,10,3216,3230,0,0,0
4,2.5,3040,12522,2.0,0,0,3,7,3040,0,2000,0,98019,47.7247,-121.959,2490,9742,454000,11,2,2015,0,15,9482,7252,0,0,0
4,1.75,1690,10854,1.0,0,0,3,7,1690,0,1977,0,98056,47.5241,-122.199,2390,7000,371000,28,7,2014,0,37,9164,4610,0,0,0
3,1.75,1430,10350,1.0,0,0,3,7,1430,0,1959,0,98008,47.6353,-122.123,1890,10350,530000,5,5,2015,0,56,8920,8460,0,0,0
3,1.75,1350,7200,1.0,0,0,5,7,1350,0,1954,0,98125,47.713,-122.284,1100,7200,450000,11,11,2014,0,60,5850,6100,0,0,1
3,1.75,1610,14182,1.0,0,0,4,7,1100,510,1978,0,98092,47.3174,-122.18,1510,8400,225000,16,9,2014,0,36,12572,6890,0,1,0
3,2.5,2390,15669,2.0,0,0,3,9,2390,0,1991,0,98011,47.7446,-122.193,2640,12500,660000,7,4,2015,0,24,13279,9860,0,0,0
3,1.75,1180,13927,1.0,0,0,5,7,1180,0,1962,0,98059,47.4818,-122.094,1400,13173,299000,13,6,2014,0,52,12747,11773,0,0,0
2,2.25,1260,1312,3.0,0,0,3,8,1260,0,2007,0,98103,47.6538,-122.356,1300,1312,530000,19,9,2014,0,7,52,12,0,0,1
3,2.5,1800,4400,1.0,0,0,5,7,1350,450,1970,0,98199,47.6599,-122.396,1920,4400,680000,17,10,2014,0,44,2600,2480,0,1,1
4,1.75,1790,12000,1.0,0,0,5,6,1790,0,1944,0,98001,47.2664,-122.256,1550,9840,199900,16,2,2015,0,71,10210,8290,0,0,0
3,1.75,1760,6300,1.0,0,0,3,7,1060,700,1963,0,98178,47.5003,-122.26,1340,7300,224000,8,1,2015,0,52,4540,5960,0,1,1
3,1.75,1540,8885,1.0,0,0,4,7,1440,100,1980,0,98031,47.4031,-122.201,1540,12734,244000,29,8,2014,0,34,7345,11194,0,1,0
4,1.75,1260,3880,1.0,0,0,5,7,860,400,1918,0,98117,47.687,-122.391,1000,3880,485000,8,4,2015,0,97,2620,2880,0,1,1
4,2.5,2240,7589,2.0,0,0,3,8,2240,0,1994,0,98030,47.3824,-122.207,2250,7300,330000,12,1,2015,0,21,5349,5050,0,0,0
4,2.0,1630,1724,1.5,0,0,3,6,1030,600,1915,1970,98119,47.6472,-122.362,1780,3810,509000,31,12,2014,55,99,94,2030,1,1,1
4,2.5,2350,7203,2.0,0,0,3,8,2350,0,1989,0,98059,47.5123,-122.151,2260,7274,440000,17,11,2014,0,25,4853,5014,0,0,0
3,2.0,1350,8587,1.0,0,0,3,7,1350,0,1998,0,98022,47.2073,-122.012,1350,8587,244000,10,12,2014,0,16,7237,7237,0,0,0
4,1.75,1320,4800,1.0,0,0,4,7,870,450,1930,0,98106,47.5534,-122.365,940,4800,399700,17,7,2014,0,84,3480,3860,0,1,1
4,2.5,1950,2617,1.5,0,0,4,7,1250,700,1910,0,98107,47.6696,-122.372,1520,1438,519000,25,6,2014,0,104,667,-82,0,1,1
4,1.0,2100,9200,1.0,0,0,3,7,1050,1050,1959,0,98168,47.476,-122.292,1540,10033,211000,8,5,2014,0,55,7100,8493,0,1,1
3,2.5,3480,7800,1.0,0,0,4,7,1750,1730,1941,1998,98177,47.7047,-122.378,3010,9918,950000,8,7,2014,57,73,4320,6908,1,1,1
3,2.5,1830,2839,2.0,0,0,3,8,1830,0,1999,0,98074,47.6022,-122.021,1830,3011,410000,2,9,2014,0,15,1009,1181,0,0,0
4,2.0,2640,5000,2.0,0,0,3,7,2040,600,1949,0,98117,47.678,-122.375,1330,5000,750000,25,3,2015,0,66,2360,3670,0,1,1
3,1.0,900,2550,1.0,0,0,4,6,900,0,1978,0,98023,47.3036,-122.363,1120,2550,133400,10,9,2014,0,36,1650,1430,0,0,0
3,2.0,1553,6550,1.0,0,0,3,7,1553,0,1900,2001,98022,47.2056,-121.994,1010,10546,240000,24,4,2015,101,115,4997,9536,1,0,0
3,2.5,1710,2300,2.0,0,0,3,8,1570,140,2005,0,98052,47.6743,-122.142,2120,2856,539000,4,6,2014,0,9,590,736,0,1,0
3,1.5,1270,5112,1.0,0,0,3,7,1270,0,1950,0,98115,47.676,-122.288,1580,5080,465000,13,5,2014,0,64,3842,3500,0,0,1
3,1.75,2960,12420,1.0,0,2,4,8,1480,1480,1952,0,98116,47.5739,-122.406,2700,9106,936000,17,6,2014,0,62,9460,6406,0,1,1
4,2.5,3040,9606,2.0,0,0,3,7,3040,0,2003,0,98053,47.6884,-122.044,1690,3849,620000,30,12,2014,0,11,6566,2159,0,0,0
3,1.75,1430,9750,1.0,0,0,5,7,1430,0,1962,0,98133,47.7441,-122.357,1630,9282,429950,20,10,2014,0,52,8320,7652,0,0,1
3,2.5,1520,4170,2.0,0,0,3,7,1520,0,2004,0,98038,47.3842,-122.04,1560,4237,296475,7,7,2014,0,10,2650,2677,0,0,0
4,2.0,1820,9450,1.0,0,0,3,7,1100,720,1962,0,98155,47.7607,-122.329,1540,9450,330000,27,4,2015,0,53,7630,7910,0,1,1
3,2.25,1800,11200,1.0,0,0,3,8,1270,530,1979,0,98052,47.7072,-122.164,1940,11250,445000,30,7,2014,0,35,9400,9310,0,1,0
4,3.25,2720,4000,2.0,0,1,3,10,2070,650,2014,0,98118,47.5554,-122.267,1450,4000,846000,1,8,2014,0,0,1280,2550,0,1,1
4,1.75,1980,5850,1.0,0,1,4,8,1380,600,1960,0,98116,47.5607,-122.391,1810,5850,725000,14,5,2015,0,55,3870,4040,0,1,1
4,2.5,2550,7349,2.0,0,0,3,9,2550,0,1989,0,98023,47.3059,-122.349,2400,8508,369000,4,5,2015,0,26,4799,6108,0,0,0
3,2.0,2120,4080,2.0,0,0,3,7,2120,0,2003,0,98053,47.682,-122.037,2280,4080,535000,18,6,2014,0,11,1960,1800,0,0,0
4,1.5,1570,6717,1.0,0,0,5,6,1570,0,1911,0,98002,47.307,-122.217,1140,6716,229950,18,12,2014,0,103,5147,5576,0,0,0
3,1.75,1310,6960,1.0,0,0,4,7,1310,0,1974,0,98092,47.2761,-122.153,1580,7200,229999,23,4,2015,0,41,5650,5620,0,0,0
5,3.5,3150,4120,2.0,0,0,3,8,2460,690,1911,2007,98115,47.6754,-122.315,2080,4160,850000,25,8,2014,96,103,970,2080,1,1,1
2,1.0,1840,4322,1.0,0,0,4,7,1160,680,1914,0,98144,47.5764,-122.289,1750,4322,513000,30,10,2014,0,100,2482,2572,0,1,1
3,1.0,1120,8321,1.0,0,0,4,6,1120,0,1941,1987,98027,47.5631,-122.091,1980,8671,401000,26,9,2014,46,73,7201,6691,1,0,0
3,2.5,1440,2500,2.0,0,0,3,7,1440,0,2006,0,98146,47.511,-122.359,1440,5000,260000,5,9,2014,0,8,1060,3560,0,0,1
3,3.5,2070,11658,1.0,0,0,4,8,1370,700,1977,0,98056,47.537,-122.178,1930,8744,470000,20,3,2015,0,38,9588,6814,0,1,0
4,1.5,1420,8063,1.0,0,0,3,7,940,480,1962,0,98198,47.4174,-122.316,1330,7515,205000,21,1,2015,0,53,6643,6185,0,1,1
3,2.25,2010,7495,1.0,0,0,4,8,1570,440,1979,0,98027,47.5613,-122.083,2050,8402,620000,10,2,2015,0,36,5485,6352,0,1,0
3,1.5,1200,5000,1.0,0,0,3,6,1200,0,1979,0,98146,47.5122,-122.357,1440,2500,229000,11,8,2014,0,35,3800,1060,0,0,1
2,2.0,1150,6634,1.0,0,0,3,7,860,290,1940,0,98115,47.7001,-122.309,1680,6892,445000,9,5,2014,0,74,5484,5212,0,1,1
2,1.0,1240,7200,1.0,0,0,3,7,1240,0,1967,0,98168,47.4971,-122.282,1130,9200,215000,14,5,2014,0,47,5960,8070,0,0,1
2,2.5,1900,4871,2.0,0,0,3,8,1900,0,2005,0,98053,47.7132,-122.034,1640,4780,504975,29,7,2014,0,9,2971,3140,0,0,0
4,2.25,2350,10072,2.0,0,0,3,8,2350,0,1980,0,98011,47.7628,-122.168,2210,9687,495000,1,8,2014,0,34,7722,7477,0,0,0
3,1.0,1120,8342,1.0,0,0,4,7,1120,0,1976,0,98042,47.3732,-122.116,1190,6660,205000,11,3,2015,0,39,7222,5470,0,0,0
1,1.0,1020,6871,1.0,0,0,3,6,1020,0,1937,1946,98146,47.5051,-122.338,1260,6933,152275,30,7,2014,9,77,5851,5673,1,0,1
4,2.25,1930,8338,1.0,0,0,3,8,1930,0,1968,0,98125,47.7026,-122.285,2280,7616,586000,25,3,2015,0,47,6408,5336,0,0,1
2,2.5,2680,7625,1.0,0,0,3,9,2680,0,2002,0,98053,47.7094,-122.024,2310,7395,779950,17,10,2014,0,12,4945,5085,0,0,0
4,1.75,2660,11315,2.0,0,0,4,8,2660,0,1983,0,98074,47.6204,-122.044,1980,11315,557000,18,12,2014,0,31,8655,9335,0,0,0
4,2.25,2200,7200,1.0,0,2,4,8,1220,980,1958,0,98144,47.5818,-122.296,1940,6000,610000,29,10,2014,0,56,5000,4060,0,1,1
3,1.5,1010,7683,1.5,0,0,5,7,1010,0,1953,0,98125,47.72,-122.318,1550,7271,405000,8,7,2014,0,61,6673,5721,0,0,1
4,2.25,2310,7490,2.0,0,0,3,8,2310,0,1980,0,98055,47.4379,-122.192,2310,8480,320000,9,5,2014,0,34,5180,6170,0,0,0
3,1.0,920,3863,1.0,0,0,3,6,920,0,1970,0,98118,47.5524,-122.27,1080,5150,356000,19,9,2014,0,44,2943,4070,0,0,1
5,3.0,3030,4120,1.5,0,0,4,7,1930,1100,1913,0,98115,47.6771,-122.319,1280,3090,794500,26,2,2015,0,102,1090,1810,0,1,1
3,1.75,1590,9620,1.0,0,0,3,7,1590,0,1988,0,98059,47.4815,-122.152,2980,9398,349000,8,5,2014,0,26,8030,6418,0,0,0
3,1.0,960,10761,1.0,0,0,4,6,960,0,1962,0,98002,47.2819,-122.224,960,10761,193000,18,7,2014,0,52,9801,9801,0,0,0
3,2.5,2400,6182,2.0,0,0,3,8,2400,0,1998,0,98065,47.5363,-121.87,2420,5829,523000,24,3,2015,0,17,3782,3409,0,0,0
4,2.5,2960,5027,2.0,0,0,3,7,2960,0,2000,0,98065,47.5328,-121.881,2760,5500,500000,5,5,2015,0,15,2067,2740,0,0,0
4,3.25,3770,4103,2.0,0,0,5,9,2710,1060,1925,0,98109,47.641,-122.349,2560,4160,1450000,7,7,2014,0,89,333,1600,0,1,1
4,2.0,2750,9001,1.0,0,0,3,8,2750,0,2008,0,98055,47.457,-122.189,1340,11050,333000,15,10,2014,0,6,6251,9710,0,0,0
3,1.75,2100,6874,1.0,0,0,3,7,1300,800,1943,0,98115,47.6724,-122.279,2220,5912,580000,17,7,2014,0,71,4774,3692,0,1,1
4,1.75,1500,8400,1.0,0,0,3,7,1200,300,1956,0,98188,47.4531,-122.273,1780,9913,289950,1,8,2014,0,58,6900,8133,0,1,1
2,1.0,710,4618,1.0,0,1,3,5,710,0,1925,0,98199,47.64,-122.394,1810,4988,375000,19,2,2015,0,90,3908,3178,0,0,1
2,3.0,2770,10800,1.5,0,0,5,8,1910,860,1984,0,98074,47.6082,-122.057,2140,10800,505000,26,9,2014,0,30,8030,8660,0,1,0
3,1.75,2050,6720,1.0,0,2,3,7,1050,1000,1939,0,98178,47.5058,-122.235,2380,7260,324950,21,7,2014,0,75,4670,4880,0,1,1
4,2.25,1960,10275,2.0,0,0,3,7,1960,0,1965,0,98052,47.6887,-122.124,1560,10275,490000,14,7,2014,0,49,8315,8715,0,0,0
4,2.0,1770,6000,2.0,0,0,5,7,1770,0,1911,1981,98199,47.6493,-122.401,1340,6000,630000,12,5,2014,70,103,4230,4660,1,0,1
4,2.0,1990,6000,1.0,0,0,3,9,1260,730,1956,2015,98199,47.6515,-122.397,1770,6000,872500,1,5,2015,59,59,4010,4230,1,1,1
2,1.0,1760,5250,1.0,0,2,4,7,1000,760,1951,0,98126,47.5577,-122.379,1760,5400,490000,22,2,2015,0,64,3490,3640,0,1,1
2,1.0,1020,8102,1.0,0,0,3,7,1020,0,1956,0,98056,47.5135,-122.193,1770,7291,310000,5,5,2015,0,59,7082,5521,0,0,0
3,1.5,1740,12000,2.0,0,0,3,9,1740,0,1974,0,98074,47.6276,-122.053,2580,12224,539000,23,10,2014,0,40,10260,9644,0,0,0
3,2.5,1520,8720,1.0,0,0,3,7,1080,440,1981,0,98058,47.4267,-122.157,1720,7551,269950,14,7,2014,0,33,7200,5831,0,1,0
3,1.75,1310,9761,1.0,0,0,3,7,1310,0,1967,0,98034,47.721,-122.228,1490,9600,300000,19,8,2014,0,47,8451,8110,0,0,0
3,2.25,2120,9804,2.0,0,0,3,7,2120,0,1994,0,98042,47.3596,-122.16,2120,7200,278000,15,4,2015,0,21,7684,5080,0,0,0
3,2.25,1200,2845,2.0,0,0,3,7,1200,0,1986,0,98034,47.7151,-122.203,1220,2140,342000,1,12,2014,0,28,1645,920,0,0,0
4,1.75,1900,9861,1.0,0,0,4,7,1900,0,1967,0,98038,47.3615,-122.057,1720,7967,190000,6,5,2015,0,48,7961,6247,0,0,0
2,1.5,1010,948,3.0,0,0,3,8,1010,0,1999,0,98103,47.6529,-122.355,1330,1318,387000,21,11,2014,0,15,-62,-12,0,0,1
3,2.25,1850,7480,2.0,0,0,3,7,1850,0,1978,0,98058,47.452,-122.159,1870,7480,279950,4,3,2015,0,37,5630,5610,0,0,0
5,2.5,2732,9500,1.0,0,2,4,8,1870,862,1975,0,98003,47.3436,-122.323,2720,10000,480000,10,6,2014,0,39,6768,7280,0,1,0
4,2.0,1910,6960,1.5,0,0,5,8,1910,0,1941,0,98103,47.6893,-122.348,1360,3300,835000,8,5,2014,0,73,5050,1940,0,0,1
5,3.5,3520,5400,2.0,0,0,3,9,2400,1120,2008,0,98119,47.6364,-122.363,1360,3600,1500000,3,3,2015,0,7,1880,2240,0,1,1
4,2.0,2220,3760,1.5,0,0,4,7,1370,850,1929,0,98117,47.6876,-122.368,1620,3760,771000,26,3,2015,0,86,1540,2140,0,1,1
4,2.25,2020,5800,1.0,0,3,4,9,1760,260,1941,0,98199,47.6471,-122.412,3100,5800,1230000,7,8,2014,0,73,3780,2700,0,1,1
4,2.5,2090,7290,1.0,0,0,5,8,1420,670,1966,0,98007,47.624,-122.142,2110,8436,600000,17,10,2014,0,48,5200,6326,0,1,0
3,1.0,1580,7424,1.0,0,0,3,7,1010,570,1962,0,98058,47.4607,-122.171,1710,7772,305000,2,7,2014,0,52,5844,6062,0,1,0
5,1.75,2650,11340,1.0,0,0,3,8,2650,0,1955,0,98004,47.626,-122.213,2780,13204,1390000,27,3,2015,0,60,8690,10424,0,0,0
3,1.0,1020,11652,1.0,0,0,4,6,1020,0,1971,0,98188,47.4459,-122.278,1690,11652,216500,10,9,2014,0,43,10632,9962,0,0,1
3,2.5,1070,1219,2.0,0,0,3,7,720,350,2004,0,98116,47.5618,-122.384,1070,1254,370000,22,1,2015,0,11,149,184,0,1,1
4,1.75,2120,9786,1.0,0,0,3,8,1640,480,1967,0,98177,47.7753,-122.365,2310,8787,492650,30,6,2014,0,47,7666,6477,0,1,1
5,1.75,1360,10609,1.0,0,0,3,7,1060,300,1966,0,98034,47.7203,-122.229,1490,9935,431200,25,7,2014,0,48,9249,8445,0,1,0
4,2.0,1700,12048,2.0,0,0,3,7,1700,0,1990,0,98030,47.3748,-122.186,1960,7650,277500,9,4,2015,0,25,10348,5690,0,0,0
5,1.5,1820,8712,1.0,0,0,5,7,1090,730,1960,0,98032,47.3712,-122.289,1820,8712,278000,17,3,2015,0,55,6892,6892,0,1,0
4,1.0,1430,8400,1.0,0,0,3,6,730,700,1969,0,98072,47.7417,-122.172,1310,8240,351000,2,9,2014,0,45,6970,6930,0,1,0
4,3.5,4140,7089,2.0,0,0,3,10,3160,980,2003,0,98034,47.7059,-122.2,2640,8896,850000,16,6,2014,0,11,2949,6256,0,1,0
2,2.0,1313,3600,1.0,0,0,3,8,1313,0,1904,2012,98119,47.6369,-122.365,1080,3600,885000,11,8,2014,108,110,2287,2520,1,0,1
3,1.75,1080,9262,1.0,0,0,3,7,1080,0,1968,0,98178,47.4883,-122.248,1090,9262,185000,5,8,2014,0,46,8182,8172,0,0,1
5,3.0,2730,6000,1.0,0,0,3,8,1470,1260,1979,0,98178,47.4994,-122.234,2590,6000,440000,25,9,2014,0,35,3270,3410,0,1,1
3,2.25,2540,9961,1.0,0,0,4,8,1320,1220,1969,0,98031,47.41,-122.208,1870,10251,299000,21,8,2014,0,45,7421,8381,0,1,0
3,1.5,1540,7506,1.0,0,0,5,7,1540,0,1961,0,98155,47.7565,-122.325,2180,7653,420000,17,3,2015,0,54,5966,5473,0,0,1
2,1.75,1460,4800,1.0,0,0,5,7,850,610,1950,0,98103,47.6928,-122.339,2050,5592,540000,14,7,2014,0,64,3340,3542,0,1,1
3,1.0,1160,7912,1.0,0,0,4,7,1160,0,1956,0,98125,47.7336,-122.306,1190,7482,330000,8,1,2015,0,59,6752,6292,0,0,1
4,3.25,3500,5960,2.0,0,0,3,9,3500,0,2010,0,98053,47.6944,-122.022,3390,6856,840000,27,4,2015,0,5,2460,3466,0,0,0
3,2.5,1980,6922,2.0,0,0,5,8,1980,0,1991,0,98031,47.396,-122.184,2090,7697,370000,7,11,2014,0,23,4942,5607,0,0,0
3,1.5,1250,7700,1.0,0,0,5,7,1250,0,1968,0,98056,47.5383,-122.178,1430,7700,410000,25,6,2014,0,46,6450,6270,0,0,0
2,1.0,770,7200,1.0,0,0,3,7,770,0,1951,0,98125,47.7143,-122.325,1320,7139,257000,9,12,2014,0,63,6430,5819,0,0,1
3,1.0,1920,6710,1.0,0,0,3,7,1320,600,1959,0,98118,47.5346,-122.286,1810,5600,350000,30,12,2014,0,55,4790,3790,0,1,1
2,1.0,1120,7560,1.0,0,1,3,6,1120,0,1947,0,98177,47.77,-122.39,1120,7200,380000,25,8,2014,0,67,6440,6080,0,0,1
3,1.0,1150,12402,1.0,0,0,4,6,1150,0,1969,0,98072,47.7422,-122.099,1400,13600,344000,10,3,2015,0,46,11252,12200,0,0,0
3,2.5,1590,2550,3.0,0,0,3,7,1590,0,1985,0,98117,47.6772,-122.393,1260,5100,488000,27,5,2014,0,29,960,3840,0,0,1
3,1.0,910,3880,1.0,0,0,3,7,780,130,1942,0,98117,47.6862,-122.392,1220,3880,465000,8,10,2014,0,72,2970,2660,0,1,1
2,1.75,1870,6625,1.0,0,0,3,7,960,910,1948,0,98178,47.5071,-122.249,1680,6000,229500,4,5,2015,0,67,4755,4320,0,1,1
5,3.0,2420,11250,2.0,0,0,3,8,2420,0,2013,0,98146,47.5082,-122.362,1510,9950,445000,12,11,2014,0,1,8830,8440,0,0,1
4,1.5,2120,7110,1.5,0,0,3,6,2120,0,1919,0,98030,47.3846,-122.227,1540,7110,246000,17,3,2015,0,96,4990,5570,0,0,0
5,2.5,2730,17240,1.0,0,0,5,7,1660,1070,1958,0,98028,47.7646,-122.267,2250,13200,545000,4,6,2014,0,56,14510,10950,0,1,0
4,2.5,2560,5672,2.0,0,1,3,8,2560,0,2005,0,98056,47.5222,-122.201,2190,6788,518000,13,8,2014,0,9,3112,4598,0,0,0
4,2.5,2620,10016,2.0,0,0,3,8,2620,0,1996,0,98056,47.5295,-122.179,2620,10016,565000,31,10,2014,0,18,7396,7396,0,0,0
4,2.5,2760,8558,2.0,0,0,3,7,2760,0,2001,0,98056,47.4802,-122.189,2760,7703,445000,10,4,2015,0,14,5798,4943,0,0,0
5,2.5,2900,9799,1.0,0,0,3,8,1450,1450,1959,0,98004,47.6255,-122.208,2810,9687,968000,17,7,2014,0,55,6899,6877,0,1,0
3,2.0,1820,6324,1.0,0,0,5,7,910,910,1945,0,98115,47.6823,-122.27,1850,6440,725000,31,3,2015,0,70,4504,4590,0,1,1
3,1.75,1870,8400,1.0,0,0,3,7,990,880,1977,0,98058,47.454,-122.164,1750,8400,315500,26,8,2014,0,37,6530,6650,0,1,0
4,1.75,2010,9211,1.0,0,0,3,7,1470,540,1977,0,98034,47.7206,-122.171,1840,8500,487585,5,5,2014,0,37,7201,6660,0,1,0
2,1.0,940,6000,1.0,0,0,2,7,940,0,1954,0,98148,47.4631,-122.329,1890,8547,246500,23,3,2015,0,61,5060,6657,0,0,1
3,1.75,1850,6000,1.5,0,0,3,8,1650,200,1913,1999,98199,47.6528,-122.401,1540,6000,819000,14,8,2014,86,101,4150,4460,1,1,1
5,2.5,2530,4229,2.0,0,0,3,7,2530,0,2004,0,98038,47.3531,-122.021,2070,4879,349900,18,12,2014,0,10,1699,2809,0,0,0
3,1.0,940,4700,1.0,0,0,4,6,940,0,1942,0,98146,47.5117,-122.378,1020,5700,267000,22,8,2014,0,72,3760,4680,0,0,1
3,2.25,1820,15000,1.0,0,0,3,7,1480,340,1978,0,98028,47.7401,-122.249,1930,13600,480000,13,5,2015,0,37,13180,11670,0,1,0
2,1.0,1510,3360,1.0,0,0,3,7,880,630,1924,0,98122,47.6135,-122.297,1330,3360,525000,10,9,2014,0,90,1850,2030,0,1,1
4,2.5,2070,5415,2.0,0,0,3,8,2070,0,1996,0,98029,47.5706,-122.006,2120,5331,578000,25,6,2014,0,18,3345,3211,0,0,0
3,2.5,1380,1547,3.0,0,0,3,8,1380,0,2000,0,98103,47.6908,-122.341,1380,1465,345000,6,5,2015,0,15,167,85,0,0,1
3,1.0,1270,6250,1.0,0,0,3,7,910,360,1955,0,98116,47.5694,-122.397,2000,6250,499000,26,3,2015,0,60,4980,4250,0,1,1
3,1.5,1390,9680,1.0,0,0,4,7,1390,0,1956,0,98008,47.634,-122.125,1460,10050,425000,26,8,2014,0,58,8290,8590,0,0,0
4,3.0,1840,7510,2.0,0,0,5,8,1840,0,1988,2013,98092,47.2595,-122.218,1650,7957,268000,27,10,2014,25,26,5670,6307,1,0,0
3,1.0,1600,12566,1.0,0,0,4,7,1600,0,1971,0,98045,47.4431,-121.765,1600,10650,240000,4,12,2014,0,43,10966,9050,0,0,0
3,1.5,1480,9606,1.0,0,0,4,7,1100,380,1964,0,98023,47.2978,-122.363,1600,9619,147000,3,3,2015,0,51,8126,8019,0,1,0
4,2.0,2120,7806,1.0,0,0,4,6,1770,350,1949,0,98033,47.6859,-122.166,1560,9920,500000,6,3,2015,0,66,5686,8360,0,1,0
4,2.75,2940,5400,1.5,0,2,5,8,1940,1000,1910,0,98119,47.6366,-122.369,1970,2008,1010000,28,10,2014,0,104,2460,38,0,1,1
5,2.0,2740,3838,1.0,0,0,4,7,1370,1370,1959,0,98117,47.6819,-122.393,1660,4040,510000,18,11,2014,0,55,1098,2380,0,1,1
4,4.0,4360,12081,2.0,0,0,3,10,4360,0,2007,0,98004,47.6377,-122.219,2180,10800,1980000,1,8,2014,0,7,7721,8620,0,0,0
4,2.5,1540,1870,2.0,0,0,3,8,1540,0,2014,0,98029,47.5524,-121.999,1540,1619,484998,2,7,2014,0,0,330,79,0,0,0
3,1.75,1590,7617,2.0,0,0,3,7,1590,0,1986,0,98198,47.3819,-122.312,1490,7450,210000,29,5,2014,0,28,6027,5960,0,0,1
2,1.0,1180,10720,1.0,0,0,4,7,1180,0,1955,0,98007,47.5893,-122.135,1420,10750,450000,4,8,2014,0,59,9540,9330,0,0,0
4,1.75,2360,8286,1.0,0,0,3,7,1320,1040,1952,0,98004,47.6226,-122.205,1680,7630,875000,2,4,2015,0,63,5926,5950,0,1,0
4,2.75,1860,7500,1.0,0,0,5,8,1220,640,1967,0,98056,47.5398,-122.173,2020,8137,529950,28,4,2015,0,48,5640,6117,0,1,0
3,1.75,1470,4000,1.0,0,0,3,7,1070,400,1979,0,98122,47.6067,-122.298,1280,3500,415000,23,7,2014,0,35,2530,2220,0,1,1
4,2.0,2990,12970,1.5,0,2,4,7,1960,1030,1948,0,98028,47.7605,-122.258,2500,10680,590000,20,2,2015,0,67,9980,8180,0,1,0
3,1.5,1690,9144,1.0,0,0,4,7,1140,550,1956,0,98028,47.739,-122.253,1840,10600,379950,26,5,2014,0,58,7454,8760,0,1,0
1,1.0,660,3570,1.0,0,0,3,6,660,0,1906,0,98118,47.5659,-122.284,1520,4080,385000,10,4,2015,0,109,2910,2560,0,0,1
3,1.75,2310,7620,2.0,0,0,3,8,2310,0,1942,1988,98177,47.7266,-122.363,2200,7672,588000,29,10,2014,46,72,5310,5472,1,0,1
2,1.0,770,2191,1.0,0,0,3,6,770,0,1937,0,98108,47.5512,-122.323,940,5000,252500,11,8,2014,0,77,1421,4060,0,0,1
3,3.5,2320,3174,2.0,0,0,3,9,2060,260,1997,0,98033,47.6897,-122.175,2320,3187,530000,19,5,2014,0,17,854,867,0,1,0
3,2.25,1700,7650,1.0,0,0,4,7,1340,360,1975,0,98034,47.7214,-122.166,1980,7200,419000,29,8,2014,0,39,5950,5220,0,1,0
2,1.0,960,5508,1.0,0,0,3,6,770,190,1951,0,98118,47.5307,-122.277,1280,5304,175000,17,10,2014,0,63,4548,4024,0,1,1
2,1.0,1150,5664,1.0,0,0,3,7,870,280,1948,0,98115,47.6894,-122.284,1380,5664,515000,31,3,2015,0,67,4514,4284,0,1,1
4,2.5,2910,4680,1.5,0,0,5,9,1850,1060,1937,0,98115,47.6745,-122.31,1960,4120,945000,18,2,2015,0,78,1770,2160,0,1,1
5,2.25,2290,7420,1.0,0,0,3,7,1290,1000,1973,0,98058,47.4375,-122.166,1660,7526,359900,20,6,2014,0,41,5130,5866,0,1,0
4,2.5,2260,5164,2.0,0,0,3,8,2260,0,1996,0,98056,47.509,-122.166,2260,5866,419950,7,8,2014,0,18,2904,3606,0,0,0
3,1.75,1300,4000,1.0,0,0,3,7,900,400,1953,0,98199,47.6368,-122.388,1750,4000,460000,26,9,2014,0,61,2700,2250,0,1,1
3,2.25,1850,7151,2.0,0,0,3,7,1850,0,1989,0,98023,47.2843,-122.352,1710,6827,255000,5,3,2015,0,26,5301,5117,0,0,0
4,1.75,1920,9500,1.0,0,0,4,7,1470,450,1966,0,98006,47.5683,-122.177,1820,10091,481000,4,11,2014,0,48,7580,8271,0,1,0
4,1.75,1920,9500,1.0,0,0,4,7,1470,450,1966,0,98006,47.5683,-122.177,1820,10091,719521,13,3,2015,0,49,7580,8271,0,1,0
4,2.5,2210,6080,1.0,0,2,4,8,1410,800,1965,0,98178,47.4915,-122.228,2210,6175,334000,23,5,2014,0,49,3870,3965,0,1,1
4,2.75,2280,3200,1.5,0,0,5,8,1520,760,1931,0,98105,47.6709,-122.282,1970,4687,675000,12,9,2014,0,83,920,2717,0,1,1
3,1.75,1640,7437,1.0,0,0,3,7,1090,550,1948,0,98126,47.5324,-122.38,1640,7436,556000,13,6,2014,0,66,5797,5796,0,1,1
4,2.0,1980,7200,2.0,0,3,3,8,1700,280,1910,0,98119,47.6318,-122.369,2490,4200,900000,15,8,2014,0,104,5220,1710,0,1,1
3,1.0,900,4084,1.5,0,0,3,7,900,0,1910,0,98117,47.684,-122.393,1280,4080,400000,2,10,2014,0,104,3184,2800,0,0,1
4,1.75,1960,4340,1.0,0,0,5,8,980,980,1912,0,98117,47.6847,-122.37,1630,4360,724950,24,3,2015,0,103,2380,2730,0,1,1
4,2.25,1800,4500,2.0,0,0,4,8,1800,0,2004,0,98031,47.394,-122.183,2010,5050,321000,3,9,2014,0,10,2700,3040,0,0,0
4,3.5,4270,5800,2.0,0,3,5,10,3170,1100,1937,0,98199,47.6474,-122.411,3100,5800,1360000,1,7,2014,0,77,1530,2700,0,1,1
3,1.75,1950,15037,1.0,0,0,3,7,1950,0,1989,0,98014,47.6892,-121.913,1760,15181,323000,24,2,2015,0,26,13087,13421,0,0,0
4,1.5,1200,10890,1.0,0,0,5,7,1200,0,1972,0,98042,47.3423,-122.088,1250,10139,226000,21,7,2014,0,42,9690,8889,0,0,0
6,1.75,2180,4000,1.5,0,0,4,7,1380,800,1926,0,98105,47.6643,-122.29,1720,4000,580000,9,10,2014,0,88,1820,2280,0,1,1
4,2.5,2320,11259,2.0,0,0,3,9,2320,0,1982,0,98004,47.6443,-122.194,2820,11770,640000,22,8,2014,0,32,8939,8950,0,0,0
3,1.75,1040,5097,1.0,0,0,4,7,800,240,1944,0,98199,47.6385,-122.401,1630,5097,619790,20,8,2014,0,70,4057,3467,0,1,1
4,2.5,2700,6998,2.0,0,0,3,8,2700,0,2001,0,98188,47.4694,-122.263,2350,10550,383962,30,6,2014,0,13,4298,8200,0,0,1
3,2.0,1400,2445,1.0,0,0,3,7,840,560,2002,0,98144,47.5926,-122.299,1400,3200,373000,15,8,2014,0,12,1045,1800,0,1,1
3,2.5,2060,8123,2.0,0,0,3,8,1010,1050,1977,0,98052,47.6642,-122.13,1760,6170,541338,10,12,2014,0,37,6063,4410,0,1,0
2,1.0,780,8160,1.0,0,0,4,6,780,0,1953,0,98133,47.7356,-122.34,1310,8160,254922,3,10,2014,0,61,7380,6850,0,0,1
3,2.25,2400,5000,1.5,0,0,4,7,1440,960,1926,0,98117,47.6897,-122.393,1630,5000,575000,24,6,2014,0,88,2600,3370,0,1,1
4,3.0,2900,15535,1.0,0,2,4,7,1870,1030,1961,0,98008,47.612,-122.119,2330,10217,650000,2,9,2014,0,53,12635,7887,0,1,0
3,1.5,1740,9547,1.0,0,0,4,7,1740,0,1962,0,98055,47.4475,-122.213,1780,9936,269950,13,8,2014,0,52,7807,8156,0,0,0
2,1.0,780,6250,1.0,0,0,3,6,780,0,1942,0,98168,47.5099,-122.33,1280,7100,270950,30,4,2015,0,73,5470,5820,0,0,1
3,2.75,2430,14861,1.0,0,0,3,9,1530,900,1988,0,98028,47.7461,-122.247,2230,10300,495000,29,12,2014,0,26,12431,8070,0,1,0
4,2.0,2210,8556,1.0,0,1,4,8,1210,1000,1954,0,98199,47.6498,-122.396,2190,7975,794154,7,5,2014,0,60,6346,5785,0,1,1
3,1.5,1510,11200,1.0,0,0,4,8,1510,0,1960,0,98003,47.3347,-122.325,2110,12070,340768,19,12,2014,0,54,9690,9960,0,0,0
2,1.0,900,5413,1.0,0,0,3,7,900,0,1947,0,98125,47.7047,-122.307,1280,6380,375000,1,8,2014,0,67,4513,5100,0,0,1
4,2.5,3670,7000,2.0,0,0,3,10,3670,0,2005,0,98075,47.5854,-122.08,3680,7437,820000,24,5,2014,0,9,3330,3757,0,0,0
2,2.25,1160,954,2.0,0,0,3,8,960,200,2014,0,98105,47.6647,-122.284,1160,1327,555000,30,9,2014,0,0,-206,167,0,1,1
2,1.5,1070,1200,2.0,0,0,3,7,1070,0,1999,0,98103,47.697,-122.347,1070,1200,312500,12,6,2014,0,15,130,130,0,0,1
2,1.0,950,4560,1.5,0,0,3,7,950,0,1925,0,98112,47.6288,-122.3,2040,4560,450000,2,12,2014,0,89,3610,2520,0,0,1
3,2.75,2950,6667,2.0,0,0,3,9,2950,0,2003,0,98029,47.5577,-122.026,3340,6667,739000,5,1,2015,0,12,3717,3327,0,0,0
3,2.0,1420,1716,2.0,0,0,3,7,1050,370,2003,0,98155,47.7364,-122.295,1420,8150,320000,13,4,2015,0,12,296,6730,0,1,1
3,1.0,1590,13000,1.5,0,0,3,6,1590,0,1944,0,98166,47.4789,-122.346,1460,8400,235000,9,6,2014,0,70,11410,6940,0,0,1
4,1.0,1290,5000,1.5,0,0,3,7,1290,0,1957,0,98146,47.5128,-122.358,1440,2500,275500,23,3,2015,0,58,3710,1060,0,0,1
2,2.0,1690,4500,1.0,0,0,3,8,1690,0,2004,0,98053,47.7133,-122.031,1640,4500,564000,18,6,2014,0,10,2810,2860,0,0,0
4,1.75,1340,8700,1.5,0,0,3,6,1340,0,1958,0,98188,47.4514,-122.287,1240,8700,263000,1,5,2015,0,57,7360,7460,0,0,1
3,2.25,2000,7560,1.0,0,0,3,7,1400,600,1979,0,98055,47.4798,-122.228,2040,6949,300000,11,12,2014,0,35,5560,4909,0,1,0
3,2.0,2250,7904,1.5,0,0,3,8,2250,0,1998,0,98001,47.3165,-122.252,2460,8622,328000,7,7,2014,0,16,5654,6162,0,0,0
3,1.0,840,8400,1.0,0,0,3,6,840,0,1959,0,98023,47.3281,-122.344,1030,8640,187500,28,7,2014,0,55,7560,7610,0,0,0
3,1.0,1100,5100,2.0,0,0,4,7,1100,0,1900,0,98117,47.679,-122.386,1540,5100,400000,23,2,2015,0,115,4000,3560,0,0,1
3,1.5,1660,5100,1.0,0,0,4,7,1210,450,1954,0,98136,47.5345,-122.383,1440,5100,515000,2,3,2015,0,61,3440,3660,0,1,1
3,1.0,1460,8400,1.0,0,0,3,7,1460,0,1958,0,98055,47.4243,-122.198,1460,9600,235000,17,4,2015,0,57,6940,8140,0,0,0
4,2.5,2470,4945,2.0,0,0,3,8,2470,0,2012,0,98053,47.6898,-122.015,2510,4988,669000,17,7,2014,0,2,2475,2478,0,0,0
3,1.0,1250,13503,1.5,0,0,4,6,1250,0,1931,0,98065,47.526,-121.829,1450,13503,282000,24,4,2015,0,84,12253,12053,0,0,0
3,2.0,1480,3876,1.0,0,0,5,7,860,620,1928,0,98117,47.6808,-122.382,1660,3774,663000,26,6,2014,0,86,2396,2114,0,1,1
3,3.25,2240,5000,2.0,0,0,3,9,1540,700,1989,0,98198,47.4114,-122.334,1800,7500,279900,24,4,2015,0,26,2760,5700,0,1,1
3,2.0,1570,7200,1.0,0,0,4,7,1570,0,1952,0,98155,47.7501,-122.314,1410,7434,335000,7,5,2014,0,62,5630,6024,0,0,1
4,2.75,3250,10000,2.0,0,0,3,9,3250,0,2014,0,98155,47.7557,-122.309,1620,10089,689000,31,12,2014,0,0,6750,8469,0,0,1
3,2.5,2080,4931,2.0,0,0,3,8,2080,0,2000,0,98065,47.5342,-121.868,1890,4229,506950,27,3,2015,0,15,2851,2339,0,0,0
3,2.5,1480,1171,3.0,0,0,3,8,1480,0,2006,0,98112,47.62,-122.3,1480,1231,500000,6,5,2014,0,8,-309,-249,0,0,1
5,3.0,3610,9775,2.0,0,0,3,8,3610,0,2003,0,98038,47.3545,-122.011,2800,8582,540000,13,6,2014,0,11,6165,5782,0,0,0
3,2.5,2040,4559,2.0,0,0,3,9,2040,0,1998,0,98122,47.6156,-122.295,1500,4500,812000,22,8,2014,0,16,2519,3000,0,0,1
4,1.0,1490,6600,1.0,0,0,3,7,1490,0,1969,0,98168,47.4835,-122.332,1280,6600,185000,7,5,2014,0,45,5110,5320,0,0,1
2,1.0,900,6000,1.0,0,0,3,7,900,0,1944,2004,98115,47.6855,-122.289,1460,4800,451000,12,7,2014,60,70,5100,3340,1,0,1
5,3.0,3900,5250,1.5,0,1,5,8,2620,1280,1931,0,98116,47.5577,-122.389,1950,5700,850000,28,7,2014,0,83,1350,3750,0,1,1
3,1.75,1760,6788,2.0,1,4,3,7,1760,0,1940,1960,98125,47.7336,-122.284,1630,7588,1150000,14,1,2015,20,75,5028,5958,1,0,1
3,2.25,1410,1377,2.0,0,0,3,7,1290,120,2005,0,98027,47.5342,-122.067,1445,1370,377500,16,5,2014,0,9,-33,-75,0,1,0
3,2.5,2780,11964,2.0,0,0,3,9,2780,0,2009,0,98034,47.7127,-122.216,1760,9640,825500,30,5,2014,0,5,9184,7880,0,0,0
5,3.25,3230,3825,2.0,0,0,3,9,2480,750,2014,0,98117,47.6785,-122.392,1480,5100,1060000,10,6,2014,0,0,595,3620,0,1,1
5,3.5,4600,8764,2.0,0,0,3,10,3180,1420,2007,0,98006,47.5491,-122.19,3210,9431,880000,20,11,2014,0,7,4164,6221,0,1,0
3,2.0,1440,4421,1.0,0,0,3,8,1440,0,2007,0,98053,47.7188,-122.024,1440,4157,413800,21,5,2014,0,7,2981,2717,0,0,0
2,1.5,1200,1687,3.0,0,0,3,8,1200,0,2008,0,98103,47.6491,-122.334,1240,1296,504200,27,6,2014,0,6,487,56,0,0,1
4,3.0,2793,5703,2.0,0,0,3,9,2793,0,2009,0,98030,47.3682,-122.178,2793,5704,421500,22,4,2015,0,6,2910,2911,0,0,0
4,2.5,2970,5050,2.0,0,0,3,8,2970,0,2014,0,98052,47.7043,-122.122,2810,4998,855169,5,3,2015,0,1,2080,2188,0,0,0
3,2.0,1440,3218,1.0,0,0,3,7,850,590,2008,0,98106,47.5655,-122.36,1170,5000,380000,7,2,2015,0,7,1778,3830,0,1,1
3,2.25,1480,1026,3.0,0,0,3,8,1480,0,2014,0,98103,47.6536,-122.354,1570,1283,580000,4,8,2014,0,0,-454,-287,0,0,1
3,2.5,1870,5333,2.0,0,0,3,8,1870,0,2012,0,98019,47.7447,-121.984,2100,3730,377000,9,4,2015,0,3,3463,1630,0,0,0
4,2.75,2475,4000,2.0,0,0,3,7,2475,0,2014,0,98002,47.3452,-122.209,2475,4000,329900,30,9,2014,0,0,1525,1525,0,0,0
4,2.5,2950,7024,2.0,0,0,3,10,2950,0,2012,0,98199,47.6651,-122.403,2950,6339,921800,28,8,2014,0,2,4074,3389,0,0,1
3,2.25,1410,905,3.0,0,0,3,9,1410,0,2014,0,98116,47.5818,-122.402,1510,1352,529500,4,3,2015,0,1,-505,-158,0,0,1
4,2.5,2240,3712,2.0,0,0,3,8,2240,0,2014,0,98038,47.3551,-122.061,2530,4315,363990,3,6,2014,0,0,1472,1785,0,0,0
5,2.75,3230,6500,2.0,0,0,3,9,3230,0,2014,0,98074,47.6237,-122.023,3180,7624,834950,15,1,2015,0,1,3270,4444,0,0,0
3,2.25,1936,9495,1.0,0,0,3,8,1936,0,2013,0,98030,47.3714,-122.197,1410,12770,338900,14,11,2014,0,1,7559,11360,0,0,0
3,2.5,3120,6000,2.0,0,0,3,9,3120,0,2007,0,98038,47.3473,-122.03,2670,6000,419950,11,3,2015,0,8,2880,3330,0,0,0
4,2.5,2070,4270,2.0,0,0,3,8,2070,0,2010,0,98028,47.773,-122.265,2070,4610,493000,13,4,2015,0,5,2200,2540,0,0,0
4,2.5,3700,4500,2.0,0,0,3,9,3700,0,2007,0,98028,47.7473,-122.23,3050,5047,650000,11,12,2014,0,7,800,1997,0,0,0
3,2.5,2130,5205,2.0,0,0,3,8,2130,0,2013,0,98045,47.4832,-121.774,2250,5462,456000,9,9,2014,0,1,3075,3212,0,0,0
3,2.25,1620,997,2.5,0,0,3,8,1540,80,2010,0,98027,47.54,-122.026,1620,1068,425000,18,9,2014,0,4,-623,-552,0,1,0
3,2.5,1490,2478,3.0,0,0,3,8,1490,0,2009,0,98133,47.7236,-122.353,1270,1156,348000,9,2,2015,0,6,988,-114,0,0,1
5,4.0,4180,7232,2.0,0,0,3,9,4180,0,2014,0,98052,47.7049,-122.125,3570,6054,1040000,29,10,2014,0,0,3052,2484,0,0,0
2,2.5,1400,1262,2.0,0,0,3,8,1160,240,2008,0,98106,47.5342,-122.349,1060,1524,299000,18,11,2014,0,6,-138,464,0,1,1
4,3.75,3490,9170,2.0,0,0,3,9,3490,0,2012,0,98004,47.5991,-122.2,1810,8470,1260000,12,5,2014,0,2,5680,6660,0,0,0
3,1.0,1300,6098,1.0,0,0,3,7,1300,0,2013,0,98014,47.7074,-121.364,1300,6849,155000,12,11,2014,0,1,4798,5549,0,0,0
4,2.5,2730,4962,2.0,0,0,3,8,2730,0,2006,0,98002,47.3363,-122.216,2150,3802,319500,25,2,2015,0,9,2232,1652,0,0,0
3,2.5,1830,2517,2.0,0,0,3,8,1830,0,2005,0,98055,47.4496,-122.189,1610,2762,274000,22,12,2014,0,9,687,1152,0,0,0
5,2.5,2340,4500,2.0,0,0,3,7,2340,0,2009,0,98059,47.4911,-122.154,2190,4500,429000,16,6,2014,0,5,2160,2310,0,0,0
3,1.75,1410,1899,2.0,0,0,3,8,1410,0,2014,0,98106,47.5171,-122.347,1410,1811,267800,2,12,2014,0,0,489,401,0,0,1
3,2.5,1930,8254,2.0,0,0,3,7,1930,0,2014,0,98146,47.4973,-122.346,1540,8849,369950,8,4,2015,0,1,6324,7309,0,0,1
4,3.5,3180,4869,2.0,0,0,3,8,2390,790,2007,0,98055,47.4482,-122.206,2850,4500,440000,15,9,2014,0,7,1689,1650,0,1,0
4,3.25,2950,4161,2.0,0,0,3,10,2210,740,2014,0,98027,47.5297,-122.073,2790,3693,839704,24,3,2015,0,1,1211,903,0,1,0
3,3.25,1430,1276,3.0,0,0,3,8,1430,0,2007,0,98107,47.6712,-122.38,1430,1243,535000,29,1,2015,0,8,-154,-187,0,0,1
2,1.5,1020,1275,3.0,0,0,3,8,1020,0,2008,0,98103,47.7003,-122.346,980,1415,290000,25,8,2014,0,6,255,435,0,0,1
3,2.5,1650,1793,3.0,0,0,3,8,1650,0,2007,0,98133,47.7107,-122.332,1650,1863,370000,21,7,2014,0,7,143,213,0,0,1
3,2.0,1060,651,3.0,0,0,3,7,1060,0,2007,0,98103,47.6828,-122.345,1440,1501,405000,3,3,2015,0,8,-409,61,0,0,1
4,2.75,2620,6019,2.0,0,0,3,8,2620,0,2013,0,98045,47.484,-121.771,2790,6716,499431,30,5,2014,0,1,3399,3926,0,0,0
4,2.5,1830,3868,2.0,0,0,3,7,1830,0,2007,0,98118,47.5186,-122.276,2330,3868,275000,10,7,2014,0,7,2038,1538,0,0,1
3,2.25,998,844,2.0,0,0,3,7,798,200,2007,0,98117,47.6983,-122.367,998,1110,320000,22,5,2014,0,7,-154,112,0,1,1
4,2.5,2070,4427,2.0,0,0,3,7,2070,0,2007,0,98065,47.5208,-121.869,2070,4556,425000,5,8,2014,0,7,2357,2486,0,0,0
4,3.5,2860,2199,3.0,0,0,3,10,2860,0,2013,0,98102,47.6262,-122.323,1990,1378,1450000,27,2,2015,0,2,-661,-612,0,0,1
3,2.0,1920,5688,1.0,0,3,3,9,1920,0,2007,0,98022,47.1952,-121.976,2384,4802,340000,10,2,2015,0,8,3768,2418,0,0,0
3,2.5,1210,2046,2.0,0,0,3,9,920,290,2008,0,98106,47.5212,-122.357,1070,651,299900,1,10,2014,0,6,836,-419,0,1,1
5,3.5,4890,12039,2.0,0,0,3,9,3590,1300,2014,0,98011,47.7338,-122.208,4590,10079,865950,26,12,2014,0,0,7149,5489,0,1,0
4,2.5,3420,17038,2.0,0,0,3,9,3420,0,2007,0,98034,47.718,-122.241,2520,14190,720000,15,8,2014,0,7,13618,11670,0,0,0
4,3.5,2870,3225,2.0,0,3,3,9,2070,800,2006,0,98178,47.5009,-122.225,1770,6450,460000,2,10,2014,0,8,355,4680,0,1,1
3,2.5,1600,2042,2.0,0,0,3,8,1600,0,2005,0,98027,47.5341,-122.067,1445,1370,375000,19,11,2014,0,9,442,-75,0,0,0
2,1.5,960,1829,2.0,0,0,3,7,960,0,2005,0,98122,47.6032,-122.308,1470,1829,386180,11,5,2015,0,10,869,359,0,0,1
3,2.75,1740,5639,1.0,0,3,3,7,1740,0,2010,0,98022,47.1942,-121.977,2380,5331,280000,14,1,2015,0,5,3899,2951,0,0,0
4,2.5,2575,4725,2.0,0,0,3,8,2575,0,2011,0,98001,47.3058,-122.277,2575,5323,359000,8,8,2014,0,3,2150,2748,0,0,0
5,3.25,3660,11995,2.0,0,2,3,10,3660,0,2006,0,98065,47.5337,-121.86,3320,11241,785000,2,5,2014,0,8,8335,7921,0,0,0
3,2.25,1420,1230,2.0,0,0,3,8,940,480,2009,0,98144,47.5703,-122.288,1400,1230,425000,6,2,2015,0,6,-190,-170,0,1,1
5,2.5,3070,7200,2.0,0,0,3,8,3070,0,2005,0,98059,47.4939,-122.137,2590,7200,575000,4,5,2015,0,10,4130,4610,0,0,0
4,3.25,4160,10335,2.0,0,0,3,10,4160,0,2014,0,98004,47.6235,-122.192,1840,10333,1850000,6,5,2015,0,1,6175,8493,0,0,0
4,3.25,3276,10801,2.0,0,0,3,9,3276,0,2008,0,98166,47.4585,-122.361,2010,11656,720000,18,2,2015,0,7,7525,9646,0,0,1
5,3.75,2890,5000,1.0,0,0,3,7,1310,1580,2006,0,98108,47.5701,-122.296,1930,5117,390000,6,5,2014,0,8,2110,3187,0,1,1
3,2.5,3430,10177,2.0,0,0,3,10,3430,0,2014,0,98034,47.7159,-122.251,3110,12339,2210000,29,4,2015,0,1,6747,9229,0,0,0
4,3.5,3390,3979,2.0,0,0,3,9,2610,780,2014,0,98199,47.6482,-122.408,3350,4165,1050000,2,7,2014,0,0,589,815,0,1,1
6,3.75,2930,14980,2.0,0,3,3,9,2930,0,2013,0,98006,47.5441,-122.117,3210,10787,915000,10,6,2014,0,1,12050,7577,0,0,0
2,2.25,1300,1314,3.0,0,0,3,8,1300,0,2008,0,98103,47.6536,-122.356,1300,1312,562000,22,4,2015,0,7,14,12,0,0,1
2,1.75,1250,1208,2.0,0,0,3,7,1040,210,2007,0,98144,47.6004,-122.299,1250,1656,349000,20,11,2014,0,7,-42,406,0,1,1
4,2.5,2310,7800,2.0,0,0,3,8,2310,0,2011,0,98042,47.3737,-122.164,2310,7140,375000,14,8,2014,0,3,5490,4830,0,0,0
2,2.25,1360,1336,3.0,0,0,3,8,1360,0,2008,0,98107,47.6714,-122.392,1280,1295,479950,12,12,2014,0,6,-24,15,0,0,1
4,2.5,2020,5100,2.0,0,0,3,7,2020,0,2010,0,98023,47.2822,-122.357,2300,5685,319000,9,1,2015,0,5,3080,3385,0,0,0
3,1.5,1270,1067,3.0,0,0,3,8,1270,0,2009,0,98133,47.7236,-122.353,1090,1118,325000,3,10,2014,0,5,-203,28,0,0,1
4,2.75,2790,8092,2.0,0,0,3,8,2790,0,2013,0,98045,47.4834,-121.773,2790,6154,505657,21,8,2014,0,1,5302,3364,0,0,0
4,2.5,2320,4142,2.0,0,0,3,7,2320,0,2010,0,98038,47.3662,-122.019,2150,4140,340000,5,3,2015,0,5,1822,1990,0,0,0
3,2.5,1750,6351,2.0,0,0,3,7,1750,0,2012,0,98001,47.2589,-122.256,1398,6092,250000,23,1,2015,0,3,4601,4694,0,0,0
4,2.5,2030,4596,2.0,0,0,3,8,2030,0,2014,0,98001,47.3515,-122.275,2040,4705,349500,26,9,2014,0,0,2566,2665,0,0,0
3,2.5,1270,865,2.0,0,0,3,7,1080,190,2008,0,98118,47.5351,-122.279,1630,7752,290750,24,4,2015,0,7,-405,6122,0,1,1
5,3.25,2710,2356,2.0,0,0,3,8,2230,480,2013,0,98027,47.5394,-122.028,2160,2108,715000,5,5,2015,0,2,-354,-52,0,1,0
4,2.75,2520,8433,2.0,0,0,3,8,2520,0,2014,0,98125,47.7214,-122.289,1890,7772,689950,11,8,2014,0,0,5913,5882,0,0,1
2,2.5,1340,1263,3.0,0,0,3,8,1340,0,2008,0,98117,47.6788,-122.388,1510,1260,425000,24,9,2014,0,6,-77,-250,0,0,1
2,3.0,1570,1281,3.0,0,0,3,8,1570,0,2014,0,98107,47.6741,-122.384,1570,2500,657000,19,1,2015,0,1,-289,930,0,0,1
4,3.5,2690,5564,2.0,0,0,3,7,2690,0,2007,0,98038,47.3537,-122.018,2210,4046,359950,20,11,2014,0,7,2874,1836,0,0,0
4,2.75,2475,4276,2.0,0,0,3,7,2475,0,2014,0,98002,47.345,-122.21,2475,4000,319900,31,7,2014,0,0,1801,1525,0,0,0
3,3.75,2260,2050,2.0,0,0,3,9,1170,1090,2010,0,98118,47.566,-122.29,2130,3082,532000,16,4,2015,0,5,-210,952,0,1,1
2,1.0,840,863,3.0,0,0,3,8,840,0,2008,0,98103,47.6974,-122.349,1110,1190,291000,30,3,2015,0,7,23,80,0,0,1
3,3.25,1720,1330,2.0,0,0,3,8,1030,690,2004,0,98112,47.62,-122.309,1720,1520,675000,21,7,2014,0,10,-390,-200,0,1,1
3,2.25,2940,6500,3.0,0,0,3,9,2940,0,2014,0,98136,47.5482,-122.388,1680,6500,885000,21,1,2015,0,1,3560,4820,0,0,1
5,3.5,4170,9090,2.0,0,0,3,10,4170,0,2008,0,98004,47.5918,-122.196,1930,13635,1450000,21,10,2014,0,6,4920,11705,0,0,0
6,4.25,4310,10000,2.0,0,0,3,8,2950,1360,2008,0,98074,47.6214,-122.062,2100,10000,780000,16,10,2014,0,6,5690,7900,0,1,0
4,2.75,3010,7200,2.0,0,0,3,9,3010,0,2014,0,98033,47.6948,-122.179,3010,7203,839950,12,7,2014,0,0,4190,4193,0,0,0
3,2.5,2170,1984,2.5,0,0,3,8,2170,0,2008,0,98027,47.5401,-122.027,2150,1984,645000,24,4,2015,0,7,-186,-166,0,0,0
3,2.5,1584,3200,2.0,0,0,3,7,1584,0,2011,0,98002,47.3451,-122.215,1584,2800,263000,23,12,2014,0,3,1616,1216,0,0,0
2,2.25,1110,1290,3.0,0,0,3,8,1110,0,2006,0,98103,47.6968,-122.34,1360,1251,345000,30,10,2014,0,8,180,-109,0,0,1
4,2.5,2420,5006,2.0,0,0,3,8,2420,0,2013,0,98059,47.4795,-122.126,2750,5471,505000,25,11,2014,0,1,2586,2721,0,0,0
2,2.25,1430,1210,2.0,0,0,3,8,1340,90,2005,0,98115,47.6765,-122.301,1430,1016,522500,3,9,2014,0,9,-220,-414,0,1,1
3,2.5,2393,4788,2.0,0,0,3,8,2393,0,2012,0,98055,47.4517,-122.204,2439,5477,400000,11,8,2014,0,2,2395,3038,0,0,0
3,2.25,1240,949,3.0,0,0,3,8,1240,0,2008,0,98103,47.6488,-122.334,1310,1140,543000,19,6,2014,0,6,-291,-170,0,0,1
4,2.5,2980,12075,1.0,0,0,3,8,1910,1070,2007,0,98056,47.5074,-122.172,2240,12075,495000,13,10,2014,0,7,9095,9835,0,1,0
4,3.5,2970,6587,2.0,0,0,3,8,2260,710,2014,0,98059,47.4776,-122.122,2970,5690,549995,11,9,2014,0,0,3617,2720,0,1,0
3,2.5,2329,5720,2.0,0,0,3,8,2329,0,2010,0,98030,47.362,-122.2,2197,5720,327555,11,2,2015,0,5,3391,3523,0,0,0
5,3.25,3340,9075,2.0,0,0,3,8,2600,740,2005,0,98065,47.5446,-121.88,2770,6646,690000,9,4,2015,0,10,5735,3876,0,1,0
4,2.25,2580,2875,2.0,0,0,3,9,2580,0,2015,0,98116,47.5674,-122.392,1290,5750,673000,18,3,2015,0,0,295,4460,0,0,1
3,2.5,2029,3906,2.0,0,0,3,9,2029,0,2014,0,98003,47.341,-122.18,2029,3920,384435,21,7,2014,0,0,1877,1891,0,0,0
4,2.75,3430,6500,2.0,0,0,3,9,3050,380,2006,0,98052,47.7079,-122.106,3070,6802,780000,15,8,2014,0,8,3070,3732,0,1,0
5,3.75,3330,5042,2.0,0,2,3,9,2470,860,2014,0,98103,47.6497,-122.339,1780,3990,1380000,29,10,2014,0,0,1712,2210,0,1,1
5,3.5,3220,5081,2.0,0,0,3,8,3220,0,2013,0,98052,47.7048,-122.111,2970,5753,950968,24,3,2015,0,2,1861,2783,0,0,0
2,2.25,1240,750,2.0,0,0,3,7,1150,90,2008,0,98027,47.5322,-122.073,1240,750,334950,29,3,2015,0,7,-490,-490,0,1,0
3,3.5,1500,1249,2.0,0,0,3,8,1240,260,2004,0,98107,47.6727,-122.373,1440,1850,489000,9,6,2014,0,10,-251,410,0,1,1
3,3.0,3530,8345,2.0,0,0,3,10,3530,0,2006,0,98028,47.7338,-122.234,1940,9600,600000,20,4,2015,0,9,4815,7660,0,0,0
3,2.25,1260,915,2.0,0,0,3,8,1020,240,2007,0,98106,47.555,-122.363,1260,1056,282000,22,8,2014,0,7,-345,-204,0,1,1
4,4.0,4168,8485,2.0,0,0,3,10,3222,946,2007,0,98023,47.3029,-122.387,4362,8100,442000,1,8,2014,0,7,4317,3738,0,1,0
2,1.5,1030,2850,2.0,0,0,3,7,1030,0,1995,0,98038,47.3845,-122.039,1030,3000,220000,12,5,2015,0,20,1820,1970,0,0,0
3,2.5,3080,5598,2.0,0,0,3,8,3080,0,2006,0,98055,47.4372,-122.206,3080,5303,489000,18,2,2015,0,9,2518,2223,0,0,0
3,1.5,1072,4339,2.0,0,0,3,7,1072,0,2009,0,98042,47.386,-122.162,1443,4341,250000,23,12,2014,0,5,3267,2898,0,0,0
4,2.75,2790,5000,2.0,0,0,3,8,2790,0,2014,0,98045,47.4831,-121.773,2620,5527,484259,24,7,2014,0,0,2210,2907,0,0,0
3,2.5,1800,4357,2.0,0,0,3,8,1800,0,2013,0,98065,47.5337,-121.841,1800,3663,450000,24,4,2015,0,2,2557,1863,0,0,0
2,1.5,830,1276,2.0,0,0,3,7,830,0,2005,0,98122,47.6175,-122.297,1540,1484,299000,14,11,2014,0,9,446,-56,0,0,1
3,2.5,2280,4557,2.0,0,0,3,8,2280,0,2010,0,98028,47.7733,-122.266,2070,4610,450000,29,10,2014,0,4,2277,2540,0,0,0
4,3.0,2110,1286,2.0,0,0,3,9,1710,400,2007,0,98029,47.5444,-122.014,2000,1286,585000,23,1,2015,0,8,-824,-714,0,1,0
3,2.25,1570,1680,3.0,0,0,3,8,1570,0,2014,0,98103,47.6585,-122.348,1290,1870,660000,3,11,2014,0,0,110,580,0,0,1
2,1.5,830,1333,2.0,0,0,3,7,830,0,2005,0,98136,47.5506,-122.381,1120,4822,301500,12,5,2014,0,9,503,3702,0,0,1
4,3.75,4120,8258,2.0,0,0,3,10,4120,0,2012,0,98075,47.5872,-122.055,3730,8332,949950,15,9,2014,0,2,4138,4602,0,0,0
4,2.5,2540,5760,2.0,0,0,3,9,2540,0,2009,0,98029,47.5405,-121.993,2580,3600,759990,30,10,2014,0,5,3220,1020,0,0,0
4,2.75,2050,4000,2.0,0,0,3,8,2050,0,2014,0,98001,47.3522,-122.275,2050,4000,355000,16,3,2015,0,1,1950,1950,0,0,0
4,2.75,3080,7242,2.0,0,0,3,9,3080,0,2014,0,98033,47.6948,-122.178,3010,7205,889950,23,7,2014,0,0,4162,4195,0,0,0
3,2.5,2390,1984,2.0,0,0,3,8,2220,170,2008,0,98027,47.5405,-122.027,2150,1984,629800,1,7,2014,0,6,-406,-166,0,1,0
4,2.5,3170,5100,2.0,0,0,3,9,3170,0,2012,0,98056,47.5187,-122.208,1580,5100,745000,24,4,2015,0,3,1930,3520,0,0,0
2,1.5,1240,1331,2.0,0,0,3,7,1050,190,2007,0,98144,47.5959,-122.298,1250,1431,379900,3,11,2014,0,7,91,181,0,1,1
3,2.5,1090,1139,2.0,0,0,3,8,960,130,2009,0,98126,47.5664,-122.369,1400,1348,335000,14,11,2014,0,5,49,-52,0,1,1
5,4.5,4630,6324,2.0,0,0,3,9,3210,1420,2006,0,98065,47.5382,-121.86,4420,6790,809000,12,5,2014,0,8,1694,2370,0,1,0
4,2.5,3230,5899,2.0,0,0,3,8,3230,0,2012,0,98065,47.515,-121.869,2720,5899,569950,26,8,2014,0,2,2669,3179,0,0,0
4,3.5,3510,9263,2.0,0,0,3,10,3510,0,2001,0,98065,47.5413,-121.877,3690,10417,723000,8,8,2014,0,13,5753,6727,0,0,0
4,2.5,1785,2552,2.0,0,0,3,8,1785,0,2009,0,98030,47.3582,-122.2,1691,2700,282000,10,11,2014,0,5,767,1009,0,0,0
5,3.25,2360,3873,2.0,0,0,3,8,1990,370,2006,0,98108,47.5635,-122.299,1720,3071,569900,30,10,2014,0,8,1513,1351,0,1,1
4,2.0,2340,9716,1.0,0,0,3,7,2340,0,2009,0,98146,47.4842,-122.347,1180,13500,385000,21,1,2015,0,6,7376,12320,0,0,1
3,2.25,1620,1075,3.0,0,0,3,8,1540,80,2009,0,98027,47.5405,-122.026,1620,1237,420000,7,7,2014,0,5,-545,-383,0,1,0
3,3.25,3890,3452,2.0,0,0,3,12,2890,1000,2006,0,98102,47.626,-122.323,2860,2199,2250000,6,8,2014,0,8,-438,-661,0,1,1
4,3.5,3590,5335,2.0,0,2,3,9,3140,450,2006,0,98115,47.6762,-122.267,2100,6250,1210000,15,9,2014,0,8,1745,4150,0,1,1
4,3.0,1984,4460,2.0,0,0,3,7,1984,0,2012,0,98002,47.3532,-122.211,2095,3402,292000,8,12,2014,0,2,2476,1307,0,0,0
3,2.25,1640,1023,3.0,0,0,3,8,1640,0,2014,0,98105,47.6636,-122.319,1720,1960,645000,16,3,2015,0,1,-617,240,0,0,1
4,2.0,1350,942,3.0,0,0,3,7,1350,0,2008,0,98027,47.5394,-122.026,1390,942,304500,19,3,2015,0,7,-408,-448,0,0,0
4,3.5,2730,5707,2.0,0,0,3,8,2000,730,2011,0,98019,47.7327,-121.965,2430,5899,489500,7,5,2015,0,4,2977,3469,0,1,0
4,4.0,5610,11063,3.0,0,0,3,11,4750,860,2006,0,98074,47.65,-122.065,4560,11063,1580000,24,4,2015,0,9,5453,6503,0,1,0
2,1.0,962,1992,2.0,0,0,3,7,962,0,2012,0,98115,47.6911,-122.313,1130,1992,390000,6,1,2015,0,3,1030,862,0,0,1
4,3.5,3040,4006,2.0,0,0,3,8,2350,690,2013,0,98029,47.5439,-122.011,2050,4000,815000,2,10,2014,0,1,966,1950,0,1,0
3,3.5,2540,10578,2.0,0,1,3,9,2010,530,2014,0,98006,47.547,-122.192,3240,9831,719000,3,4,2015,0,1,8038,6591,0,1,0
4,2.5,2240,4800,2.0,0,0,3,8,2240,0,2014,0,98001,47.2911,-122.266,2240,5040,331210,3,4,2015,0,1,2560,2800,0,0,0
3,1.5,1260,1270,2.0,0,0,3,7,1040,220,2005,0,98133,47.7111,-122.331,1260,1472,245000,7,5,2014,0,9,10,212,0,1,1
5,4.0,3210,7200,2.0,0,0,3,8,2410,800,2011,0,98019,47.7329,-121.966,2750,7200,465000,9,9,2014,0,3,3990,4450,0,1,0
3,2.5,1620,1171,3.0,0,4,3,8,1470,150,2008,0,98103,47.6681,-122.355,1620,1505,580000,30,9,2014,0,6,-449,-115,0,1,1
3,2.0,1580,1972,2.5,0,2,3,8,1180,400,2007,0,98116,47.5903,-122.386,1500,1908,540000,14,4,2015,0,8,392,408,0,1,1
3,2.5,1430,1250,3.0,0,0,3,7,1430,0,2007,0,98103,47.6904,-122.342,1360,1269,399000,18,11,2014,0,7,-180,-91,0,0,1
4,2.5,1850,5388,2.0,0,0,3,8,1850,0,2009,0,98038,47.3494,-122.041,2140,5086,328000,4,8,2014,0,5,3538,2946,0,0,0
4,2.5,3340,5314,2.0,0,0,3,10,3340,0,2010,0,98065,47.5167,-121.885,3220,5500,701000,11,5,2015,0,5,1974,2280,0,0,0
3,2.75,2670,4800,2.0,0,0,3,8,2670,0,2014,0,98038,47.3483,-122.042,2340,5000,408000,22,10,2014,0,0,2130,2660,0,0,0
3,2.5,1550,930,2.0,0,0,3,8,1060,490,2006,0,98144,47.5857,-122.314,1550,1301,445000,14,8,2014,0,8,-620,-249,0,1,1
4,2.5,3470,6651,2.0,0,0,3,9,3470,0,2005,0,98065,47.5426,-121.879,2730,6179,672500,21,10,2014,0,9,3181,3449,0,0,0
3,2.5,3010,7014,2.0,0,0,3,8,3010,0,2009,0,98059,47.4949,-122.149,3030,6180,538000,9,7,2014,0,5,4004,3150,0,0,0
5,3.5,3931,9497,2.0,0,0,3,10,2650,1281,2014,0,98023,47.3008,-122.386,3510,9497,450000,4,9,2014,0,0,5566,5987,0,1,0
3,2.5,1800,2700,2.0,0,0,3,8,1800,0,2011,0,98126,47.5458,-122.369,1380,1200,362500,19,6,2014,0,3,900,-180,0,0,1
3,2.5,1570,1551,3.0,0,0,3,8,1570,0,2008,0,98103,47.6961,-122.341,1570,1705,414950,15,10,2014,0,6,-19,135,0,0,1
3,2.5,2230,3939,2.0,0,0,3,8,2230,0,2014,0,98133,47.73,-122.335,2230,4200,679950,27,1,2015,0,1,1709,1970,0,0,1
4,2.5,2423,7292,2.0,0,0,3,8,2423,0,2005,0,98023,47.3227,-122.37,2495,7489,290000,12,11,2014,0,9,4869,4994,0,0,0
3,2.0,1160,1174,2.0,0,0,3,7,790,370,2007,0,98106,47.5225,-122.357,1160,994,230000,23,10,2014,0,7,14,-166,0,1,1
2,2.0,1440,4666,1.0,0,0,3,8,1440,0,2010,0,98053,47.709,-122.019,1510,4595,439950,20,2,2015,0,5,3226,3085,0,0,0
4,2.5,2052,3723,2.0,0,0,3,8,2052,0,2014,0,98003,47.2824,-122.295,2052,5250,349900,22,5,2014,0,0,1671,3198,0,0,0
5,2.5,2780,9272,2.0,0,0,3,8,2780,0,2014,0,98126,47.5168,-122.378,1150,8460,550000,22,12,2014,0,0,6492,7310,0,0,1
4,4.25,3720,5750,2.0,0,2,3,9,2960,760,2006,0,98116,47.5632,-122.399,2550,5750,1050000,30,4,2015,0,9,2030,3200,0,1,1
2,2.25,1460,1851,2.0,0,0,3,9,1180,280,2014,0,98119,47.6461,-122.362,1800,4269,655000,19,3,2015,0,1,391,2469,0,1,1
3,3.5,1370,1540,2.0,0,0,3,8,1100,270,2006,0,98116,47.5638,-122.388,1370,915,385000,10,11,2014,0,8,170,-455,0,1,1
6,4.5,3600,6110,2.0,0,0,3,9,2510,1090,2012,0,98118,47.5687,-122.291,1360,5800,729999,10,4,2015,0,3,2510,4440,0,1,1
3,2.25,1420,1282,3.0,0,0,3,8,1420,0,2006,0,98103,47.6533,-122.346,1530,1280,523950,16,6,2014,0,8,-138,-250,0,0,1
2,2.5,980,895,2.0,0,0,3,8,670,310,2009,0,98116,47.5874,-122.386,980,899,369000,12,5,2014,0,5,-85,-81,0,1,1
3,2.5,1790,2700,2.0,0,0,3,8,1790,0,2010,0,98027,47.564,-122.093,1890,3078,509900,5,5,2014,0,4,910,1188,0,0,0
3,2.5,2010,5399,2.0,0,0,3,7,2010,0,2006,0,98042,47.3338,-122.052,2280,5141,282000,15,7,2014,0,8,3389,2861,0,0,0
3,2.5,2370,4200,2.0,0,0,3,8,2370,0,2014,0,98038,47.3696,-122.018,2370,4200,387865,27,8,2014,0,0,1830,1830,0,0,0
4,2.5,2560,6238,2.0,0,0,3,8,2560,0,2007,0,98178,47.4899,-122.255,2560,6240,385000,20,11,2014,0,7,3678,3680,0,0,1
3,2.5,1900,6224,2.0,0,0,3,7,1900,0,2005,0,98075,47.5941,-122.004,2260,5450,536000,9,6,2014,0,9,4324,3190,0,0,0
2,2.25,1350,1493,2.0,0,0,3,8,1050,300,2007,0,98136,47.5421,-122.388,1250,1202,395000,25,6,2014,0,7,143,-48,0,1,1
4,2.75,2650,6717,2.0,0,0,3,10,2650,0,2014,0,98056,47.4947,-122.171,2740,7923,545000,17,11,2014,0,0,4067,5183,0,0,0
4,2.5,3020,7035,2.0,0,4,3,9,3020,0,2001,0,98065,47.5344,-121.874,3020,6771,715000,13,4,2015,0,14,4015,3751,0,0,0
3,2.5,1500,2255,2.0,0,0,3,7,1500,0,2005,0,98029,47.5538,-121.997,1440,2040,348000,10,7,2014,0,9,755,600,0,0,0
3,1.75,1320,1014,3.0,0,0,3,9,1320,0,2015,0,98122,47.6047,-122.305,1380,1495,455000,1,8,2014,0,-1,-306,115,0,0,1
4,2.75,3120,7644,2.0,0,0,3,10,3120,0,2010,0,98065,47.5156,-121.884,2980,6050,575000,3,6,2014,0,4,4524,3070,0,0,0
3,2.25,1540,1270,3.0,0,0,3,7,1540,0,2014,0,98103,47.6935,-122.341,1230,1454,449950,7,10,2014,0,0,-270,224,0,0,1
3,2.5,1800,2790,2.0,0,0,3,8,1800,0,2011,0,98126,47.5455,-122.371,1580,2036,364000,25,6,2014,0,3,990,456,0,0,1
4,2.5,3640,6389,2.0,0,0,3,9,3640,0,2014,0,98052,47.7049,-122.123,3570,6303,932990,1,12,2014,0,0,2749,2733,0,0,0
3,2.5,2440,4153,2.0,0,0,3,9,2440,0,2003,0,98052,47.665,-122.087,2030,4143,710000,27,6,2014,0,11,1713,2113,0,0,0
4,4.0,3970,7314,2.0,0,0,3,9,3970,0,2014,0,98074,47.6173,-122.056,3560,5258,949990,13,2,2015,0,1,3344,1698,0,0,0
3,2.5,2060,4200,2.0,0,0,3,8,2060,0,2014,0,98038,47.3706,-122.017,2370,4200,326989,31,7,2014,0,0,2140,1830,0,0,0
3,2.5,2538,4600,2.0,0,0,3,8,2538,0,2013,0,98092,47.2584,-122.196,2570,4800,335606,8,7,2014,0,1,2062,2230,0,0,0
5,4.5,4270,8076,2.0,0,0,3,11,3400,870,2007,0,98033,47.699,-122.206,4100,10631,1530000,7,5,2014,0,7,3806,6531,0,1,0
3,2.5,1320,3150,2.0,0,0,3,7,1320,0,2005,0,98118,47.5328,-122.282,1390,1725,299950,26,11,2014,0,9,1830,335,0,0,1
4,2.75,3340,5700,2.0,0,0,3,11,3340,0,2013,0,98059,47.5059,-122.146,3340,6940,962000,14,10,2014,0,1,2360,3600,0,0,0
2,2.5,1590,1679,2.0,0,0,3,8,1590,0,2012,0,98029,47.5449,-122.011,1590,1680,395825,13,8,2014,0,2,89,90,0,0,0
5,2.75,2710,4500,2.0,0,0,3,8,2710,0,2014,0,98038,47.3547,-122.062,2710,4626,419354,14,10,2014,0,0,1790,1916,0,0,0
4,2.75,3140,7258,2.0,0,1,3,10,3140,0,2006,0,98034,47.7064,-122.232,2990,13600,920000,26,8,2014,0,8,4118,10610,0,0,0
3,2.25,1445,1028,2.0,0,0,3,7,1300,145,2005,0,98027,47.5339,-122.067,1445,1377,366000,29,8,2014,0,9,-417,-68,0,1,0
4,2.5,2430,5000,2.0,0,0,3,7,2430,0,2009,0,98065,47.515,-121.873,2430,5441,480000,16,5,2014,0,5,2570,3011,0,0,0
3,3.25,1370,915,2.0,0,0,3,8,1100,270,2006,0,98116,47.5639,-122.388,1370,1146,388000,20,11,2014,0,8,-455,-224,0,1,1
4,3.5,5050,9520,2.0,0,0,3,11,3610,1440,2007,0,98004,47.6364,-122.209,2430,9248,2320000,21,4,2015,0,8,4470,6818,0,1,0
3,2.5,1860,1290,2.0,0,0,3,9,1240,620,2010,0,98122,47.6179,-122.301,1710,1525,730000,21,1,2015,0,5,-570,-185,0,1,1
5,3.75,5330,6000,2.0,0,2,3,10,3570,1760,2006,0,98027,47.5401,-122.073,4420,5797,950000,21,5,2014,0,8,670,1377,0,1,0
3,3.25,1710,2171,2.0,0,0,3,7,1400,310,2014,0,98106,47.5434,-122.368,1380,1300,358990,28,7,2014,0,0,461,-80,0,1,1
4,2.5,2650,4120,2.0,0,0,3,8,2650,0,2014,0,98146,47.5019,-122.34,2030,3768,398651,16,10,2014,0,0,1470,1738,0,0,1
4,2.5,2590,7891,2.0,0,0,3,9,2590,0,2006,0,98056,47.5055,-122.194,1400,7891,530000,14,11,2014,0,8,5301,6491,0,0,0
4,2.5,2610,5562,2.0,0,0,3,9,2610,0,2013,0,98056,47.5137,-122.169,2720,7400,610360,23,7,2014,0,1,2952,4680,0,0,0
3,2.5,1770,1235,3.0,0,0,3,8,1600,170,2007,0,98103,47.6965,-122.342,1680,1203,436110,2,5,2014,0,7,-535,-477,0,1,1
4,2.75,3730,8014,2.0,0,0,3,10,3730,0,2012,0,98074,47.6036,-122.059,3670,8279,925000,20,6,2014,0,2,4284,4609,0,0,0
4,2.5,2420,5244,2.0,0,0,3,9,2420,0,2007,0,98166,47.4729,-122.35,1400,5250,449950,13,3,2015,0,8,2824,3850,0,0,1
4,2.5,3330,7399,2.0,0,0,3,9,3330,0,2009,0,98052,47.679,-122.153,2640,8601,760000,27,5,2014,0,5,4069,5961,0,0,0
3,2.25,1910,3481,2.0,0,0,3,8,1910,0,2009,0,98055,47.4293,-122.188,1714,3177,293000,8,7,2014,0,5,1571,1463,0,0,0
2,2.5,2170,7665,1.0,0,2,3,8,2170,0,2013,0,98053,47.7112,-122.019,2300,7100,695000,12,2,2015,0,2,5495,4800,0,0,0
3,2.5,2437,5136,2.0,0,0,3,7,2437,0,2011,0,98002,47.3517,-122.21,2437,4614,285000,4,6,2014,0,3,2699,2177,0,0,0
5,4.0,4180,12042,2.0,0,0,3,10,4180,0,2014,0,98075,47.5959,-122.014,1800,6052,1260000,30,12,2014,0,0,7862,4252,0,0,0
3,2.5,1800,2791,2.0,0,0,3,8,1800,0,2011,0,98126,47.5442,-122.371,1580,2617,379900,14,7,2014,0,3,991,1037,0,0,1
5,2.5,2570,7412,2.0,0,0,3,8,2570,0,2006,0,98019,47.7265,-121.957,2890,8056,472000,27,4,2015,0,9,4842,5166,0,0,0
4,2.5,2090,5195,2.0,0,0,3,7,2090,0,2007,0,98031,47.3986,-122.166,2090,5236,300000,7,7,2014,0,7,3105,3146,0,0,0
4,2.5,2789,3960,2.0,0,0,3,7,2789,0,2007,0,98001,47.3059,-122.28,2547,3960,272000,20,11,2014,0,7,1171,1413,0,0,0
4,2.5,2906,5893,2.0,0,0,3,9,2906,0,2014,0,98092,47.2599,-122.192,2680,4950,418395,20,11,2014,0,0,2987,2270,0,0,0
5,2.5,2550,6405,2.0,0,0,3,7,2550,0,2008,0,98065,47.5191,-121.869,2190,5900,465000,22,12,2014,0,6,3855,3710,0,0,0
4,2.75,3550,9400,2.0,0,0,3,9,3550,0,2014,0,98059,47.4827,-122.131,3550,9421,659950,16,7,2014,0,0,5850,5871,0,0,0
3,2.25,1590,926,3.0,0,0,3,8,1590,0,2014,0,98136,47.5402,-122.387,1640,1321,484950,7,1,2015,0,1,-664,-319,0,0,1
3,2.25,1950,1968,2.0,0,0,4,7,1160,790,1979,0,98056,47.5179,-122.195,1950,1968,359000,26,4,2015,0,36,18,18,0,1,0
4,2.5,3250,4500,2.0,0,0,3,8,3250,0,2009,0,98059,47.4944,-122.149,3030,4518,519000,17,6,2014,0,5,1250,1488,0,0,0
5,4.5,4590,14685,2.0,0,0,3,10,4590,0,2009,0,98033,47.664,-122.2,3030,9486,1710000,27,5,2014,0,5,10095,6456,0,0,0
4,2.75,3070,7201,2.0,0,0,3,9,3070,0,2006,0,98059,47.4897,-122.147,2880,8364,535000,17,6,2014,0,8,4131,5484,0,0,0
4,3.25,3030,7644,2.0,0,0,3,8,2830,200,2006,0,98065,47.5457,-121.881,3400,6908,622950,9,4,2015,0,9,4614,3508,0,1,0
3,2.5,2610,5845,2.0,0,0,3,8,2610,0,2005,0,98059,47.4821,-122.142,2810,5000,515000,11,8,2014,0,9,3235,2190,0,0,0
4,3.5,3150,6202,2.0,0,0,3,7,3150,0,2005,0,98042,47.3993,-122.162,2950,5940,330000,22,5,2014,0,9,3052,2990,0,0,0
3,1.5,1240,983,3.0,0,0,3,8,1240,0,2009,0,98133,47.7235,-122.353,1240,1026,318000,13,2,2015,0,6,-257,-214,0,0,1
3,2.5,1680,2801,2.0,0,0,3,7,1680,0,2011,0,98011,47.745,-122.181,1920,2723,439000,7,10,2014,0,3,1121,803,0,0,0
3,2.5,2220,5279,2.0,0,0,3,8,2220,0,2006,0,98146,47.5132,-122.387,1610,5297,540000,24,3,2015,0,9,3059,3687,0,0,1
4,3.25,4800,12727,2.0,0,0,3,10,4800,0,2011,0,98059,47.5311,-122.134,4750,13602,1080000,17,7,2014,0,3,7927,8852,0,0,0
4,2.5,3100,4699,2.0,0,0,3,9,3100,0,2010,0,98038,47.3785,-122.023,2450,5130,435000,26,3,2015,0,5,1599,2680,0,0,0
4,2.75,3590,5625,2.0,0,0,3,10,3590,0,2012,0,98052,47.6959,-122.133,3590,5625,1100000,17,10,2014,0,2,2035,2035,0,0,0
4,2.0,1590,942,3.0,0,0,3,7,1590,0,2008,0,98027,47.54,-122.026,1390,942,293467,6,2,2015,0,7,-648,-448,0,0,0
3,2.5,2242,4800,2.0,0,0,3,8,2242,0,2013,0,98092,47.2581,-122.2,2009,4800,328000,12,5,2015,0,2,2558,2791,0,0,0
3,3.5,2490,3582,2.0,0,0,3,8,1720,770,2005,0,98027,47.5338,-122.067,1445,1590,550000,8,7,2014,0,9,1092,145,0,1,0
3,2.0,1530,1442,3.0,0,0,3,9,1530,0,2015,0,98107,47.6692,-122.372,1620,1456,649000,2,4,2015,0,0,-88,-164,0,0,1
4,2.5,2150,3143,2.0,0,0,3,7,2150,0,2010,0,98059,47.5048,-122.154,2640,3200,435000,8,7,2014,0,4,993,560,0,0,0
3,2.5,2440,4800,2.0,0,0,3,10,2440,0,2014,0,98106,47.5595,-122.365,1180,5480,625000,20,6,2014,0,0,2360,4300,0,0,1
3,1.5,1270,1483,3.0,0,0,3,8,1270,0,2007,0,98115,47.6987,-122.317,1270,1413,415000,29,4,2015,0,8,213,143,0,0,1
3,2.25,1450,4706,2.0,0,0,3,7,1450,0,2009,0,98028,47.761,-122.232,1490,4667,400000,3,6,2014,0,5,3256,3177,0,0,0
3,2.5,2690,4047,3.0,0,0,3,10,2690,0,2014,0,98117,47.6797,-122.385,2040,5000,979000,6,5,2014,0,0,1357,2960,0,0,1
4,2.5,2755,4831,2.0,0,0,3,7,2755,0,2003,0,98053,47.685,-122.039,2510,4831,625250,20,2,2015,0,12,2076,2321,0,0,0
4,3.5,2650,3474,2.0,0,0,3,8,2230,420,2011,0,98027,47.5377,-122.046,2330,3474,665000,9,9,2014,0,3,824,1144,0,1,0
3,3.25,2310,3075,2.0,0,0,3,8,1730,580,2005,0,98116,47.5644,-122.383,2310,3075,589500,27,6,2014,0,9,765,765,0,1,1
2,3.0,1460,1452,2.0,0,0,3,8,1140,320,2007,0,98136,47.5224,-122.39,1460,1452,437000,9,3,2015,0,8,-8,-8,0,1,1
3,1.0,1400,9000,1.0,0,0,5,7,1400,0,1959,0,98059,47.5022,-122.145,1440,8400,320000,1,10,2014,0,55,7600,6960,0,0,0
3,2.5,2196,7475,2.0,0,0,3,8,2196,0,2006,0,98030,47.3803,-122.204,1860,6755,333500,14,1,2015,0,9,5279,4895,0,0,0
3,2.25,2020,2750,2.0,0,0,3,8,1680,340,2008,0,98108,47.5633,-122.297,1720,1546,430000,24,11,2014,0,6,730,-174,0,1,1
5,4.5,4280,8465,2.0,0,0,3,10,4280,0,2014,0,98034,47.7325,-122.165,2990,11067,995500,5,8,2014,0,0,4185,8077,0,0,0
3,3.0,2340,5002,2.0,0,0,3,8,2340,0,2013,0,98045,47.4831,-121.773,2790,5375,427874,3,6,2014,0,1,2662,2585,0,0,0
4,2.5,2220,4228,2.0,0,0,3,8,2220,0,2014,0,98146,47.5014,-122.341,2220,4157,334990,21,5,2014,0,0,2008,1937,0,0,1
4,4.0,4420,5940,2.0,0,0,3,10,3410,1010,2006,0,98027,47.5397,-122.072,4510,5797,909500,11,2,2015,0,9,1520,1287,0,1,0
3,2.0,1580,4961,2.0,0,0,3,7,1580,0,2006,0,98042,47.3338,-122.053,2280,5000,210000,19,3,2015,0,9,3381,2720,0,0,0
4,2.75,3550,6558,2.0,0,0,3,9,3550,0,2013,0,98052,47.7076,-122.115,3140,5617,952990,23,1,2015,0,2,3008,2477,0,0,0
2,1.75,1510,851,3.0,0,0,3,8,1420,90,2013,0,98107,47.6536,-122.358,1300,1338,622500,18,2,2015,0,2,-659,38,0,1,1
3,3.5,1360,1419,2.0,0,0,3,8,1040,320,2007,0,98107,47.6697,-122.371,1560,1977,515000,18,6,2014,0,7,59,417,0,1,1
3,2.5,2040,13590,2.0,0,0,3,8,2040,0,2009,0,98042,47.3122,-122.04,1850,12485,350000,26,1,2015,0,6,11550,10635,0,0,0
1,1.5,1120,912,3.0,0,0,3,7,1120,0,2011,0,98144,47.5924,-122.299,1380,3200,310000,16,10,2014,0,3,-208,1820,0,0,1
4,3.5,4490,5099,2.0,0,0,3,9,3390,1100,2006,0,98065,47.5394,-121.861,4290,5537,700000,28,5,2014,0,8,609,1247,0,1,0
4,2.5,3560,6786,2.0,0,0,3,9,2930,630,2014,0,98075,47.5756,-122.071,3560,5886,907687,15,7,2014,0,0,3226,2326,0,1,0
2,2.5,2150,5760,1.0,0,0,3,8,2150,0,2010,0,98053,47.7094,-122.018,1640,4680,741500,9,7,2014,0,4,3610,3040,0,0,0
3,2.5,2130,5088,2.0,0,0,3,8,1840,290,2011,0,98019,47.7329,-121.976,2130,5762,395000,24,7,2014,0,3,2958,3632,0,1,0
5,2.75,2990,6370,2.0,0,0,3,8,2990,0,2014,0,98059,47.4853,-122.154,2730,5740,559950,23,2,2015,0,1,3380,3010,0,0,0
4,2.5,1847,8000,2.0,0,0,3,7,1847,0,2008,0,98001,47.2872,-122.257,1847,8000,215000,25,7,2014,0,6,6153,6153,0,0,0
4,2.5,2610,7227,2.0,0,0,3,9,2610,0,2011,0,98010,47.314,-122.023,2630,7421,390000,22,2,2015,0,4,4617,4791,0,0,0
4,3.5,3440,9776,2.0,0,0,3,10,3440,0,2006,0,98040,47.5374,-122.216,2400,11000,1330000,7,4,2015,0,9,6336,8600,0,0,0
4,3.5,3510,9364,2.0,0,0,3,10,3510,0,2001,0,98065,47.54,-121.876,3510,9161,695000,10,6,2014,0,13,5854,5651,0,0,0
3,2.5,1740,1279,3.0,0,0,3,8,1740,0,2008,0,98116,47.589,-122.387,1740,1280,545000,20,1,2015,0,7,-461,-460,0,0,1
4,2.5,2240,5500,2.0,0,0,3,8,2240,0,2013,0,98056,47.496,-122.169,700,5500,389950,11,7,2014,0,1,3260,4800,0,0,0
3,2.25,1550,1485,3.0,0,0,3,8,1550,0,2011,0,98103,47.6989,-122.346,1550,1480,380000,30,3,2015,0,4,-65,-70,0,0,1
4,2.0,1390,745,3.0,0,0,3,7,1390,0,2008,0,98027,47.5401,-122.026,1390,942,288790,17,11,2014,0,6,-645,-448,0,0,0
3,3.0,2500,6000,2.0,0,0,3,8,2500,0,2012,0,98058,47.4408,-122.161,2130,6000,432500,1,4,2015,0,3,3500,3870,0,0,0
3,3.5,2710,3326,2.0,0,0,3,8,1650,1060,2005,0,98027,47.5371,-122.073,2280,2738,615000,6,12,2014,0,9,616,458,0,1,0
3,2.5,1720,3012,2.0,0,0,3,9,1720,0,2011,0,98133,47.7312,-122.334,1720,7658,500000,7,7,2014,0,3,1292,5938,0,0,1
3,2.25,1760,1146,3.0,0,0,3,9,1760,0,2014,0,98122,47.6073,-122.304,1346,3472,615000,31,5,2014,0,0,-614,2126,0,0,1
4,2.25,2270,8196,1.0,0,0,5,7,1150,1120,1963,0,98034,47.7214,-122.227,1920,10122,500000,26,9,2014,0,51,5926,8202,0,1,0
3,3.5,1690,1765,2.0,0,0,3,8,1370,320,2006,0,98103,47.6536,-122.34,1690,1694,622000,15,10,2014,0,8,75,4,0,1,1
5,3.5,4000,9234,2.0,0,0,3,9,4000,0,2015,0,98024,47.5265,-121.887,3690,6600,802945,9,4,2015,0,0,5234,2910,0,0,0
4,2.5,2880,9003,2.0,0,0,3,10,2880,0,2008,0,98033,47.6844,-122.199,2640,8126,1260000,31,7,2014,0,6,6123,5486,0,0,0
3,2.5,1480,1531,3.0,0,0,3,8,1480,0,2014,0,98107,47.669,-122.402,1530,1321,598950,24,2,2015,0,1,51,-209,0,0,1
3,2.5,1950,4949,2.0,0,0,3,7,1950,0,2009,0,98065,47.5155,-121.87,2200,5740,430000,2,1,2015,0,6,2999,3540,0,0,0
4,2.75,2700,5150,2.0,0,0,3,9,2700,0,2009,0,98065,47.5209,-121.874,2700,5747,515000,24,11,2014,0,5,2450,3047,0,0,0
2,3.0,2210,3917,2.0,0,0,3,10,1500,710,2008,0,98122,47.6166,-122.291,1720,3933,1260000,17,7,2014,0,6,1707,2213,0,1,1
4,3.5,2370,3692,2.5,0,0,3,8,2370,0,2013,0,98056,47.5044,-122.17,2520,5425,400000,9,6,2014,0,1,1322,2905,0,0,0
3,2.5,1310,1254,2.0,0,0,3,7,850,460,2007,0,98116,47.5622,-122.384,1310,1372,390000,22,4,2015,0,8,-56,62,0,1,1
3,2.5,2410,4293,2.0,0,0,3,7,2410,0,2007,0,98065,47.5196,-121.869,2190,5900,450000,1,10,2014,0,7,1883,3710,0,0,0
5,1.5,3360,5402,2.0,0,0,3,9,3360,0,2014,0,98074,47.6067,-122.053,3360,5415,804995,16,5,2014,0,0,2042,2055,0,0,0
4,3.25,3040,4155,2.0,0,0,3,8,2350,690,2013,0,98029,47.5429,-122.012,2680,4000,825000,26,3,2015,0,2,1115,1320,0,1,0
4,2.25,2140,6355,2.0,0,0,3,7,2140,0,2002,0,98065,47.5367,-121.88,2480,5746,435000,13,5,2014,0,12,4215,3266,0,0,0
3,2.5,1720,1715,2.0,0,0,3,7,1240,480,2004,0,98136,47.5481,-122.384,1610,1626,398000,9,6,2014,0,10,-5,16,0,1,1
4,2.5,2658,3960,2.0,0,0,3,9,2658,0,2014,0,98092,47.2603,-122.194,2578,4200,411605,5,6,2014,0,0,1302,1622,0,0,0
3,3.25,1480,983,2.0,0,0,3,8,1180,300,2013,0,98106,47.5555,-122.363,1330,1062,315000,8,12,2014,0,1,-497,-268,0,1,1
2,2.0,1350,1209,3.0,0,0,3,8,1350,0,2013,0,98199,47.649,-122.383,1310,982,455000,20,11,2014,0,1,-141,-328,0,0,1
3,2.5,1150,1194,2.0,0,0,3,8,1020,130,2006,0,98107,47.6684,-122.365,1450,1714,452950,1,5,2015,0,9,44,264,0,1,1
3,1.75,1690,1468,2.0,0,0,3,8,1380,310,2008,0,98108,47.563,-122.297,1690,1936,380000,20,5,2014,0,6,-222,246,0,1,1
2,1.75,1270,1916,2.0,0,0,3,8,1270,0,2012,0,98108,47.5648,-122.294,1140,1916,340000,24,11,2014,0,2,646,776,0,0,1
3,2.5,2655,5080,2.0,0,0,3,8,2655,0,2013,0,98023,47.2972,-122.348,2879,5232,409950,3,11,2014,0,1,2425,2353,0,0,0
2,1.0,880,1165,2.0,0,0,3,8,880,0,2005,0,98122,47.6192,-122.297,1640,3825,360000,4,5,2015,0,10,285,2185,0,0,1
4,4.25,4645,7757,2.0,0,0,3,10,3855,790,2006,0,98112,47.6248,-122.29,2150,6970,1600000,3,4,2015,0,9,3112,4820,0,1,1
3,1.5,1270,1443,3.0,0,0,3,8,1270,0,2007,0,98115,47.699,-122.317,1270,1413,440000,20,5,2014,0,7,173,143,0,0,1
3,2.25,1950,7221,1.0,0,0,4,8,1950,0,2006,0,98188,47.431,-122.285,2310,8125,408000,22,5,2014,0,8,5271,5815,0,0,1
4,2.5,3170,3862,3.0,0,0,3,8,3170,0,2008,0,98034,47.6705,-122.145,2840,4181,820000,25,8,2014,0,6,692,1341,0,0,0
2,2.5,1233,1244,2.0,0,0,3,7,963,270,2007,0,98136,47.5533,-122.381,1230,1300,360000,31,7,2014,0,7,11,70,0,1,1
3,2.5,2570,4600,2.0,0,0,3,8,2570,0,2014,0,98092,47.2582,-122.196,2570,5000,339990,20,6,2014,0,0,2030,2430,0,0,0
3,2.0,1560,1020,3.0,0,0,3,8,1560,0,2014,0,98122,47.605,-122.304,1560,1728,515000,8,10,2014,0,0,-540,168,0,0,1
3,1.75,1630,1166,2.0,0,0,3,8,1020,610,2013,0,98107,47.6646,-122.367,1420,1670,541000,21,1,2015,0,2,-464,250,0,1,1
4,2.5,2510,7245,2.0,0,0,3,9,2510,0,2007,0,98146,47.5096,-122.363,1830,8900,375000,6,4,2015,0,8,4735,7070,0,0,1
4,2.5,2223,5780,2.0,0,0,3,8,2223,0,2010,0,98042,47.3586,-122.157,1690,7766,320000,20,10,2014,0,4,3557,6076,0,0,0
2,2.25,1230,1058,2.0,0,0,3,7,1160,70,2008,0,98027,47.5325,-122.073,1240,817,325000,27,2,2015,0,7,-172,-423,0,1,0
5,2.75,3050,7520,2.0,0,0,3,8,3050,0,2014,0,98056,47.5245,-122.184,2180,10800,740000,18,3,2015,0,1,4470,8620,0,0,0
5,2.75,2710,6220,2.0,0,0,3,8,2710,0,2014,0,98038,47.3555,-122.061,2530,4759,450000,30,10,2014,0,0,3510,2229,0,0,0
4,2.5,2090,4400,2.0,0,0,3,8,2090,0,2011,0,98118,47.5403,-122.286,2090,3430,455000,23,7,2014,0,3,2310,1340,0,0,1
3,2.5,1440,1068,2.0,0,0,3,8,1160,280,2006,0,98106,47.5393,-122.361,1580,1483,292500,3,2,2015,0,9,-372,-97,0,1,1
4,2.75,2740,7872,2.0,0,0,3,10,2740,0,2015,0,98056,47.4954,-122.172,1220,6300,530000,6,3,2015,0,0,5132,5080,0,0,0
5,3.25,3360,6120,2.0,0,0,3,9,3360,0,2014,0,98074,47.607,-122.053,3230,5398,829995,4,8,2014,0,0,2760,2168,0,0,0
4,2.75,2280,5013,2.0,0,0,3,8,2280,0,2009,0,98019,47.7333,-121.976,2130,5121,395000,23,12,2014,0,5,2733,2991,0,0,0
4,2.75,3520,5500,2.0,0,0,3,9,3520,0,2014,0,98074,47.6181,-122.056,3340,5500,859990,11,7,2014,0,0,1980,2160,0,0,0
2,1.5,1320,826,2.0,0,0,3,8,1100,220,2008,0,98144,47.5879,-122.304,1340,1213,342500,10,7,2014,0,6,-494,-127,0,1,1
4,2.75,3410,5838,2.0,0,0,3,9,3410,0,2012,0,98053,47.6931,-122.022,3420,7048,743000,5,12,2014,0,2,2428,3628,0,0,0
3,2.25,2730,9388,1.0,0,0,3,7,1390,1340,1975,0,98030,47.3785,-122.185,2255,5701,345000,15,12,2014,0,39,6658,3446,0,1,0
3,2.5,1780,2778,2.0,0,0,3,8,1530,250,2007,0,98126,47.5487,-122.372,1380,1998,443000,31,12,2014,0,7,998,618,0,1,1
3,2.5,1427,4337,2.0,0,0,3,7,1427,0,2009,0,98042,47.3857,-122.162,1443,4347,260000,29,9,2014,0,5,2910,2904,0,0,0
4,2.5,2910,6555,2.0,0,0,3,9,2910,0,2005,0,98033,47.6659,-122.172,2910,10419,810000,22,7,2014,0,9,3645,7509,0,0,0
4,2.75,3250,5600,2.0,0,0,3,8,3250,0,2011,0,98059,47.4806,-122.125,2730,5667,570000,22,12,2014,0,3,2350,2937,0,0,0
5,3.5,3630,8100,2.0,0,0,3,10,3630,0,2008,0,98004,47.5951,-122.2,1730,8246,1560000,3,3,2015,0,7,4470,6516,0,0,0
2,2.5,1680,975,3.0,0,0,3,9,1680,0,2009,0,98119,47.6321,-122.361,1680,977,840000,13,11,2014,0,5,-705,-703,0,0,1
3,2.5,2280,2296,3.0,0,0,3,9,1890,390,2013,0,98112,47.6256,-122.299,1390,4000,950000,14,4,2015,0,2,16,2610,0,1,1
3,2.5,3310,4682,2.0,0,0,3,9,2380,930,2015,0,98065,47.5201,-121.885,2660,5166,572800,27,1,2015,0,0,1372,2506,0,1,0
3,3.0,1290,1112,3.0,0,0,3,7,1290,0,2008,0,98125,47.7282,-122.296,1230,9000,305000,1,10,2014,0,6,-178,7770,0,0,1
5,4.75,3940,7067,2.0,0,0,3,10,3230,710,2008,0,98004,47.6232,-122.205,1910,7735,1700000,30,7,2014,0,6,3127,5825,0,1,0
4,2.5,2170,6000,2.0,0,0,3,7,1630,540,2008,0,98106,47.5589,-122.365,1720,5668,445000,27,8,2014,0,6,3830,3948,0,1,1
4,3.5,3290,8059,2.0,0,0,3,9,3290,0,2012,0,98029,47.5573,-122.02,3290,10758,801000,2,9,2014,0,2,4769,7468,0,0,0
3,2.5,2550,5376,2.0,0,0,3,9,2550,0,2004,0,98052,47.6647,-122.083,2250,4050,711000,14,7,2014,0,10,2826,1800,0,0,0
3,2.25,1140,977,2.0,0,0,3,7,850,290,2008,0,98126,47.5439,-122.375,1140,976,268500,27,8,2014,0,6,-163,-164,0,1,1
4,2.5,2300,3825,2.0,0,0,3,7,2300,0,2012,0,98042,47.3594,-122.082,2110,3825,320000,6,10,2014,0,2,1525,1715,0,0,0
4,3.25,2670,5001,1.0,0,0,3,9,1640,1030,2013,0,98108,47.5666,-122.293,1610,5001,500000,21,9,2014,0,1,2331,3391,0,1,1
4,2.5,2440,6651,2.0,0,0,3,9,2440,0,2014,0,98117,47.6971,-122.371,1350,7653,631625,5,5,2014,0,0,4211,6303,0,0,1
2,2.5,1611,2210,2.0,0,2,3,10,1611,0,2005,0,98109,47.6291,-122.347,2070,2182,850000,27,1,2015,0,10,599,112,0,0,1
3,3.5,2710,3290,2.0,0,0,3,8,1650,1060,2006,0,98027,47.5367,-122.072,2440,3290,600000,27,10,2014,0,8,580,850,0,1,0
3,2.75,2015,16807,2.0,1,4,3,9,2015,0,2007,0,98166,47.45,-122.377,1780,12310,988500,8,5,2014,0,7,14792,10530,0,0,1
4,3.25,3444,5166,2.0,0,0,3,8,2714,730,2014,0,98023,47.2966,-122.348,2848,5182,430236,27,3,2015,0,1,1722,2334,0,1,0
3,2.5,3060,9576,2.0,0,0,3,10,3060,0,2005,0,98004,47.5928,-122.199,3060,9579,1270000,15,9,2014,0,9,6516,6519,0,0,0
4,2.5,2050,2772,2.0,0,0,3,8,2050,0,2013,0,98029,47.5431,-122.011,1800,2886,689500,28,4,2015,0,2,722,1086,0,0,0
3,1.5,1390,1882,2.0,0,0,3,7,1390,0,2014,0,98108,47.5667,-122.297,1490,2175,175003,1,12,2014,0,0,492,685,0,0,1
2,2.5,1240,1249,3.0,0,0,3,8,1240,0,2006,0,98107,47.6718,-122.386,1240,2500,459000,15,9,2014,0,8,9,1260,0,0,1
3,3.25,1410,1442,3.0,0,0,3,8,1360,50,2006,0,98125,47.7183,-122.317,1500,1200,358000,2,9,2014,0,8,32,-300,0,1,1
4,2.5,2448,4949,2.0,0,0,3,9,2448,0,2014,0,98030,47.3428,-122.179,2815,5446,447055,14,7,2014,0,0,2501,2631,0,0,0
4,3.25,3330,9000,2.0,0,0,3,9,2870,460,2004,0,98033,47.6836,-122.208,2550,6349,1210000,13,10,2014,0,10,5670,3799,0,1,0
2,2.25,1160,1010,2.0,0,0,3,8,1000,160,2006,0,98112,47.6207,-122.301,1200,1170,495000,21,10,2014,0,8,-150,-30,0,1,1
2,2.25,1330,1380,2.0,0,0,3,8,1060,270,2005,0,98116,47.577,-122.41,1580,4802,479000,20,11,2014,0,9,50,3222,0,1,1
3,2.5,1610,3517,2.0,0,0,3,8,1610,0,2005,0,98055,47.4496,-122.189,1830,2889,249900,16,10,2014,0,9,1907,1059,0,0,0
4,2.5,2800,4000,2.0,0,0,3,9,2800,0,2011,0,98103,47.6695,-122.339,1770,4200,1470000,30,10,2014,0,3,1200,2430,0,0,1
5,3.75,4570,10194,2.0,0,0,3,11,4570,0,2006,0,98034,47.718,-122.161,2040,7560,1040000,10,4,2015,0,9,5624,5520,0,0,0
4,2.5,2820,6120,2.0,0,0,3,9,2820,0,2014,0,98115,47.6911,-122.293,1510,6120,897000,20,10,2014,0,0,3300,4610,0,0,1
4,2.5,2570,9470,2.0,0,0,3,9,2570,0,2006,0,98033,47.6548,-122.19,2570,10663,1100000,27,3,2015,0,9,6900,8093,0,0,0
3,2.25,1710,1193,2.0,0,0,3,9,1140,570,2014,0,98122,47.6173,-122.31,1510,1193,685000,13,11,2014,0,0,-517,-317,0,1,1
3,1.5,1220,3286,2.0,0,0,3,7,1220,0,1982,0,98033,47.7168,-122.189,1220,2640,295000,30,9,2014,0,32,2066,1420,0,0,0
3,2.25,1650,946,3.0,0,0,3,8,1650,0,2014,0,98103,47.6536,-122.354,1570,1283,619000,4,8,2014,0,0,-704,-287,0,0,1
2,1.5,1130,1340,2.0,0,0,3,8,910,220,2008,0,98116,47.5761,-122.41,1310,1340,439108,25,11,2014,0,6,210,30,0,1,1
3,2.25,1489,2800,2.0,0,0,3,7,1489,0,2011,0,98002,47.3452,-122.215,1584,3200,260000,20,2,2015,0,4,1311,1616,0,0,0
5,2.5,2690,5557,2.0,0,0,3,7,2690,0,2012,0,98178,47.4914,-122.253,2090,10500,279000,6,6,2014,0,2,2867,8410,0,0,1
3,2.25,1530,1305,2.0,0,0,3,7,1116,414,2007,0,98177,47.7034,-122.357,1320,1427,380000,30,3,2015,0,8,-225,107,0,1,1
3,2.5,1600,6315,2.0,0,0,3,8,1600,0,2013,0,98092,47.2611,-122.198,1608,4300,287000,7,11,2014,0,1,4715,2692,0,0,0
2,1.5,1000,1251,2.0,0,0,3,7,930,70,2006,0,98199,47.6529,-122.384,1420,1187,377000,11,12,2014,0,8,251,-233,0,1,1
4,3.5,2440,3012,3.0,0,1,3,8,2440,0,2005,0,98117,47.6923,-122.392,1860,4650,649950,23,2,2015,0,10,572,2790,0,0,1
3,2.5,1260,1102,3.0,0,0,3,8,1260,0,2007,0,98107,47.675,-122.387,1320,2500,445000,24,10,2014,0,7,-158,1180,0,0,1
3,2.5,1660,1692,3.0,0,0,3,7,1610,50,2005,0,98115,47.6801,-122.322,1210,1230,605000,4,5,2015,0,10,32,20,0,1,1
3,2.25,1190,1137,2.0,0,0,3,7,960,230,1999,0,98115,47.677,-122.325,1190,1080,475000,23,9,2014,0,15,-53,-110,0,1,1
3,3.0,1520,1884,3.0,0,0,3,8,1520,0,2009,0,98125,47.7176,-122.284,1360,1939,399000,28,8,2014,0,5,364,579,0,0,1
5,2.75,3250,8100,2.0,0,0,3,8,3250,0,2014,0,98125,47.7133,-122.311,1270,8100,718000,20,4,2015,0,1,4850,6830,0,0,1
4,3.25,4700,9160,1.0,0,4,3,11,2520,2180,2005,0,98116,47.5744,-122.406,2240,8700,1400000,28,5,2014,0,9,4460,6460,0,1,1
3,2.5,1480,1663,2.0,0,0,3,9,1180,300,2012,0,98126,47.5443,-122.375,1380,1537,341000,16,5,2014,0,2,183,157,0,1,1
2,2.5,2380,9374,1.0,0,2,3,8,2380,0,2011,0,98053,47.7095,-122.019,1610,5000,818000,19,5,2014,0,3,6994,3390,0,0,0
3,2.25,1640,1873,3.0,0,0,3,8,1640,0,2014,0,98112,47.6196,-122.297,1640,3920,759000,2,12,2014,0,0,233,2280,0,0,1
3,3.5,1650,2262,3.0,0,0,3,8,1650,0,2010,0,98103,47.6823,-122.347,1620,3166,547500,11,6,2014,0,4,612,1546,0,0,1
5,4.75,5305,8401,2.0,0,2,3,11,3745,1560,2005,0,98033,47.6864,-122.215,2960,7200,2700000,21,5,2014,0,9,3096,4240,0,1,0
2,2.5,1278,987,2.0,0,0,3,7,1002,276,2007,0,98136,47.5532,-122.381,1220,1287,358000,22,7,2014,0,7,-291,67,0,1,1
3,2.5,1200,813,3.0,0,0,3,9,1200,0,2010,0,98144,47.5894,-122.315,1750,4365,412000,1,10,2014,0,4,-387,2615,0,0,1
2,1.5,690,1058,2.0,0,0,3,7,690,0,2005,0,98103,47.6951,-122.343,690,1058,245000,30,1,2015,0,10,368,368,0,0,1
4,2.5,3202,4964,2.0,0,0,3,9,3202,0,2014,0,98030,47.3412,-122.179,2425,4886,460940,7,10,2014,0,0,1762,2461,0,0,0
3,2.25,1347,1292,3.0,0,0,3,7,1347,0,2010,0,98125,47.7306,-122.291,1480,1865,321000,22,5,2014,0,4,-55,385,0,0,1
4,3.5,2960,6000,2.0,0,0,3,9,2960,0,2014,0,98065,47.5183,-121.886,2960,6000,633634,23,6,2014,0,0,3040,3040,0,0,0
1,0.75,740,1284,1.0,0,0,4,6,740,0,1928,0,98107,47.6741,-122.406,1430,3988,290000,23,9,2014,0,86,544,2558,0,0,1
2,2.25,1200,1137,3.0,0,0,3,7,1200,0,2007,0,98107,47.6715,-122.392,1280,1295,445000,1,4,2015,0,8,-63,15,0,0,1
5,3.5,4320,7502,2.0,0,0,3,9,3500,820,2012,0,98056,47.5235,-122.168,3250,7538,887250,7,4,2015,0,3,3182,4288,0,1,0
3,2.5,2310,7348,1.0,0,3,3,8,2310,0,2010,0,98053,47.7116,-122.019,2310,7153,739000,11,9,2014,0,4,5038,4843,0,0,0
3,2.0,1490,1286,3.0,0,0,3,8,1490,0,2014,0,98144,47.57,-122.288,1420,1230,429900,16,12,2014,0,0,-204,-190,0,0,1
3,2.0,1480,800,2.0,0,0,3,8,1000,480,2014,0,98136,47.5492,-122.387,1480,886,459000,6,1,2015,0,1,-680,-594,0,1,1
3,2.25,1481,2820,2.0,0,0,3,7,1481,0,2012,0,98002,47.3457,-122.217,1481,3028,240000,25,6,2014,0,2,1339,1547,0,0,0
3,3.0,1730,1902,3.0,0,0,3,8,1730,0,2014,0,98117,47.6944,-122.377,1830,1804,566950,10,9,2014,0,0,172,-26,0,0,1
4,3.5,3900,8391,2.0,0,0,3,10,3900,0,2006,0,98033,47.6979,-122.205,3820,12268,1040000,7,5,2014,0,8,4491,8448,0,0,0
3,3.5,1130,1449,3.0,0,0,3,7,1130,0,2005,0,98103,47.6968,-122.348,1130,1200,343000,10,3,2015,0,10,319,70,0,0,1
4,3.25,3230,4838,2.0,0,0,3,9,3230,0,2014,0,98038,47.3559,-122.023,2980,5094,572115,11,11,2014,0,0,1608,2114,0,0,0
5,3.5,3920,5150,2.0,0,0,3,9,2820,1100,2004,0,98052,47.6638,-122.084,3170,5530,918000,8,1,2015,0,11,1230,2360,0,1,0
2,1.5,1190,1361,2.0,0,0,3,8,1190,0,2007,0,98122,47.6161,-122.302,1280,3360,555000,5,5,2015,0,8,171,2080,0,0,1
4,2.5,2311,4396,2.0,0,0,3,9,2311,0,2014,0,98092,47.3276,-122.163,2458,4616,399440,16,7,2014,0,0,2085,2158,0,0,0
3,2.5,1810,914,3.0,0,0,3,8,1380,430,2008,0,98116,47.5732,-122.387,1810,914,450000,11,7,2014,0,6,-896,-896,0,1,1
4,2.5,3290,6203,2.0,0,0,3,9,3290,0,2008,0,98065,47.5441,-121.86,2990,6835,648000,4,6,2014,0,6,2913,3845,0,0,0
4,2.5,3250,5000,2.0,0,0,3,8,3250,0,2008,0,98059,47.4988,-122.148,3230,5507,580000,18,6,2014,0,6,1750,2277,0,0,0
4,2.5,2544,4071,2.0,0,0,3,9,2544,0,2013,0,98030,47.341,-122.179,2358,4179,415000,31,3,2015,0,2,1527,1821,0,0,0
3,2.5,1380,1389,3.0,0,0,3,8,1380,0,2008,0,98102,47.6427,-122.327,1380,1249,527500,21,10,2014,0,6,9,-131,0,0,1
3,2.25,1430,800,2.0,0,0,3,8,1140,290,2011,0,98136,47.5477,-122.388,1430,1387,384000,30,7,2014,0,3,-630,-43,0,1,1
2,1.5,910,966,2.0,0,0,3,8,820,90,2006,0,98119,47.627,-122.361,2740,6400,455000,22,8,2014,0,8,56,3660,0,1,1
4,3.25,3080,4120,2.0,0,0,3,9,2380,700,2014,0,98117,47.6845,-122.359,1410,4120,1280000,3,4,2015,0,1,1040,2710,0,1,1
3,2.5,2280,6031,2.0,0,0,3,8,2280,0,2011,0,98019,47.7322,-121.966,2430,7200,415000,24,6,2014,0,3,3751,4770,0,0,0
3,2.5,1660,1344,3.0,0,0,3,8,1660,0,2008,0,98102,47.644,-122.327,1750,2040,975000,22,12,2014,0,6,-316,290,0,0,1
4,2.5,3320,7429,2.0,0,0,3,9,3320,0,2014,0,98034,47.7189,-122.225,1840,7429,799950,6,10,2014,0,0,4109,5589,0,0,0
5,4.0,1680,7268,1.0,0,0,3,8,1370,310,2008,0,98106,47.5571,-122.356,2040,8259,545000,5,4,2015,0,7,5588,6219,0,1,1
4,3.5,2584,5005,2.0,0,0,3,8,2584,0,2014,0,98023,47.296,-122.35,2767,5201,429900,3,10,2014,0,0,2421,2434,0,0,0
3,2.5,2217,8019,2.0,0,0,3,7,2217,0,2009,0,98001,47.2776,-122.251,1470,8037,275000,29,7,2014,0,5,5802,6567,0,0,0
3,2.5,2480,4136,2.0,0,0,3,8,2480,0,2009,0,98059,47.493,-122.147,2510,4314,498000,18,7,2014,0,5,1656,1804,0,0,0
3,2.5,2610,7256,2.0,0,0,3,9,2610,0,2014,0,98033,47.695,-122.18,2610,7206,754950,27,5,2014,0,0,4646,4596,0,0,0
4,3.0,3240,5562,2.0,0,0,3,10,3240,0,2013,0,98075,47.5919,-121.975,3380,5562,895000,6,6,2014,0,1,2322,2182,0,0,0
4,3.25,3569,8327,2.0,0,0,3,10,3569,0,2013,0,98055,47.4595,-122.208,2550,5251,580000,6,5,2014,0,1,4758,2701,0,0,0
4,2.5,1921,4888,2.0,0,0,3,7,1921,0,2009,0,98001,47.2689,-122.24,1921,9140,245000,10,3,2015,0,6,2967,7219,0,0,0
3,2.5,1570,4926,2.0,0,0,3,8,1570,0,2014,0,98065,47.5342,-121.842,1800,3202,417000,26,8,2014,0,0,3356,1402,0,0,0
3,2.5,1940,3211,2.0,0,0,3,8,1940,0,2009,0,98027,47.5644,-122.093,1880,3078,555000,5,5,2014,0,5,1271,1198,0,0,0
3,2.5,1940,3211,2.0,0,0,3,8,1940,0,2009,0,98027,47.5644,-122.093,1880,3078,555000,26,8,2014,0,5,1271,1198,0,0,0
4,2.5,2210,13721,2.0,0,0,3,8,2210,0,2009,0,98042,47.3122,-122.039,1850,12951,353000,10,9,2014,0,5,11511,11101,0,0,0
3,2.25,1280,1187,2.0,0,0,3,8,1080,200,2008,0,98107,47.6651,-122.368,1280,1681,539000,25,4,2015,0,7,-93,401,0,1,1
3,2.0,1520,5040,2.0,0,0,3,7,1520,0,1977,2006,98177,47.777,-122.362,1860,8710,434900,4,9,2014,29,37,3520,6850,1,0,1
2,2.25,1230,1078,2.0,0,0,3,7,1160,70,2008,0,98027,47.5324,-122.073,1240,817,325000,2,12,2014,0,6,-152,-423,0,1,0
3,2.5,1480,2159,3.0,0,0,3,8,1480,0,2007,0,98103,47.6533,-122.341,1480,1554,650000,9,4,2015,0,8,679,74,0,0,1
4,2.5,2612,5850,2.0,0,0,3,8,2612,0,2014,0,98030,47.3751,-122.189,2419,8984,379950,25,2,2015,0,1,3238,6565,0,0,0
3,2.5,2350,4975,2.0,0,0,3,8,2350,0,2012,0,98029,47.5418,-122.01,2350,3951,700000,19,11,2014,0,2,2625,1601,0,0,0
3,2.5,1300,1590,2.0,0,0,3,8,1100,200,2014,0,98109,47.6384,-122.343,1070,1223,675000,15,12,2014,0,0,290,153,0,1,1
4,1.5,2020,7560,1.0,0,0,4,7,2020,0,1960,0,98059,47.502,-122.146,1410,8080,379000,9,6,2014,0,54,5540,6670,0,0,0
3,2.5,2140,2867,2.0,0,0,3,8,1960,180,2005,0,98027,47.5357,-122.073,2280,2836,571000,30,3,2015,0,10,727,556,0,1,0
3,2.25,1380,1621,2.0,0,0,3,8,1140,240,2007,0,98117,47.678,-122.375,1460,1403,475000,24,10,2014,0,7,241,-57,0,1,1
4,3.5,2730,3047,2.0,0,0,3,8,2400,330,2006,0,98116,47.5797,-122.391,1980,4600,769900,9,5,2014,0,8,317,2620,0,1,1
4,3.5,4220,5817,2.0,0,0,3,9,2910,1310,2006,0,98065,47.5392,-121.862,4290,6637,633000,22,12,2014,0,8,1597,2347,0,1,0
3,2.5,1570,1433,3.0,0,0,3,8,1570,0,2010,0,98103,47.6858,-122.336,1570,2652,635000,12,5,2014,0,4,-137,1082,0,0,1
4,3.5,4670,6000,2.0,0,3,3,11,3820,850,2007,0,98027,47.5414,-121.994,4310,6000,1240000,25,7,2014,0,7,1330,1690,0,1,0
3,2.25,1370,1007,3.0,0,0,3,8,1330,40,2009,0,98107,47.6682,-122.361,1570,1635,524000,8,1,2015,0,6,-363,65,0,1,1
4,3.5,3273,5115,2.0,0,0,3,8,2671,602,2014,0,98055,47.4477,-122.204,2996,5100,485000,26,11,2014,0,0,1842,2104,0,1,0
3,4.0,3880,13095,2.0,0,3,3,11,3700,180,2009,0,98034,47.6996,-122.233,3880,10830,1030000,21,5,2014,0,5,9215,6950,0,1,0
3,3.5,1494,1262,3.0,0,0,3,8,1494,0,2011,0,98115,47.6826,-122.324,1494,1264,650000,24,10,2014,0,3,-232,-230,0,0,1
3,2.5,2930,5641,2.0,0,0,3,8,2930,0,2013,0,98052,47.71,-122.113,3300,5641,754842,1,10,2014,0,1,2711,2341,0,0,0
4,2.5,2598,5553,2.0,0,0,3,9,2598,0,2014,0,98092,47.3412,-122.178,2502,4900,428900,24,9,2014,0,0,2955,2398,0,0,0
3,2.5,2242,4995,2.0,0,0,3,8,2242,0,2011,0,98092,47.2595,-122.202,1798,4942,329900,23,6,2014,0,3,2753,3144,0,0,0
4,2.5,2830,5932,2.0,0,0,3,9,2830,0,2014,0,98199,47.6479,-122.408,2840,5593,1040000,18,12,2014,0,0,3102,2753,0,0,1
4,2.5,2710,6937,2.0,0,0,3,7,2710,0,2009,0,98065,47.5153,-121.871,2380,5866,544999,9,9,2014,0,5,4227,3486,0,0,0
4,2.75,2320,4344,2.0,0,0,3,8,2320,0,2012,0,98059,47.4862,-122.163,2310,3770,449950,29,5,2014,0,2,2024,1460,0,0,0
4,2.5,2720,7991,2.0,0,0,3,9,2720,0,2006,0,98133,47.7168,-122.331,1590,8611,635000,13,1,2015,0,9,5271,7021,0,0,1
3,1.75,1650,1180,3.0,0,0,3,8,1650,0,2014,0,98105,47.6638,-122.319,1650,1960,599000,3,11,2014,0,0,-470,310,0,0,1
3,3.25,1430,1348,2.0,0,0,3,8,1160,270,2008,0,98107,47.6743,-122.374,1160,1265,478000,3,11,2014,0,6,-82,105,0,1,1
4,2.5,2090,5040,2.0,0,0,3,9,2090,0,2014,0,98055,47.4797,-122.23,1430,12000,388000,29,9,2014,0,0,2950,10570,0,0,0
4,3.5,3660,4903,2.0,0,0,3,9,2760,900,2014,0,98034,47.7184,-122.156,3630,4992,809950,4,8,2014,0,0,1243,1362,0,1,0
4,3.5,4220,8417,3.0,0,0,3,10,4220,0,2012,0,98075,47.5869,-122.054,3730,8435,1060000,15,4,2015,0,3,4197,4705,0,0,0
2,2.5,1450,1213,2.0,0,0,3,9,1110,340,2015,0,98107,47.6692,-122.372,1620,1456,659000,22,4,2015,0,0,-237,-164,0,1,1
4,3.75,3460,6738,2.0,0,0,3,11,3460,0,2013,0,98059,47.506,-122.145,3340,6120,971971,26,6,2014,0,1,3278,2780,0,0,0
3,2.5,1350,874,3.0,0,0,3,8,1270,80,2006,0,98136,47.5491,-122.387,1350,886,389000,15,1,2015,0,9,-476,-464,0,1,1
4,2.75,3000,5470,2.0,0,0,3,8,3000,0,2005,0,98038,47.3613,-122.038,2420,4891,355000,8,7,2014,0,9,2470,2471,0,0,0
4,2.5,2950,10003,2.0,0,0,3,9,2950,0,2006,0,98059,47.489,-122.14,2790,9323,551500,8,12,2014,0,8,7053,6533,0,0,0
4,2.5,2530,5048,2.0,0,0,3,8,2530,0,2014,0,98038,47.3559,-122.063,2530,4359,417838,1,7,2014,0,0,2518,1829,0,0,0
4,4.5,4650,7660,2.0,0,0,3,11,3640,1010,2008,0,98004,47.6349,-122.198,1710,8400,1750000,14,7,2014,0,6,3010,6690,0,1,0
2,1.0,710,1131,2.0,0,0,4,7,710,0,1943,0,98102,47.6413,-122.329,1370,1173,399950,11,6,2014,0,71,421,-197,0,0,1
4,2.5,3050,8000,2.0,0,0,3,9,3050,0,2007,0,98028,47.7465,-122.231,1910,8000,740000,15,7,2014,0,7,4950,6090,0,0,0
3,2.5,1150,683,2.0,0,0,3,7,1150,0,2013,0,98027,47.5323,-122.071,1150,755,335000,23,2,2015,0,2,-467,-395,0,0,0
3,1.75,1370,1921,3.0,0,0,3,8,1370,0,2007,0,98103,47.6595,-122.351,1370,4000,667000,20,4,2015,0,8,551,2630,0,0,1
4,2.5,3540,7009,2.0,0,0,3,9,3540,0,2007,0,98033,47.6749,-122.176,2150,10290,920000,12,3,2015,0,8,3469,8140,0,0,0
3,2.5,1370,1350,2.0,0,0,3,7,1010,360,2007,0,98136,47.5534,-122.382,1450,6000,368000,11,5,2014,0,7,-20,4550,0,1,1
4,2.5,1714,3080,2.0,0,0,3,8,1714,0,2009,0,98055,47.429,-122.188,1714,3250,307000,10,7,2014,0,5,1366,1536,0,0,0
4,2.75,3650,4534,2.0,0,0,3,7,2940,710,2014,0,98028,47.7397,-122.224,2400,7682,550000,16,1,2015,0,1,884,5282,0,1,0
4,2.5,2990,6037,2.0,0,0,3,9,2990,0,2013,0,98045,47.4766,-121.735,2990,5992,594491,13,1,2015,0,2,3047,3002,0,0,0
4,2.5,3284,6516,2.0,0,0,3,8,3284,0,2014,0,98092,47.3393,-122.181,2555,5008,460458,29,9,2014,0,0,3232,2453,0,0,0
4,2.25,3550,13900,1.0,0,0,3,8,1830,1720,2010,0,98006,47.5681,-122.127,2770,12200,859000,24,6,2014,0,4,10350,9430,0,1,0
3,3.0,1860,2875,2.0,0,0,3,8,1710,150,2009,0,98126,47.5511,-122.373,1350,4830,399950,11,12,2014,0,5,1015,3480,0,1,1
3,3.25,1720,1977,2.0,0,0,3,8,1360,360,2007,0,98122,47.6127,-122.299,1720,3420,547500,1,4,2015,0,8,257,1700,0,1,1
3,2.5,2540,4775,2.0,0,0,3,7,2540,0,2006,0,98042,47.3341,-122.052,2270,5000,310000,23,6,2014,0,8,2235,2730,0,0,0
4,2.75,3270,12880,2.0,0,0,3,9,3270,0,2014,0,98033,47.6679,-122.172,2420,7505,939000,2,6,2014,0,0,9610,5085,0,0,0
2,2.5,980,1021,3.0,0,0,3,8,980,0,2008,0,98117,47.6844,-122.387,980,1023,329900,14,10,2014,0,6,41,43,0,0,1
3,2.5,1150,1193,2.0,0,0,3,8,1020,130,2006,0,98107,47.6684,-122.365,1450,1640,436000,22,12,2014,0,8,43,190,0,1,1
3,2.5,1820,1855,2.0,0,0,3,8,1570,250,2008,0,98166,47.4643,-122.346,1470,6900,320000,16,7,2014,0,6,35,5430,0,1,1
3,2.5,1580,3825,2.0,0,0,3,8,1580,0,2011,0,98126,47.5458,-122.369,1380,1500,375000,26,9,2014,0,3,2245,120,0,0,1
3,2.0,1460,3696,2.0,0,0,3,7,1460,0,2010,0,98053,47.6861,-122.013,1720,3631,392137,24,3,2015,0,5,2236,1911,0,0,0
4,2.5,2900,4950,2.0,0,0,3,8,2900,0,2004,0,98028,47.7717,-122.236,2590,4950,520000,26,8,2014,0,10,2050,2360,0,0,0
5,2.75,2620,6389,2.0,0,0,3,9,2620,0,2007,0,98028,47.77,-122.236,2620,4504,535000,16,10,2014,0,7,3769,1884,0,0,0
2,2.5,1340,999,2.0,0,0,3,8,940,400,2008,0,98116,47.5655,-122.386,1470,1436,407000,24,3,2015,0,7,-341,-34,0,1,1
4,3.25,3266,5398,2.0,0,0,3,8,3266,0,2014,0,98023,47.2975,-122.35,3087,5152,424950,25,11,2014,0,0,2132,2065,0,0,0
2,1.5,1076,1060,3.0,0,0,3,7,1076,0,2006,0,98125,47.7167,-122.298,1076,1060,290000,11,8,2014,0,8,-16,-16,0,0,1
3,3.25,1680,1478,2.0,0,0,3,8,1360,320,2009,0,98126,47.5674,-122.369,1530,2753,399000,29,10,2014,0,5,-202,1223,0,1,1
3,2.5,1930,1348,2.0,0,0,3,8,1300,630,2005,0,98199,47.6513,-122.384,1630,6000,439990,3,7,2014,0,9,-582,4370,0,1,1
4,2.5,2880,3091,2.0,0,0,3,9,1940,940,2014,0,98144,47.5711,-122.286,1560,4080,635000,22,2,2015,0,1,211,2520,0,1,1
4,2.25,2240,5000,2.0,0,0,3,8,2240,0,2013,0,98074,47.6212,-122.058,1760,7500,635000,17,7,2014,0,1,2760,5740,0,0,0
3,2.5,2594,4455,2.0,0,0,3,8,2594,0,2012,0,98001,47.3054,-122.276,2981,4950,351000,29,4,2015,0,3,1861,1969,0,0,0
2,1.5,1210,1232,3.0,0,0,3,8,1210,0,2007,0,98107,47.6712,-122.39,1330,1174,437500,22,8,2014,0,7,22,-156,0,0,1
4,3.5,3760,5000,2.0,0,0,3,9,2860,900,2014,0,98117,47.6826,-122.394,1340,5000,919204,30,5,2014,0,0,1240,3660,0,1,1
4,2.5,3600,6055,2.0,0,0,3,9,3600,0,2014,0,98052,47.7053,-122.126,3590,6050,923990,8,9,2014,0,0,2455,2460,0,0,0
4,2.5,2050,2772,2.0,0,0,3,8,2050,0,2012,0,98029,47.5421,-122.011,2050,2934,639888,24,6,2014,0,2,722,884,0,0,0
3,3.25,1510,2064,2.0,0,0,3,8,1220,290,2008,0,98109,47.6398,-122.345,1670,2594,675000,14,1,2015,0,7,554,924,0,1,1
4,2.5,2580,3909,2.0,0,0,3,8,2580,0,2013,0,98033,47.6852,-122.21,1820,5772,899900,10,6,2014,0,1,1329,3952,0,0,0
3,2.5,1670,4020,2.0,0,0,3,7,1670,0,2009,0,98118,47.53,-122.268,1670,4020,252000,30,1,2015,0,6,2350,2350,0,0,1
4,2.5,3190,10034,2.0,0,0,3,9,3190,0,2007,0,98052,47.6379,-122.111,2110,9300,925000,17,3,2015,0,8,6844,7190,0,0,0
3,2.5,1280,1920,3.0,0,0,3,8,1280,0,2009,0,98105,47.6621,-122.324,1450,1900,552000,29,10,2014,0,5,640,450,0,0,1
4,2.5,2718,6197,2.0,0,0,3,8,2718,0,2006,0,98092,47.3255,-122.164,2667,5000,388500,7,4,2015,0,9,3479,2333,0,0,0
2,2.0,1370,1878,3.0,0,0,3,8,1370,0,2004,0,98107,47.6721,-122.387,1280,1878,548000,29,8,2014,0,10,508,598,0,0,1
3,2.5,1794,4769,2.0,0,0,3,7,1794,0,2005,0,98001,47.3052,-122.283,3557,4807,254950,22,9,2014,0,9,2975,1250,0,0,0
3,2.5,2160,1912,2.0,0,0,3,9,1970,190,2014,0,98118,47.5642,-122.292,1810,2653,629000,30,9,2014,0,0,-248,843,0,1,1
4,2.5,2180,7204,2.0,0,0,3,8,2180,0,2014,0,98133,47.7221,-122.352,1500,7650,734000,3,3,2015,0,1,5024,6150,0,0,1
3,2.25,1490,1294,2.0,0,0,3,7,1220,270,2010,0,98106,47.5569,-122.363,1490,1283,309000,18,6,2014,0,4,-196,-207,0,1,1
3,2.5,2950,10254,2.0,0,0,3,9,2950,0,2006,0,98059,47.4888,-122.14,2800,9323,554950,3,7,2014,0,8,7304,6523,0,0,0
4,2.5,2700,5150,2.0,0,0,3,9,2700,0,2007,0,98059,47.5071,-122.148,3160,7620,550000,5,6,2014,0,7,2450,4460,0,0,0
4,3.5,3130,5000,3.0,0,0,3,10,3130,0,2014,0,98116,47.5656,-122.403,1950,5152,1010000,11,8,2014,0,0,1870,3202,0,0,1
3,2.0,3620,14250,2.0,0,0,3,8,3220,400,2007,0,98040,47.5767,-122.225,2370,14250,1580000,28,10,2014,0,7,10630,11880,0,1,0
5,2.75,2481,4045,2.0,0,0,3,8,2481,0,2014,0,98001,47.2602,-122.284,2363,4175,309000,3,6,2014,0,0,1564,1812,0,0,0
3,2.5,1730,3600,2.0,0,0,3,8,1730,0,2014,0,98146,47.5019,-122.34,2030,3600,328423,25,6,2014,0,0,1870,1570,0,0,1
3,1.5,1420,1192,2.0,0,0,3,8,1140,280,2008,0,98144,47.5881,-122.304,1340,1213,345000,23,6,2014,0,6,-228,-127,0,1,1
5,3.5,3160,5175,2.0,0,0,3,9,3160,0,2014,0,98011,47.755,-122.216,2100,9351,660000,21,11,2014,0,0,2015,7251,0,0,0
3,3.25,1320,1327,2.0,0,0,3,8,1040,280,2008,0,98199,47.6506,-122.383,1440,1263,385000,2,5,2014,0,6,7,-177,0,1,1
2,2.25,1010,1107,2.0,0,0,3,8,710,300,2006,0,98119,47.6363,-122.371,1140,1531,459000,18,3,2015,0,9,97,391,0,1,1
3,2.5,1870,4046,2.0,0,0,3,7,1870,0,2007,0,98042,47.342,-122.059,2130,4800,248000,14,1,2015,0,8,2176,2670,0,0,0
4,3.5,5220,15411,2.0,0,3,3,11,3550,1670,2006,0,98075,47.592,-122.085,3110,14124,1480000,20,8,2014,0,8,10191,11014,0,1,0
4,2.5,2260,5824,2.0,0,0,3,8,2260,0,2011,0,98038,47.3496,-122.042,2240,5561,379000,1,8,2014,0,3,3564,3321,0,0,0
5,4.5,4340,5722,3.0,0,4,3,10,4340,0,2010,0,98107,47.6715,-122.406,1770,5250,2950000,4,3,2015,0,5,1382,3480,0,0,1
2,2.25,1620,1841,2.0,0,0,3,8,1540,80,2004,0,98029,47.5483,-122.004,1530,1831,395000,26,9,2014,0,10,221,301,0,1,0
3,2.5,2280,2289,2.0,0,0,3,8,1880,400,2006,0,98027,47.5375,-122.073,2280,2425,535000,7,5,2014,0,8,9,145,0,1,0
5,3.5,3400,9804,2.0,0,0,3,9,2550,850,2008,0,98118,47.543,-122.266,2380,7440,970000,22,10,2014,0,6,6404,5060,0,1,1
2,1.5,830,1020,2.0,0,0,3,7,830,0,2006,0,98106,47.5604,-122.363,830,1379,205000,1,2,2015,0,9,190,549,0,0,1
4,2.5,2310,7384,2.0,0,0,3,8,2310,0,2010,0,98042,47.3737,-122.165,2310,7800,310000,15,10,2014,0,4,5074,5490,0,0,0
2,1.5,830,1858,2.0,0,0,3,7,830,0,2005,0,98144,47.5828,-122.314,1480,3030,334500,2,7,2014,0,9,1028,1550,0,0,1
5,3.25,4130,7197,2.0,0,0,3,10,4130,0,2012,0,98074,47.6022,-122.06,3730,7202,995000,28,8,2014,0,2,3067,3472,0,0,0
4,3.0,2050,4000,2.0,0,0,3,8,2050,0,2014,0,98001,47.3525,-122.275,2050,4000,370228,1,4,2015,0,1,1950,1950,0,0,0
4,2.5,2050,4953,2.0,0,0,3,9,2050,0,2014,0,98038,47.3448,-122.024,2340,6175,383000,4,3,2015,0,1,2903,3835,0,0,0
3,2.5,1600,2610,2.0,0,0,3,8,1600,0,2005,0,98027,47.5344,-122.068,1445,1288,384500,4,8,2014,0,9,1010,-157,0,0,0
5,2.5,3190,8160,2.0,0,0,3,9,3190,0,2014,0,98177,47.7246,-122.363,1650,8160,865000,18,7,2014,0,0,4970,6510,0,0,1
4,3.75,3860,5474,2.5,0,0,3,10,3860,0,2007,0,98029,47.5396,-121.995,3040,5474,1050000,22,5,2014,0,7,1614,2434,0,0,0
4,2.5,2040,5616,2.0,0,0,3,8,2040,0,2012,0,98028,47.7737,-122.238,2380,4737,502000,13,5,2014,0,2,3576,2357,0,0,0
4,3.5,3845,8400,2.0,0,0,3,10,3845,0,2013,0,98004,47.6354,-122.198,1710,8400,1750000,24,9,2014,0,1,4555,6690,0,0,0
4,2.5,2650,6875,2.0,0,0,3,8,2650,0,2014,0,98059,47.479,-122.124,2650,5831,569995,12,9,2014,0,0,4225,3181,0,0,0
3,2.5,2430,5400,2.0,0,0,3,8,2430,0,2007,0,98074,47.6062,-122.057,2640,11990,550000,30,12,2014,0,7,2970,9350,0,0,0
3,3.5,2876,5086,2.0,0,0,3,8,2360,516,2007,0,98072,47.7511,-122.173,2390,4419,525000,13,5,2014,0,7,2210,2029,0,1,0
4,3.5,2550,8698,2.0,0,0,3,7,2550,0,2007,0,98065,47.5216,-121.869,2430,5519,516000,11,6,2014,0,7,6148,3089,0,0,0
4,2.5,2730,4526,2.0,0,0,3,7,2730,0,2009,0,98059,47.491,-122.153,2190,4572,440000,28,4,2015,0,6,1796,2382,0,0,0
3,2.5,1780,1729,2.0,0,0,3,8,1080,700,2008,0,98103,47.6594,-122.355,1780,1741,660000,14,4,2015,0,7,-51,-39,0,1,1
3,2.5,1880,5000,2.0,0,0,3,7,1880,0,2010,0,98042,47.3359,-122.054,2260,5000,261950,9,12,2014,0,4,3120,2740,0,0,0
5,3.75,3090,4943,2.0,0,0,3,10,3090,0,2010,0,98058,47.4594,-122.133,3191,5561,551000,27,8,2014,0,4,1853,2370,0,0,0
3,3.5,2460,14155,2.0,0,0,3,8,1900,560,2014,0,98155,47.7743,-122.279,2440,14080,665000,25,2,2015,0,1,11695,11640,0,1,1
4,3.5,2910,5260,2.0,0,0,3,9,2910,0,2012,0,98065,47.5168,-121.883,2910,5260,610000,4,6,2014,0,2,2350,2350,0,0,0
4,3.5,2910,5260,2.0,0,0,3,9,2910,0,2012,0,98065,47.5168,-121.883,2910,5260,645000,19,2,2015,0,3,2350,2350,0,0,0
3,1.75,1930,6360,1.0,0,0,3,9,1930,0,2013,0,98065,47.5181,-121.885,2770,6373,536751,18,6,2014,0,1,4430,3603,0,0,0
3,2.25,1413,3403,2.0,0,0,3,8,1413,0,2009,0,98031,47.4196,-122.193,1763,3719,260000,26,4,2015,0,6,1990,1956,0,0,0
3,3.25,4030,6300,2.0,0,0,3,10,3630,400,2006,0,98105,47.6664,-122.276,1660,6300,1310000,21,1,2015,0,9,2270,4640,0,1,1
4,3.25,2880,5929,2.5,0,0,3,8,2880,0,2014,0,98023,47.2752,-122.349,2880,5846,429900,20,2,2015,0,1,3049,2966,0,0,0
4,2.75,2360,15100,1.0,0,0,3,8,2360,0,2014,0,98146,47.5117,-122.365,1440,13346,535000,20,8,2014,0,0,12740,11906,0,0,1
2,1.75,1070,1276,3.0,0,0,3,8,1070,0,2006,0,98107,47.6719,-122.39,1290,2057,462550,14,4,2015,0,9,206,767,0,0,1
3,3.25,1460,1367,3.0,0,0,3,8,1460,0,2008,0,98103,47.6485,-122.334,1310,1191,602000,10,3,2015,0,7,-93,-119,0,0,1
4,2.75,3800,9606,2.0,0,0,3,9,3800,0,2008,0,98011,47.7368,-122.208,3400,9677,730000,8,12,2014,0,6,5806,6277,0,0,0
2,1.5,1190,801,3.0,0,0,3,8,1190,0,2010,0,98106,47.5212,-122.358,1190,810,300500,23,4,2015,0,5,-389,-380,0,0,1
5,2.5,3200,6455,2.0,0,0,3,9,3200,0,2009,0,98065,47.5446,-121.862,3290,7924,675000,16,5,2014,0,5,3255,4634,0,0,0
3,2.25,1970,2377,2.0,0,0,3,8,1680,290,2008,0,98108,47.5631,-122.297,1690,1936,415000,20,5,2014,0,6,407,246,0,1,1
3,2.5,2830,5831,2.0,0,0,3,9,2830,0,2010,0,98011,47.7744,-122.224,2830,6064,614000,17,11,2014,0,4,3001,3234,0,0,0
4,2.5,2630,5701,2.0,0,0,3,7,2630,0,2010,0,98042,47.375,-122.16,2770,5939,385000,4,12,2014,0,4,3071,3169,0,0,0
4,2.75,2720,4613,2.0,0,0,3,9,2720,0,2005,0,98028,47.7352,-122.223,2830,4836,594000,25,6,2014,0,9,1893,2006,0,0,0
4,2.75,3160,8097,2.0,0,0,3,9,3160,0,2014,0,98033,47.6709,-122.166,2200,8097,860000,20,5,2014,0,0,4937,5897,0,0,0
4,4.0,3770,8899,2.0,0,0,3,10,2940,830,2006,0,98074,47.6476,-122.079,3300,8308,1100000,9,9,2014,0,8,5129,5008,0,1,0
4,2.75,3500,6226,2.0,0,0,3,9,3500,0,2004,0,98053,47.6846,-122.045,3480,7222,775000,24,10,2014,0,10,2726,3742,0,0,0
5,2.75,2710,4685,2.0,0,0,3,8,2710,0,2014,0,98038,47.3555,-122.062,2710,4449,430760,6,8,2014,0,0,1975,1739,0,0,0
2,2.5,2170,6361,1.0,0,2,3,8,2170,0,2009,0,98053,47.7109,-122.017,2310,7419,755000,27,4,2015,0,6,4191,5109,0,0,0
2,2.25,1540,958,3.0,0,0,3,9,1540,0,2007,0,98122,47.6179,-122.318,1410,958,640000,19,5,2014,0,7,-582,-452,0,0,1
3,3.25,1876,1531,3.0,0,0,3,9,1876,0,2009,0,98115,47.6864,-122.265,1876,1533,613500,1,5,2015,0,6,-345,-343,0,0,1
4,2.5,3148,9612,2.0,0,3,3,9,3148,0,2014,0,98198,47.3994,-122.311,3000,11475,550000,4,3,2015,0,1,6464,8475,0,0,1
4,3.25,3240,4852,2.0,0,0,3,9,3240,0,2010,0,98053,47.695,-122.022,3320,5318,789500,8,10,2014,0,4,1612,1998,0,0,0
5,3.5,3340,5000,2.0,0,0,3,8,2580,760,2012,0,98065,47.5168,-121.871,3420,5000,592000,10,7,2014,0,2,1660,1580,0,1,0
4,2.5,2413,5701,2.0,0,0,3,8,2413,0,2014,0,98042,47.3731,-122.159,2380,5725,454950,10,4,2015,0,1,3288,3345,0,0,0
4,2.5,2500,4500,2.0,0,0,3,7,2500,0,2010,0,98059,47.4928,-122.149,2230,4500,475000,13,4,2015,0,5,2000,2270,0,0,0
2,1.75,1180,904,2.0,0,0,3,10,780,400,2014,0,98102,47.6396,-122.329,1380,3610,659000,29,12,2014,0,0,-276,2230,0,1,1
4,2.5,2890,5801,2.0,0,0,3,9,2890,0,2005,0,98028,47.7349,-122.238,2890,6286,570000,24,11,2014,0,9,2911,3396,0,0,0
5,3.0,2230,6551,1.0,0,0,3,7,1330,900,2014,0,98168,47.487,-122.32,2230,9476,347500,26,2,2015,0,1,4321,7246,0,1,1
4,2.5,1767,4500,2.0,0,0,3,8,1767,0,2006,0,98001,47.2607,-122.25,1949,4636,205000,2,4,2015,0,9,2733,2687,0,0,0
3,3.25,1450,1468,2.0,0,0,3,8,1100,350,2009,0,98126,47.5664,-122.37,1450,1478,380000,3,9,2014,0,5,18,28,0,1,1
5,2.75,2930,7663,2.0,0,0,3,9,2930,0,2013,0,98056,47.5308,-122.184,2750,10335,718000,3,10,2014,0,1,4733,7585,0,0,0
5,2.75,2710,4136,2.0,0,0,3,8,2710,0,2014,0,98059,47.4786,-122.123,2590,4136,515805,24,7,2014,0,0,1426,1546,0,0,0
4,3.25,3600,18645,2.0,0,1,3,10,3000,600,2013,0,98059,47.5294,-122.154,3970,10957,1030000,14,7,2014,0,1,15045,6987,0,1,0
3,2.5,1800,3265,2.0,0,0,3,8,1800,0,2014,0,98065,47.5338,-121.841,1800,3663,437718,13,11,2014,0,0,1465,1863,0,0,0
4,2.5,2290,5515,2.0,0,0,3,8,2290,0,2006,0,98106,47.5518,-122.357,1380,5515,450000,14,8,2014,0,8,3225,4135,0,0,1
3,2.5,1510,1178,2.0,0,0,3,8,1060,450,2007,0,98122,47.6181,-122.301,1510,1210,515000,28,10,2014,0,7,-332,-300,0,1,1
2,2.5,1090,13444,2.0,0,0,3,7,1090,0,2007,0,98198,47.4166,-122.319,1380,6000,204000,2,3,2015,0,8,12354,4620,0,0,1
3,2.0,1270,1323,3.0,0,0,3,8,1270,0,2006,0,98103,47.6934,-122.342,1330,1323,360000,23,5,2014,0,8,53,-7,0,0,1
3,2.25,1540,1005,3.0,0,0,3,8,1540,0,2008,0,98103,47.6827,-122.346,1510,1501,550000,3,12,2014,0,6,-535,-9,0,0,1
3,2.5,2930,6050,2.0,0,0,3,9,2930,0,2008,0,98065,47.5151,-121.883,2760,5765,650880,29,5,2014,0,6,3120,3005,0,0,0
5,3.75,4360,8504,2.0,0,4,3,10,3530,830,2014,0,98033,47.6936,-122.19,2680,9000,1790000,25,2,2015,0,1,4144,6320,0,1,0
4,3.5,3640,4983,2.0,0,3,3,9,2790,850,2014,0,98075,47.5619,-122.027,3270,14700,895900,25,2,2015,0,1,1343,11430,0,1,0
4,2.5,2430,4747,2.0,0,0,3,8,2430,0,2008,0,98027,47.5285,-122.031,1930,7200,585000,6,6,2014,0,6,2317,5270,0,0,0
3,2.25,1520,1464,2.0,0,0,3,8,1240,280,2010,0,98126,47.543,-122.375,1710,1464,380000,8,5,2015,0,5,-56,-246,0,1,1
5,2.75,2730,5820,2.0,0,0,3,8,2730,0,2014,0,98059,47.4856,-122.154,2730,5700,565997,18,11,2014,0,0,3090,2970,0,0,0
3,3.0,2440,2076,2.0,0,0,3,8,1930,510,2006,0,98126,47.5476,-122.37,2440,2310,459000,4,5,2015,0,9,-364,-130,0,1,1
3,3.75,1580,1303,2.0,0,0,3,8,1340,240,2010,0,98144,47.5875,-122.315,1560,1294,550000,21,4,2015,0,5,-277,-266,0,1,1
3,2.25,1420,983,3.0,0,0,3,8,1420,0,2006,0,98103,47.6533,-122.346,1530,1280,500000,25,7,2014,0,8,-437,-250,0,0,1
5,3.25,2820,3275,2.0,0,0,3,8,2230,590,2006,0,98118,47.5339,-122.284,2610,3275,461500,27,3,2015,0,9,455,665,0,1,1
4,5.5,5060,10320,2.0,0,0,3,11,5060,0,2008,0,98004,47.6245,-122.21,3010,10080,2150000,22,5,2014,0,6,5260,7070,0,0,0
4,2.5,2650,5000,2.0,0,0,3,8,2650,0,2007,0,98116,47.5605,-122.396,1110,6250,790000,21,4,2015,0,8,2350,5140,0,0,1
3,2.25,1490,1212,2.0,0,0,3,9,1040,450,2011,0,98112,47.6226,-122.313,1490,1337,735000,27,6,2014,0,3,-278,-153,0,1,1
4,2.5,3060,7710,2.0,0,0,3,9,3060,0,2009,0,98059,47.4828,-122.136,3040,7840,588000,30,3,2015,0,6,4650,4800,0,0,0
3,3.25,3240,4185,2.0,0,0,3,8,2770,470,2011,0,98075,47.5794,-122.03,2660,4692,724500,13,5,2015,0,4,945,2032,0,1,0
3,2.75,2820,5348,2.0,0,0,3,9,2820,0,2008,0,98052,47.7073,-122.118,3140,5640,749000,9,7,2014,0,6,2528,2500,0,0,0
5,3.5,4140,7642,2.0,0,0,3,8,4140,0,2003,0,98075,47.591,-122.008,3330,6953,720000,18,9,2014,0,11,3502,3623,0,0,0
2,1.5,982,846,2.0,0,0,3,8,806,176,2006,0,98133,47.7034,-122.345,1010,3844,250000,11,6,2014,0,8,-136,2834,0,1,1
3,2.75,2460,3600,2.0,0,0,3,9,2460,0,2007,0,98029,47.5409,-121.994,2570,3600,790000,27,3,2015,0,8,1140,1030,0,0,0
4,2.5,2547,4800,2.0,0,0,3,9,2547,0,2014,0,98092,47.2592,-122.194,2598,4800,392440,21,1,2015,0,1,2253,2202,0,0,0
4,2.25,1834,7460,2.0,0,0,3,8,1834,0,2012,0,98042,47.3568,-122.163,1979,9008,280000,25,7,2014,0,2,5626,7029,0,0,0
4,4.5,3130,5126,3.0,0,0,3,10,2450,680,2014,0,98112,47.6239,-122.29,2540,7784,1330000,13,11,2014,0,0,1996,5244,0,1,1
4,2.5,2730,4847,2.0,0,0,3,9,2730,0,2008,0,98126,47.549,-122.374,1250,4840,649000,17,12,2014,0,6,2117,3590,0,0,1
2,2.5,1380,1329,2.0,0,0,3,8,1050,330,2008,0,98117,47.6903,-122.37,1360,3750,457000,31,10,2014,0,6,-51,2390,0,1,1
4,4.25,4700,10800,2.0,0,1,3,11,3910,790,2002,0,98033,47.6882,-122.214,2370,7680,2230000,23,3,2015,0,13,6100,5310,0,1,0
3,3.0,2330,4284,2.0,0,0,3,9,1920,410,2004,0,98108,47.5547,-122.308,2330,3709,453000,23,8,2014,0,10,1954,1379,0,1,1
3,2.5,1730,3600,2.0,0,0,3,8,1730,0,2014,0,98146,47.5014,-122.34,2030,3600,329780,22,9,2014,0,0,1870,1570,0,0,1
2,2.5,2350,2390,3.0,0,2,3,10,2000,350,2007,0,98144,47.5999,-122.286,1950,2390,1050000,12,11,2014,0,7,40,440,0,1,1
5,4.5,4000,6713,2.0,0,0,3,9,4000,0,2015,0,98024,47.5254,-121.886,3690,6600,771005,5,5,2015,0,0,2713,2910,0,0,0
3,2.5,3350,7752,1.0,0,0,3,9,2180,1170,2009,0,98008,47.6263,-122.099,2570,7988,1300000,25,7,2014,0,5,4402,5418,0,1,0
3,3.25,1530,1612,3.0,0,0,3,8,1530,0,2006,0,98107,47.6706,-122.378,1530,1611,607500,19,6,2014,0,8,82,81,0,0,1
2,2.25,1610,1968,2.0,0,0,4,7,1610,0,1979,0,98056,47.5184,-122.196,1950,1968,278000,16,1,2015,0,36,358,18,0,0,0
4,2.75,2620,6178,2.0,0,0,3,8,2620,0,2013,0,98045,47.4823,-121.771,2790,6538,475000,2,7,2014,0,1,3558,3748,0,0,0
3,2.0,1300,1920,2.0,0,0,3,8,850,450,2006,0,98126,47.5183,-122.376,1300,1344,270000,14,8,2014,0,8,620,44,0,1,1
4,3.5,3590,5334,2.0,0,2,3,9,3140,450,2006,0,98115,47.6763,-122.267,2100,6250,1300000,23,4,2015,0,9,1744,4150,0,1,1
4,2.5,2490,5647,2.0,0,0,3,8,2490,0,2014,0,98052,47.7043,-122.114,2970,5450,778983,11,8,2014,0,0,3157,2480,0,0,0
3,2.5,1320,1780,2.0,0,0,3,7,880,440,2005,0,98118,47.528,-122.269,3040,6000,221000,22,10,2014,0,9,460,2960,0,1,1
4,2.25,1800,2752,2.0,0,0,3,8,1800,0,2014,0,98106,47.5165,-122.346,1800,2752,338800,21,8,2014,0,0,952,952,0,0,1
5,1.5,3360,5225,2.0,0,0,3,9,3360,0,2014,0,98074,47.6072,-122.053,3230,5368,834995,4,8,2014,0,0,1865,2138,0,0,0
4,2.5,3220,9328,2.0,0,0,3,8,3220,0,2006,0,98019,47.7273,-121.958,3020,9300,550000,1,5,2015,0,9,6108,6280,0,0,0
3,3.5,2514,1559,2.0,0,0,3,8,2024,490,2007,0,98034,47.7044,-122.209,2090,10454,575000,31,10,2014,0,7,-955,8364,0,1,0
4,2.75,3130,9711,2.0,0,0,3,9,3130,0,2014,0,98059,47.4823,-122.124,1570,10500,649000,23,9,2014,0,0,6581,8930,0,0,0
4,2.5,2720,4738,2.0,0,0,3,8,2720,0,2012,0,98065,47.515,-121.869,2590,5740,545000,30,5,2014,0,2,2018,3150,0,0,0
2,2.25,1390,916,2.0,0,0,3,8,1165,225,2007,0,98122,47.6168,-122.314,1415,1488,625000,20,11,2014,0,7,-474,73,0,1,1
3,2.5,2134,1984,2.5,0,0,3,8,2134,0,2008,0,98027,47.5402,-122.027,2170,1984,611000,16,5,2014,0,6,-150,-186,0,0,0
3,2.5,1741,5701,2.0,0,0,3,8,1741,0,2012,0,98030,47.379,-122.184,2002,5700,300000,17,3,2015,0,3,3960,3698,0,0,0
3,2.5,2560,5238,2.0,0,0,3,8,2560,0,2001,0,98053,47.6887,-122.04,2560,5185,577000,29,12,2014,0,13,2678,2625,0,0,0
4,2.5,2220,3561,2.0,0,0,3,8,2220,0,2014,0,98038,47.3561,-122.063,2530,4449,349990,20,10,2014,0,0,1341,1919,0,0,0
3,2.5,1910,4363,2.0,0,0,3,9,1910,0,2006,0,98029,47.5482,-121.996,1890,3732,650000,14,7,2014,0,8,2453,1842,0,0,0
2,1.5,980,853,2.0,0,0,3,7,820,160,2009,0,98144,47.5925,-122.295,1130,1270,378000,28,3,2015,0,6,-127,140,0,1,1
3,2.5,1950,4197,2.0,0,0,3,7,1950,0,2013,0,98042,47.3613,-122.081,2300,4178,313200,5,2,2015,0,2,2247,1878,0,0,0
2,1.5,1110,986,2.0,0,0,3,7,950,160,2009,0,98118,47.5427,-122.272,1110,3515,252500,6,5,2015,0,6,-124,2405,0,1,1
3,2.5,1250,1150,2.0,0,0,3,8,1080,170,2009,0,98106,47.5582,-122.363,1250,1150,308000,5,3,2015,0,6,-100,-100,0,1,1
4,2.5,3310,5404,2.0,0,0,3,9,3310,0,2004,0,98052,47.6635,-122.083,2600,4730,803100,15,5,2014,0,10,2094,2130,0,0,0
4,2.5,2020,5501,2.0,0,0,3,7,2020,0,2010,0,98059,47.4937,-122.15,2020,5494,415000,18,6,2014,0,4,3481,3474,0,0,0
4,3.5,3310,4850,2.0,0,0,3,9,3310,0,2010,0,98053,47.6954,-122.022,3320,5955,785000,14,8,2014,0,4,1540,2635,0,0,0
4,2.5,2798,4473,2.0,0,0,3,9,2798,0,2012,0,98055,47.4295,-122.205,2358,4593,499950,28,5,2014,0,2,1675,2235,0,0,0
4,2.5,1847,8000,2.0,0,0,3,7,1847,0,2008,0,98001,47.2874,-122.257,1767,8000,216000,17,3,2015,0,7,6153,6233,0,0,0
4,2.5,2420,4981,2.0,0,0,3,9,2420,0,2009,0,98038,47.3785,-122.023,2420,5000,380000,26,2,2015,0,6,2561,2580,0,0,0
4,2.5,2020,3600,2.0,0,0,3,7,2020,0,2012,0,98038,47.3535,-122.017,2210,3800,345000,6,11,2014,0,2,1580,1590,0,0,0
4,2.5,2400,6811,2.0,0,0,3,8,2400,0,2007,0,98059,47.4959,-122.15,2710,5314,456500,4,11,2014,0,7,4411,2604,0,0,0
3,2.5,1760,5390,1.0,0,0,3,8,1760,0,2014,0,98038,47.3482,-122.042,2310,5117,382495,4,11,2014,0,0,3630,2807,0,0,0
4,2.5,2110,4178,2.0,0,0,3,7,2110,0,2013,0,98042,47.3612,-122.081,2300,4142,324950,6,3,2015,0,2,2068,1842,0,0,0
4,2.5,2692,8392,2.0,0,0,3,9,2692,0,2014,0,98030,47.3519,-122.197,2574,14446,436472,11,8,2014,0,0,5700,11872,0,0,0
3,2.25,1490,4522,2.0,0,0,3,7,1490,0,2009,0,98028,47.7611,-122.233,1580,4667,365250,30,5,2014,0,5,3032,3087,0,0,0
5,3.25,3960,6352,2.0,0,0,3,10,3960,0,2014,0,98075,47.5806,-122.055,2930,9875,919990,24,3,2015,0,1,2392,6945,0,0,0
4,2.5,1740,4642,2.0,0,0,3,7,1740,0,2012,0,98042,47.3686,-122.117,1950,4642,316475,29,4,2015,0,3,2902,2692,0,0,0
4,2.5,1940,4517,1.0,0,0,3,8,1190,750,2010,0,98028,47.776,-122.26,1910,10410,425000,24,3,2015,0,5,2577,8500,0,1,0
2,1.0,970,3279,2.0,0,0,3,7,790,180,2007,0,98136,47.5469,-122.383,1150,1351,302860,11,3,2015,0,8,2309,201,0,1,1
3,2.5,1852,4000,2.0,0,0,3,7,1852,0,2014,0,98002,47.3455,-122.21,2166,4000,298000,22,7,2014,0,0,2148,1834,0,0,0
4,4.0,5635,9695,2.0,0,3,3,10,4360,1275,2011,0,98003,47.3389,-122.334,3726,9765,950000,1,12,2014,0,3,4060,6039,0,1,0
3,2.5,1520,3041,2.0,0,0,3,7,1520,0,2009,0,98059,47.4874,-122.152,1820,3229,333000,21,11,2014,0,5,1521,1409,0,0,0
3,2.5,2099,4275,2.0,0,0,3,7,2099,0,2010,0,98002,47.3521,-122.211,2099,4275,289950,5,3,2015,0,5,2176,2176,0,0,0
3,2.25,1250,811,3.0,0,0,3,8,1250,0,2014,0,98136,47.5419,-122.388,1250,1232,419950,6,5,2015,0,1,-439,-18,0,0,1
2,1.5,1090,1183,3.0,0,0,3,8,1090,0,2008,0,98103,47.6974,-122.349,1110,1384,306000,15,7,2014,0,6,93,274,0,0,1
4,2.5,3216,5902,2.0,0,0,3,9,3216,0,2014,0,98030,47.3425,-122.179,2815,4916,498445,29,11,2014,0,0,2686,2101,0,0,0
4,2.5,2970,4400,2.0,0,0,3,8,2970,0,2014,0,98052,47.705,-122.114,3010,4892,775950,20,6,2014,0,0,1430,1882,0,0,0
3,2.5,2610,6405,2.0,0,0,3,8,2610,0,2001,0,98065,47.5373,-121.874,2580,6285,605000,3,7,2014,0,13,3795,3705,0,0,0
2,1.75,1340,1368,2.0,0,0,3,7,1060,280,2006,0,98122,47.618,-122.311,2480,1707,520000,9,9,2014,0,8,28,-773,0,1,1
4,2.75,3300,4987,2.0,0,0,3,9,3300,0,2014,0,98074,47.6175,-122.056,3520,5453,849990,28,10,2014,0,0,1687,1933,0,0,0
3,2.0,1630,7599,1.0,0,0,3,10,1630,0,2006,0,98117,47.6981,-122.376,2030,7599,767450,4,6,2014,0,8,5969,5569,0,0,1
3,2.25,1590,929,2.0,0,0,3,9,1060,530,2014,0,98122,47.6172,-122.31,1510,1193,665000,8,8,2014,0,0,-661,-317,0,1,1
2,2.75,1310,1268,3.5,0,0,3,8,1310,0,2007,0,98103,47.6534,-122.355,1350,1288,525000,18,9,2014,0,7,-42,-62,0,0,1
4,3.5,3600,5697,2.0,0,0,3,9,2940,660,2014,0,98075,47.5755,-122.071,3490,5911,870515,22,7,2014,0,0,2097,2421,0,1,0
4,2.5,2154,4153,2.0,0,0,3,9,2154,0,2012,0,98058,47.4557,-122.13,2154,4091,390000,21,7,2014,0,2,1999,1937,0,0,0
3,1.75,1530,825,3.0,0,0,3,8,1530,0,2015,0,98144,47.5929,-122.308,1580,1915,500000,11,4,2015,0,0,-705,335,0,0,1
3,2.25,1360,1041,2.0,0,0,3,8,1094,266,2006,0,98117,47.6925,-122.375,1522,1382,399950,5,8,2014,0,8,-319,-140,0,1,1
3,2.5,1320,2480,2.0,0,0,3,7,1320,0,2005,0,98118,47.536,-122.284,1320,3240,305000,9,2,2015,0,10,1160,1920,0,0,1
4,2.5,1660,6724,2.0,0,0,3,7,1660,0,2009,0,98001,47.259,-122.256,1544,6054,255000,23,1,2015,0,6,5064,4510,0,0,0
4,2.5,2891,6499,2.0,0,0,3,9,2891,0,2014,0,98001,47.3359,-122.257,2550,8383,415000,30,9,2014,0,0,3608,5833,0,0,0
3,2.5,2340,2155,2.0,0,0,3,10,2120,220,2012,0,98027,47.53,-122.073,2640,2680,716500,27,3,2015,0,3,-185,40,0,1,0
3,2.5,2320,2267,3.0,0,0,3,8,2320,0,2009,0,98177,47.7027,-122.359,1240,1883,425000,25,6,2014,0,5,-53,643,0,0,1
4,2.5,2190,3855,2.0,0,0,3,8,2190,0,2010,0,98011,47.7705,-122.169,2190,3600,540000,17,2,2015,0,5,1665,1410,0,0,0
3,2.5,2060,4742,2.0,0,0,3,8,2060,0,2014,0,98038,47.3706,-122.017,2370,4725,324747,4,8,2014,0,0,2682,2355,0,0,0
3,2.5,1740,4145,2.0,0,0,3,7,1740,0,2010,0,98053,47.6875,-122.015,1740,4045,385000,28,1,2015,0,5,2405,2305,0,0,0
3,2.25,1400,3825,2.0,0,0,3,7,1400,0,2012,0,98042,47.3596,-122.082,2110,3825,270000,12,8,2014,0,2,2425,1715,0,0,0
5,4.0,4410,14380,2.0,0,0,3,11,4410,0,2006,0,98052,47.6463,-122.121,2720,11454,1240000,12,6,2014,0,8,9970,8734,0,0,0
3,2.5,1780,1647,2.0,0,0,3,8,1080,700,2008,0,98103,47.6597,-122.355,2000,1741,672000,16,4,2015,0,7,-133,-259,0,1,1
3,2.5,1760,10137,2.0,0,0,3,8,1760,0,2010,0,98038,47.355,-122.059,2000,6935,310000,29,1,2015,0,5,8377,4935,0,0,0
3,3.5,4410,10756,2.0,1,4,3,11,3430,980,2014,0,98056,47.5283,-122.205,3550,5634,3000000,11,8,2014,0,0,6346,2084,0,1,0
6,4.25,5550,11547,2.0,0,2,3,11,4270,1280,2014,0,98033,47.6547,-122.202,3480,11547,2350000,25,2,2015,0,1,5997,8067,0,1,0
3,2.5,2432,9391,2.0,0,2,3,9,2432,0,2005,0,98001,47.3453,-122.267,2912,8932,427000,27,6,2014,0,9,6959,6020,0,0,0
3,2.5,2283,3996,2.0,0,0,3,8,2283,0,2008,0,98031,47.4221,-122.192,1760,3992,389950,23,4,2015,0,7,1713,2232,0,0,0
3,2.5,1860,3730,2.0,0,0,3,8,1860,0,2012,0,98019,47.7442,-121.984,2110,4509,309620,25,6,2014,0,2,1870,2399,0,0,0
4,2.5,2701,4500,2.0,0,0,3,9,2701,0,2014,0,98092,47.2586,-122.194,2570,4800,399895,1,7,2014,0,0,1799,2230,0,0,0
4,2.5,2930,4875,2.0,0,0,3,9,2930,0,2014,0,98030,47.3421,-122.179,2815,4900,442515,2,2,2015,0,1,1945,2085,0,0,0
3,2.25,1540,1561,3.0,0,0,3,8,1540,0,2010,0,98103,47.6991,-122.346,1540,1547,375000,2,12,2014,0,4,21,7,0,0,1
3,2.5,2242,4500,2.0,0,0,3,8,2242,0,2014,0,98092,47.2583,-122.198,2009,4500,309780,2,7,2014,0,0,2258,2491,0,0,0
3,2.5,1950,4345,2.0,0,0,3,7,1950,0,2007,0,98065,47.5202,-121.873,2260,4345,425000,12,3,2015,0,8,2395,2085,0,0,0
2,3.0,1160,1073,2.0,0,0,3,7,880,280,2007,0,98144,47.5788,-122.315,1250,4812,405000,1,5,2015,0,8,-87,3562,0,1,1
3,2.5,2060,5115,2.0,0,0,3,9,2060,0,2014,0,98092,47.3261,-122.163,2648,4500,356250,19,7,2014,0,0,3055,1852,0,0,0
3,2.25,1230,875,3.0,0,0,3,8,1230,0,2013,0,98199,47.6521,-122.4,1760,5664,550000,19,2,2015,0,2,-355,3904,0,0,1
2,1.5,1160,1438,2.0,0,0,3,7,1160,0,2001,0,98144,47.5917,-122.295,1220,1740,340000,5,5,2014,0,13,278,520,0,0,1
4,2.5,2245,4301,2.0,0,0,3,8,2245,0,2014,0,98038,47.3555,-122.063,2530,4478,362865,23,8,2014,0,0,2056,1948,0,0,0
4,3.5,4120,12626,2.0,0,1,3,11,3970,150,2014,0,98034,47.7089,-122.245,4120,11913,1360000,23,3,2015,0,1,8506,7793,0,1,0
4,2.5,3400,9692,2.0,0,0,3,9,3400,0,2007,0,98052,47.708,-122.109,3070,7375,830000,5,5,2014,0,7,6292,4305,0,0,0
5,3.75,4270,7500,2.0,0,0,3,10,3210,1060,2014,0,98033,47.6845,-122.207,2410,8350,1600000,1,8,2014,0,0,3230,5940,0,1,0
4,3.5,2890,5911,2.0,0,0,3,9,2370,520,2014,0,98075,47.5754,-122.071,3490,6093,855000,4,3,2015,0,1,3021,2603,0,1,0
5,3.5,3220,8000,2.0,0,0,3,9,2900,320,2008,0,98033,47.6834,-122.2,2100,9680,1210000,19,8,2014,0,6,4780,7580,0,1,0
4,3.5,4010,15365,2.0,0,1,3,11,4010,0,2006,0,98027,47.5528,-122.093,3550,13429,1390000,11,8,2014,0,8,11355,9879,0,0,0
2,1.0,1140,1730,1.5,0,0,3,8,1010,130,2007,0,98126,47.5494,-122.372,1360,1730,235000,23,5,2014,0,7,590,370,0,1,1
3,2.0,1640,4714,1.0,0,0,3,8,1640,0,2009,0,98038,47.3539,-122.021,1770,4802,349950,7,5,2015,0,6,3074,3032,0,0,0
4,2.75,3510,9400,2.0,0,0,3,9,3510,0,2014,0,98059,47.4827,-122.131,3550,9429,659950,9,7,2014,0,0,5890,5879,0,0,0
3,2.75,3010,1842,2.0,0,0,3,9,3010,0,2011,0,98075,47.5836,-121.994,2950,4200,785000,8,5,2014,0,3,-1168,1250,0,0,0
2,2.25,1060,925,2.0,0,0,3,8,980,80,2006,0,98199,47.6386,-122.388,1020,4000,475000,16,4,2015,0,9,-135,2980,0,1,1
3,2.5,1658,2700,2.0,0,0,3,8,1658,0,2014,0,98198,47.3667,-122.307,1658,2700,263900,27,5,2014,0,0,1042,1042,0,0,1
3,2.5,1960,3540,2.0,0,0,3,8,1960,0,2012,0,98038,47.3568,-122.055,1840,3825,342000,1,5,2015,0,3,1580,1985,0,0,0
3,2.5,2420,4725,2.0,0,0,3,8,2420,0,2014,0,98038,47.371,-122.018,2370,4200,367899,18,9,2014,0,0,2305,1830,0,0,0
2,1.5,893,965,2.0,0,0,3,8,893,0,2007,0,98122,47.6187,-122.301,1340,1436,359950,13,11,2014,0,7,72,96,0,0,1
4,2.75,3020,7203,2.0,0,0,3,9,3020,0,2014,0,98033,47.6948,-122.178,3010,7215,879950,23,7,2014,0,0,4183,4205,0,0,0
4,2.5,2470,5954,2.0,0,0,3,8,2470,0,2013,0,98028,47.7685,-122.236,2470,4800,550000,26,8,2014,0,1,3484,2330,0,0,0
4,2.5,2009,4800,2.0,0,0,3,8,2009,0,2012,0,98092,47.2586,-122.2,1798,4800,279000,9,12,2014,0,2,2791,3002,0,0,0
3,2.5,1530,1116,2.5,0,0,3,7,1530,0,2005,0,98028,47.7385,-122.25,1530,7780,255000,18,7,2014,0,9,-414,6250,0,0,0
3,1.75,1590,1113,3.0,0,0,3,8,1590,0,2014,0,98107,47.6691,-122.402,1520,1357,609500,24,2,2015,0,1,-477,-163,0,0,1
5,3.0,2630,3149,2.0,0,0,3,8,1670,960,2013,0,98056,47.5065,-122.171,2240,4825,420000,20,6,2014,0,1,519,2585,0,1,0
4,2.5,3230,7187,2.0,0,0,3,9,3230,0,2008,0,98059,47.4995,-122.15,2950,6537,570000,8,10,2014,0,6,3957,3587,0,0,0
3,2.25,1430,2343,2.0,0,0,3,8,1430,0,2012,0,98108,47.5648,-122.294,1270,1916,439000,12,5,2015,0,3,913,646,0,0,1
3,2.5,2242,5744,2.0,0,0,3,8,2242,0,2012,0,98092,47.2597,-122.199,2009,5712,310000,8,11,2014,0,2,3502,3703,0,0,0
4,2.5,2500,4000,2.0,0,0,3,8,2500,0,2014,0,98144,47.5902,-122.311,1480,4300,635000,9,2,2015,0,1,1500,2820,0,0,1
3,2.5,1230,922,2.0,0,0,3,8,1080,150,2009,0,98199,47.6518,-122.384,1230,1237,399950,28,11,2014,0,5,-308,7,0,1,1
4,2.5,3020,3600,2.5,0,0,3,9,3020,0,2009,0,98029,47.5407,-121.993,2570,3600,805000,5,8,2014,0,5,580,1030,0,0,0
4,3.5,3480,4000,2.0,0,0,3,9,2460,1020,2015,0,98112,47.6356,-122.281,2620,4000,1800000,7,4,2015,0,0,520,1380,0,1,1
4,3.0,3330,7650,1.0,0,0,3,9,1830,1500,2008,0,98103,47.6889,-122.352,1200,3876,1210000,3,4,2015,0,7,4320,2676,0,1,1
4,2.5,3400,4840,2.0,0,0,3,10,3190,210,2006,0,98059,47.5066,-122.146,3400,5710,745000,15,10,2014,0,8,1440,2310,0,1,0
2,1.5,830,1119,2.0,0,0,3,7,830,0,2005,0,98144,47.5828,-122.314,1480,3622,329445,24,6,2014,0,9,289,2142,0,0,1
5,3.0,3110,4464,2.0,0,0,3,8,3110,0,2007,0,98011,47.7719,-122.168,2450,4221,588000,15,10,2014,0,7,1354,1771,0,0,0
3,2.5,1910,2091,2.0,0,0,3,8,1910,0,2014,0,98029,47.5445,-122.013,1630,1546,494815,7,7,2014,0,0,181,-84,0,0,0
3,2.75,3230,5250,2.0,0,0,3,9,2680,550,2014,0,98065,47.5196,-121.878,2710,5250,591975,14,10,2014,0,0,2020,2540,0,1,0
5,2.75,3380,8179,2.0,0,0,3,9,3380,0,2011,0,98059,47.4827,-122.135,2840,8179,600000,8,1,2015,0,4,4799,5339,0,0,0
3,2.75,2830,3496,2.0,0,0,3,8,2830,0,2012,0,98029,47.5606,-122.011,2160,3501,673000,8,7,2014,0,2,666,1341,0,0,0
5,3.5,3700,7055,2.0,0,0,3,9,3700,0,2014,0,98074,47.5929,-122.057,3170,6527,889950,11,2,2015,0,1,3355,3357,0,0,0
4,3.0,2520,4104,2.0,0,0,3,7,2520,0,2002,0,98065,47.5352,-121.88,2510,5015,500000,25,3,2015,0,13,1584,2505,0,0,0
3,2.25,1530,1396,2.0,0,0,3,8,1240,290,2007,0,98107,47.666,-122.367,1690,2500,500000,1,10,2014,0,7,-134,810,0,1,1
4,4.25,4420,5750,2.0,0,0,3,10,3410,1010,2006,0,98027,47.5404,-122.073,4420,5750,890000,5,5,2014,0,8,1330,1330,0,1,0
3,3.0,1460,1180,3.0,0,0,3,8,1460,0,2006,0,98117,47.6998,-122.367,1460,1224,437000,29,4,2015,0,9,-280,-236,0,0,1
3,2.25,1450,1486,2.0,0,0,3,8,1160,290,2006,0,98116,47.5694,-122.387,1370,1437,419700,5,9,2014,0,8,36,67,0,1,1
3,2.0,1160,3441,1.0,0,0,4,6,580,580,1930,0,98136,47.5314,-122.392,1160,4000,394000,23,7,2014,0,84,2281,2840,0,1,1
3,2.0,1640,4802,1.0,0,0,3,8,1640,0,2010,0,98038,47.3538,-122.021,1940,4802,342000,6,8,2014,0,4,3162,2862,0,0,0
3,2.5,1620,1173,3.0,0,4,3,8,1470,150,2008,0,98103,47.6681,-122.355,1620,1505,580000,23,5,2014,0,6,-447,-115,0,1,1
2,1.5,1100,1228,2.0,0,0,3,7,900,200,2007,0,98118,47.5538,-122.282,1340,1380,343000,27,3,2015,0,8,128,40,0,1,1
2,1.5,1340,1402,2.0,0,0,3,8,1120,220,2008,0,98144,47.588,-122.304,1340,1213,390000,2,4,2015,0,7,62,-127,0,1,1
3,1.5,1450,4694,2.0,0,0,3,7,1450,0,2011,0,98038,47.3654,-122.021,1870,4198,274000,11,8,2014,0,3,3244,2328,0,0,0
4,2.5,3040,7200,2.0,0,0,3,9,3040,0,2008,0,98177,47.7747,-122.366,2360,8245,700000,14,1,2015,0,7,4160,5885,0,0,1
4,2.5,2560,7210,2.0,0,0,3,9,2560,0,2006,0,98136,47.5535,-122.395,2160,10439,838000,16,4,2015,0,9,4650,8279,0,0,1
6,3.0,2744,9926,2.0,0,0,3,7,2744,0,2006,0,98002,47.2773,-122.216,2470,9926,300000,17,9,2014,0,8,7182,7456,0,0,0
3,2.25,1420,990,3.0,0,0,3,8,1420,0,2008,0,98103,47.6801,-122.348,1350,1415,467000,3,9,2014,0,6,-430,65,0,0,1
2,1.0,700,7457,1.0,0,0,3,6,700,0,1943,0,98108,47.5348,-122.295,1500,7130,395000,2,3,2015,0,72,6757,5630,0,0,1
5,2.75,2670,4780,2.0,0,0,3,8,2670,0,2013,0,98059,47.4866,-122.155,2560,5380,480000,6,1,2015,0,2,2110,2820,0,0,0
3,2.75,2130,1400,2.0,0,0,3,9,1080,1050,2010,0,98118,47.5661,-122.29,1520,3132,539000,17,2,2015,0,5,-730,1612,0,1,1
2,1.0,840,892,2.0,0,0,3,7,840,0,2006,0,98136,47.5396,-122.387,1030,1007,306500,30,10,2014,0,8,52,-23,0,0,1
3,2.5,1800,2731,2.0,0,0,3,8,1800,0,2014,0,98065,47.5342,-121.841,1800,3265,408474,26,3,2015,0,1,931,1465,0,0,0
3,2.75,2580,5200,2.0,0,0,3,8,2580,0,2008,0,98059,47.496,-122.151,2700,5602,437000,14,5,2014,0,6,2620,2902,0,0,0
3,1.5,1270,2356,2.0,0,0,3,7,1270,0,2012,0,98108,47.5671,-122.298,1490,2175,160797,23,6,2014,0,2,1086,685,0,0,1
4,3.5,3065,5440,3.0,0,0,3,9,3065,0,2014,0,98056,47.524,-122.2,2210,8400,729000,7,1,2015,0,1,2375,6190,0,0,0
3,2.5,1861,1587,2.0,0,0,3,8,1578,283,2007,0,98034,47.7043,-122.209,2090,10454,499000,31,10,2014,0,7,-274,8364,0,1,0
4,2.75,2260,5705,2.0,0,0,3,8,2260,0,2014,0,98042,47.3726,-122.159,2260,5727,359950,16,10,2014,0,0,3445,3467,0,0,0
5,3.25,4150,7100,2.0,0,0,3,10,4150,0,2013,0,98074,47.6026,-122.06,3560,7214,929000,10,12,2014,0,1,2950,3654,0,0,0
2,2.5,1500,1174,2.0,0,0,3,8,1140,360,2014,0,98107,47.6689,-122.363,1550,1519,529950,6,10,2014,0,0,-326,-31,0,1,1
3,2.25,1620,998,2.5,0,0,3,8,1540,80,2012,0,98027,47.5394,-122.027,1620,1068,461000,3,4,2015,0,3,-622,-552,0,1,0
2,1.5,830,1325,2.0,0,0,3,7,830,0,2005,0,98136,47.5472,-122.384,1310,1485,271115,14,10,2014,0,9,495,175,0,0,1
4,2.5,3120,5137,2.0,0,0,3,7,3120,0,2003,0,98053,47.6842,-122.04,2755,5137,653000,6,1,2015,0,12,2017,2382,0,0,0
3,2.5,1870,1058,3.0,0,0,3,8,1380,490,2007,0,98103,47.6512,-122.345,1440,1136,565000,24,10,2014,0,7,-812,-304,0,1,1
3,2.25,1240,1250,3.0,0,0,3,8,1240,0,2014,0,98107,47.6748,-122.377,1470,1250,529950,4,12,2014,0,0,10,-220,0,0,1
4,2.5,2820,5612,2.0,0,0,3,9,2820,0,2007,0,98028,47.7477,-122.236,1620,14881,585000,26,3,2015,0,8,2792,13261,0,0,0
3,1.75,1630,1526,3.0,0,0,3,8,1630,0,2014,0,98103,47.6536,-122.354,1570,1274,609000,3,7,2014,0,0,-104,-296,0,0,1
3,2.25,1584,2800,2.0,0,0,3,7,1584,0,2012,0,98002,47.3454,-122.214,1584,2800,267000,18,6,2014,0,2,1216,1216,0,0,0
4,2.5,2840,4500,2.0,0,0,3,8,2840,0,2012,0,98028,47.7678,-122.237,2840,4939,557000,9,5,2014,0,2,1660,2099,0,0,0
4,3.25,3910,6293,2.0,0,0,3,9,3130,780,2006,0,98065,47.5389,-121.86,4410,6015,709950,17,11,2014,0,8,2383,1605,0,1,0
3,2.5,1730,1301,3.0,0,0,3,9,1730,0,2011,0,98103,47.653,-122.352,1330,1240,625000,18,7,2014,0,3,-429,-90,0,0,1
3,2.75,1840,2060,2.0,0,0,3,10,1700,140,2013,0,98027,47.53,-122.073,2590,2680,599000,23,12,2014,0,1,220,90,0,1,0
4,3.5,3440,3800,3.0,0,0,3,9,3440,0,2014,0,98112,47.6408,-122.307,1760,3800,1290000,16,10,2014,0,0,360,2040,0,0,1
4,2.5,2110,3825,2.0,0,0,3,7,2110,0,2012,0,98042,47.3602,-122.082,2110,3825,324500,30,3,2015,0,3,1715,1715,0,0,0
3,2.5,2430,5866,2.0,0,0,3,7,2430,0,2009,0,98065,47.5158,-121.871,2380,5866,471500,16,1,2015,0,6,3436,3486,0,0,0
4,2.5,2070,8685,2.0,0,0,3,7,2070,0,2006,0,98188,47.4697,-122.267,2170,9715,262000,29,1,2015,0,9,6615,7545,0,0,1
4,3.5,3350,6350,2.0,0,2,3,8,2610,740,2009,0,98116,47.5602,-122.39,1820,6350,844000,1,4,2015,0,6,3000,4530,0,1,1
4,2.5,2440,4850,2.0,0,0,3,8,2440,0,2013,0,98052,47.7043,-122.114,2970,5450,745641,24,6,2014,0,1,2410,2480,0,0,0
5,3.0,3010,7357,2.0,0,0,3,9,3010,0,2008,0,98133,47.7226,-122.33,2370,8050,659950,12,12,2014,0,6,4347,5680,0,0,1
3,2.5,2060,4200,2.0,0,0,3,8,2060,0,2014,0,98038,47.3706,-122.018,2370,4200,339989,4,8,2014,0,0,2140,1830,0,0,0
2,2.5,1570,2399,2.0,0,0,3,7,1180,390,2009,0,98106,47.5488,-122.364,1590,2306,352500,4,5,2015,0,6,829,716,0,1,1
3,2.5,1580,1161,2.0,0,0,3,8,1010,570,2008,0,98112,47.6206,-122.299,1680,1177,525000,13,5,2014,0,6,-419,-503,0,1,1
5,3.5,4280,6530,2.0,0,3,3,10,4280,0,2014,0,98075,47.5941,-121.973,3960,6863,1140000,29,9,2014,0,0,2250,2903,0,0,0
5,3.5,2815,4900,2.0,0,0,3,9,2815,0,2011,0,98030,47.3424,-122.179,2798,4900,491000,12,8,2014,0,3,2085,2102,0,0,0
4,2.5,2620,6114,2.0,0,0,3,9,2620,0,2011,0,98029,47.5603,-122.013,2620,5808,675000,18,7,2014,0,3,3494,3188,0,0,0
3,2.25,1250,1033,3.0,0,0,3,8,1250,0,2007,0,98103,47.6907,-122.343,1250,1150,344000,6,1,2015,0,8,-217,-100,0,0,1
4,2.5,3250,4500,2.0,0,0,3,8,3250,0,2008,0,98059,47.4944,-122.15,3030,4598,530000,4,11,2014,0,6,1250,1568,0,0,0
4,3.25,2510,7686,2.0,0,0,3,9,2510,0,2003,0,98055,47.4785,-122.228,2510,6732,290500,10,12,2014,0,11,5176,4222,0,0,0
2,1.75,1270,1685,2.0,0,0,3,8,1270,0,2012,0,98108,47.5646,-122.295,1270,1843,335000,13,1,2015,0,3,415,573,0,0,1
3,2.5,1580,3075,2.0,0,0,3,8,1580,0,2013,0,98126,47.545,-122.368,1710,2934,379000,19,9,2014,0,1,1495,1224,0,0,1
3,1.5,1360,2030,3.0,0,0,3,8,1360,0,2008,0,98103,47.6961,-122.349,1360,1167,385000,17,7,2014,0,6,670,-193,0,0,1
4,2.5,2400,9612,1.0,0,0,3,8,1230,1170,1962,2009,98059,47.4799,-122.127,2430,5539,500012,25,2,2015,47,53,7212,3109,1,1,0
3,3.0,1571,2017,3.0,0,0,3,8,1571,0,2008,0,98125,47.7338,-122.309,1520,1497,366750,5,5,2014,0,6,446,-23,0,0,1
2,2.0,1405,1073,2.0,0,0,3,8,1140,265,2007,0,98122,47.612,-122.295,1405,3000,405000,6,6,2014,0,7,-332,1595,0,1,1
3,1.5,1010,1546,2.0,0,0,3,8,1010,0,1971,2014,98144,47.5998,-122.311,1010,1517,356999,12,2,2015,43,44,536,507,1,0,1
2,2.5,1450,1281,2.0,0,0,3,8,1220,230,2006,0,98105,47.665,-122.285,1440,1281,590000,17,4,2015,0,9,-169,-159,0,1,1
3,1.75,1420,1361,2.0,0,0,3,7,960,460,2014,0,98108,47.5684,-122.314,1340,1343,294000,4,11,2014,0,0,-59,3,0,1,1
4,2.5,2650,4644,2.0,0,0,3,8,2650,0,2013,0,98053,47.6945,-122.018,2640,5099,731500,26,4,2015,0,2,1994,2459,0,0,0
5,2.75,3030,7679,2.0,0,0,3,9,3030,0,2014,0,98074,47.593,-122.057,3080,6341,837219,6,6,2014,0,0,4649,3261,0,0,0
3,2.75,2670,3738,1.0,0,0,3,10,1720,950,2013,0,98056,47.5299,-122.203,2610,3734,798800,16,6,2014,0,1,1068,1124,0,1,0
2,2.5,1170,809,2.0,0,0,3,9,1170,0,2007,0,98103,47.6875,-122.339,1170,1121,482500,8,10,2014,0,7,-361,-49,0,0,1
3,1.5,1480,1722,3.0,0,0,3,7,1480,0,2007,0,98125,47.728,-122.292,1480,5764,319000,11,7,2014,0,7,242,4284,0,0,1
3,2.5,2700,6947,2.0,0,3,3,9,2700,0,2013,0,98056,47.5172,-122.208,2500,6947,950000,13,8,2014,0,1,4247,4447,0,0,0
4,3.5,4640,13404,2.0,0,0,3,10,4640,0,2007,0,98059,47.531,-122.134,4690,13590,1270000,7,5,2015,0,8,8764,8900,0,0,0
3,2.5,1601,2491,3.0,0,0,3,7,1536,65,2007,0,98125,47.719,-122.317,1420,1156,378000,7,7,2014,0,7,890,-264,0,1,1
3,2.5,2540,5237,2.0,0,0,3,8,2540,0,2011,0,98118,47.5492,-122.276,1800,4097,489950,27,10,2014,0,3,2697,2297,0,0,1
2,1.75,1030,1106,2.0,0,0,3,7,765,265,2006,0,98136,47.5397,-122.387,1030,1066,345000,27,4,2015,0,9,76,36,0,1,1
3,2.5,2730,7136,2.0,0,0,3,8,2730,0,2012,0,98198,47.3938,-122.321,2130,8932,510000,26,2,2015,0,3,4406,6802,0,0,1
4,2.5,3172,5033,2.0,0,0,3,8,3172,0,2014,0,98023,47.2961,-122.348,2704,5232,432500,29,7,2014,0,0,1861,2528,0,0,0
4,2.5,3160,8530,2.0,0,0,3,9,3160,0,2006,0,98059,47.5075,-122.148,3160,6460,650000,20,4,2015,0,9,5370,3300,0,0,0
4,2.5,2850,12429,2.0,0,0,3,9,2850,0,2008,0,98033,47.6915,-122.177,2540,12000,750000,3,10,2014,0,6,9579,9460,0,0,0
4,3.5,2780,3100,2.0,0,0,3,8,2120,660,2014,0,98117,47.6886,-122.364,1740,3600,870000,27,4,2015,0,1,320,1860,0,1,1
4,3.5,3860,6543,2.0,0,0,3,10,3860,0,2014,0,98075,47.5934,-121.974,3760,6888,900000,15,12,2014,0,0,2683,3128,0,0,0
2,1.75,1180,900,2.0,0,0,3,10,780,400,2014,0,98102,47.6395,-122.329,1380,3610,664950,16,12,2014,0,0,-280,2230,0,1,1
3,2.25,1410,1290,2.0,0,0,3,7,1290,120,2004,0,98027,47.5345,-122.069,1490,1380,391000,2,6,2014,0,10,-120,-110,0,1,0
5,3.0,3223,6371,2.0,0,0,3,9,3223,0,2014,0,98042,47.3584,-122.163,1979,9008,479349,14,5,2015,0,1,3148,7029,0,0,0
4,3.25,2600,2074,2.0,0,0,3,8,2150,450,2011,0,98027,47.5402,-122.028,2510,2074,661000,23,12,2014,0,3,-526,-436,0,1,0
3,3.25,1380,1234,3.0,0,0,3,8,1380,0,2006,0,98103,47.6935,-122.342,1370,1282,379000,2,10,2014,0,8,-146,-88,0,0,1
3,2.25,1620,998,2.5,0,0,3,8,1540,80,2010,0,98027,47.5401,-122.027,1620,1299,415000,5,5,2014,0,4,-622,-321,0,1,0
3,3.25,1370,1227,3.0,0,0,3,8,1370,0,2007,0,98103,47.6964,-122.341,1370,1236,375000,1,12,2014,0,7,-143,-134,0,0,1
3,2.0,1220,1186,3.0,0,0,3,8,1220,0,2007,0,98103,47.6972,-122.341,1280,1251,355000,23,5,2014,0,7,-34,-29,0,0,1
3,2.5,1280,1889,3.0,0,0,3,8,1280,0,2009,0,98105,47.6619,-122.324,1450,1889,540000,5,9,2014,0,5,609,439,0,0,1
2,1.5,770,850,2.0,0,0,3,7,770,0,2006,0,98116,47.5644,-122.388,1350,915,290000,24,7,2014,0,8,80,-435,0,0,1
3,2.5,1210,1200,3.0,0,0,3,8,1210,0,2008,0,98103,47.6543,-122.345,1210,1200,500000,20,5,2014,0,6,-10,-10,0,0,1
4,2.5,2890,6322,2.0,0,0,3,8,2890,0,2011,0,98038,47.3494,-122.044,2380,5738,416000,2,9,2014,0,3,3432,3358,0,0,0
3,2.5,1580,2765,2.0,0,0,3,8,1580,0,2011,0,98126,47.5444,-122.369,1580,1820,349900,11,8,2014,0,3,1185,240,0,0,1
3,2.25,1530,1245,2.0,0,0,3,9,1050,480,2014,0,98122,47.6018,-122.297,1530,2307,465000,5,6,2014,0,0,-285,777,0,1,1
4,2.5,3670,7680,2.5,0,0,3,10,3670,0,2007,0,98029,47.5401,-121.993,3130,6112,950000,30,6,2014,0,7,4010,2982,0,0,0
4,2.25,1850,2340,2.5,0,0,3,8,1850,0,2014,0,98126,47.543,-122.372,1850,2340,496800,26,3,2015,0,1,490,490,0,0,1
4,2.5,2440,6581,2.0,0,0,3,8,2440,0,2014,0,98133,47.7321,-122.334,1480,7432,680000,20,3,2015,0,1,4141,5952,0,0,1
4,3.25,2190,4265,2.0,0,0,3,9,1540,650,2015,0,98122,47.6178,-122.29,1730,4265,920000,24,4,2015,0,0,2075,2535,0,1,1
5,4.0,4360,8030,2.0,0,0,3,10,4360,0,2015,0,98075,47.5923,-121.973,3570,6185,1290000,2,2,2015,0,0,3670,2615,0,0,0
4,2.75,3990,6637,2.0,0,0,3,9,3990,0,2003,0,98053,47.6835,-122.045,3500,7074,825000,1,7,2014,0,11,2647,3574,0,0,0
3,2.5,1270,1283,3.0,0,0,3,7,1270,0,2007,0,98125,47.7209,-122.291,1270,1512,292000,2,10,2014,0,7,13,242,0,0,1
4,2.5,3340,6924,2.0,0,0,3,8,3340,0,2009,0,98059,47.495,-122.149,3030,6119,576000,9,4,2015,0,6,3584,3089,0,0,0
2,2.0,1500,761,3.0,0,3,3,8,1500,0,2008,0,98103,47.6522,-122.346,1360,1527,670000,13,3,2015,0,7,-739,167,0,0,1
4,3.5,3120,5086,2.0,0,0,3,9,2480,640,2008,0,98115,47.6762,-122.288,1880,5092,953007,20,5,2014,0,6,1966,3212,0,1,1
4,2.5,2480,4334,2.0,0,0,3,8,2480,0,2012,0,98038,47.3826,-122.036,2480,5632,399000,23,2,2015,0,3,1854,3152,0,0,0
2,2.0,1110,1155,3.0,0,0,3,7,980,130,2008,0,98136,47.5496,-122.388,1110,1089,399000,27,4,2015,0,7,45,-21,0,1,1
4,2.75,2760,5670,2.0,0,0,3,10,2760,0,2014,0,98075,47.5819,-122.047,2760,6600,847093,17,11,2014,0,0,2910,3840,0,0,0
3,2.5,1510,1493,3.0,0,0,3,8,1510,0,2014,0,98107,47.669,-122.402,1530,1357,599950,6,2,2015,0,1,-17,-173,0,0,1
3,2.5,1460,1614,2.0,0,0,3,8,1180,280,2007,0,98117,47.6781,-122.374,1380,1402,499000,13,8,2014,0,7,154,22,0,1,1
4,3.75,3320,8234,2.0,0,0,3,10,3320,0,2014,0,98004,47.5963,-122.2,1560,8240,1700000,29,10,2014,0,0,4914,6680,0,0,0
4,3.25,3270,5187,2.0,0,0,3,9,3110,160,2014,0,98052,47.6966,-122.133,3600,5825,1030000,12,5,2014,0,0,1917,2225,0,1,0
4,2.5,2670,8765,2.0,0,0,3,9,2670,0,2006,0,98059,47.4876,-122.146,2880,8765,515000,20,5,2014,0,8,6095,5885,0,0,0
3,2.25,1410,1332,2.0,0,0,3,7,1290,120,2004,0,98027,47.5345,-122.069,1445,1290,355000,9,12,2014,0,10,-78,-155,0,1,0
4,2.75,2475,4000,2.0,0,0,3,7,2475,0,2014,0,98002,47.3452,-122.21,2166,4000,319900,5,8,2014,0,0,1525,1834,0,0,0
3,3.5,1600,1431,2.0,0,0,3,8,1240,360,2006,0,98117,47.6865,-122.363,1500,4120,460000,27,5,2014,0,8,-169,2620,0,1,1
2,1.0,1290,3383,2.0,0,0,3,7,1290,0,2008,0,98053,47.6968,-122.025,1290,2828,305000,8,1,2015,0,7,2093,1538,0,0,0
3,2.5,1608,4818,2.0,0,0,3,8,1608,0,2012,0,98092,47.2583,-122.203,2009,5200,280000,17,3,2015,0,3,3210,3191,0,0,0
2,2.25,1300,2104,2.0,0,0,3,8,1010,290,2011,0,98136,47.5477,-122.388,1430,1850,394950,27,2,2015,0,4,804,420,0,1,1
4,3.5,2530,3000,2.0,0,0,3,8,1850,680,2014,0,98146,47.4919,-122.336,1470,6000,382000,21,8,2014,0,0,470,4530,0,1,1
3,2.5,1390,1411,3.0,0,0,3,8,1390,0,2008,0,98103,47.6485,-122.334,1350,1266,560000,22,4,2015,0,7,21,-84,0,0,1
3,2.25,1640,1204,3.0,0,0,3,8,1640,0,2014,0,98112,47.6196,-122.297,1630,3136,772000,20,5,2014,0,0,-436,1506,0,0,1
4,2.5,2229,5723,2.0,0,0,3,7,2229,0,2012,0,98032,47.3693,-122.286,2738,5742,324950,22,7,2014,0,2,3494,3004,0,0,0
3,2.5,1790,3078,2.0,0,0,3,8,1790,0,2010,0,98027,47.5638,-122.094,1890,3078,530000,9,7,2014,0,4,1288,1188,0,0,0
3,2.25,990,736,2.5,0,0,3,8,880,110,2009,0,98105,47.6605,-122.319,1030,1201,384000,24,10,2014,0,5,-254,171,0,1,1
5,2.75,3240,6863,2.0,0,0,3,10,3240,0,2013,0,98056,47.5033,-122.193,2360,6002,719950,11,6,2014,0,1,3623,3642,0,0,0
2,2.5,1280,819,2.0,0,0,3,8,1060,220,2006,0,98103,47.6905,-122.364,1290,2900,319950,11,8,2014,0,8,-461,1610,0,1,1
3,2.5,1610,3848,2.0,0,0,3,8,1610,0,2006,0,98055,47.4497,-122.188,1610,3049,292000,28,1,2015,0,9,2238,1439,0,0,0
6,3.5,3670,3959,2.0,0,0,3,10,2410,1260,2008,0,98119,47.6356,-122.373,2060,3625,1500000,28,4,2015,0,7,289,1565,0,1,1
2,2.5,1150,1027,3.0,0,0,3,8,1150,0,2008,0,98103,47.6534,-122.356,1360,1210,425000,7,5,2014,0,6,-123,-150,0,0,1
5,3.75,3760,4702,2.0,0,0,3,9,2780,980,2014,0,98034,47.7202,-122.223,2950,5981,799950,10,10,2014,0,0,942,3031,0,1,0
2,2.5,1320,1157,2.0,0,0,3,8,990,330,2014,0,98107,47.6689,-122.363,1550,1519,499000,25,8,2014,0,0,-163,-31,0,1,1
4,2.75,2700,7992,2.0,0,0,3,9,2700,0,2012,0,98059,47.4831,-122.135,2840,7992,572000,27,3,2015,0,3,5292,5152,0,0,0
2,2.0,1480,804,3.0,0,0,3,8,1480,0,2008,0,98122,47.602,-122.308,1380,1751,459000,22,7,2014,0,6,-676,371,0,0,1
3,2.25,1410,905,3.0,0,0,3,9,1410,0,2014,0,98116,47.5818,-122.402,1510,1352,529500,18,3,2015,0,1,-505,-158,0,0,1
4,2.5,3135,5811,2.0,0,0,3,9,3135,0,2005,0,98092,47.3263,-122.18,3008,5799,374500,9,9,2014,0,9,2676,2791,0,0,0
3,2.5,1480,1485,2.0,0,0,3,8,1280,200,2007,0,98102,47.6376,-122.326,1470,1277,584000,5,6,2014,0,7,5,-193,0,1,1
4,4.5,4020,9656,2.0,0,0,3,10,4020,0,2007,0,98004,47.6358,-122.207,1960,9520,1900000,15,1,2015,0,8,5636,7560,0,0,0
2,2.25,1060,1209,2.0,0,0,3,8,940,120,2006,0,98102,47.6369,-122.327,1300,1169,505000,7,7,2014,0,8,149,-131,0,1,1
2,2.5,1950,2457,3.0,0,0,3,8,1950,0,2009,0,98144,47.5925,-122.302,1650,1639,565000,14,11,2014,0,5,507,-11,0,0,1
4,2.75,3340,5677,2.0,0,0,3,9,3340,0,2011,0,98052,47.709,-122.118,3240,5643,799000,25,3,2015,0,4,2337,2403,0,0,0
3,2.5,1570,1452,2.5,0,0,3,9,1240,330,2007,0,98199,47.648,-122.396,1670,1596,547000,29,4,2015,0,8,-118,-74,0,1,1
3,2.5,1930,6604,2.0,0,0,3,7,1930,0,2014,0,98166,47.4692,-122.351,910,6604,550000,27,2,2015,0,1,4674,5694,0,0,1
3,2.0,1590,8100,1.0,0,0,3,7,1060,530,1996,0,98038,47.3611,-122.047,1590,8100,250000,18,9,2014,0,18,6510,6510,0,1,0
4,4.5,3720,7746,2.0,0,0,3,10,3720,0,2014,0,98034,47.7323,-122.165,3080,11067,960000,5,1,2015,0,1,4026,7987,0,0,0
4,4.25,4470,5884,2.0,0,1,3,11,3230,1240,2010,0,98199,47.6387,-122.405,2570,6000,2950000,30,10,2014,0,4,1414,3430,0,1,1
2,1.0,1290,1289,2.0,0,0,3,7,1030,260,2005,0,98144,47.6006,-122.305,1290,1332,441000,27,3,2015,0,10,-1,42,0,1,1
3,2.25,1489,2800,2.0,0,0,3,7,1489,0,2012,0,98002,47.3454,-122.214,1584,2800,265000,7,4,2015,0,3,1311,1216,0,0,0
3,2.5,1413,3600,2.0,0,0,3,8,1413,0,2011,0,98031,47.4222,-122.193,2150,3869,286800,17,6,2014,0,3,2187,1719,0,0,0
3,2.5,1300,1362,2.0,0,0,3,8,880,420,2008,0,98144,47.5893,-122.317,1300,1251,375000,16,4,2015,0,7,62,-49,0,1,1
3,3.25,1480,983,2.0,0,0,3,8,1180,300,2013,0,98106,47.5555,-122.363,1330,1062,312500,15,12,2014,0,1,-497,-268,0,1,1
4,2.75,3320,5559,2.0,0,0,3,9,3320,0,2012,0,98075,47.5607,-122.031,3400,6854,850000,7,1,2015,0,3,2239,3454,0,0,0
3,2.25,1530,1279,2.0,0,0,3,7,1116,414,2007,0,98177,47.7035,-122.357,1320,1427,390500,25,3,2015,0,8,-251,107,0,1,1
3,2.5,1180,932,3.0,0,0,3,8,1180,0,2010,0,98119,47.638,-122.375,1180,2632,455000,29,10,2014,0,4,-248,1452,0,0,1
2,2.0,1190,1303,2.0,0,0,3,8,800,390,2009,0,98107,47.6675,-122.368,1670,2425,455000,6,4,2015,0,6,113,755,0,1,1
3,2.25,1300,1180,3.0,0,0,3,8,1300,0,2008,0,98103,47.6871,-122.339,1300,1174,515000,3,12,2014,0,6,-120,-126,0,0,1
3,3.5,1710,2212,2.0,0,0,3,7,1400,310,2013,0,98126,47.5459,-122.368,1580,2212,362500,1,4,2015,0,2,502,632,0,1,1
4,3.5,3510,6005,2.0,0,0,3,8,2750,760,2010,0,98065,47.5168,-121.87,3090,5866,540000,4,9,2014,0,4,2495,2776,0,1,0
3,1.75,1140,1165,2.0,0,0,3,8,1140,0,2014,0,98108,47.5638,-122.295,1150,1552,230000,31,7,2014,0,0,25,402,0,0,1
2,2.5,1320,1329,2.0,0,0,3,8,1180,140,2007,0,98107,47.6728,-122.374,1490,5000,425000,29,9,2014,0,7,9,3510,0,1,1
5,3.0,2100,9752,1.0,0,0,3,8,1200,900,2007,0,98003,47.3341,-122.304,1270,10200,298450,19,5,2014,0,7,7652,8930,0,1,0
4,2.5,2400,4848,2.0,0,0,3,8,2400,0,2004,0,98038,47.3626,-122.04,1980,5199,344000,22,12,2014,0,10,2448,3219,0,0,0
3,2.5,1408,989,3.0,0,0,3,8,1408,0,2005,0,98115,47.6856,-122.315,1408,1342,416286,5,5,2014,0,9,-419,-66,0,0,1
4,2.5,2560,5102,2.0,0,0,3,8,2560,0,2013,0,98092,47.3404,-122.181,2586,5059,379500,23,2,2015,0,2,2542,2473,0,0,0
2,2.5,1260,1347,3.0,0,0,3,8,1260,0,2005,0,98103,47.6994,-122.341,1260,1356,350000,17,6,2014,0,9,87,96,0,0,1
2,1.75,1290,1624,2.0,0,0,3,8,1290,0,2014,0,98106,47.5171,-122.347,1410,1963,258800,8,4,2015,0,1,334,553,0,0,1
4,2.5,2730,9260,2.0,0,0,3,8,2730,0,2008,0,98133,47.7222,-122.331,2730,7357,620000,18,12,2014,0,6,6530,4627,0,0,1
2,2.5,1630,1368,2.0,0,0,3,7,1280,350,2009,0,98106,47.5489,-122.363,1590,2306,295000,2,5,2014,0,5,-262,716,0,1,1
4,2.75,3530,6844,2.0,0,0,3,10,3530,0,2014,0,98075,47.5975,-121.985,3530,10038,908990,27,2,2015,0,1,3314,6508,0,0,0
4,2.5,2714,12558,2.0,0,0,3,9,2714,0,2014,0,98031,47.3522,-122.201,2873,8269,485230,17,11,2014,0,0,9844,5396,0,0,0
3,2.25,1630,2520,2.0,0,0,3,7,1630,0,2005,0,98029,47.5493,-121.998,1630,3131,475000,11,6,2014,0,9,890,1501,0,0,0
5,3.25,5790,13726,2.0,0,3,3,10,4430,1360,2014,0,98006,47.5388,-122.114,5790,13726,1240000,4,8,2014,0,0,7936,7936,0,1,0
3,3.0,2230,1407,2.5,0,0,3,8,1850,380,2013,0,98027,47.5446,-122.017,2290,1407,635000,19,8,2014,0,1,-823,-883,0,1,0
3,2.5,1380,1590,2.0,0,0,3,9,1160,220,2012,0,98126,47.5444,-122.375,1380,1590,350000,5,11,2014,0,2,210,210,0,1,1
3,3.5,1320,1161,3.0,0,0,3,8,1320,0,2010,0,98125,47.7162,-122.294,1320,1161,345000,29,12,2014,0,4,-159,-159,0,0,1
2,2.0,1490,713,3.0,0,0,3,9,1490,0,2014,0,98109,47.6356,-122.346,1490,1110,700000,21,9,2014,0,0,-777,-380,0,0,1
3,2.25,1280,1520,2.0,0,0,3,8,1080,200,2008,0,98107,47.6651,-122.368,1280,1681,490000,21,8,2014,0,6,240,401,0,1,1
5,4.0,3870,5929,2.0,0,0,3,10,3870,0,2014,0,98052,47.6965,-122.134,3600,5625,1300000,5,8,2014,0,0,2059,2025,0,0,0
2,2.5,1280,1051,2.0,0,0,3,8,1080,200,2009,0,98119,47.6273,-122.359,1580,1279,579000,10,9,2014,0,5,-229,-301,0,1,1
3,1.5,1300,1435,2.0,0,0,3,8,1120,180,2007,0,98122,47.6114,-122.31,1320,1652,552500,27,3,2015,0,8,135,332,0,1,1
4,2.75,2170,5024,2.0,0,0,3,8,2170,0,2012,0,98059,47.495,-122.145,2460,5024,467000,4,2,2015,0,3,2854,2564,0,0,0
4,2.25,1763,3717,2.0,0,0,3,8,1763,0,2012,0,98031,47.4213,-122.194,1763,3666,305000,13,11,2014,0,2,1954,1903,0,0,0
2,1.5,1020,1525,2.0,0,0,3,7,1020,0,2004,0,98133,47.704,-122.347,1020,3844,212000,9,5,2014,0,10,505,2824,0,0,1
4,2.5,1840,4593,2.0,0,0,3,7,1840,0,2010,0,98053,47.6866,-122.013,1740,3600,429000,21,8,2014,0,4,2753,1860,0,0,0
3,2.0,1820,1358,3.0,0,0,3,9,1820,0,2014,0,98126,47.5433,-122.376,1710,1367,479950,25,9,2014,0,0,-462,-343,0,0,1
3,3.5,2670,3000,2.0,0,0,3,9,1870,800,2014,0,98117,47.6813,-122.372,1750,5000,825000,18,12,2014,0,0,330,3250,0,1,1
6,6.5,6260,10955,2.0,0,0,3,11,4840,1420,2007,0,98075,47.5947,-122.039,2710,12550,1180000,28,3,2015,0,8,4695,9840,0,1,0
3,2.25,1400,3814,2.0,0,0,3,7,1400,0,2012,0,98042,47.3584,-122.083,1610,3814,250000,13,6,2014,0,2,2414,2204,0,0,0
2,1.5,1160,2158,2.0,0,0,3,7,1160,0,1982,0,98034,47.7178,-122.19,1150,2158,289000,27,10,2014,0,32,998,1008,0,0,0
3,2.5,1400,3368,2.0,0,0,3,7,1400,0,2013,0,98146,47.5134,-122.342,1400,4316,265000,2,10,2014,0,1,1968,2916,0,0,1
3,2.5,1232,1130,3.0,0,0,3,7,1232,0,2007,0,98125,47.7185,-122.317,1232,1202,344000,15,5,2014,0,7,-102,-30,0,0,1
4,2.75,2700,6000,2.0,0,0,4,8,2100,600,1910,0,98116,47.586,-122.383,2050,5400,749000,9,7,2014,0,104,3300,3350,0,1,1
4,2.5,2550,6382,2.0,0,0,3,7,2550,0,2007,0,98065,47.5202,-121.87,2430,5900,492000,8,9,2014,0,7,3832,3470,0,0,0
4,2.5,3260,6902,2.0,0,0,3,8,3260,0,2008,0,98059,47.4829,-122.156,3130,6588,552500,19,1,2015,0,7,3642,3458,0,0,0
2,2.5,1680,1240,2.0,0,0,3,8,1120,560,2014,0,98102,47.6372,-122.324,2060,3630,653500,12,11,2014,0,0,-440,1570,0,1,1
4,3.25,2630,2550,2.0,0,0,3,10,2030,600,2006,0,98117,47.6775,-122.385,1810,2600,855000,2,4,2015,0,9,-80,790,0,1,1
3,1.5,1260,5758,2.0,0,0,3,7,1260,0,1999,0,98006,47.5524,-122.139,3090,10142,333000,19,11,2014,0,15,4498,7052,0,0,0
4,2.5,2550,4500,2.0,0,0,3,7,2550,0,2009,0,98059,47.4916,-122.153,2340,4526,415000,11,6,2014,0,5,1950,2186,0,0,0
4,3.25,3450,5000,2.0,0,0,3,8,3450,0,2008,0,98178,47.4925,-122.273,1420,5000,445000,7,11,2014,0,6,1550,3580,0,0,1
3,2.5,1550,3402,2.0,0,0,3,7,1550,0,2009,0,98002,47.3523,-122.212,2095,3402,273500,10,7,2014,0,5,1852,1307,0,0,0
4,2.5,4150,8436,2.0,0,0,3,10,4150,0,2014,0,98075,47.5802,-122.039,4070,8438,969990,6,6,2014,0,0,4286,4368,0,0,0
5,3.5,3900,4400,2.0,0,0,3,9,2650,1250,2014,0,98107,47.6607,-122.362,1190,4400,1200000,8,10,2014,0,0,500,3210,0,1,1
3,3.25,1550,1444,3.0,0,0,3,8,1550,0,2006,0,98115,47.6767,-122.291,1550,1444,430000,6,8,2014,0,8,-106,-106,0,0,1
4,2.5,2130,4000,2.0,0,0,3,8,2130,0,2014,0,98146,47.5108,-122.362,1830,7217,392000,23,3,2015,0,1,1870,5387,0,0,1
3,2.5,1220,1330,2.0,0,0,3,8,1010,210,2008,0,98117,47.6904,-122.37,1360,3750,457000,30,6,2014,0,6,110,2390,0,1,1
4,2.5,2502,8306,2.0,0,0,3,9,2502,0,2013,0,98001,47.2953,-122.265,2597,6983,453000,20,3,2015,0,2,5804,4386,0,0,0
3,2.0,1340,1384,3.0,0,0,3,8,1340,0,2008,0,98103,47.6973,-122.35,1110,1384,376000,9,5,2014,0,6,44,274,0,0,1
4,2.5,2350,3800,2.0,0,0,3,8,2350,0,2014,0,98059,47.4783,-122.123,2670,4180,469995,4,8,2014,0,0,1450,1510,0,0,0
3,2.5,1810,3930,2.0,0,0,3,8,1810,0,2008,0,98053,47.7169,-122.02,1560,5100,540000,4,5,2015,0,7,2120,3540,0,0,0
4,2.5,3310,6500,2.0,0,0,3,8,3310,0,2012,0,98065,47.515,-121.87,2380,5000,555000,2,5,2014,0,2,3190,2620,0,0,0
3,2.0,1620,5101,1.0,0,0,3,7,590,1030,2006,0,98118,47.5448,-122.288,1700,7750,445000,25,7,2014,0,8,3481,6050,0,1,1
2,2.0,1070,635,2.0,0,0,3,9,720,350,2008,0,98106,47.5212,-122.357,1070,928,256950,15,12,2014,0,6,-435,-142,0,1,1
4,2.5,2230,4952,2.0,0,0,3,8,2230,0,2011,0,98002,47.3363,-122.211,2030,3721,297000,6,10,2014,0,3,2722,1691,0,0,0
4,2.5,1970,4558,2.0,0,0,3,8,1970,0,2005,0,98038,47.3627,-122.04,1980,5123,320000,17,10,2014,0,9,2588,3143,0,0,0
5,4.5,4600,7810,2.0,0,0,3,9,3200,1400,2006,0,98065,47.5381,-121.86,4480,6324,805000,14,11,2014,0,8,3210,1844,0,1,0
4,2.75,3110,6050,2.0,0,0,3,9,3110,0,2014,0,98052,47.705,-122.126,3590,6054,799990,1,8,2014,0,0,2940,2464,0,0,0
4,2.5,3490,3677,2.0,0,0,3,9,2850,640,2007,0,98072,47.774,-122.162,3440,3600,680000,9,4,2015,0,8,187,160,0,1,0
3,2.5,1600,1936,2.0,0,0,3,7,1600,0,2007,0,98108,47.5629,-122.297,1600,1936,395000,24,6,2014,0,7,336,336,0,0,1
3,2.5,1960,3060,2.0,0,0,3,8,1960,0,2010,0,98117,47.6764,-122.389,1220,3060,732000,2,12,2014,0,4,1100,1840,0,0,1
2,2.5,1000,1092,2.0,0,0,3,7,990,10,2004,0,98118,47.5419,-122.271,1330,1466,163800,2,8,2014,0,10,92,136,0,1,1
2,2.5,1000,1092,2.0,0,0,3,7,990,10,2004,0,98118,47.5419,-122.271,1330,1466,220000,1,12,2014,0,10,92,136,0,1,1
2,2.0,1500,1408,3.0,0,0,3,7,1500,0,1999,0,98133,47.7293,-122.343,1500,1245,308625,6,11,2014,0,15,-92,-255,0,0,1
3,2.5,2424,5931,2.0,0,0,3,9,2424,0,2014,0,98042,47.3515,-122.134,2424,6036,375000,31,3,2015,0,1,3507,3612,0,0,0
4,2.5,2303,3826,2.0,0,0,3,8,2303,0,2006,0,98092,47.3258,-122.165,2516,4500,300000,1,7,2014,0,8,1523,1984,0,0,0
3,2.5,1880,6008,2.0,0,0,3,7,1880,0,2009,0,98042,47.3366,-122.052,2180,5185,284000,16,6,2014,0,5,4128,3005,0,0,0
2,2.0,1210,740,2.0,0,0,3,8,780,430,2014,0,98112,47.6206,-122.3,1480,1171,610000,20,2,2015,0,1,-470,-309,0,1,1
4,3.25,3720,6765,2.0,0,0,3,9,3720,0,2012,0,98053,47.688,-122.018,3100,6790,955000,24,3,2015,0,3,3045,3690,0,0,0
4,2.75,3610,8580,2.0,0,0,3,9,3610,0,2014,0,98033,47.6706,-122.173,2360,8580,982000,27,6,2014,0,0,4970,6220,0,0,0
3,1.5,1360,885,3.0,0,0,3,8,1360,0,2008,0,98103,47.6961,-122.349,1360,1167,359000,22,5,2014,0,6,-475,-193,0,0,1
5,2.5,2590,7084,2.0,0,0,3,8,2590,0,2014,0,98052,47.7053,-122.113,3010,4823,779380,18,7,2014,0,0,4494,1813,0,0,0
5,3.25,4390,11250,2.0,0,0,3,10,4390,0,2007,0,98040,47.5785,-122.225,2160,9249,1510000,30,6,2014,0,7,6860,7089,0,0,0
3,3.0,2290,1407,2.5,0,0,3,8,1890,400,2014,0,98027,47.5446,-122.017,2230,1407,635000,23,2,2015,0,1,-883,-823,0,1,0
4,3.75,3880,9979,2.5,0,0,3,10,3880,0,2007,0,98029,47.5408,-121.992,3130,6112,1060000,26,8,2014,0,7,6099,2982,0,0,0
3,2.5,1350,874,3.0,0,0,3,8,1270,80,2006,0,98136,47.549,-122.387,1350,886,389500,16,7,2014,0,8,-476,-464,0,1,1
5,2.5,2170,2752,2.0,0,0,3,8,2170,0,2014,0,98106,47.5165,-122.346,1800,2752,359800,7,8,2014,0,0,582,952,0,0,1
3,3.0,1296,1051,3.0,0,0,3,8,1296,0,2009,0,98125,47.7175,-122.284,1520,1939,399950,27,5,2014,0,5,-245,419,0,0,1
3,3.25,1530,1602,2.0,0,0,3,8,1140,390,2013,0,98106,47.5555,-122.362,1450,1198,320000,3,6,2014,0,1,72,-252,0,1,1
3,2.5,1489,3266,2.0,0,0,3,7,1489,0,2014,0,98002,47.3452,-122.217,1537,3273,255900,25,7,2014,0,0,1777,1736,0,0,0
4,2.5,2130,4467,2.0,0,0,3,8,2130,0,2014,0,98146,47.5108,-122.363,1830,8160,380000,9,2,2015,0,1,2337,6330,0,0,1
3,2.75,1430,1521,2.0,0,0,3,9,1130,300,2009,0,98119,47.6353,-122.371,1930,2700,580000,18,9,2014,0,5,91,770,0,1,1
5,3.75,2380,7268,1.0,0,0,3,8,1430,950,2008,0,98106,47.5571,-122.357,2040,10810,545000,29,4,2015,0,7,4888,8770,0,1,1
3,2.5,1420,814,2.0,0,0,3,8,1140,280,2008,0,98136,47.5429,-122.387,1340,1382,451300,25,7,2014,0,6,-606,42,0,1,1
4,3.25,3450,6184,2.0,0,0,3,9,3450,0,2014,0,98074,47.6072,-122.054,3020,5369,852880,16,6,2014,0,0,2734,2349,0,0,0
4,2.5,1914,3150,2.0,0,0,3,8,1914,0,2009,0,98055,47.43,-122.188,1714,3164,305000,19,9,2014,0,5,1236,1450,0,0,0
2,1.5,988,1080,3.0,0,0,3,7,988,0,2007,0,98125,47.7123,-122.301,1128,1080,295000,30,4,2015,0,8,92,-48,0,0,1
3,2.25,1584,2800,2.0,0,0,3,7,1584,0,2012,0,98002,47.3451,-122.214,1584,2800,261000,16,10,2014,0,2,1216,1216,0,0,0
4,2.5,2630,5710,2.0,0,0,3,8,2630,0,2001,0,98065,47.5342,-121.876,2550,5500,560000,17,3,2015,0,14,3080,2950,0,0,0
4,3.25,3520,5250,2.0,0,0,3,9,3520,0,2012,0,98053,47.6869,-122.019,3220,5781,795000,19,9,2014,0,2,1730,2561,0,0,0
4,2.5,2380,4913,2.0,0,0,3,8,2380,0,2006,0,98038,47.3607,-122.038,2580,5311,384950,29,9,2014,0,8,2533,2731,0,0,0
3,1.75,1410,1197,3.0,0,0,3,8,1410,0,2012,0,98103,47.6558,-122.348,1350,2512,500000,8,5,2014,0,2,-213,1162,0,0,1
4,3.5,3220,5741,2.0,0,0,3,9,3220,0,2013,0,98065,47.5169,-121.886,2960,6534,640000,5,2,2015,0,2,2521,3574,0,0,0
4,3.25,3266,5969,2.0,0,0,3,8,3266,0,2014,0,98023,47.2975,-122.35,3087,5169,418000,21,11,2014,0,0,2703,2082,0,0,0
3,2.0,2550,4794,2.0,0,0,3,9,2550,0,2007,0,98115,47.6955,-122.29,1630,5100,799000,10,10,2014,0,7,2244,3470,0,0,1
3,2.25,1670,1596,3.0,0,0,3,8,1670,0,2014,0,98136,47.5402,-122.387,1640,1310,539950,19,12,2014,0,0,-74,-330,0,0,1
4,2.5,3056,11385,2.0,0,0,3,9,3056,0,2014,0,98001,47.2905,-122.264,2849,8607,524225,20,1,2015,0,1,8329,5758,0,0,0
2,1.5,1000,1188,3.0,0,0,3,8,1000,0,2005,0,98115,47.6823,-122.327,2300,3500,424950,2,2,2015,0,10,188,1200,0,0,1
3,3.25,1530,1786,2.0,0,0,3,8,1200,330,2007,0,98117,47.6783,-122.366,1390,2900,560000,25,11,2014,0,7,256,1510,0,1,1
5,3.0,3490,6091,2.0,0,0,3,9,3490,0,2009,0,98011,47.7744,-122.225,2870,5932,715000,29,4,2015,0,6,2601,3062,0,0,0
5,2.5,2760,6000,2.0,0,0,3,8,2760,0,2006,0,98108,47.5289,-122.321,1360,6000,300000,22,5,2014,0,8,3240,4640,0,0,1
3,2.5,1440,2163,2.0,0,0,3,7,1440,0,2005,0,98029,47.554,-121.998,1440,2207,405000,24,2,2015,0,10,723,767,0,0,0
3,3.0,1370,1001,3.0,0,0,3,8,1370,0,2009,0,98133,47.7302,-122.355,1399,1151,327000,7,10,2014,0,5,-369,-248,0,0,1
6,4.0,3180,6551,2.0,0,0,3,9,3180,0,2014,0,98074,47.6236,-122.023,3230,7602,859950,9,12,2014,0,0,3371,4372,0,0,0
4,3.0,2720,7570,2.0,0,0,3,9,2720,0,2008,0,98133,47.7113,-122.349,1770,5705,560000,13,1,2015,0,7,4850,3935,0,0,1
3,2.5,1800,2792,2.0,0,0,3,8,1800,0,2011,0,98126,47.5442,-122.371,1580,2617,379900,7,9,2014,0,3,992,1037,0,0,1
3,2.5,3220,6409,2.0,0,0,3,9,3220,0,2008,0,98059,47.4815,-122.127,3330,6231,625000,1,5,2015,0,7,3189,2901,0,0,0
3,2.5,2370,5321,2.0,0,0,3,8,2370,0,2014,0,98038,47.37,-122.019,2370,4357,398096,23,4,2015,0,1,2951,1987,0,0,0
3,2.5,1410,1325,2.0,0,0,3,7,1180,230,2007,0,98106,47.5582,-122.363,1270,1282,315000,20,11,2014,0,7,-85,12,0,1,1
4,3.5,3640,6049,2.0,0,0,3,9,3640,0,2014,0,98052,47.7049,-122.125,3590,6104,939000,12,12,2014,0,0,2409,2514,0,0,0
3,2.5,1920,3624,2.0,0,0,3,9,1920,0,2003,0,98052,47.6647,-122.087,1930,3533,674000,25,7,2014,0,11,1704,1603,0,0,0
4,2.5,2267,3577,2.0,0,0,3,7,2267,0,2014,0,98092,47.3384,-122.18,2056,3577,306000,14,8,2014,0,0,1310,1521,0,0,0
5,4.75,5780,17004,2.0,0,0,3,11,4260,1520,2006,0,98040,47.5802,-122.212,3460,10855,2320000,9,7,2014,0,8,11224,7395,0,1,0
2,1.0,1131,1304,3.0,0,0,3,7,1131,0,2011,0,98115,47.6912,-122.313,1131,1992,394950,2,2,2015,0,4,173,861,0,0,1
3,3.5,2940,6431,2.0,0,0,3,10,2940,0,2014,0,98075,47.5818,-122.047,2760,6695,914154,18,9,2014,0,0,3491,3935,0,0,0
3,2.5,2180,4533,2.0,0,0,3,7,2180,0,2010,0,98011,47.754,-122.215,2180,7347,496000,17,11,2014,0,4,2353,5167,0,0,0
3,2.25,1400,1078,2.0,0,0,3,8,940,460,2009,0,98144,47.5701,-122.288,1420,1230,430100,17,4,2015,0,6,-322,-190,0,1,1
4,2.5,2680,5539,2.0,0,0,3,8,2680,0,2013,0,98045,47.4759,-121.734,2680,5992,449990,8,7,2014,0,1,2859,3312,0,0,0
4,2.5,2680,5539,2.0,0,0,3,8,2680,0,2013,0,98045,47.4759,-121.734,2680,5992,502000,30,3,2015,0,2,2859,3312,0,0,0
3,2.5,1300,3612,2.0,0,0,3,7,1300,0,2005,0,98118,47.5328,-122.282,1390,2943,310000,11,3,2015,0,10,2312,1553,0,0,1
4,3.5,2796,3520,2.5,0,0,3,8,2796,0,2013,0,98001,47.3427,-122.278,2040,5195,349950,23,3,2015,0,2,724,3155,0,0,0
2,1.75,1460,1500,2.0,0,0,3,8,1000,460,2008,0,98103,47.6853,-122.356,1440,4120,625000,19,9,2014,0,6,40,2680,0,1,1
4,3.5,4210,6481,2.0,0,3,3,9,3260,950,2014,0,98075,47.5765,-122.072,3920,5331,1050000,27,8,2014,0,0,2271,1411,0,1,0
4,2.75,2330,3920,2.0,0,0,3,9,2330,0,2005,0,98029,47.5525,-121.99,2410,4063,680000,7,7,2014,0,9,1590,1653,0,0,0
4,3.5,3930,5680,2.0,0,1,3,9,2820,1110,2013,0,98027,47.5528,-122.076,3700,5816,828950,15,5,2014,0,1,1750,2116,0,1,0
3,2.5,1608,4000,2.0,0,0,3,8,1608,0,2014,0,98092,47.2582,-122.198,2009,4983,274950,3,4,2015,0,1,2392,2974,0,0,0
2,2.25,1610,1968,2.0,0,0,4,7,1610,0,1979,0,98056,47.5184,-122.196,1950,1968,293000,12,3,2015,0,36,358,18,0,0,0
4,3.5,3200,3250,2.0,0,0,3,9,2670,530,2007,0,98029,47.5515,-122.0,3400,3663,795000,13,6,2014,0,7,50,263,0,1,0
4,2.5,1710,3500,2.0,0,0,3,7,1710,0,2014,0,98002,47.3448,-122.217,1710,3500,282900,22,9,2014,0,0,1790,1790,0,0,0
5,3.75,3050,8972,2.0,0,0,3,9,3050,0,2014,0,98033,47.6819,-122.172,2750,8979,909950,16,4,2015,0,1,5922,6229,0,0,0
4,3.5,3560,4951,2.0,0,0,3,9,3560,0,2014,0,98074,47.6178,-122.055,3540,5500,922755,4,11,2014,0,0,1391,1960,0,0,0
4,2.5,2650,8685,2.0,0,0,3,9,2650,0,2006,0,98001,47.344,-122.269,2650,7932,424000,16,4,2015,0,9,6035,5282,0,0,0
3,2.5,3490,12410,2.0,0,0,3,8,2590,900,2009,0,98059,47.4714,-122.071,1740,14448,630000,23,4,2015,0,6,8920,12708,0,1,0
3,2.0,1670,4441,1.0,0,0,3,7,1670,0,2014,0,98022,47.1948,-121.975,1670,4622,256703,30,7,2014,0,0,2771,2952,0,0,0
3,2.5,1720,3600,2.0,0,0,3,7,1720,0,2010,0,98053,47.6856,-122.013,1720,3600,386380,15,5,2014,0,4,1880,1880,0,0,0
2,2.0,1510,3961,1.0,0,0,3,8,1510,0,2010,0,98053,47.709,-122.018,1510,3962,485000,16,9,2014,0,4,2451,2452,0,0,0
3,2.25,1450,4040,2.0,0,0,3,7,1450,0,2010,0,98038,47.3665,-122.022,1610,4040,275000,11,2,2015,0,5,2590,2430,0,0,0
4,2.5,1812,5026,2.0,0,0,3,8,1812,0,2011,0,98055,47.4513,-122.202,2440,6007,370000,2,3,2015,0,4,3214,3567,0,0,0
2,2.25,1060,1208,2.0,0,0,3,8,940,120,2005,0,98102,47.6371,-122.327,1300,1169,499950,10,6,2014,0,9,148,-131,0,1,1
3,2.5,1600,3073,3.0,0,0,3,8,1600,0,2009,0,98144,47.5934,-122.298,1130,2921,502000,24,4,2015,0,6,1473,1791,0,0,1
3,3.25,1530,1565,2.0,0,0,3,8,1280,250,2005,0,98122,47.6179,-122.312,1530,1381,654000,20,6,2014,0,9,35,-149,0,1,1
4,2.25,2070,1230,3.0,0,0,3,9,1500,570,2013,0,98116,47.5775,-122.41,1569,4802,575000,14,7,2014,0,1,-840,3233,0,1,1
3,2.5,2140,4126,2.0,0,0,3,8,1960,180,2005,0,98027,47.5368,-122.073,2280,2615,554000,14,1,2015,0,10,1986,335,0,1,0
4,1.75,2010,12188,1.0,0,0,4,7,1150,860,1960,0,98059,47.5013,-122.147,1720,8475,360000,8,5,2015,0,55,10178,6755,0,1,0
4,2.75,2630,4501,2.0,0,0,3,8,2630,0,2015,0,98028,47.7748,-122.244,2380,4599,619990,29,4,2015,0,0,1871,2219,0,0,0
4,2.5,2233,6025,2.0,0,0,3,7,2233,0,2012,0,98001,47.2599,-122.256,1544,6036,317500,12,3,2015,0,3,3792,4492,0,0,0
4,2.75,2990,4521,2.0,0,0,3,7,2990,0,2014,0,98028,47.7401,-122.226,2580,7539,564950,28,8,2014,0,0,1531,4959,0,0,0
2,1.25,1240,2150,2.0,0,0,3,8,1240,0,2014,0,98117,47.6884,-122.374,1340,5289,545000,11,6,2014,0,0,910,3949,0,0,1
3,2.5,2230,5050,2.0,0,0,3,7,2230,0,2006,0,98042,47.3359,-122.055,2260,5050,333700,1,5,2015,0,9,2820,2790,0,0,0
3,3.25,3700,2264,2.0,0,0,3,11,2280,1420,1998,0,98033,47.6653,-122.205,3930,2567,1480000,11,7,2014,0,16,-1436,-1363,0,1,0
4,3.0,2290,5105,2.0,0,0,3,8,2290,0,2012,0,98028,47.7727,-122.237,2450,5105,530000,8,4,2015,0,3,2815,2655,0,0,0
2,1.5,950,865,3.0,0,0,3,8,950,0,2006,0,98107,47.6714,-122.382,1290,1189,396000,13,4,2015,0,9,-85,-101,0,0,1
2,1.75,1120,758,2.0,0,0,3,7,1120,0,2012,0,98027,47.5325,-122.072,1150,758,305000,16,10,2014,0,2,-362,-392,0,0,0
5,3.5,2420,4670,2.0,0,0,3,7,2420,0,2013,0,98118,47.5241,-122.285,1430,4468,380000,22,5,2014,0,1,2250,3038,0,0,1
4,2.5,1714,3250,2.0,0,0,3,8,1714,0,2010,0,98055,47.429,-122.189,1714,3250,305000,3,3,2015,0,5,1536,1536,0,0,0
4,2.5,2230,5650,2.0,0,0,3,7,2230,0,2011,0,98056,47.5073,-122.168,1590,7241,440000,28,9,2014,0,3,3420,5651,0,0,0
4,3.0,2530,10000,2.0,0,0,3,7,2530,0,2013,0,98148,47.431,-122.335,1420,9898,459000,27,6,2014,0,1,7470,8478,0,0,1
3,3.5,1550,1233,2.0,0,0,3,8,1160,390,2005,0,98122,47.6034,-122.309,1490,1539,530000,6,3,2015,0,10,-317,49,0,1,1
4,2.75,3110,11225,2.0,0,0,3,8,3110,0,2012,0,98059,47.4865,-122.143,2610,8535,600000,16,4,2015,0,3,8115,5925,0,0,0
3,3.0,2100,2409,2.0,0,0,3,8,1660,440,2008,0,98144,47.5973,-122.298,1900,2400,515000,18,7,2014,0,6,309,500,0,1,1
4,2.5,2150,3721,2.0,0,0,3,8,2150,0,2007,0,98002,47.3363,-122.215,2150,3721,275000,8,4,2015,0,8,1571,1571,0,0,0
3,1.75,1630,1404,2.0,0,0,3,8,1020,610,2014,0,98107,47.6646,-122.367,1420,1670,540000,12,1,2015,0,1,-226,250,0,1,1
3,2.5,2230,7934,2.0,0,0,3,7,2230,0,2005,0,98065,47.5439,-121.88,2310,4818,445000,5,8,2014,0,9,5704,2508,0,0,0
3,2.5,1320,955,3.0,0,0,3,7,1320,0,2009,0,98106,47.5202,-122.357,1300,1003,285000,7,4,2015,0,6,-365,-297,0,0,1
3,2.5,1590,1431,2.0,0,0,3,8,1060,530,2010,0,98144,47.5893,-122.309,1620,1548,480000,31,7,2014,0,4,-159,-72,0,1,1
5,3.25,2610,3642,2.0,0,0,3,8,2080,530,2005,0,98118,47.535,-122.284,1750,3118,440000,20,1,2015,0,10,1032,1368,0,1,1
3,2.5,1440,2500,2.0,0,0,3,7,1440,0,2008,0,98146,47.5123,-122.358,1440,5000,287450,11,2,2015,0,7,1060,3560,0,0,1
4,2.5,2630,6283,2.0,0,0,3,9,2630,0,2006,0,98059,47.5079,-122.158,2630,7210,507950,1,4,2015,0,9,3653,4580,0,0,0
3,3.5,3390,10078,2.0,0,0,3,10,3040,350,2012,0,98056,47.537,-122.185,3290,12332,750000,19,6,2014,0,2,6688,9042,0,1,0
3,1.5,1400,1022,3.0,0,0,3,8,1400,0,2007,0,98115,47.6989,-122.317,1270,1205,425000,3,7,2014,0,7,-378,-65,0,0,1
3,3.5,1900,2133,2.0,0,0,3,8,1520,380,2009,0,98126,47.5675,-122.369,1530,3264,420000,2,12,2014,0,5,233,1734,0,1,1
3,2.5,1350,1250,3.0,0,0,3,8,1270,80,2006,0,98136,47.5491,-122.387,1350,886,394950,10,5,2014,0,8,-100,-464,0,1,1
4,3.25,3420,6752,2.0,0,2,3,9,3030,390,2012,0,98065,47.517,-121.876,3010,5172,635000,11,7,2014,0,2,3332,2162,0,1,0
4,2.5,2110,5306,2.0,0,0,3,8,2110,0,2012,0,98038,47.356,-122.057,2250,5306,380000,5,5,2015,0,3,3196,3056,0,0,0
4,3.25,3810,8519,1.0,0,1,3,10,2680,1130,2007,0,98033,47.699,-122.207,3240,10748,1130000,21,5,2014,0,7,4709,7508,0,1,0
5,3.0,2870,4369,2.0,0,0,3,8,2090,780,2007,0,98011,47.7449,-122.192,2640,4610,540000,8,6,2014,0,7,1499,1970,0,1,0
2,2.25,1240,705,2.0,0,0,3,7,1150,90,2009,0,98027,47.5321,-122.073,1240,750,352499,27,4,2015,0,6,-535,-490,0,1,0
4,2.5,2310,5100,2.0,0,0,3,9,2310,0,2013,0,98177,47.7039,-122.36,1260,5100,685000,30,5,2014,0,1,2790,3840,0,0,1
4,3.0,1930,3031,1.0,0,0,3,7,1200,730,2006,0,98019,47.7457,-121.985,1930,2611,330675,26,6,2014,0,8,1101,681,0,1,0
3,3.0,1390,1080,2.0,0,0,3,7,1140,250,2006,0,98118,47.5323,-122.281,1450,1081,275000,5,6,2014,0,8,-310,-369,0,1,1
3,2.5,1578,7340,2.0,0,0,3,7,1578,0,2010,0,98030,47.3771,-122.186,1850,7200,259950,16,7,2014,0,4,5762,5350,0,0,0
5,3.75,4700,11237,2.0,0,0,3,10,2930,1770,2006,0,98033,47.6624,-122.197,3180,13140,1140000,3,12,2014,0,8,6537,9960,0,1,0
3,3.5,1970,5079,2.0,0,0,3,8,1680,290,2007,0,98144,47.5816,-122.296,1940,6000,590000,5,12,2014,0,7,3109,4060,0,1,1
3,2.25,1460,1353,2.0,0,0,3,8,1050,410,2012,0,98116,47.5774,-122.412,1690,3776,497000,18,9,2014,0,2,-107,2086,0,1,1
3,2.5,1930,4000,2.0,0,0,3,8,1930,0,2014,0,98001,47.3518,-122.275,2050,4000,345500,21,11,2014,0,0,2070,1950,0,0,0
3,2.25,1300,907,2.0,0,0,3,8,1000,300,2006,0,98102,47.6371,-122.327,1300,1169,562500,23,6,2014,0,8,-393,-131,0,1,1
3,2.25,1445,1087,2.0,0,0,3,7,1300,145,2005,0,98027,47.5339,-122.067,1410,1336,355000,4,9,2014,0,9,-358,-74,0,1,0
2,2.25,860,696,2.0,0,0,3,9,860,0,2009,0,98118,47.5663,-122.29,1100,3000,345000,5,9,2014,0,5,-164,1900,0,0,1
3,2.5,3040,4535,2.0,0,0,3,9,3040,0,2007,0,98056,47.51,-122.185,2670,4666,478000,5,5,2014,0,7,1495,1996,0,0,0
3,2.5,2424,6143,2.0,0,0,3,9,2424,0,2014,0,98030,47.3512,-122.135,2381,6036,391500,2,4,2015,0,1,3719,3655,0,0,0
2,1.5,1084,3427,2.0,0,0,3,7,1084,0,1976,0,98125,47.7117,-122.326,1084,6250,265000,12,4,2015,0,39,2343,5166,0,0,1
3,2.5,2510,5320,2.0,0,0,3,8,2510,0,2005,0,98106,47.5374,-122.357,1820,5736,395000,30,10,2014,0,9,2810,3916,0,0,1
2,1.5,1220,1036,3.0,0,0,3,7,1220,0,2006,0,98133,47.7348,-122.347,1210,659,286308,27,7,2014,0,8,-184,-551,0,0,1
2,2.25,1280,835,2.0,0,0,3,7,1080,200,2009,0,98118,47.5592,-122.284,1280,1246,370000,27,5,2014,0,5,-445,-34,0,1,1
5,3.5,3740,5610,2.0,0,0,3,9,2860,880,2014,0,98117,47.6764,-122.392,1520,4590,1080000,23,9,2014,0,0,1870,3070,0,1,1
3,2.5,1852,4000,2.0,0,0,3,7,1852,0,2014,0,98002,47.3451,-122.209,2475,4000,298900,15,10,2014,0,0,2148,1525,0,0,0
4,2.5,2580,5787,2.0,0,0,3,9,2580,0,2007,0,98029,47.5416,-121.994,2580,4410,775000,21,4,2015,0,8,3207,1830,0,0,0
3,2.5,3400,5119,2.0,0,0,3,8,2300,1100,2014,0,98115,47.6843,-122.305,1740,5969,1050000,27,8,2014,0,0,1719,4229,0,1,1
2,1.5,1090,2686,2.0,0,0,3,7,1090,0,1982,0,98034,47.717,-122.19,1160,2158,249000,8,7,2014,0,32,1596,998,0,0,0
3,2.0,2360,6145,1.0,0,0,3,8,2360,0,2011,0,98030,47.3564,-122.198,2304,5880,348000,29,9,2014,0,3,3785,3576,0,0,0
5,2.5,2460,5604,2.0,0,0,3,8,2460,0,2011,0,98038,47.3658,-122.037,2210,6395,358000,14,11,2014,0,3,3144,4185,0,0,0
5,2.5,2025,7760,2.0,0,0,3,7,2025,0,2007,0,98001,47.2671,-122.256,1664,9000,260000,25,6,2014,0,7,5735,7336,0,0,0
4,3.0,4410,5104,2.0,0,0,3,9,3400,1010,2006,0,98065,47.5392,-121.861,4390,5537,765000,4,6,2014,0,8,694,1147,0,1,0
3,2.5,2810,5400,2.0,0,0,3,9,2810,0,2005,0,98052,47.7065,-122.118,2870,5400,739000,28,5,2014,0,9,2590,2530,0,0,0
5,3.5,4490,6000,2.0,0,0,3,10,3200,1290,2006,0,98027,47.5396,-122.073,4530,6000,890000,5,5,2014,0,8,1510,1470,0,1,0
4,2.5,3070,6432,2.0,0,0,3,9,3070,0,2006,0,98055,47.4487,-122.205,2910,5106,462000,7,6,2014,0,8,3362,2196,0,0,0
5,3.5,4750,8234,2.0,0,2,3,10,3350,1400,2013,0,98198,47.3574,-122.318,2160,14496,770000,11,5,2015,0,2,3484,12336,0,1,1
4,3.25,2760,4104,2.0,0,0,3,8,1900,860,2014,0,98056,47.5286,-122.187,2760,5186,641000,18,8,2014,0,0,1344,2426,0,1,0
4,4.0,4360,8175,2.5,1,4,3,10,3940,420,2007,0,98008,47.5724,-122.104,2670,8525,2300000,17,4,2015,0,8,3815,5855,0,1,0
4,3.0,2770,2650,2.0,0,0,3,9,2180,590,2014,0,98109,47.6435,-122.354,1820,2960,1110000,16,9,2014,0,0,-120,1140,0,1,1
3,2.75,1540,1251,2.0,0,0,3,8,1230,310,2002,0,98102,47.6298,-122.321,1540,1287,650000,26,11,2014,0,12,-289,-253,0,1,1
3,2.5,1400,1312,3.5,0,0,3,8,1400,0,2007,0,98103,47.6534,-122.355,1350,1312,563500,25,6,2014,0,7,-88,-38,0,0,1
3,2.5,1680,2229,2.0,0,0,3,7,1680,0,2007,0,98155,47.7484,-122.322,1230,9300,345000,17,6,2014,0,7,549,8070,0,0,1
3,2.0,2260,7163,1.0,0,0,3,9,2260,0,2012,0,98058,47.4593,-122.136,2340,6730,479950,25,7,2014,0,2,4903,4390,0,0,0
4,3.5,3400,5196,2.0,0,0,3,9,3400,0,2012,0,98065,47.5169,-121.884,3170,5260,660000,13,5,2014,0,2,1796,2090,0,0,0
4,2.5,2930,5000,2.0,0,0,3,9,2760,170,2007,0,98006,47.5424,-122.12,3230,5778,800000,29,7,2014,0,7,2070,2548,0,1,0
3,2.0,1239,6036,1.0,0,0,3,7,1239,0,2009,0,98030,47.3689,-122.175,2060,5746,253101,24,7,2014,0,5,4797,3686,0,0,0
3,3.5,2100,2479,2.0,0,0,3,9,1450,650,2011,0,98118,47.562,-122.292,1800,2457,555000,29,9,2014,0,3,379,657,0,1,1
4,1.0,1200,2171,1.5,0,0,3,7,1200,0,1933,0,98133,47.7076,-122.342,1130,1598,240000,26,6,2014,0,81,971,468,0,0,1
4,1.0,1200,2171,1.5,0,0,3,7,1200,0,1933,0,98133,47.7076,-122.342,1130,1598,380000,4,5,2015,0,82,971,468,0,0,1
2,1.5,680,772,2.0,0,0,3,7,680,0,2005,0,98103,47.695,-122.343,690,1059,239000,17,11,2014,0,9,92,369,0,0,1
4,3.25,2690,3995,2.0,0,0,3,9,2060,630,2014,0,98136,47.532,-122.384,1810,4590,760000,18,3,2015,0,1,1305,2780,0,1,1
4,2.5,2750,7200,2.0,0,0,3,8,2750,0,2011,0,98019,47.7327,-121.966,2750,7200,430000,26,8,2014,0,3,4450,4450,0,0,0
3,2.5,2450,4332,2.0,0,0,3,8,2450,0,2010,0,98053,47.6942,-122.016,2450,4154,660000,22,5,2014,0,4,1882,1704,0,0,0
4,2.5,2620,4050,2.0,0,0,3,8,2620,0,2014,0,98146,47.5017,-122.34,2030,3944,399963,20,8,2014,0,0,1430,1914,0,0,1
2,2.0,1130,1148,2.0,0,0,3,9,800,330,2007,0,98122,47.6023,-122.314,1350,1201,411000,18,7,2014,0,7,18,-149,0,1,1
4,2.75,2790,5527,2.0,0,0,3,8,2790,0,2014,0,98045,47.4827,-121.773,2620,5509,483453,27,6,2014,0,0,2737,2889,0,0,0
3,2.0,1820,1357,3.0,0,0,3,9,1820,0,2014,0,98126,47.5432,-122.376,1710,1372,469950,10,11,2014,0,0,-463,-338,0,0,1
4,2.75,2910,7467,2.0,0,0,3,8,2910,0,2013,0,98045,47.4841,-121.772,2790,7868,504058,15,7,2014,0,1,4557,5078,0,0,0
4,2.5,2568,5000,2.0,0,0,3,9,2568,0,2014,0,98092,47.2596,-122.194,2547,4500,425996,28,4,2015,0,1,2432,1953,0,0,0
4,2.75,3090,5859,2.0,0,0,3,9,3090,0,2010,0,98074,47.6057,-122.047,2960,5250,760005,8,7,2014,0,4,2769,2290,0,0,0
2,2.0,1460,1085,2.0,0,0,3,8,950,510,2014,0,98112,47.6205,-122.299,1580,1202,699999,20,4,2015,0,1,-375,-378,0,1,1
3,2.5,2010,2263,2.0,0,0,3,8,1340,670,2014,0,98122,47.6088,-122.311,1500,2670,749950,16,7,2014,0,0,253,1170,0,1,1
4,2.5,2610,5140,2.0,0,0,3,8,2610,0,2006,0,98103,47.6951,-122.346,1190,5101,674600,8,7,2014,0,8,2530,3911,0,0,1
2,1.5,960,1000,2.0,0,0,3,8,920,40,2008,0,98103,47.6489,-122.335,1200,1297,450000,24,2,2015,0,7,40,97,0,1,1
3,2.5,1528,7616,2.0,0,0,3,7,1528,0,2011,0,98030,47.3774,-122.186,1850,7340,272000,7,4,2015,0,4,6088,5490,0,0,0
2,1.5,1310,1264,2.0,0,0,3,8,1120,190,2006,0,98106,47.5772,-122.409,1330,1265,450000,14,7,2014,0,8,-46,-65,0,1,1
3,2.25,1760,2122,3.0,0,0,3,9,1760,0,2015,0,98116,47.5633,-122.385,1420,1618,643950,5,5,2015,0,0,362,198,0,0,1
3,2.5,1420,3542,2.0,0,0,3,8,1310,110,2007,0,98133,47.7731,-122.343,1180,1622,290000,10,11,2014,0,7,2122,442,0,1,1
3,2.5,1650,2082,3.0,0,0,3,8,1650,0,2007,0,98133,47.7108,-122.332,1650,1965,378000,8,10,2014,0,7,432,315,0,0,1
3,2.5,2320,6775,1.0,0,0,3,8,2320,0,2008,0,98053,47.7158,-122.016,1680,4750,728050,19,6,2014,0,6,4455,3070,0,0,0
4,2.5,2628,11466,2.0,0,0,3,9,2628,0,2014,0,98001,47.2904,-122.264,2849,10909,499160,26,4,2015,0,1,8838,8060,0,0,0
4,2.5,2520,4831,2.0,0,0,3,8,2520,0,2009,0,98072,47.7711,-122.168,2430,3937,536000,1,12,2014,0,5,2311,1507,0,0,0
5,3.5,2880,5000,2.0,0,0,3,8,2260,620,2012,0,98038,47.3455,-122.023,2590,4800,419900,5,2,2015,0,3,2120,2210,0,1,0
3,2.25,1440,1362,3.0,0,0,3,7,1440,0,2014,0,98117,47.6908,-122.365,1180,2603,469000,10,12,2014,0,0,-78,1423,0,0,1
3,2.5,2185,6042,2.0,0,0,3,9,2185,0,2009,0,98030,47.3573,-122.202,2297,5876,374000,8,4,2015,0,6,3857,3579,0,0,0
4,1.5,1500,2106,2.0,0,0,3,7,1500,0,2014,0,98108,47.5669,-122.297,1490,2175,182568,28,7,2014,0,0,606,685,0,0,1
3,2.5,1769,7324,2.0,0,0,3,9,1769,0,2012,0,98092,47.3307,-122.188,2502,6017,334888,26,6,2014,0,2,5555,3515,0,0,0
4,4.0,3650,18223,2.0,0,3,3,9,3330,320,2013,0,98006,47.5442,-122.116,3220,11022,799900,17,9,2014,0,1,14573,7802,0,1,0
4,2.5,2160,6223,2.0,0,0,3,8,2160,0,2010,0,98038,47.3494,-122.042,2160,5555,383000,12,5,2014,0,4,4063,3395,0,0,0
3,2.5,2370,4200,2.0,0,0,3,8,2370,0,2014,0,98038,47.3706,-122.017,2370,4200,351999,7,7,2014,0,0,1830,1830,0,0,0
3,3.0,3180,2758,2.0,0,2,3,11,2240,940,2008,0,98109,47.6377,-122.342,2420,2758,1330000,23,2,2015,0,7,-422,338,0,1,1
3,2.5,1780,4077,2.0,0,0,3,8,1780,0,2011,0,98038,47.3568,-122.056,1970,4077,312000,25,1,2015,0,4,2297,2107,0,0,0
4,3.5,2650,3127,2.0,0,0,3,8,2230,420,2011,0,98027,47.5381,-122.046,2330,3137,674950,12,9,2014,0,3,477,807,0,1,0
5,2.75,3300,7560,2.0,0,0,3,10,3300,0,2007,0,98052,47.6467,-122.118,3150,8580,1110000,29,12,2014,0,7,4260,5430,0,0,0
2,2.5,1160,1219,3.0,0,0,3,8,1160,0,2007,0,98107,47.6543,-122.358,1320,2800,415000,13,3,2015,0,8,59,1480,0,0,1
3,3.0,3460,5353,2.0,0,0,3,10,2850,610,2007,0,98116,47.5858,-122.393,2460,6325,1250000,10,7,2014,0,7,1893,3865,0,1,1
3,2.5,1390,2450,2.0,0,0,3,7,1390,0,2009,0,98118,47.5298,-122.269,1390,2450,208800,19,9,2014,0,5,1060,1060,0,0,1
2,2.5,1260,1131,3.0,0,0,3,8,1260,0,2006,0,98107,47.6715,-122.384,1490,2500,452000,29,10,2014,0,8,-129,1010,0,0,1
5,2.75,2940,5225,2.0,0,0,3,8,2760,180,2010,0,98052,47.6879,-122.107,3090,6261,837000,22,4,2015,0,5,2285,3171,0,1,0
5,3.5,3190,4247,2.0,0,0,3,8,2430,760,2013,0,98052,47.7016,-122.103,2580,3989,780000,24,2,2015,0,2,1057,1409,0,1,0
4,3.5,3930,6120,2.0,0,0,3,10,3310,620,2007,0,98105,47.6646,-122.28,3390,6120,1490000,2,10,2014,0,7,2190,2730,0,1,1
5,3.75,3570,10125,2.0,0,0,3,10,3570,0,2014,0,98040,47.5639,-122.223,1760,10125,1600000,26,9,2014,0,0,6555,8365,0,0,0
3,2.5,2420,4725,2.0,0,0,3,8,2420,0,2014,0,98038,47.371,-122.018,2370,4200,369946,18,9,2014,0,0,2305,1830,0,0,0
3,2.75,3400,7200,2.0,0,2,3,9,2470,930,2009,0,98056,47.4878,-122.191,1580,8676,530000,8,6,2014,0,5,3800,7096,0,1,0
4,2.5,2478,6079,2.0,0,0,3,8,2478,0,2012,0,98030,47.3524,-122.175,2279,6079,386000,20,3,2015,0,3,3601,3800,0,0,0
4,2.5,3070,7830,2.0,0,2,3,11,1970,1100,2009,0,98144,47.593,-122.291,2440,4682,1900000,18,2,2015,0,6,4760,2242,0,1,1
4,3.5,3200,7605,2.0,0,2,3,9,2500,700,2013,0,98198,47.3443,-122.327,2240,4416,735000,11,9,2014,0,1,4405,2176,0,1,1
5,3.25,5790,12739,2.0,0,3,3,10,4430,1360,2014,0,98006,47.538,-122.114,5790,13928,1750000,2,10,2014,0,0,6949,8138,0,1,0
3,2.25,1590,926,3.0,0,0,3,8,1590,0,2014,0,98136,47.5402,-122.387,1640,1321,489950,23,2,2015,0,1,-664,-319,0,0,1
3,3.0,1730,1442,2.0,0,0,3,8,1440,290,2008,0,98106,47.5344,-122.348,1370,1524,357500,13,4,2015,0,7,-288,154,0,1,1
4,2.5,2303,3680,2.0,0,0,3,8,2303,0,2013,0,98001,47.2599,-122.283,2303,3760,329995,20,5,2014,0,1,1377,1457,0,0,0
3,2.5,1790,3754,2.0,0,0,3,8,1790,0,2013,0,98065,47.534,-121.841,1800,3393,414000,25,9,2014,0,1,1964,1593,0,0,0
3,3.5,2490,3517,2.0,0,0,3,8,1720,770,2005,0,98027,47.5341,-122.067,1600,2378,533500,10,12,2014,0,9,1027,778,0,1,0
4,2.5,2669,5385,2.0,0,0,3,9,2669,0,2014,0,98092,47.3262,-122.165,2669,4645,402395,5,3,2015,0,1,2716,1976,0,0,0
4,3.25,2610,2552,2.0,0,0,3,10,2160,450,2008,0,98027,47.5322,-122.076,2610,2664,725000,10,4,2015,0,7,-58,54,0,1,0
2,1.75,1290,1493,2.0,0,0,3,8,1290,0,2014,0,98106,47.5171,-122.346,1410,1875,239800,17,9,2014,0,0,203,465,0,0,1
5,3.5,3560,5008,2.0,0,0,3,8,2810,750,2013,0,98106,47.5542,-122.359,2910,5026,616950,4,9,2014,0,1,1448,2116,0,1,1
4,3.25,4360,6000,2.0,0,3,3,11,3400,960,2007,0,98027,47.5408,-121.994,4310,6000,1260000,1,10,2014,0,7,1640,1690,0,1,0
3,2.25,1230,1238,2.0,0,0,3,8,1080,150,2009,0,98199,47.6519,-122.384,1230,953,435000,17,6,2014,0,5,8,-277,0,1,1
2,2.5,1780,2493,3.0,0,0,3,8,1780,0,1981,0,98107,47.6704,-122.358,2050,4400,631500,28,4,2015,0,34,713,2350,0,0,1
3,1.5,1140,1069,3.0,0,0,3,8,1140,0,2005,0,98103,47.6907,-122.342,1230,1276,399995,30,3,2015,0,10,-71,46,0,0,1
3,2.0,1270,1320,3.0,0,0,3,8,1270,0,2006,0,98103,47.6937,-122.342,1370,1320,369950,6,5,2014,0,8,50,-50,0,0,1
5,3.5,2780,3583,2.0,0,0,3,8,2180,600,2005,0,98059,47.4879,-122.152,2640,3850,475000,23,4,2015,0,10,803,1210,0,1,0
4,2.5,1912,5000,2.0,0,0,3,8,1912,0,2012,0,98001,47.3511,-122.275,2020,5000,353000,25,11,2014,0,2,3088,2980,0,0,0
4,2.5,2300,9690,2.0,0,0,3,8,2300,0,2006,0,98023,47.2793,-122.352,1200,9085,329950,25,2,2015,0,9,7390,7885,0,0,0
3,2.5,2828,4050,2.0,0,0,3,8,2828,0,2013,0,98030,47.382,-122.197,2513,4507,367000,13,3,2015,0,2,1222,1994,0,0,0
4,2.5,2425,9017,2.0,0,0,3,9,2425,0,2013,0,98001,47.3003,-122.263,2725,7019,447500,5,9,2014,0,1,6592,4294,0,0,0
4,3.25,3730,4560,2.0,0,0,3,9,2760,970,2015,0,98103,47.6725,-122.33,1800,4560,595000,9,7,2014,0,-1,830,2760,0,1,1
1,1.0,730,1942,1.0,0,0,3,7,730,0,2009,0,98144,47.5943,-122.299,1020,2044,325000,4,9,2014,0,5,1212,1024,0,0,1
2,2.5,1990,1756,3.0,0,0,3,9,1780,210,2005,0,98102,47.6264,-122.323,1955,1438,690000,3,2,2015,0,10,-234,-517,0,1,1
3,2.5,1300,812,2.0,0,0,3,8,880,420,2008,0,98144,47.5893,-122.317,1300,824,329950,11,11,2014,0,6,-488,-476,0,1,1
4,2.5,2560,7492,2.0,0,0,3,8,2560,0,2014,0,98188,47.4467,-122.287,1260,11541,399500,28,1,2015,0,1,4932,10281,0,0,1
5,2.5,2450,5047,2.0,0,0,3,8,2450,0,2007,0,98011,47.7724,-122.168,2450,4478,555000,21,1,2015,0,8,2597,2028,0,0,0
2,1.5,1440,725,2.0,0,0,3,8,1100,340,2011,0,98126,47.5607,-122.378,1440,4255,427000,1,10,2014,0,3,-715,2815,0,1,1
3,2.25,1140,1557,3.0,0,0,3,8,1140,0,2007,0,98103,47.6947,-122.342,1140,1245,375000,20,10,2014,0,7,417,105,0,0,1
2,1.5,1110,957,2.0,0,0,3,8,930,180,2005,0,98119,47.6319,-122.362,1680,1104,499000,8,5,2014,0,9,-153,-576,0,1,1
3,2.5,1690,1200,2.0,0,0,3,8,1410,280,2014,0,98106,47.5388,-122.367,1740,1664,336900,29,12,2014,0,0,-490,-76,0,1,1
2,2.75,1950,1610,3.0,0,0,3,8,1950,0,2009,0,98144,47.5925,-122.302,910,1745,555000,19,9,2014,0,5,-340,835,0,0,1
4,3.5,3530,8126,2.0,0,0,3,10,3530,0,2007,0,98033,47.6847,-122.2,2660,8126,1280000,6,11,2014,0,7,4596,5466,0,0,0
4,3.5,3310,4684,2.0,0,0,3,9,2290,1020,2014,0,98116,47.579,-122.389,1850,4750,999950,14,10,2014,0,0,1374,2900,0,1,1
5,3.0,2620,5477,2.0,0,0,3,10,2620,0,2009,0,98115,47.6804,-122.288,1680,5217,975000,25,6,2014,0,5,2857,3537,0,0,1
3,2.25,1350,3582,2.0,0,0,3,8,1350,0,2010,0,98031,47.4214,-122.191,1940,3860,299000,19,2,2015,0,5,2232,1920,0,0,0
2,2.5,1741,1439,2.0,0,0,3,8,1446,295,2007,0,98034,47.7043,-122.209,2090,10454,479000,17,4,2015,0,8,-302,8364,0,1,0
3,2.5,1650,2201,3.0,0,0,3,8,1650,0,2007,0,98133,47.7108,-122.333,1650,1965,428000,17,4,2015,0,8,551,315,0,0,1
3,2.5,1890,6500,2.0,0,0,3,7,1890,0,2012,0,98074,47.6225,-122.058,2340,7500,409000,29,8,2014,0,2,4610,5160,0,0,0
3,3.0,1950,1833,3.0,0,0,3,9,1610,340,2009,0,98004,47.6078,-122.202,2040,2131,798500,26,3,2015,0,6,-117,91,0,1,0
4,3.5,4490,5805,2.0,0,0,3,9,3390,1100,2006,0,98065,47.5389,-121.86,4410,6299,689000,12,12,2014,0,8,1315,1889,0,1,0
6,2.25,3206,5793,2.0,0,0,3,7,3206,0,2012,0,98032,47.369,-122.287,2527,5804,375000,8,5,2014,0,2,2587,3277,0,0,0
5,3.0,2800,5700,2.0,0,0,3,8,2800,0,2014,0,98059,47.4969,-122.145,2910,5349,639983,14,10,2014,0,0,2900,2439,0,0,0
4,3.0,1984,4419,2.0,0,0,3,7,1984,0,2010,0,98002,47.3514,-122.213,2440,4418,300000,26,3,2015,0,5,2435,1978,0,0,0
4,2.5,2750,11830,2.0,0,0,3,9,2750,0,2014,0,98059,47.4698,-122.121,2310,11830,627000,22,12,2014,0,0,9080,9520,0,0,0
3,2.75,1740,5757,1.0,0,0,3,7,1740,0,2010,0,98022,47.1941,-121.979,2380,5647,275000,15,4,2015,0,5,4017,3267,0,0,0
4,2.25,1800,2752,2.0,0,0,3,8,1800,0,2014,0,98106,47.5167,-122.346,1650,2752,352800,26,9,2014,0,0,952,1102,0,0,1
3,2.25,1540,1005,3.0,0,0,3,8,1540,0,2008,0,98103,47.6828,-122.346,1510,1501,565000,12,3,2015,0,7,-535,-9,0,0,1
4,2.25,2030,2222,2.0,0,0,3,9,1610,420,2015,0,98117,47.679,-122.375,1420,2222,765000,14,4,2015,0,0,192,802,0,1,1
4,2.5,3310,4839,2.0,0,0,3,9,3310,0,2007,0,98072,47.773,-122.161,3240,5280,644000,9,4,2015,0,8,1529,2040,0,0,0
3,1.5,1270,1416,3.0,0,0,3,8,1270,0,2007,0,98115,47.6988,-122.317,1270,1413,461000,23,2,2015,0,8,146,143,0,0,1
5,2.5,2406,7093,2.0,0,0,3,8,2406,0,2006,0,98001,47.2615,-122.252,1767,7093,270500,23,12,2014,0,8,4687,5326,0,0,0
2,2.25,1540,965,3.0,0,0,3,9,1540,0,2007,0,98122,47.6181,-122.318,1410,964,640000,1,7,2014,0,7,-575,-446,0,0,1
4,2.5,2820,6983,2.0,0,0,3,9,2820,0,2013,0,98001,47.2958,-122.265,2597,7222,457000,5,8,2014,0,1,4163,4625,0,0,0
5,2.5,2540,5100,2.0,0,0,3,7,2540,0,2014,0,98168,47.5123,-122.316,1400,9440,355000,1,12,2014,0,0,2560,8040,0,0,1
2,2.25,1230,989,3.0,0,0,3,8,1230,0,2007,0,98103,47.6975,-122.348,1230,1223,356000,15,12,2014,0,7,-241,-7,0,0,1
4,2.5,1900,2766,2.0,0,0,3,8,1900,0,2014,0,98106,47.543,-122.368,1900,2604,425000,5,8,2014,0,0,866,704,0,0,1
5,2.75,2920,6327,2.0,0,0,3,8,2920,0,2007,0,98059,47.4935,-122.145,2520,5026,562500,23,9,2014,0,7,3407,2506,0,0,0
3,2.5,1450,1053,2.0,0,0,3,8,940,510,2008,0,98107,47.6754,-122.374,1410,1080,460000,1,7,2014,0,6,-397,-330,0,1,1
3,2.0,1270,1333,3.0,0,0,3,8,1270,0,2006,0,98103,47.6933,-122.342,1330,1333,401000,18,3,2015,0,9,63,3,0,0,1
3,2.5,2550,5100,2.0,0,0,3,9,2550,0,2014,0,98115,47.6757,-122.326,1250,4080,1100000,28,8,2014,0,0,2550,2830,0,0,1
4,3.0,3070,7150,2.0,0,0,3,9,3070,0,2007,0,98052,47.7079,-122.107,3200,6984,850000,3,4,2015,0,8,4080,3784,0,0,0
3,2.25,1450,4050,2.0,0,0,3,7,1450,0,2010,0,98038,47.367,-122.019,1660,3800,274500,2,7,2014,0,4,2600,2140,0,0,0
5,3.5,4230,16526,2.0,0,0,3,10,4230,0,2008,0,98004,47.5933,-122.199,3000,12362,1940000,15,4,2015,0,7,12296,9362,0,0,0
4,2.5,3480,6262,2.0,0,0,3,9,3480,0,2003,0,98053,47.6857,-122.045,3490,6629,808000,4,8,2014,0,11,2782,3139,0,0,0
3,2.25,1490,974,2.0,0,0,3,7,1220,270,2009,0,98106,47.5567,-122.363,1490,1283,312000,15,5,2014,0,5,-516,-207,0,1,1
3,2.25,1200,1400,3.0,0,0,3,8,1200,0,2005,0,98133,47.7046,-122.357,1370,6552,320000,16,6,2014,0,9,200,5182,0,0,1
3,2.5,2150,4332,2.0,0,0,3,8,2150,0,2013,0,98019,47.7373,-121.969,2140,4332,410000,13,1,2015,0,2,2182,2192,0,0,0
3,3.5,3690,8837,2.0,0,0,3,10,3690,0,2001,0,98065,47.5402,-121.876,3690,9585,725000,20,6,2014,0,13,5147,5895,0,0,0
4,2.5,1900,3301,2.0,0,0,3,7,1900,0,2007,0,98178,47.489,-122.249,1960,3379,335000,15,10,2014,0,7,1401,1419,0,0,1
4,3.25,1690,1321,2.0,0,0,3,8,1320,370,2014,0,98052,47.678,-122.117,3080,4558,519990,20,1,2015,0,1,-369,1478,0,1,0
4,2.75,2790,8853,2.0,0,0,3,8,2790,0,2013,0,98045,47.4842,-121.772,2790,8092,533112,10,6,2014,0,1,6063,5302,0,0,0
2,2.25,1150,711,2.0,0,0,3,7,1150,0,2013,0,98027,47.5323,-122.07,1150,748,325000,22,12,2014,0,1,-439,-402,0,0,0
4,2.5,2470,7539,2.0,0,0,3,9,2470,0,2006,0,98028,47.7407,-122.226,2580,7539,550000,23,9,2014,0,8,5069,4959,0,0,0
4,2.5,1890,4158,2.0,0,0,3,8,1890,0,2014,0,98042,47.343,-122.056,2720,4549,311850,9,3,2015,0,1,2268,1829,0,0,0
3,2.5,1626,1583,2.5,0,0,3,8,1419,207,2007,0,98122,47.6031,-122.309,1400,1583,526000,10,2,2015,0,8,-43,183,0,1,1
4,2.5,2250,5306,2.0,0,0,3,8,2250,0,2012,0,98038,47.356,-122.057,2250,5306,375000,1,10,2014,0,2,3056,3056,0,0,0
3,2.25,1350,1234,2.0,0,0,3,7,1160,190,2007,0,98106,47.5565,-122.363,1420,1234,299999,23,2,2015,0,8,-116,-186,0,1,1
3,2.5,1460,1238,2.0,0,0,3,8,1200,260,2008,0,98107,47.6719,-122.374,1280,1257,436000,19,9,2014,0,6,-222,-23,0,1,1
3,2.5,2056,3564,2.0,0,0,3,7,2056,0,2014,0,98092,47.338,-122.181,2056,3577,303000,12,12,2014,0,0,1508,1521,0,0,0
2,2.5,1160,1458,2.0,0,0,3,8,1040,120,2012,0,98119,47.6384,-122.373,1650,2311,525000,1,7,2014,0,2,298,661,0,1,1
3,3.0,1384,1287,2.0,0,0,3,8,1144,240,2006,0,98102,47.6295,-122.32,1570,1288,575000,13,6,2014,0,8,-97,-282,0,1,1
2,1.5,1100,1107,3.0,0,0,3,8,1100,0,2008,0,98103,47.6584,-122.35,1110,2750,420000,24,10,2014,0,6,7,1640,0,0,1
3,2.5,2456,7566,2.0,0,0,3,8,2456,0,2012,0,98023,47.297,-122.351,2478,7212,329950,11,6,2014,0,2,5110,4734,0,0,0
4,3.25,3780,10099,1.0,0,1,3,11,2240,1540,2006,0,98006,47.5508,-122.192,3120,10669,1180000,8,4,2015,0,9,6319,7549,0,1,0
2,2.5,1320,1157,2.0,0,0,3,8,990,330,2014,0,98107,47.6689,-122.363,1550,1519,499950,11,9,2014,0,0,-163,-31,0,1,1
4,3.0,5940,11533,2.0,0,4,3,11,4950,990,2004,0,98065,47.5443,-121.87,4240,12813,1150000,27,5,2014,0,10,5593,8573,0,1,0
3,2.0,1650,5027,1.5,0,0,3,7,1650,0,2009,0,98065,47.515,-121.874,2430,6000,400000,18,2,2015,0,6,3377,3570,0,0,0
3,3.0,1670,4440,1.0,0,0,3,7,1670,0,2014,0,98022,47.1948,-121.975,1670,4622,246950,27,6,2014,0,0,2770,2952,0,0,0
3,3.25,1610,1275,2.0,0,0,3,8,1220,390,2005,0,98102,47.6236,-122.318,1750,3000,630000,6,8,2014,0,9,-335,1250,0,1,1
5,2.75,3370,10315,2.0,0,0,3,9,3370,0,2006,0,98059,47.4893,-122.146,3010,8296,561000,12,9,2014,0,8,6945,5286,0,0,0
4,2.5,2660,4082,2.0,0,0,3,7,2660,0,2010,0,98042,47.3414,-122.055,2390,4876,287000,8,12,2014,0,4,1422,2486,0,0,0
3,3.25,1690,1473,2.0,0,0,3,8,1380,310,2008,0,98109,47.6397,-122.345,1670,2594,600000,31,3,2015,0,7,-217,924,0,1,1
3,2.25,1620,1062,3.0,0,0,3,8,1620,0,2014,0,98122,47.6051,-122.304,1560,1728,490000,28,8,2014,0,0,-558,168,0,0,1
3,1.75,1300,958,2.0,0,0,3,7,840,460,2011,0,98108,47.5677,-122.314,1340,1254,330000,30,3,2015,0,4,-342,-86,0,1,1
4,2.5,1610,4052,2.0,0,0,3,7,1610,0,2013,0,98042,47.3603,-122.081,2110,4034,286950,1,12,2014,0,1,2442,1924,0,0,0
3,3.25,3530,4920,2.0,0,0,3,9,2660,870,2015,0,98109,47.641,-122.357,1900,4200,1550000,23,4,2015,0,0,1390,2300,0,1,1
4,2.5,3550,8618,2.0,0,0,3,10,3550,0,2007,0,98052,47.6776,-122.161,1310,9746,880000,12,2,2015,0,8,5068,8436,0,0,0
3,3.0,1730,1755,3.0,0,0,3,8,1730,0,2014,0,98117,47.6944,-122.377,1830,1804,577450,13,10,2014,0,0,25,-26,0,0,1
5,2.75,2400,4900,2.0,0,0,3,8,2400,0,2011,0,98038,47.355,-122.057,2110,5696,405000,30,4,2015,0,4,2500,3586,0,0,0
3,2.5,1420,1237,3.0,0,0,3,8,1420,0,2014,0,98107,47.674,-122.387,1510,2501,510000,7,7,2014,0,0,-183,991,0,0,1
2,1.5,1220,1120,2.5,0,0,3,8,1110,110,2008,0,98199,47.6374,-122.388,2010,3175,465000,12,8,2014,0,6,-100,1165,0,1,1
4,2.25,2360,4000,2.0,0,0,3,9,2360,0,2013,0,98112,47.6198,-122.289,3040,4400,1300000,7,7,2014,0,1,1640,1360,0,0,1
4,3.5,3990,11270,2.0,0,3,3,9,2930,1060,2007,0,98055,47.488,-122.225,1980,11328,609000,8,4,2015,0,8,7280,9348,0,1,0
3,2.5,1260,1211,3.0,0,0,3,8,1260,0,2004,0,98103,47.6969,-122.343,1270,1211,336000,11,9,2014,0,10,-49,-59,0,0,1
3,2.5,1580,2407,2.0,0,0,3,8,1580,0,2013,0,98126,47.5455,-122.368,1580,2212,375000,8,1,2015,0,2,827,632,0,0,1
3,2.5,1760,2688,2.0,0,0,3,7,1760,0,2005,0,98059,47.4903,-122.166,1760,2329,294500,4,12,2014,0,9,928,569,0,0,0
5,3.5,3420,4216,2.0,0,0,3,9,2520,900,2008,0,98115,47.6799,-122.304,1420,4500,925000,25,11,2014,0,6,796,3080,0,1,1
5,2.75,2870,6593,2.0,0,0,3,9,2870,0,2006,0,98052,47.7075,-122.102,3150,6593,730000,15,12,2014,0,8,3723,3443,0,0,0
4,2.5,1934,5677,2.0,0,0,3,8,1934,0,2013,0,98001,47.2602,-122.252,1919,5049,280000,19,9,2014,0,1,3743,3130,0,0,0
3,1.5,1220,962,3.0,0,0,3,8,1220,0,2014,0,98107,47.674,-122.387,1510,2501,500000,15,8,2014,0,0,-258,991,0,0,1
3,2.75,2450,5750,2.0,0,0,3,9,2450,0,2013,0,98065,47.5439,-121.862,3200,8036,605000,24,3,2015,0,2,3300,4836,0,0,0
3,3.25,1860,1787,3.0,0,0,3,8,1860,0,2007,0,98155,47.7563,-122.316,1830,1787,379950,16,5,2014,0,7,-73,-43,0,0,1
3,2.5,1500,1119,3.0,0,2,3,7,1110,390,2008,0,98109,47.6327,-122.346,1500,1057,605000,23,3,2015,0,7,-381,-443,0,1,1
2,1.75,1570,1108,3.0,0,0,3,9,1570,0,2007,0,98004,47.6215,-122.2,1940,1160,720000,1,5,2015,0,8,-462,-780,0,0,0
3,2.0,1280,960,2.0,0,0,3,9,1040,240,2014,0,98122,47.602,-122.311,1280,1173,549900,3,11,2014,0,0,-320,-107,0,1,1
3,2.5,3192,5653,2.0,0,0,3,8,3192,0,2014,0,98023,47.2956,-122.35,3000,5134,427000,21,1,2015,0,1,2461,2134,0,0,0
3,2.5,1690,1479,3.0,0,0,3,8,1420,270,2005,0,98122,47.6022,-122.311,1280,1253,492000,28,10,2014,0,9,-211,-27,0,1,1
2,2.5,1590,1426,2.0,0,0,3,8,1590,0,2014,0,98029,47.5441,-122.013,1590,1426,419190,5,5,2014,0,0,-164,-164,0,0,0
3,2.5,2870,7288,2.0,0,0,3,9,2870,0,2012,0,98011,47.7745,-122.225,2870,5998,650000,12,11,2014,0,2,4418,3128,0,0,0
4,2.5,2580,4818,2.0,0,0,3,8,2580,0,2005,0,98038,47.3607,-122.038,2570,5386,379950,24,11,2014,0,9,2238,2816,0,0,0
4,2.75,1830,3420,2.0,0,0,3,8,1830,0,2012,0,98198,47.366,-122.308,1813,3420,269800,28,7,2014,0,2,1590,1607,0,0,1
4,2.5,2927,6000,2.0,0,0,3,7,2927,0,2011,0,98042,47.3737,-122.16,2533,6000,407000,13,8,2014,0,3,3073,3467,0,0,0
3,1.5,1320,1250,3.0,0,0,3,8,1320,0,2008,0,98103,47.6536,-122.341,1560,1694,580000,15,4,2015,0,7,-70,134,0,0,1
3,2.5,1720,3581,2.0,0,0,3,7,1720,0,2011,0,98053,47.6861,-122.013,1720,3600,389700,16,1,2015,0,4,1861,1880,0,0,0
2,1.0,828,4524,1.0,0,0,3,6,828,0,1968,2007,98001,47.2655,-122.244,828,5402,110000,11,3,2015,39,47,3696,4574,1,0,0
3,1.5,1040,1264,2.0,0,0,3,9,900,140,2015,0,98144,47.5951,-122.301,1350,3000,230000,31,7,2014,0,-1,224,1650,0,1,1
4,2.75,2790,6685,2.0,0,0,3,8,2790,0,2014,0,98045,47.4838,-121.773,2790,6444,533380,29,8,2014,0,0,3895,3654,0,0,0
3,2.5,1410,1332,2.0,0,0,3,7,960,450,2014,0,98108,47.5683,-122.314,1410,1343,295500,18,9,2014,0,0,-78,-67,0,1,1
4,4.5,4040,8400,2.0,0,0,3,9,3220,820,2006,0,98052,47.7067,-122.131,3940,8400,860000,7,10,2014,0,8,4360,4460,0,1,0
4,3.5,3370,3634,2.0,0,0,3,9,2750,620,2007,0,98029,47.5519,-122.001,3200,3650,812000,8,7,2014,0,7,264,450,0,1,0
3,2.5,1660,3990,2.0,0,0,3,7,1660,0,2009,0,98118,47.5298,-122.268,1670,4050,324500,5,6,2014,0,5,2330,2380,0,0,1
2,1.75,910,2550,1.0,0,0,3,6,910,0,2004,0,98038,47.3494,-122.022,1310,2550,193000,26,3,2015,0,11,1640,1240,0,0,0
3,2.25,1280,959,3.0,0,0,3,8,1280,0,2005,0,98103,47.6914,-122.343,1130,1126,355000,22,5,2014,0,9,-321,-4,0,0,1
4,2.75,2360,4924,2.0,0,0,3,8,2360,0,2008,0,98028,47.7737,-122.235,2360,4670,525000,14,6,2014,0,6,2564,2310,0,0,0
3,2.5,2529,9653,2.0,0,0,3,7,2529,0,2012,0,98042,47.3738,-122.161,2533,6125,370950,27,2,2015,0,3,7124,3592,0,0,0
4,3.5,4700,10183,1.0,0,2,3,11,2660,2040,2002,0,98033,47.6728,-122.189,3770,9000,1240000,7,11,2014,0,12,5483,5230,0,1,0
4,2.75,3540,5500,2.0,0,0,3,9,3540,0,2014,0,98074,47.6181,-122.056,3540,5500,888990,18,9,2014,0,0,1960,1960,0,0,0
3,2.5,1580,1321,2.0,0,2,3,8,1080,500,2014,0,98107,47.6688,-122.402,1530,1357,705000,19,3,2015,0,1,-259,-173,0,1,1
3,2.5,1700,2250,2.0,0,0,3,7,1700,0,2014,0,98168,47.4914,-122.334,1520,4500,268000,26,8,2014,0,0,550,2980,0,0,1
3,2.5,1600,3573,2.0,0,0,3,7,1600,0,2013,0,98056,47.507,-122.181,1500,11089,305450,7,5,2014,0,1,1973,9589,0,0,0
2,1.75,1410,1005,1.5,0,0,3,9,900,510,2011,0,98027,47.5446,-122.018,1440,1188,399900,3,7,2014,0,3,-405,-252,0,1,0
3,1.5,1580,1228,3.0,0,0,3,8,1580,0,2014,0,98115,47.6765,-122.32,1580,3605,495000,29,12,2014,0,0,-352,2025,0,0,1
3,3.5,3940,11632,2.0,0,0,3,10,3940,0,2014,0,98166,47.438,-122.344,2015,11632,857326,4,11,2014,0,0,7692,9617,0,0,1
5,2.75,4450,9600,2.0,0,0,3,9,3650,800,2014,0,98011,47.7336,-122.21,4000,9750,845950,11,9,2014,0,0,5150,5750,0,1,0
4,2.5,2009,5000,2.0,0,0,3,8,2009,0,2014,0,98092,47.2577,-122.198,2009,5182,303210,10,6,2014,0,0,2991,3173,0,0,0
3,2.5,2090,4590,2.0,0,0,3,7,2090,0,2005,0,98042,47.3992,-122.163,2190,4060,300000,16,7,2014,0,9,2500,1870,0,0,0
2,2.5,980,1013,3.0,0,0,3,8,980,0,2008,0,98117,47.6844,-122.387,980,1023,334900,22,11,2014,0,6,33,43,0,0,1
5,3.5,2815,5619,2.0,0,0,3,9,2815,0,2012,0,98055,47.4299,-122.207,2583,5295,477500,16,4,2015,0,3,2804,2712,0,0,0
4,2.5,3170,8523,2.0,0,0,3,9,3170,0,2008,0,98033,47.6854,-122.184,3230,8523,820000,18,6,2014,0,6,5353,5293,0,0,0
5,3.25,3030,7410,2.0,0,0,3,8,2150,880,2014,0,98106,47.553,-122.354,2020,7410,580000,5,8,2014,0,0,4380,5390,0,1,1
2,2.5,1280,940,2.0,0,0,3,8,1060,220,2006,0,98103,47.6904,-122.364,1290,2900,350000,22,7,2014,0,8,-340,1610,0,1,1
3,2.5,2030,1160,3.0,0,0,3,9,1970,60,2007,0,98004,47.6213,-122.2,1950,1160,910000,26,2,2015,0,8,-870,-790,0,1,0
3,2.5,2490,4540,2.5,0,0,3,8,2490,0,2012,0,98059,47.5051,-122.155,2640,3844,414000,26,6,2014,0,2,2050,1204,0,0,0
3,2.5,3030,4500,2.0,0,0,3,8,3030,0,2009,0,98059,47.4944,-122.15,3030,4501,525000,30,3,2015,0,6,1470,1471,0,0,0
2,2.5,1470,690,3.0,0,3,3,8,1470,0,2008,0,98103,47.6523,-122.346,1480,1284,650000,9,4,2015,0,7,-780,-196,0,0,1
3,2.25,1620,997,2.5,0,0,3,8,1540,80,2012,0,98027,47.5394,-122.027,1620,1068,450000,10,12,2014,0,2,-623,-552,0,1,0
4,3.0,5520,8313,2.0,0,3,3,9,3570,1950,2008,0,98006,47.5655,-122.129,3770,8278,1270000,16,5,2014,0,6,2793,4508,0,1,0
4,2.5,2580,3943,2.0,0,0,3,8,2580,0,2013,0,98033,47.6853,-122.21,1700,5772,899000,23,7,2014,0,1,1363,4072,0,0,0
4,3.0,2050,4000,2.0,0,0,3,8,2050,0,2014,0,98001,47.3523,-122.275,2050,4000,353500,8,8,2014,0,0,1950,1950,0,0,0
3,2.5,2430,5867,2.0,0,0,3,7,2430,0,2011,0,98065,47.5162,-121.872,2620,5866,485000,8,9,2014,0,3,3437,3246,0,0,0
4,3.25,3060,3898,2.0,0,0,3,10,2300,760,2014,0,98027,47.5311,-122.073,2920,3448,782900,26,6,2014,0,0,838,528,0,1,0
2,2.0,1540,9714,2.0,0,0,3,8,1540,0,2008,0,98177,47.7628,-122.359,1840,8179,529000,28,4,2015,0,7,8174,6339,0,0,1
3,3.25,1310,1072,2.0,0,0,3,8,1060,250,2008,0,98107,47.6744,-122.374,1160,1266,514700,16,4,2015,0,7,-238,106,0,1,1
3,2.5,1800,3168,2.0,0,0,3,8,1800,0,2014,0,98065,47.5342,-121.841,1800,3393,409316,20,5,2014,0,0,1368,1593,0,0,0
3,2.5,2370,4200,2.0,0,0,3,8,2370,0,2014,0,98038,47.3699,-122.019,2370,4370,388598,6,5,2015,0,1,1830,2000,0,0,0
3,2.25,1445,1512,2.0,0,0,3,7,1300,145,2004,0,98027,47.5341,-122.069,1445,1082,415000,27,2,2015,0,11,67,-363,0,1,0
3,2.25,1450,1619,2.0,0,0,3,8,1140,310,2006,0,98122,47.6076,-122.304,1580,3472,521500,7,4,2015,0,9,169,1892,0,1,1
3,2.5,1740,1236,3.0,0,2,3,8,1740,0,2008,0,98116,47.5891,-122.387,1740,1280,580000,20,8,2014,0,6,-504,-460,0,0,1
4,2.5,3560,5265,3.0,0,0,3,8,3560,0,2014,0,98052,47.7047,-122.113,3220,4892,882566,30,6,2014,0,0,1705,1672,0,0,0
3,2.75,2130,1400,2.0,0,0,3,9,1080,1050,2010,0,98118,47.5661,-122.29,1880,3132,525000,8,4,2015,0,5,-730,1252,0,1,1
5,2.75,2980,4502,2.0,0,0,3,9,2980,0,2007,0,98028,47.7698,-122.235,2850,4501,515000,1,12,2014,0,7,1522,1651,0,0,0
3,3.0,2840,7201,2.0,0,0,3,9,2840,0,2014,0,98065,47.5165,-121.883,2540,5260,589410,26,9,2014,0,0,4361,2720,0,0,0
4,2.5,3420,6845,2.0,0,0,3,9,3420,0,2009,0,98052,47.6777,-122.156,2800,5715,757500,24,3,2015,0,6,3425,2915,0,0,0
3,2.5,1660,4083,2.0,0,0,3,7,1660,0,2013,0,98038,47.3595,-122.045,1800,4087,284000,2,10,2014,0,1,2423,2287,0,0,0
2,2.25,1150,711,2.0,0,0,3,7,1150,0,2013,0,98027,47.5323,-122.071,1150,748,338500,28,3,2015,0,2,-439,-402,0,0,0
3,2.25,1410,1287,2.0,0,0,3,7,1290,120,2005,0,98027,47.5344,-122.068,1490,1435,379500,13,6,2014,0,9,-123,-55,0,1,0
3,2.0,1420,1369,2.5,0,0,3,9,1340,80,2007,0,98109,47.6472,-122.357,1540,2168,550000,23,7,2014,0,7,-51,628,0,1,1
3,2.5,1860,5025,2.0,0,0,3,8,1860,0,2010,0,98038,47.3557,-122.059,2000,5550,294900,2,9,2014,0,4,3165,3550,0,0,0
2,1.5,1340,1210,2.0,0,0,3,8,1120,220,2008,0,98144,47.588,-122.305,1340,1213,345000,9,6,2014,0,6,-130,-127,0,1,1
2,1.5,1530,1012,2.0,0,0,3,8,1200,330,2005,0,98122,47.602,-122.306,1530,1425,450000,9,2,2015,0,10,-518,-105,0,1,1
3,2.5,1509,1114,3.0,0,0,3,8,1509,0,2014,0,98133,47.7049,-122.34,1509,2431,420000,15,4,2015,0,1,-395,922,0,0,1
3,2.5,2350,3798,2.0,0,0,3,8,2350,0,2013,0,98029,47.543,-122.01,2020,3532,740000,2,4,2015,0,2,1448,1512,0,0,0
2,1.5,1010,825,3.0,0,0,3,7,1010,0,2007,0,98125,47.7124,-122.301,1128,1080,286000,20,2,2015,0,8,-185,-48,0,0,1
5,3.5,4495,10079,2.0,0,0,3,9,3580,915,2013,0,98011,47.7339,-122.209,4495,10079,870000,17,3,2015,0,2,5584,5584,0,1,0
3,2.5,1580,991,3.0,0,0,3,9,1580,0,2009,0,98119,47.6276,-122.359,1610,1297,727000,14,11,2014,0,5,-589,-313,0,0,1
4,3.0,2750,7965,2.0,0,0,3,9,2750,0,2012,0,98038,47.3479,-122.028,2750,6000,395000,4,2,2015,0,3,5215,3250,0,0,0
4,2.25,1890,3615,2.0,0,0,3,7,1890,0,2005,0,98029,47.5493,-121.999,1630,3280,535000,5,8,2014,0,9,1725,1650,0,0,0
3,2.25,1320,963,2.0,0,0,3,7,1040,280,2007,0,98106,47.5199,-122.357,1300,1285,255000,29,12,2014,0,7,-357,-15,0,1,1
4,2.5,2150,3721,2.0,0,0,3,8,2150,0,2006,0,98002,47.3363,-122.217,2150,3721,260000,15,10,2014,0,8,1571,1571,0,0,0
4,2.5,3340,8384,2.0,0,0,3,9,3340,0,2014,0,98052,47.6761,-122.152,1560,9429,810000,10,9,2014,0,0,5044,7869,0,0,0
3,2.5,1850,3400,2.0,0,0,3,7,1850,0,2010,0,98053,47.6871,-122.014,1850,3400,359782,1,12,2014,0,4,1550,1550,0,0,0
2,2.5,1950,2162,2.0,0,0,3,9,1500,450,2012,0,98118,47.5622,-122.292,1800,2457,500000,20,3,2015,0,3,212,657,0,1,1
5,3.25,4240,9588,2.0,0,0,3,9,4240,0,2014,0,98053,47.6901,-122.018,4080,8425,1050000,27,10,2014,0,0,5348,4345,0,0,0
4,3.5,2700,2868,2.0,0,0,3,11,1920,780,2006,0,98118,47.5685,-122.286,1430,3858,810000,25,2,2015,0,9,168,2428,0,1,1
5,4.0,3040,6000,2.0,0,0,3,8,2280,760,2011,0,98065,47.5189,-121.876,3070,5558,605000,6,2,2015,0,4,2960,2488,0,1,0
4,2.5,2460,7930,2.0,0,0,3,8,2460,0,2005,0,98033,47.6684,-122.175,1850,9000,730000,17,3,2015,0,10,5470,7150,0,0,0
4,2.5,2110,3825,2.0,0,0,3,7,2110,0,2013,0,98042,47.359,-122.082,1950,3825,327000,17,3,2015,0,2,1715,1875,0,0,0
2,1.0,780,1133,2.0,0,0,3,7,780,0,2009,0,98144,47.5924,-122.295,1130,1270,370000,10,11,2014,0,5,353,140,0,0,1
5,3.5,2640,6895,2.0,0,0,3,7,2640,0,2001,0,98065,47.5298,-121.879,2640,5267,459000,25,6,2014,0,13,4255,2627,0,0,0
4,2.5,2420,8404,2.0,0,0,3,8,2420,0,2013,0,98042,47.372,-122.13,2440,4822,365000,10,12,2014,0,1,5984,2382,0,0,0
4,2.5,1987,6000,2.0,0,0,3,7,1987,0,2011,0,98001,47.2679,-122.255,1880,9589,255000,26,12,2014,0,3,4013,7709,0,0,0
1,1.0,720,3166,1.0,0,0,3,6,720,0,1920,0,98116,47.5811,-122.389,1140,6250,375000,17,7,2014,0,94,2446,5110,0,0,1
2,1.5,1130,912,2.0,0,0,3,8,1000,130,2006,0,98116,47.5638,-122.388,1500,1474,375000,2,10,2014,0,8,-218,-26,0,1,1
4,2.5,2810,4500,2.0,0,0,3,9,2810,0,2014,0,98038,47.3552,-122.023,2980,5046,518380,22,7,2014,0,0,1690,2066,0,0,0
3,3.25,1500,1442,2.0,0,0,3,8,1150,350,2007,0,98106,47.5592,-122.362,1500,1533,346000,21,7,2014,0,7,-58,33,0,1,1
4,2.0,1390,745,3.0,0,0,3,7,1390,0,2008,0,98027,47.5393,-122.026,1390,942,302059,23,2,2015,0,7,-645,-448,0,0,0
4,2.5,2500,4945,2.0,0,0,3,9,2500,0,2013,0,98065,47.5185,-121.885,2760,6000,575000,19,5,2014,0,1,2445,3240,0,0,0
4,3.5,3906,9674,2.0,0,2,3,9,3906,0,2014,0,98001,47.2931,-122.264,2673,6500,549950,23,7,2014,0,0,5768,3827,0,0,0
3,2.5,1470,1256,2.0,0,0,3,8,930,540,2006,0,98122,47.6033,-122.309,1510,1797,397500,11,7,2014,0,8,-214,287,0,1,1
5,3.5,3230,7560,2.0,0,0,3,10,3230,0,2007,0,98052,47.6467,-122.118,3230,8580,1080000,21,11,2014,0,7,4330,5350,0,0,0
3,2.5,2700,5764,2.0,0,0,3,9,2700,0,2014,0,98075,47.5618,-122.027,3270,14700,775900,22,4,2015,0,1,3064,11430,0,0,0
4,2.5,4073,17334,2.0,0,0,3,8,4073,0,2008,0,98001,47.2949,-122.27,1780,9625,510000,8,5,2015,0,7,13261,7845,0,0,0
4,2.5,3361,5038,2.0,0,0,3,9,3361,0,2014,0,98092,47.3269,-122.165,2316,4105,471275,29,8,2014,0,0,1677,1789,0,0,0
4,2.25,1610,3560,2.0,0,0,3,7,1610,0,2010,0,98038,47.3669,-122.02,1760,3692,288000,11,9,2014,0,4,1950,1932,0,0,0
4,3.5,3830,7150,2.0,0,0,3,9,3830,0,2014,0,98052,47.7049,-122.126,3640,6055,989990,16,10,2014,0,0,3320,2415,0,0,0
3,3.25,1470,1235,2.0,0,0,3,7,1180,290,2008,0,98108,47.5537,-122.313,1470,1243,300000,12,6,2014,0,6,-235,-227,0,1,1
5,3.0,3190,7081,1.0,0,2,3,9,1890,1300,2013,0,98178,47.509,-122.24,2270,7623,664950,23,6,2014,0,1,3891,5353,0,1,1
4,3.25,3250,5478,2.0,0,0,3,9,3250,0,2014,0,98065,47.5178,-121.887,3250,5482,699188,16,7,2014,0,0,2228,2232,0,0,0
3,2.25,1490,4539,2.0,0,0,3,7,1490,0,2009,0,98028,47.7607,-122.233,1750,4667,390000,3,3,2015,0,6,3049,2917,0,0,0
5,2.75,2900,5155,2.0,0,0,3,8,2900,0,2008,0,98075,47.5977,-122.008,2900,6176,670000,21,3,2015,0,7,2255,3276,0,0,0
4,2.5,2540,5001,2.0,0,0,3,9,2540,0,2005,0,98108,47.5423,-122.302,2360,6834,487000,9,7,2014,0,9,2461,4474,0,0,1
5,2.75,3360,12080,2.0,0,0,3,9,3360,0,2014,0,98011,47.7757,-122.173,3360,9724,769995,23,7,2014,0,0,8720,6364,0,0,0
2,1.25,860,1277,2.0,0,0,3,7,860,0,2007,0,98144,47.5842,-122.314,1280,1265,321950,8,5,2014,0,7,417,-15,0,0,1
4,2.5,3020,6068,2.0,0,0,3,9,3020,0,2006,0,98072,47.773,-122.16,3240,5757,613500,27,4,2015,0,9,3048,2517,0,0,0
3,2.5,1330,1200,3.0,0,0,3,7,1330,0,2002,0,98133,47.7034,-122.344,1330,1206,300000,6,8,2014,0,12,-130,-124,0,0,1
4,2.5,2578,4554,2.0,0,0,3,9,2578,0,2014,0,98092,47.2603,-122.194,2647,4554,400950,25,11,2014,0,0,1976,1907,0,0,0
4,2.5,2640,4725,2.0,0,0,3,8,2640,0,2014,0,98038,47.371,-122.017,2370,4725,389517,18,9,2014,0,0,2085,2355,0,0,0
3,1.75,1260,1133,2.0,0,0,3,7,810,450,2011,0,98106,47.5261,-122.361,1260,1172,255000,21,8,2014,0,3,-127,-88,0,1,1
3,2.5,1990,1891,3.0,0,0,3,9,1990,0,2012,0,98102,47.6271,-122.324,1990,3600,1080000,20,2,2015,0,3,-99,1610,0,0,1
5,3.25,3340,4900,2.0,0,2,3,9,2500,840,2014,0,98065,47.5193,-121.877,3220,5200,637850,21,11,2014,0,0,1560,1980,0,1,0
4,2.5,2840,6284,2.0,0,0,3,9,2840,0,2013,0,98056,47.5135,-122.169,2790,7168,636230,28,8,2014,0,1,3444,4378,0,0,0
3,2.5,1530,1131,3.0,0,0,3,8,1530,0,2009,0,98103,47.6993,-122.346,1530,1445,375000,16,12,2014,0,5,-399,-85,0,0,1
3,2.5,1780,1487,3.0,0,0,3,8,1600,180,2006,0,98107,47.6539,-122.351,1780,1300,586500,4,6,2014,0,8,-293,-480,0,1,1
4,2.5,2340,6973,2.0,0,0,3,8,1930,410,2005,0,98065,47.5451,-121.882,2950,6908,544000,20,1,2015,0,10,4633,3958,0,1,0
4,2.5,2390,5021,2.0,0,0,3,7,2390,0,2002,0,98065,47.5353,-121.879,2520,5333,425000,6,8,2014,0,12,2631,2813,0,0,0
4,2.5,2090,3777,2.0,0,0,3,8,2090,0,2012,0,98038,47.3595,-122.042,2160,3993,374950,11,3,2015,0,3,1687,1833,0,0,0
3,1.0,1140,8400,1.0,0,0,4,7,1140,0,1960,0,98059,47.5022,-122.144,1400,9000,294570,12,3,2015,0,55,7260,7600,0,0,0
3,2.5,1960,1477,2.0,0,0,3,7,1670,290,2012,0,98059,47.4873,-122.166,1980,1467,300000,13,10,2014,0,2,-483,-513,0,1,0
5,3.5,2738,6031,2.0,0,0,3,8,2738,0,2014,0,98023,47.2962,-122.35,2738,5201,395950,10,9,2014,0,0,3293,2463,0,0,0
4,2.5,3691,11088,2.0,0,1,3,8,3691,0,2013,0,98074,47.6122,-122.059,3190,11270,800000,18,7,2014,0,1,7397,8080,0,0,0
3,2.5,2340,5171,2.0,0,0,3,8,2340,0,2013,0,98045,47.4832,-121.772,2790,5684,439990,30,7,2014,0,1,2831,2894,0,0,0
4,3.5,2510,3763,2.0,0,0,3,8,1990,520,2013,0,98052,47.7002,-122.103,2560,3820,680000,6,11,2014,0,1,1253,1260,0,1,0
6,3.0,2800,4213,2.0,0,0,3,8,2800,0,1998,0,98117,47.6892,-122.389,1440,3960,677790,18,3,2015,0,17,1413,2520,0,0,1
3,2.5,1650,4777,2.0,0,0,3,8,1650,0,2013,0,98065,47.5336,-121.841,1800,3331,424950,1,5,2015,0,2,3127,1531,0,0,0
2,2.25,1061,2884,2.0,0,0,3,7,1061,0,2013,0,98002,47.346,-122.218,1481,2887,223990,31,3,2015,0,2,1823,1406,0,0,0
4,2.5,3402,14355,2.0,0,0,3,10,2846,556,2014,0,98023,47.3009,-122.385,3402,8487,498000,13,5,2015,0,1,10953,5085,0,1,0
4,2.5,2542,6120,2.0,0,0,3,8,2542,0,2014,0,98030,47.3751,-122.188,2419,8984,359950,31,10,2014,0,0,3578,6565,0,0,0
4,2.5,3010,9000,2.0,0,0,3,8,3010,0,2008,0,98059,47.4987,-122.147,3250,5531,530000,12,11,2014,0,6,5990,2281,0,0,0
3,2.5,1660,4898,2.0,0,0,3,7,1660,0,2011,0,98038,47.3588,-122.044,1810,4462,295000,7,10,2014,0,3,3238,2652,0,0,0
3,2.5,1770,5000,2.0,0,0,3,7,1770,0,2009,0,98042,47.3358,-122.051,2230,5200,255500,21,10,2014,0,5,3230,2970,0,0,0
3,3.0,1960,1168,2.0,0,0,3,9,1600,360,2007,0,98027,47.5445,-122.014,2080,1423,556000,21,5,2014,0,7,-792,-657,0,1,0
4,2.5,1889,6000,2.0,0,0,3,7,1889,0,2012,0,98001,47.2676,-122.256,1990,6350,277950,10,7,2014,0,2,4111,4360,0,0,0
4,2.5,3040,6000,2.0,0,0,3,9,3040,0,2007,0,98038,47.3473,-122.03,2640,6000,431000,8,4,2015,0,8,2960,3360,0,0,0
4,2.75,3420,6787,2.0,0,0,3,9,3420,0,2010,0,98053,47.6962,-122.023,3450,6137,780000,17,11,2014,0,4,3367,2687,0,0,0
3,3.25,1720,936,2.0,0,0,3,8,1030,690,2004,0,98112,47.6201,-122.309,1720,1527,649000,14,10,2014,0,10,-784,-193,0,1,1
3,2.5,1740,3043,2.0,0,0,3,7,1740,0,2012,0,98011,47.744,-122.181,1920,2869,447000,14,7,2014,0,2,1303,949,0,0,0
4,2.5,2450,4247,2.0,0,0,3,8,2450,0,2013,0,98052,47.7048,-122.113,2970,4685,712198,5,5,2014,0,1,1797,1715,0,0,0
3,1.5,1190,785,2.0,0,0,3,8,920,270,2014,0,98052,47.6781,-122.117,2820,5626,277140,15,8,2014,0,0,-405,2806,0,1,0
4,2.5,3753,7204,2.0,0,0,3,10,3336,417,2008,0,98023,47.3011,-122.385,3494,9375,363000,28,5,2014,0,6,3451,5881,0,1,0
5,3.5,3440,6037,2.0,0,0,3,9,3440,0,2014,0,98045,47.4765,-121.734,3270,6037,598992,2,2,2015,0,1,2597,2767,0,0,0
3,2.5,2160,1250,3.0,0,0,3,8,1830,330,2010,0,98119,47.6515,-122.375,1870,2825,585000,11,12,2014,0,4,-910,955,0,1,1
4,2.75,3820,8850,2.0,0,0,3,10,3820,0,2014,0,98033,47.6506,-122.195,2330,12000,1270000,31,7,2014,0,0,5030,9670,0,0,0
2,2.0,1120,1039,2.0,0,0,3,7,840,280,2007,0,98144,47.5788,-122.315,1130,5400,380950,12,2,2015,0,8,-81,4270,0,1,1
4,2.5,2250,3916,2.0,0,0,3,8,2250,0,2014,0,98003,47.3413,-122.18,2156,3920,333490,8,7,2014,0,0,1666,1764,0,0,0
3,3.25,1540,1487,2.0,0,0,3,8,1540,0,2011,0,98027,47.5397,-122.027,1620,1104,520000,4,6,2014,0,3,-53,-516,0,0,0
2,2.25,1240,705,2.0,0,0,3,7,1150,90,2009,0,98027,47.5321,-122.073,1240,750,315000,7,10,2014,0,5,-535,-490,0,1,0
2,1.5,1160,1118,2.0,0,0,3,8,1020,140,2007,0,98117,47.6754,-122.375,1210,1118,487000,31,3,2015,0,8,-42,-92,0,1,1
5,3.5,2760,3865,2.5,0,0,3,8,2760,0,2013,0,98056,47.5049,-122.17,2590,4587,424950,8,8,2014,0,1,1105,1997,0,0,0
3,2.25,1580,1487,3.0,0,0,3,9,1580,0,2013,0,98199,47.6514,-122.386,1600,1525,542300,10,2,2015,0,2,-93,-75,0,0,1
3,3.25,1480,1192,2.0,0,0,3,8,1180,300,2013,0,98106,47.5556,-122.363,1330,1094,320000,11,12,2014,0,1,-288,-236,0,1,1
4,2.5,1950,5000,2.0,0,0,3,8,1950,0,2012,0,98065,47.515,-121.872,2710,5000,425000,15,12,2014,0,2,3050,2290,0,0,0
3,3.0,1530,1568,3.0,0,0,3,8,1530,0,2012,0,98117,47.6998,-122.367,1460,1224,474950,31,10,2014,0,2,38,-236,0,0,1
3,2.5,1820,4200,2.0,0,0,3,8,1820,0,2014,0,98038,47.3693,-122.017,2370,4200,307635,4,8,2014,0,0,2380,1830,0,0,0
3,2.5,2760,6187,2.0,0,0,3,10,2760,0,2014,0,98075,47.5821,-122.047,2760,6600,834538,10,12,2014,0,0,3427,3840,0,0,0
5,2.75,3010,5398,2.0,0,0,3,9,3010,0,2014,0,98074,47.6067,-122.053,3360,5407,769995,23,7,2014,0,0,2388,2047,0,0,0
5,3.25,3860,9387,2.0,0,2,3,9,3860,0,2006,0,98065,47.538,-121.858,3860,8979,820875,24,4,2015,0,9,5527,5119,0,0,0
4,2.5,2490,6537,2.0,0,0,3,8,2490,0,2013,0,98065,47.5185,-121.884,2520,5848,595500,16,3,2015,0,2,4047,3328,0,0,0
4,2.5,3236,9608,2.0,0,0,3,10,3236,0,2005,0,98030,47.3838,-122.195,3236,9660,450000,12,9,2014,0,9,6372,6424,0,0,0
4,2.5,2830,14538,2.0,0,0,3,8,2830,0,2003,0,98065,47.5405,-121.882,2270,6939,695000,21,4,2015,0,12,11708,4669,0,0,0
3,2.0,1451,7159,1.0,0,0,3,7,1451,0,2010,0,98042,47.3754,-122.163,2303,6126,300000,23,3,2015,0,5,5708,3823,0,0,0
5,3.25,2910,5027,2.0,0,0,3,8,2040,870,2013,0,98106,47.5543,-122.359,2910,5027,515000,23,6,2014,0,1,2117,2117,0,1,1
3,2.5,1280,1845,3.0,0,0,3,8,1280,0,2009,0,98105,47.662,-122.324,1450,1889,545000,3,9,2014,0,5,565,439,0,0,1
3,2.25,1110,979,2.0,0,0,3,7,960,150,2008,0,98144,47.5999,-122.3,1170,1400,365000,18,2,2015,0,7,-131,230,0,1,1
4,2.75,2840,8800,2.0,0,0,3,9,2840,0,2008,0,98033,47.7029,-122.171,1840,7700,718500,14,7,2014,0,6,5960,5860,0,0,0
3,1.75,1410,2052,2.0,0,0,3,8,1410,0,2014,0,98106,47.5171,-122.347,1410,1988,279800,1,4,2015,0,1,642,578,0,0,1
4,2.5,3250,13360,2.0,0,0,3,9,3250,0,2014,0,98030,47.3524,-122.198,2612,14448,486940,25,9,2014,0,0,10110,11836,0,0,0
4,2.75,3030,6625,2.0,0,0,3,8,3030,0,2011,0,98059,47.4815,-122.152,3030,9620,525000,26,6,2014,0,3,3595,6590,0,0,0
4,2.5,1983,6002,2.0,0,0,3,9,1983,0,2012,0,98092,47.3281,-122.164,2502,4750,345000,25,7,2014,0,2,4019,2248,0,0,0
3,3.25,2440,2812,2.0,0,0,3,8,1710,730,2005,0,98027,47.5362,-122.072,2440,2836,613000,30,10,2014,0,9,372,396,0,1,0
3,2.5,2313,5700,2.0,0,0,3,9,2313,0,2011,0,98030,47.3572,-122.202,2323,5701,370000,25,8,2014,0,3,3387,3378,0,0,0
3,2.25,1260,2556,2.0,0,0,3,7,1260,0,2005,0,98029,47.5482,-121.998,1630,2844,449500,2,10,2014,0,9,1296,1214,0,0,0
3,2.5,2000,3837,2.0,0,0,3,8,2000,0,2011,0,98072,47.7713,-122.167,2210,4075,515000,16,4,2015,0,4,1837,1865,0,0,0
2,1.75,1150,698,2.0,0,0,3,7,1150,0,2013,0,98027,47.5323,-122.071,1150,757,346100,4,5,2015,0,2,-452,-393,0,0,0
4,2.5,2820,6666,2.0,0,0,3,9,2820,0,2007,0,98038,47.3473,-122.031,1880,7200,398500,9,12,2014,0,7,3846,5320,0,0,0
2,1.75,1160,2500,2.0,0,0,3,7,1160,0,2008,0,98014,47.6489,-121.911,970,7500,310000,20,8,2014,0,6,1340,6530,0,0,0
3,2.25,1481,2820,2.0,0,0,3,7,1481,0,2012,0,98002,47.3457,-122.217,1481,2889,250000,26,2,2015,0,3,1339,1408,0,0,0
5,3.5,4390,6220,2.0,0,3,3,9,3170,1220,2013,0,98115,47.6789,-122.273,2740,6448,1880000,6,8,2014,0,1,1830,3708,0,1,1
2,1.75,1570,1207,3.0,0,0,3,9,1570,0,2007,0,98004,47.6215,-122.201,1570,1206,695000,27,8,2014,0,7,-363,-364,0,0,0
4,3.0,3410,6541,2.0,0,2,3,9,2680,730,2007,0,98126,47.5416,-122.38,2300,6345,1090000,27,8,2014,0,7,3131,4045,0,1,1
5,3.25,3480,6507,2.0,0,0,3,9,3480,0,2014,0,98074,47.607,-122.053,3360,5398,864327,4,8,2014,0,0,3027,2038,0,0,0
4,3.25,3430,9870,2.0,0,0,3,9,3430,0,2014,0,98011,47.776,-122.173,3360,9724,749995,16,6,2014,0,0,6440,6364,0,0,0
5,2.75,2880,8364,2.0,0,0,3,9,2880,0,2006,0,98059,47.4893,-122.147,3010,8296,525000,10,6,2014,0,8,5484,5286,0,0,0
3,2.5,2990,9413,2.0,0,0,3,10,2990,0,2006,0,98028,47.7341,-122.234,1940,9600,659950,21,11,2014,0,8,6423,7660,0,0,0
5,5.0,4490,10279,2.0,0,0,3,10,3930,560,2013,0,98004,47.5974,-122.202,2490,10279,1800000,6,5,2014,0,1,5789,7789,0,1,0
5,4.0,4100,8120,2.0,0,0,3,9,4100,0,2011,0,98053,47.6917,-122.02,4100,7625,950000,29,10,2014,0,3,4020,3525,0,0,0
4,2.75,3870,10046,2.0,0,0,3,11,3870,0,2005,0,98033,47.6651,-122.191,3560,10046,1400000,18,6,2014,0,9,6176,6486,0,0,0
2,1.5,800,2119,2.0,0,0,3,7,800,0,2008,0,98106,47.554,-122.362,1020,4800,265050,2,7,2014,0,6,1319,3780,0,0,1
3,2.25,1620,1057,3.0,0,0,3,8,1540,80,2009,0,98027,47.5396,-122.026,1390,942,450000,6,3,2015,0,6,-563,-448,0,1,0
4,2.5,2910,4356,3.0,0,0,3,8,2910,0,2010,0,98034,47.6705,-122.146,2840,4181,915000,5,5,2015,0,5,1446,1341,0,0,0
4,3.25,3530,8589,2.0,0,0,3,10,3530,0,2007,0,98033,47.6975,-122.195,2470,9019,963000,30,6,2014,0,7,5059,6549,0,0,0
4,2.5,2701,5821,2.0,0,0,3,7,2701,0,2013,0,98092,47.2873,-122.177,2566,5843,270000,8,10,2014,0,1,3120,3277,0,0,0
2,2.5,1380,889,2.0,0,0,3,7,1140,240,2012,0,98126,47.5441,-122.369,1580,1397,294000,24,7,2014,0,2,-491,-183,0,1,1
3,2.5,2050,4185,2.0,0,0,3,9,2050,0,2011,0,98117,47.6922,-122.371,1150,5000,700000,5,6,2014,0,3,2135,3850,0,0,1
3,4.0,3370,8252,2.0,0,0,3,10,3370,0,2014,0,98075,47.5965,-122.013,3710,8252,1070000,16,3,2015,0,1,4882,4542,0,0,0
3,2.5,2040,2500,2.0,0,0,3,7,1470,570,2008,0,98126,47.573,-122.372,1410,2500,494900,29,4,2015,0,7,460,1090,0,1,1
3,2.5,1610,3600,2.0,0,0,3,8,1610,0,2010,0,98072,47.771,-122.169,2210,3600,415000,1,8,2014,0,4,1990,1390,0,0,0
3,2.5,2680,5539,2.0,0,0,3,8,2680,0,2013,0,98045,47.4761,-121.734,2990,6037,459990,2,5,2014,0,1,2859,3047,0,0,0
4,3.5,3560,6562,2.0,0,0,3,10,3560,0,2014,0,98075,47.5929,-121.974,3710,6562,882990,3,10,2014,0,0,3002,2852,0,0,0
4,3.5,3880,8244,2.0,0,0,3,10,3060,820,2007,0,98019,47.7426,-121.976,3180,10947,620000,29,12,2014,0,7,4364,7767,0,1,0
3,2.0,1824,7120,1.0,0,0,3,9,1824,0,2010,0,98001,47.3457,-122.27,2409,6264,375900,12,2,2015,0,5,5296,3855,0,0,0
3,2.5,2220,2873,2.0,0,0,3,10,2010,210,2012,0,98027,47.5311,-122.074,2290,3213,654000,6,10,2014,0,2,653,923,0,1,0
4,3.25,4140,11007,2.0,0,0,3,10,4140,0,2013,0,98040,47.5707,-122.217,2150,9663,1840000,25,3,2015,0,2,6867,7513,0,0,0
3,2.5,1322,6006,2.0,0,0,3,7,1322,0,2009,0,98001,47.2706,-122.254,1440,6796,215000,10,12,2014,0,5,4684,5356,0,0,0
3,2.5,1909,1300,3.0,0,0,3,8,1766,143,2006,0,98103,47.6538,-122.352,1780,1248,630500,24,11,2014,0,8,-609,-532,0,1,1
4,3.5,3460,7702,2.0,0,0,3,10,3460,0,2010,0,98075,47.5942,-121.977,3380,7464,855000,7,11,2014,0,4,4242,4084,0,0,0
4,2.5,1954,5075,2.0,0,0,3,8,1954,0,2007,0,98001,47.2606,-122.253,1934,5000,235245,27,1,2015,0,8,3121,3066,0,0,0
5,2.5,3000,7912,1.0,0,0,3,9,1610,1390,2007,0,98033,47.6765,-122.175,2700,7205,770000,10,7,2014,0,7,4912,4505,0,1,0
4,2.5,2650,6884,2.0,0,0,3,8,2650,0,2012,0,98053,47.6901,-122.015,2520,5866,734990,19,6,2014,0,2,4234,3346,0,0,0
4,2.5,2580,3436,2.0,0,0,3,8,2580,0,2013,0,98033,47.6853,-122.21,1780,5772,880000,9,1,2015,0,2,856,3992,0,0,0
4,3.0,2650,4924,2.0,0,0,3,8,2650,0,2011,0,98028,47.7734,-122.238,2380,4733,525000,14,1,2015,0,4,2274,2353,0,0,0
4,3.5,3390,3960,2.0,0,0,3,10,3390,0,2008,0,98027,47.5406,-121.995,2990,3400,775000,7,8,2014,0,6,570,410,0,0,0
3,1.75,1470,873,3.0,0,0,3,10,1470,0,2009,0,98119,47.6256,-122.362,1410,967,687015,30,4,2015,0,6,-597,-443,0,0,1
3,2.5,1910,5125,2.0,0,0,3,9,1910,0,2006,0,98029,47.5481,-121.995,1910,3215,663000,12,11,2014,0,8,3215,1305,0,0,0
4,2.5,3030,7187,2.0,0,0,3,9,3030,0,2005,0,98033,47.6934,-122.166,3030,7187,815000,30,3,2015,0,10,4157,4157,0,0,0
3,2.5,1650,2787,2.0,0,0,3,8,1650,0,2014,0,98065,47.5336,-121.838,1760,2787,433190,23,4,2015,0,1,1137,1027,0,0,0
4,2.5,2870,5118,2.0,0,0,3,9,2870,0,2006,0,98029,47.5544,-121.99,2940,4800,725000,10,12,2014,0,8,2248,1860,0,0,0
3,2.5,1608,4800,2.0,0,0,3,8,1608,0,2013,0,98092,47.2585,-122.201,2009,4800,279950,8,4,2015,0,2,3192,2791,0,0,0
2,2.5,1620,3795,2.0,0,0,3,7,1620,0,2014,0,98027,47.5321,-122.034,1620,6000,272167,27,3,2015,0,1,2175,4380,0,0,0
3,2.5,1350,1186,2.0,0,0,3,8,1120,230,2007,0,98117,47.6786,-122.375,1500,1605,468500,16,6,2014,0,7,-164,105,0,1,1
3,2.5,1950,3600,2.0,0,0,3,7,1950,0,2010,0,98038,47.3658,-122.021,1870,4184,298000,2,6,2014,0,4,1650,2314,0,0,0
6,4.5,3390,7200,2.0,0,0,3,8,2440,950,2007,0,98118,47.5205,-122.288,2040,7214,303500,14,1,2015,0,8,3810,5174,0,1,1
3,1.75,1300,1237,2.0,0,0,3,7,1060,240,2008,0,98027,47.539,-122.026,1350,942,308000,10,4,2015,0,7,-63,-408,0,1,0
3,3.0,2230,1407,2.5,0,0,3,8,1850,380,2014,0,98027,47.5446,-122.017,2230,1407,646800,15,4,2015,0,1,-823,-823,0,1,0
4,2.5,1880,3853,2.0,0,0,3,8,1880,0,2010,0,98027,47.5636,-122.094,1890,3078,530200,2,1,2015,0,5,1973,1188,0,0,0
5,2.5,3370,5092,2.0,0,0,3,7,3370,0,2006,0,98038,47.3594,-122.036,2910,5092,405000,12,11,2014,0,8,1722,2182,0,0,0
2,2.5,1320,1395,2.0,0,0,3,8,990,330,2014,0,98107,47.6689,-122.362,1550,1519,529000,24,7,2014,0,0,75,-31,0,1,1
3,2.5,2920,9096,2.0,0,0,3,9,2920,0,2013,0,98059,47.4855,-122.149,2930,7995,675900,8,9,2014,0,1,6176,5065,0,0,0
3,3.25,1550,1280,2.0,0,0,3,9,1220,330,2013,0,98199,47.6493,-122.384,1550,1579,570000,2,4,2015,0,2,-270,29,0,1,1
4,2.5,2301,6452,2.0,0,0,3,9,2301,0,2010,0,98001,47.346,-122.269,2650,6054,375500,26,12,2014,0,4,4151,3404,0,0,0
3,3.25,1710,1960,2.0,0,0,3,8,1360,350,2004,0,98029,47.5479,-122.003,1420,955,445000,21,10,2014,0,10,250,-465,0,1,0
4,3.75,2890,4164,2.0,0,0,3,9,2240,650,2013,0,98033,47.676,-122.197,2354,3207,1100000,5,1,2015,0,2,1274,853,0,1,0
3,2.5,2100,5060,2.0,0,0,3,7,2100,0,2006,0,98108,47.563,-122.298,1520,2468,477000,25,8,2014,0,8,2960,948,0,0,1
3,2.75,2240,3360,2.0,0,0,3,8,2100,140,2014,0,98178,47.4999,-122.232,1790,5873,450000,21,11,2014,0,0,1120,4083,0,1,1
3,3.0,1460,1200,3.0,0,0,3,8,1460,0,2006,0,98117,47.7,-122.367,1460,1245,427005,26,3,2015,0,9,-260,-215,0,0,1
3,1.75,1370,1990,3.0,0,0,3,9,1370,0,2014,0,98102,47.6434,-122.324,1730,1990,720000,24,2,2015,0,1,620,260,0,0,1
3,3.5,3760,5634,2.0,1,4,3,11,2830,930,2014,0,98056,47.5285,-122.205,3560,5762,2230000,8,10,2014,0,0,1874,2202,0,1,0
4,3.25,2510,5311,2.0,0,0,3,9,2510,0,2009,0,98056,47.5028,-122.17,1590,9583,450800,27,5,2014,0,5,2801,7993,0,0,0
2,2.25,1210,1267,2.0,0,0,3,8,1120,90,2010,0,98117,47.6783,-122.376,1360,1349,461100,29,8,2014,0,4,57,-11,0,1,1
4,3.0,2990,6695,2.0,0,0,3,10,2990,0,2014,0,98075,47.5817,-122.047,2760,6600,1060000,1,10,2014,0,0,3705,3840,0,0,0
3,2.5,1710,2875,2.0,0,0,3,8,1710,0,2006,0,98116,47.5787,-122.392,1640,5750,590000,8,4,2015,0,9,1165,4110,0,0,1
4,2.5,3274,4950,2.0,0,0,3,9,3274,0,2014,0,98092,47.2603,-122.195,2578,4200,478830,16,7,2014,0,0,1676,1622,0,0,0
4,2.25,3300,8365,3.0,0,0,3,9,3300,0,2014,0,98126,47.5363,-122.377,1290,8369,760000,9,7,2014,0,0,5065,7079,0,0,1
4,3.5,4370,10860,2.0,0,0,3,11,4370,0,2008,0,98059,47.5066,-122.148,3560,8070,1030000,3,7,2014,0,6,6490,4510,0,0,0
4,2.5,2050,5276,2.0,0,0,3,7,2050,0,2006,0,98059,47.491,-122.15,2480,5447,385000,13,6,2014,0,8,3226,2967,0,0,0
2,2.5,1310,1500,2.0,0,0,3,8,1160,150,2006,0,98122,47.6112,-122.309,1320,1581,500000,16,5,2014,0,8,190,261,0,1,1
3,3.0,1330,1379,2.0,0,0,4,8,1120,210,2005,0,98122,47.6126,-122.313,1810,1770,552100,5,9,2014,0,9,49,-40,0,1,1
3,3.0,1950,1983,3.0,0,0,3,9,1610,340,2009,0,98004,47.6078,-122.202,2040,2131,785000,29,12,2014,0,5,33,91,0,1,0
5,3.25,3090,7069,2.0,0,0,3,9,3090,0,2012,0,98056,47.5114,-122.196,2480,8000,615000,23,3,2015,0,3,3979,5520,0,0,0
3,2.5,1950,3825,2.0,0,0,3,7,1950,0,2013,0,98042,47.3588,-122.082,1950,3825,309000,23,4,2015,0,2,1875,1875,0,0,0
3,2.0,1108,1128,3.0,0,0,3,7,1108,0,2009,0,98115,47.6961,-122.318,1285,1253,369500,20,2,2015,0,6,20,-32,0,0,1
4,2.25,2190,3850,2.0,0,0,3,7,2190,0,2006,0,98059,47.4861,-122.161,2190,3980,391000,11,2,2015,0,9,1660,1790,0,0,0
3,1.75,1590,1322,2.0,0,0,3,8,1060,530,2014,0,98144,47.5753,-122.294,1530,5400,465000,29,10,2014,0,0,-268,3870,0,1,1
4,2.75,3010,7215,2.0,0,0,3,9,3010,0,2014,0,98033,47.6952,-122.178,3010,7215,879950,6,6,2014,0,0,4205,4205,0,0,0
3,2.0,1330,1042,2.0,0,0,3,8,1060,270,2014,0,98136,47.5522,-122.382,1440,2428,372000,23,10,2014,0,0,-288,988,0,1,1
3,2.5,1550,3569,2.0,0,0,3,7,1550,0,2011,0,98002,47.3528,-122.211,2095,3402,259000,22,5,2014,0,3,2019,1307,0,0,0
2,1.5,1260,1575,2.0,0,0,3,7,1260,0,2001,0,98144,47.5914,-122.295,1220,1740,374000,7,7,2014,0,13,315,520,0,0,1
4,2.5,2550,5395,2.0,0,0,3,8,2550,0,2001,0,98065,47.5355,-121.874,2850,6109,561000,5,3,2015,0,14,2845,3259,0,0,0
3,2.5,1300,1331,3.0,0,0,3,8,1300,0,2007,0,98103,47.6607,-122.352,1450,5270,610000,3,4,2015,0,8,31,3820,0,0,1
3,3.0,2230,1407,2.5,0,0,3,8,1850,380,2014,0,98027,47.5446,-122.017,2290,1407,635000,8,1,2015,0,1,-823,-883,0,1,0
1,1.5,1170,1456,2.0,0,0,3,8,1070,100,2007,0,98126,47.5493,-122.372,1360,1730,235000,27,6,2014,0,7,286,370,0,1,1
4,3.5,4170,4524,2.0,0,0,3,9,3500,670,2007,0,98072,47.7726,-122.162,3510,5001,623300,16,7,2014,0,7,354,1491,0,1,0
3,2.0,1680,5246,1.0,0,0,3,7,1680,0,2007,0,98065,47.5206,-121.868,2430,6883,412500,23,10,2014,0,7,3566,4453,0,0,0
4,3.25,2864,8035,3.0,0,0,3,8,2864,0,2014,0,98030,47.3746,-122.189,2419,8984,380000,21,11,2014,0,0,5171,6565,0,0,0
3,2.25,1630,3817,2.0,0,0,3,7,1630,0,2005,0,98029,47.5485,-121.999,1630,3348,497000,23,6,2014,0,9,2187,1718,0,0,0
4,2.5,2716,7850,2.0,0,0,3,9,2716,0,2014,0,98030,47.352,-122.197,2580,14448,452000,11,11,2014,0,0,5134,11868,0,0,0
3,2.5,1750,4076,2.0,0,0,3,7,1750,0,2013,0,98038,47.3597,-122.045,1810,4090,312000,25,10,2014,0,1,2326,2280,0,0,0
5,2.5,2600,4284,2.0,0,0,3,9,2600,0,2014,0,98136,47.5409,-122.39,1620,5000,775000,5,8,2014,0,0,1684,3380,0,0,1
4,2.75,3320,8653,2.0,0,0,3,8,3320,0,2014,0,98133,47.7521,-122.334,2140,8727,679990,27,4,2015,0,1,5333,6587,0,0,1
4,2.0,1350,942,3.0,0,0,3,7,1350,0,2008,0,98027,47.5401,-122.026,1390,942,288790,27,6,2014,0,6,-408,-448,0,0,0
5,2.5,3410,4726,2.0,0,0,3,9,3410,0,2007,0,98006,47.5459,-122.184,2810,5129,800000,8,4,2015,0,8,1316,2319,0,0,0
3,2.5,1572,4000,2.0,0,0,3,8,1572,0,2013,0,98092,47.2615,-122.198,1608,5175,299000,27,4,2015,0,2,2428,3567,0,0,0
4,2.5,2300,4482,2.0,0,0,3,7,2300,0,2013,0,98042,47.3599,-122.082,2300,3825,332000,29,1,2015,0,2,2182,1525,0,0,0
1,1.5,1030,5923,1.0,0,0,3,8,1030,0,1940,0,98105,47.6653,-122.305,2650,5000,525000,20,4,2015,0,75,4893,2350,0,0,1
3,1.75,1458,858,2.0,0,0,3,8,950,508,2014,0,98144,47.592,-122.293,1458,3000,620000,3,9,2014,0,0,-600,1542,0,1,1
4,2.5,2190,6896,2.0,0,0,3,7,2190,0,2007,0,98065,47.5191,-121.869,2190,5900,452000,3,11,2014,0,7,4706,3710,0,0,0
4,3.0,3640,5096,2.0,0,0,3,8,2740,900,2010,0,98118,47.5428,-122.27,1910,9189,630000,28,10,2014,0,4,1456,7279,0,1,1
4,2.75,2790,7803,2.0,0,0,3,8,2790,0,2013,0,98045,47.4823,-121.772,2620,6178,485000,24,7,2014,0,1,5013,3558,0,0,0
4,2.5,2632,4117,2.0,0,0,3,8,2632,0,2013,0,98001,47.3428,-122.278,2040,5195,349950,13,10,2014,0,1,1485,3155,0,0,0
4,2.75,2910,6334,2.0,0,0,3,8,2910,0,2013,0,98045,47.4826,-121.771,2790,6352,499990,1,7,2014,0,1,3424,3562,0,0,0
2,2.25,1470,1101,2.0,0,0,3,8,1340,130,2005,0,98115,47.6768,-122.301,1470,1582,510000,5,12,2014,0,9,-369,112,0,1,1
3,2.5,2310,4729,2.0,0,0,3,8,2310,0,2011,0,98028,47.7734,-122.237,2440,4711,494000,8,5,2014,0,3,2419,2271,0,0,0
3,2.5,2370,5353,2.0,0,0,3,8,2370,0,2009,0,98019,47.7333,-121.975,2130,6850,429900,26,6,2014,0,5,2983,4720,0,0,0
4,2.75,2980,9825,1.0,0,0,3,8,1910,1070,2007,0,98056,47.5073,-122.172,2580,12231,505000,15,10,2014,0,7,6845,9651,0,1,0
4,2.0,1870,6551,1.0,0,3,3,7,1870,0,2009,0,98022,47.1934,-121.977,2280,5331,272000,15,7,2014,0,5,4681,3051,0,0,0
3,2.5,1770,1714,3.0,0,0,3,8,1770,0,2012,0,98103,47.6532,-122.348,1720,3360,671500,10,2,2015,0,3,-56,1640,0,0,1
4,3.5,3510,10010,2.0,0,0,3,10,3510,0,2001,0,98065,47.5412,-121.876,4200,9935,729950,11,3,2015,0,14,6500,5735,0,0,0
4,2.5,3281,5354,2.0,0,0,3,9,3281,0,2014,0,98092,47.3273,-122.163,2598,4815,471835,21,7,2014,0,0,2073,2217,0,0,0
3,2.0,1670,4438,1.0,0,0,3,7,1670,0,2014,0,98022,47.1948,-121.974,1670,4558,249950,3,11,2014,0,0,2768,2888,0,0,0
5,3.5,2760,3846,2.5,0,0,3,8,2760,0,2013,0,98056,47.5047,-122.17,2760,4587,424950,8,8,2014,0,1,1086,1827,0,0,0
5,3.5,5430,10327,2.0,0,2,3,10,4010,1420,2007,0,98006,47.5476,-122.116,4340,10324,1240000,9,7,2014,0,7,4897,5984,0,1,0
4,2.5,2990,7928,2.0,0,0,3,9,2990,0,2011,0,98010,47.3139,-122.024,2810,7401,440000,11,9,2014,0,3,4938,4591,0,0,0
4,3.5,3170,3858,2.0,0,0,3,8,2530,640,2008,0,98059,47.5049,-122.155,2640,3844,495000,8,4,2015,0,7,688,1204,0,1,0
4,2.5,3520,6773,2.5,0,0,3,9,2650,870,2006,0,98136,47.5317,-122.391,2930,6458,870000,13,5,2014,0,8,3253,3528,0,1,1
2,3.0,1650,960,3.0,0,0,3,8,1350,300,2015,0,98103,47.6611,-122.346,1650,3000,559000,25,11,2014,0,-1,-690,1350,0,1,1
3,2.5,2230,4850,2.0,0,0,3,8,2230,0,2014,0,98133,47.7295,-122.334,2230,4513,722000,13,2,2015,0,1,2620,2283,0,0,1
3,2.5,2280,2502,2.0,0,0,3,8,1880,400,2006,0,98027,47.5364,-122.073,2280,2812,567500,2,7,2014,0,8,222,532,0,1,0
4,2.5,2798,5085,2.0,0,0,3,9,2798,0,2011,0,98092,47.3308,-122.187,2502,5707,440000,17,12,2014,0,3,2287,3205,0,0,0
4,2.5,2398,5988,2.0,0,0,3,8,2398,0,2008,0,98055,47.452,-122.204,2370,5988,400000,29,8,2014,0,6,3590,3618,0,0,0
4,2.5,2350,3760,2.0,0,0,3,8,2350,0,2014,0,98059,47.4786,-122.123,2590,4136,459995,6,10,2014,0,0,1410,1546,0,0,0
5,2.75,2410,5003,1.0,0,0,3,7,1410,1000,2008,0,98118,47.5298,-122.274,1590,5003,365000,7,5,2014,0,6,2593,3413,0,1,1
3,2.25,1580,920,3.0,0,0,3,8,1580,0,2015,0,98106,47.5578,-122.363,1250,1150,389950,17,4,2015,0,0,-660,-100,0,0,1
3,3.25,1450,1387,2.0,0,0,3,8,1180,270,2013,0,98106,47.5556,-122.362,1450,1198,320000,8,7,2014,0,1,-63,-252,0,1,1
4,2.5,1750,4779,2.0,0,0,3,7,1750,0,2009,0,98028,47.7608,-122.232,1580,4687,415500,13,6,2014,0,5,3029,3107,0,0,0
3,2.5,3020,4120,2.0,0,0,3,9,2360,660,2008,0,98126,47.5714,-122.373,2280,4120,775000,9,3,2015,0,7,1100,1840,0,1,1
3,3.0,1740,1100,3.0,0,0,3,8,1740,0,2007,0,98107,47.67,-122.391,1370,1180,590000,11,3,2015,0,8,-640,-190,0,0,1
2,2.25,2200,2043,2.0,0,0,3,9,1760,440,2007,0,98004,47.6213,-122.2,2020,1957,950000,23,1,2015,0,8,-157,-63,0,1,0
4,2.5,1867,15314,2.0,0,0,3,9,1867,0,2013,0,98030,47.3524,-122.198,2616,8048,378950,6,8,2014,0,1,13447,5432,0,0,0
2,1.5,1020,1060,3.0,0,0,3,8,1020,0,2008,0,98103,47.6801,-122.348,1340,1415,441750,8,5,2014,0,6,40,75,0,0,1
4,2.75,2475,4000,2.0,0,0,3,7,2475,0,2014,0,98002,47.345,-122.209,2475,4000,335900,31,10,2014,0,0,1525,1525,0,0,0
2,1.75,1110,1773,2.0,0,0,3,8,1110,0,2014,0,98108,47.5647,-122.293,1420,2855,229800,27,6,2014,0,0,663,1435,0,0,1
3,2.5,1900,1258,2.5,0,0,3,7,1700,200,2007,0,98119,47.6465,-122.358,1780,1877,645000,10,3,2015,0,8,-642,97,0,1,1
3,3.25,1560,1345,2.0,0,0,3,8,1260,300,2009,0,98126,47.5637,-122.375,1560,4800,448000,23,4,2015,0,6,-215,3240,0,1,1
4,2.5,2510,5436,2.0,0,0,3,8,2510,0,2011,0,98053,47.6894,-122.016,2520,5436,706000,16,12,2014,0,3,2926,2916,0,0,0
4,4.75,4150,6303,3.0,0,0,3,9,4150,0,2014,0,98052,47.7047,-122.123,3570,6285,988990,27,2,2015,0,1,2153,2715,0,0,0
3,3.0,1660,1849,3.0,0,0,3,9,1660,0,2013,0,98103,47.6649,-122.353,1660,3300,716000,16,7,2014,0,1,189,1640,0,0,1
2,1.5,1090,847,3.0,0,0,3,8,1090,0,2009,0,98133,47.7235,-122.352,1090,1118,319000,21,4,2015,0,6,-243,28,0,0,1
4,2.5,1914,3272,2.0,0,0,3,8,1914,0,2009,0,98055,47.4297,-122.189,1714,3250,300000,14,10,2014,0,5,1358,1536,0,0,0
3,2.75,2470,3600,2.0,0,0,3,9,2470,0,2007,0,98029,47.5406,-121.994,2570,3600,773000,14,5,2014,0,7,1130,1030,0,0,0
5,2.5,2340,5670,2.0,0,0,3,7,2340,0,2009,0,98059,47.4913,-122.152,2190,4869,392000,25,9,2014,0,5,3330,2679,0,0,0
4,3.5,2660,5690,2.0,0,0,3,8,1920,740,2014,0,98059,47.4775,-122.122,2970,5690,549995,11,9,2014,0,0,3030,2720,0,1,0
3,2.5,2410,4656,2.0,0,0,3,7,2410,0,2009,0,98065,47.5203,-121.874,2410,4840,480000,20,9,2014,0,5,2246,2430,0,0,0
3,2.25,1430,4777,2.0,0,0,3,7,1430,0,2010,0,98059,47.4867,-122.152,1639,3854,355000,20,10,2014,0,4,3347,2215,0,0,0
2,2.5,1570,1268,3.0,0,0,3,7,1570,0,2007,0,98106,47.534,-122.365,1570,1300,208400,30,12,2014,0,7,-302,-270,0,0,1
5,2.75,3010,4919,2.0,0,0,3,9,3010,0,2014,0,98074,47.6067,-122.052,3230,5415,831548,22,8,2014,0,0,1909,2185,0,0,0
4,2.5,1613,4338,2.0,0,0,3,7,1613,0,2009,0,98042,47.3859,-122.162,1427,4341,279500,17,11,2014,0,5,2725,2914,0,0,0
3,2.5,2380,5269,2.0,0,0,3,8,2380,0,2008,0,98056,47.5066,-122.192,2150,7600,445000,27,2,2015,0,7,2889,5450,0,0,0
5,2.5,2570,9962,2.0,0,0,3,8,2570,0,2006,0,98019,47.7275,-121.957,2890,9075,492500,16,6,2014,0,8,7392,6185,0,0,0
4,2.5,2550,5200,2.0,0,0,3,7,2550,0,2009,0,98059,47.4919,-122.153,2550,4660,435000,9,7,2014,0,5,2650,2110,0,0,0
3,2.25,1330,969,3.0,0,0,3,7,1330,0,2007,0,98125,47.7177,-122.292,1310,1941,325000,12,5,2015,0,8,-361,631,0,0,1
2,1.5,1160,1269,2.0,0,0,3,7,970,190,2005,0,98103,47.6608,-122.335,1700,3150,453000,17,11,2014,0,9,109,1450,0,1,1
5,3.5,3240,6919,2.0,0,0,3,8,2760,480,2014,0,98059,47.4779,-122.122,2970,5690,612995,22,8,2014,0,0,3679,2720,0,1,0
4,2.5,2710,9248,2.0,0,0,3,7,2710,0,2011,0,98065,47.5164,-121.875,2710,5000,540000,4,9,2014,0,3,6538,2290,0,0,0
3,2.25,1860,1386,3.0,0,0,3,9,1860,0,2014,0,98112,47.6368,-122.279,1680,3080,799950,12,8,2014,0,0,-474,1400,0,0,1
3,2.25,1280,1517,2.0,0,0,3,8,1080,200,2008,0,98107,47.6651,-122.368,1280,1681,495000,24,11,2014,0,6,237,401,0,1,1
3,2.5,1810,1585,3.0,0,0,3,7,1810,0,2014,0,98117,47.6957,-122.376,1560,1586,579950,28,2,2015,0,1,-225,26,0,0,1
2,2.25,1240,720,2.0,0,0,3,7,1150,90,2008,0,98027,47.5322,-122.072,1260,810,331000,20,2,2015,0,7,-520,-450,0,1,0
4,3.5,1460,951,3.0,0,0,3,8,1460,0,2008,0,98115,47.6821,-122.326,1430,1282,580000,25,8,2014,0,6,-509,-148,0,0,1
2,2.5,1640,1953,2.0,0,0,3,10,1640,0,2014,0,98118,47.5639,-122.292,1820,2653,669000,14,4,2015,0,1,313,833,0,0,1
3,3.25,1300,1325,2.0,0,0,3,8,1080,220,2005,0,98103,47.6584,-122.346,1290,1323,539900,16,1,2015,0,10,25,33,0,1,1
4,2.5,2510,4349,2.0,0,0,3,8,2510,0,2010,0,98059,47.4927,-122.147,2510,4314,490000,23,7,2014,0,4,1839,1804,0,0,0
3,3.5,2710,3475,2.0,0,0,3,8,1650,1060,2005,0,98027,47.5359,-122.072,2440,2867,627000,27,5,2014,0,9,765,427,0,1,0
4,3.5,3217,4000,2.0,0,0,3,8,2587,630,2008,0,98055,47.4483,-122.203,2996,5418,458000,28,7,2014,0,6,783,2422,0,1,0
3,2.5,1650,4929,2.0,0,0,3,7,1520,130,2007,0,98108,47.5634,-122.298,1520,2287,440000,10,11,2014,0,7,3279,767,0,1,1
4,3.5,3950,6240,2.0,0,0,3,11,3950,0,2015,0,98112,47.6221,-122.29,2040,6240,1700000,10,3,2015,0,0,2290,4200,0,0,1
2,2.5,1680,977,3.0,0,0,3,9,1680,0,2009,0,98119,47.632,-122.361,1680,977,935000,11,5,2015,0,6,-703,-703,0,0,1
5,3.5,3420,6403,2.0,0,2,3,8,2700,720,2013,0,98065,47.5162,-121.874,2710,6038,641000,17,4,2015,0,2,2983,3328,0,1,0
3,2.75,2300,5090,2.0,0,0,3,8,1700,600,2007,0,98106,47.545,-122.36,1530,9100,452000,11,9,2014,0,7,2790,7570,0,1,1
4,2.75,3010,6854,2.0,0,2,3,9,2570,440,2012,0,98065,47.5171,-121.876,1830,2952,625000,23,12,2014,0,2,3844,1122,0,1,0
4,3.5,4680,12495,2.0,0,0,3,10,3040,1640,2008,0,98033,47.6984,-122.206,3240,10749,1350000,3,3,2015,0,7,7815,7509,0,1,0
5,3.5,3630,4911,2.0,0,0,3,9,2790,840,2014,0,98034,47.718,-122.156,3600,4992,834950,8,9,2014,0,0,1281,1392,0,1,0
3,3.5,3530,3610,2.0,0,0,3,10,2370,1160,2008,0,98103,47.6857,-122.339,1780,3610,1500000,28,10,2014,0,6,80,1830,0,1,1
4,2.5,2280,3800,2.0,0,0,3,7,2280,0,2006,0,98038,47.3586,-122.036,2630,4045,305000,25,8,2014,0,8,1520,1415,0,0,0
1,1.0,550,1279,2.0,0,0,3,7,550,0,2008,0,98122,47.616,-122.314,1460,1385,353000,22,5,2014,0,6,729,-75,0,0,1
4,3.25,2840,4000,2.0,0,3,3,9,2330,510,2014,0,98108,47.5529,-122.293,2160,4867,535000,4,3,2015,0,1,1160,2707,0,1,1
4,2.5,3130,10849,2.0,0,0,3,10,3130,0,2013,0,98033,47.6828,-122.186,2470,9131,999000,8,7,2014,0,1,7719,6661,0,0,0
3,2.5,1440,1102,3.0,0,0,3,8,1440,0,2009,0,98103,47.6995,-122.346,1440,1434,375000,29,1,2015,0,6,-338,-6,0,0,1
4,3.5,2840,4637,3.0,0,0,3,8,2840,0,2008,0,98125,47.7033,-122.321,1730,5279,685000,16,6,2014,0,6,1797,3549,0,0,1
4,2.5,2623,7184,2.0,0,0,3,8,2623,0,2012,0,98092,47.259,-122.202,2010,4939,333000,8,8,2014,0,2,4561,2929,0,0,0
1,1.0,390,2000,1.0,0,0,4,6,390,0,1920,0,98103,47.6938,-122.347,1340,5100,245000,11,5,2015,0,95,1610,3760,0,0,1
2,2.25,1260,1032,2.0,0,0,3,7,1170,90,2008,0,98027,47.5323,-122.072,1240,809,329950,15,10,2014,0,6,-228,-431,0,1,0
2,1.0,894,1552,2.0,0,0,3,7,894,0,2011,0,98115,47.6911,-122.313,1131,1992,403000,20,4,2015,0,4,658,861,0,0,1
4,2.5,3370,4934,2.0,0,0,3,9,3370,0,2014,0,98038,47.3562,-122.022,2980,5046,559630,11,11,2014,0,0,1564,2066,0,0,0
3,2.25,1250,871,3.0,0,0,3,8,1250,0,2007,0,98103,47.6907,-122.343,1250,1158,344000,18,8,2014,0,7,-379,-92,0,0,1
3,1.5,1180,1231,3.0,0,0,3,7,1180,0,2008,0,98115,47.6845,-122.315,1280,3360,435000,2,4,2015,0,7,51,2080,0,0,1
2,2.5,1520,1588,2.0,0,0,3,8,1240,280,2007,0,98144,47.5825,-122.313,1660,6000,430000,22,5,2014,0,7,68,4340,0,1,1
3,2.5,2000,4500,2.0,0,0,3,7,2000,0,2010,0,98059,47.4937,-122.149,2230,4501,417000,17,11,2014,0,4,2500,2271,0,0,0
5,2.75,3180,9255,2.0,0,0,3,9,3180,0,2014,0,98074,47.6232,-122.023,3180,7782,895950,9,4,2015,0,1,6075,4602,0,0,0
4,2.75,3050,4750,2.0,0,0,3,8,3050,0,2014,0,98059,47.4857,-122.153,2730,5480,563950,19,3,2015,0,1,1700,2750,0,0,0
3,2.5,2570,3600,2.5,0,0,3,9,2570,0,2007,0,98027,47.5412,-121.994,2570,3600,680000,12,6,2014,0,7,1030,1030,0,0,0
4,3.5,2950,3737,2.0,0,0,3,10,2270,680,2012,0,98027,47.5313,-122.074,2580,3581,825750,9,2,2015,0,3,787,1001,0,1,0
3,2.5,1690,1760,2.0,0,0,3,8,1410,280,2014,0,98106,47.5387,-122.367,1740,1760,338000,9,12,2014,0,0,70,20,0,1,1
4,2.75,2790,6969,2.0,0,0,3,8,2790,0,2012,0,98045,47.4836,-121.769,2620,6307,535365,18,7,2014,0,2,4179,3687,0,0,0
3,2.25,1720,5234,2.0,0,0,3,9,1240,480,2011,0,98118,47.5547,-122.278,1720,5825,608000,11,12,2014,0,3,3514,4105,0,1,1
3,2.25,2890,5000,3.0,0,0,3,9,2890,0,2014,0,98117,47.6983,-122.389,2020,5000,930000,16,10,2014,0,0,2110,2980,0,0,1
2,2.25,1460,1623,2.0,0,0,3,8,1260,200,2005,0,98115,47.6764,-122.301,1460,1137,495000,19,12,2014,0,9,163,-323,0,1,1
3,2.5,2510,3819,2.0,0,0,3,8,2510,0,2007,0,98052,47.6987,-122.096,2520,3990,667000,22,7,2014,0,7,1309,1470,0,0,0
4,2.5,3390,7870,2.0,0,0,3,8,3390,0,2014,0,98188,47.4536,-122.274,1960,10069,495000,12,11,2014,0,0,4480,8109,0,0,1
4,2.5,3570,6054,2.0,0,0,3,9,3570,0,2014,0,98052,47.7053,-122.126,3600,6050,928990,29,9,2014,0,0,2484,2450,0,0,0
4,2.5,2280,5000,2.0,0,0,3,7,2280,0,2006,0,98038,47.3593,-122.037,2910,5000,345000,30,6,2014,0,8,2720,2090,0,0,0
5,3.5,2920,3000,2.0,0,0,3,9,2260,660,2014,0,98103,47.6846,-122.349,1580,4000,1070000,16,12,2014,0,0,80,2420,0,1,1
4,3.0,2590,6160,2.0,0,0,3,8,2590,0,2014,0,98059,47.4784,-122.122,2670,5600,519995,3,7,2014,0,0,3570,2930,0,0,0
5,2.75,3210,8001,2.0,0,0,3,9,3210,0,2014,0,98074,47.5935,-122.061,3190,6624,924000,5,11,2014,0,0,4791,3434,0,0,0
3,2.0,1230,3405,1.0,0,0,3,7,1230,0,2010,0,98058,47.438,-122.179,1440,4066,295000,24,4,2015,0,5,2175,2626,0,0,0
3,2.5,1500,2314,2.0,0,0,3,7,1500,0,2005,0,98029,47.5537,-121.998,1440,2170,405000,1,8,2014,0,9,814,730,0,0,0
4,2.25,2510,4090,2.0,0,0,3,8,1840,670,2012,0,98019,47.7345,-121.967,2070,4090,410000,18,7,2014,0,2,1580,2020,0,1,0
3,1.5,1400,1091,3.0,0,0,3,8,1400,0,2007,0,98115,47.6989,-122.317,1270,1413,419500,25,11,2014,0,7,-309,143,0,0,1
3,2.25,1450,4667,2.0,0,0,3,7,1450,0,2009,0,98028,47.7611,-122.233,1490,4667,382000,3,9,2014,0,5,3217,3177,0,0,0
2,2.5,1390,1821,2.0,0,0,3,7,1180,210,2007,0,98118,47.5537,-122.282,1350,1821,370000,24,2,2015,0,8,431,471,0,1,1
3,2.75,3160,9072,2.0,0,0,3,9,3160,0,2005,0,98056,47.5147,-122.177,3160,9072,553000,6,10,2014,0,9,5912,5912,0,0,0
4,3.75,4350,7965,2.0,0,0,3,10,4350,0,2013,0,98004,47.6289,-122.205,2190,8557,2070000,30,6,2014,0,1,3615,6367,0,0,0
4,2.5,2720,5771,2.0,0,0,3,8,2720,0,2015,0,98056,47.4917,-122.17,1940,4184,455950,1,4,2015,0,0,3051,2244,0,0,0
3,3.25,1290,1153,3.0,0,0,3,7,1290,0,2008,0,98103,47.6904,-122.346,1290,1200,331000,27,10,2014,0,6,-137,-90,0,0,1
3,2.25,1606,1452,3.0,0,0,3,8,1606,0,2009,0,98125,47.7175,-122.284,1516,1939,417250,7,5,2014,0,5,-154,423,0,0,1
5,3.5,4460,2975,3.0,0,2,3,10,3280,1180,2015,0,98119,47.6313,-122.37,2490,4231,490000,20,5,2014,0,-1,-1485,1741,0,1,1
4,3.25,2800,5291,2.0,0,0,3,7,2800,0,2011,0,98022,47.1937,-121.977,2380,5291,325000,4,8,2014,0,3,2491,2911,0,0,0
5,3.5,3250,4800,2.0,0,0,3,9,2410,840,2010,0,98106,47.5618,-122.362,1330,4920,705000,23,2,2015,0,5,1550,3590,0,1,1
6,3.5,4310,7760,2.0,0,0,3,10,3260,1050,2013,0,98059,47.5297,-122.155,4620,10217,1170000,17,7,2014,0,1,3450,5597,0,1,0
3,2.25,1310,915,2.0,0,0,3,7,1060,250,2007,0,98144,47.5738,-122.293,1500,1215,365000,22,2,2015,0,8,-395,-285,0,1,1
2,1.5,1240,1101,2.0,0,0,3,8,1080,160,2009,0,98144,47.5758,-122.309,1530,1209,403000,17,11,2014,0,5,-139,-321,0,1,1
3,2.5,1950,7263,2.0,0,0,3,7,1950,0,2007,0,98065,47.5194,-121.869,2190,5900,409000,13,8,2014,0,7,5313,3710,0,0,0
3,2.5,1800,1120,2.0,0,0,3,8,1800,0,2011,0,98126,47.5436,-122.369,1800,2380,391000,7,4,2015,0,4,-680,580,0,0,1
4,2.5,2650,5600,2.0,0,0,3,8,2650,0,2014,0,98059,47.4786,-122.122,2650,5600,542525,16,6,2014,0,0,2950,2950,0,0,0
2,1.0,820,681,3.0,0,0,3,8,820,0,2006,0,98103,47.6619,-122.352,820,1156,339950,7,5,2014,0,8,-139,336,0,0,1
4,2.75,2620,7001,2.0,0,0,3,8,2620,0,2012,0,98045,47.4838,-121.769,2620,6543,499990,19,8,2014,0,2,4381,3923,0,0,0
4,3.25,3980,10249,2.0,0,0,3,10,3980,0,2011,0,98004,47.5873,-122.196,2450,10912,1770000,23,9,2014,0,3,6269,8462,0,0,0
3,3.5,1660,2298,2.0,0,0,3,8,1260,400,2009,0,98116,47.5809,-122.403,1500,2198,608000,23,3,2015,0,6,638,698,0,1,1
4,2.5,2130,4028,2.0,0,0,3,8,2130,0,2014,0,98146,47.5108,-122.363,1830,7817,392000,12,3,2015,0,1,1898,5987,0,0,1
3,1.75,1410,1988,2.0,0,0,3,8,1410,0,2014,0,98106,47.5171,-122.347,1410,1899,274800,17,4,2015,0,1,578,489,0,0,1
3,2.25,1330,1198,2.0,0,0,3,8,1080,250,2007,0,98106,47.555,-122.362,1260,1062,325000,27,4,2015,0,8,-132,-198,0,1,1
4,2.5,2190,4866,2.0,0,0,3,7,2190,0,2009,0,98059,47.4907,-122.152,2190,5670,418500,29,4,2015,0,6,2676,3480,0,0,0
3,2.5,2540,5050,2.0,0,0,3,7,2540,0,2006,0,98042,47.3358,-122.055,2280,5050,300000,2,5,2014,0,8,2510,2770,0,0,0
3,2.5,2244,4079,2.0,0,0,3,7,2244,0,2012,0,98001,47.2606,-122.254,2077,4078,269950,5,1,2015,0,3,1835,2001,0,0,0
3,2.5,2026,7611,2.0,0,0,3,8,2026,0,2010,0,98042,47.3733,-122.162,2270,7611,358000,6,5,2015,0,5,5585,5341,0,0,0
3,2.5,1730,4086,2.0,0,0,3,8,1730,0,2013,0,98146,47.5016,-122.341,2030,4086,350000,4,5,2015,0,2,2356,2056,0,0,1
4,3.5,3910,8095,2.0,0,0,3,9,3130,780,2007,0,98029,47.5588,-122.036,3770,7021,782000,28,5,2014,0,7,4185,3251,0,1,0
3,2.5,1580,1487,3.0,0,1,3,9,1580,0,2009,0,98119,47.6276,-122.359,1610,1297,779000,15,9,2014,0,5,-93,-313,0,0,1
4,2.5,2510,3479,2.0,0,0,3,8,2510,0,2007,0,98052,47.6981,-122.099,2540,4171,685000,17,12,2014,0,7,969,1631,0,0,0
2,2.25,1000,905,3.0,0,0,3,8,1000,0,2006,0,98117,47.6842,-122.387,980,1023,305000,29,5,2014,0,8,-95,43,0,0,1
4,2.5,1660,2500,2.0,0,0,3,7,1660,0,2007,0,98118,47.5437,-122.283,1030,5000,350000,17,4,2015,0,8,840,3970,0,0,1
4,3.5,3060,4573,2.0,0,0,3,9,2410,650,2012,0,98029,47.5522,-122.001,3170,3634,775000,23,9,2014,0,2,1513,464,0,1,0
3,2.5,1980,4500,2.0,0,0,3,7,1980,0,2012,0,98042,47.3682,-122.117,1980,4500,317750,28,8,2014,0,2,2520,2520,0,0,0
2,1.0,980,1179,2.0,0,0,3,8,980,0,2010,0,98119,47.6381,-122.375,1190,1600,438000,8,5,2014,0,4,199,410,0,0,1
2,2.5,1050,1609,2.0,0,0,3,7,1050,0,2005,0,98144,47.5854,-122.313,1120,1693,325000,28,5,2014,0,9,559,573,0,0,1
4,3.25,3080,4287,2.0,0,0,3,10,2230,850,2012,0,98027,47.5313,-122.076,2250,2520,830000,28,4,2015,0,3,1207,270,0,1,0
3,2.25,1900,3800,2.0,0,0,3,7,1900,0,2006,0,98059,47.4866,-122.16,1950,3800,353000,22,9,2014,0,8,1900,1850,0,0,0
4,2.5,2200,6400,2.0,0,0,3,8,2200,0,2010,0,98059,47.4856,-122.156,2600,5870,460000,25,7,2014,0,4,4200,3270,0,0,0
3,1.5,1360,1167,3.0,0,0,3,8,1360,0,2008,0,98103,47.6962,-122.349,1360,1167,370000,16,3,2015,0,7,-193,-193,0,0,1
3,2.5,2238,7209,2.0,0,0,3,8,2238,0,2011,0,98023,47.2966,-122.353,2456,7212,330000,19,6,2014,0,3,4971,4756,0,0,0
4,2.5,2590,6474,2.0,0,0,3,8,2590,0,2014,0,98056,47.5164,-122.19,1960,8679,569888,28,1,2015,0,1,3884,6719,0,0,0
3,2.5,2517,3900,2.0,0,0,3,8,2517,0,2014,0,98092,47.3211,-122.182,2390,7108,353900,18,9,2014,0,0,1383,4718,0,0,0
4,3.5,3510,9084,2.0,0,0,3,10,3510,0,2001,0,98065,47.5402,-121.875,3690,9568,695000,4,3,2015,0,14,5574,5878,0,0,0
3,1.75,1290,1237,2.0,0,0,3,7,1060,230,2008,0,98027,47.54,-122.026,1370,942,288790,18,7,2014,0,6,-53,-428,0,1,0
5,3.0,2230,8642,1.0,0,0,3,7,1330,900,2014,0,98168,47.487,-122.32,2100,11056,334950,13,2,2015,0,1,6412,8956,0,1,1
4,2.75,3140,7928,2.0,0,0,3,9,3140,0,2013,0,98074,47.5923,-122.058,3500,7055,869950,15,12,2014,0,1,4788,3555,0,0,0
3,3.5,3350,5025,2.0,0,2,3,8,2670,680,2014,0,98144,47.5699,-122.296,2030,5117,557500,8,10,2014,0,0,1675,3087,0,1,1
4,2.5,2245,4330,2.0,0,0,3,8,2245,0,2014,0,98038,47.3557,-122.063,2530,4478,389990,19,9,2014,0,0,2085,1948,0,0,0
3,1.75,1420,1189,3.0,0,0,3,8,1420,0,2006,0,98103,47.6625,-122.352,1380,1196,455000,4,6,2014,0,8,-231,-184,0,0,1
3,3.0,1560,2091,3.0,0,0,3,8,1560,0,2006,0,98103,47.6604,-122.352,1530,2091,598500,30,10,2014,0,8,531,561,0,0,1
4,2.75,2810,5497,2.0,0,0,3,9,2810,0,2011,0,98052,47.7081,-122.116,2990,5842,750000,2,3,2015,0,4,2687,2852,0,0,0
2,2.25,1630,1686,2.0,0,0,3,10,1330,300,2014,0,98122,47.6113,-122.314,1570,2580,729999,13,11,2014,0,0,56,1010,0,1,1
3,2.5,1740,4497,2.0,0,0,3,7,1740,0,2012,0,98042,47.3697,-122.117,1950,4486,299950,3,3,2015,0,3,2757,2536,0,0,0
3,2.25,1390,1484,3.0,0,0,3,8,1390,0,2007,0,98103,47.6912,-122.343,1250,1087,374950,9,7,2014,0,7,94,-163,0,0,1
3,2.5,1070,1089,2.0,0,0,3,7,900,170,2009,0,98116,47.5902,-122.387,1450,1437,386950,19,2,2015,0,6,19,-13,0,1,1
5,3.25,2850,4551,2.0,0,0,3,8,2370,480,2006,0,98059,47.4916,-122.144,2850,4849,535000,10,7,2014,0,8,1701,1999,0,1,0
5,3.25,4100,7578,2.0,0,2,3,10,4100,0,2011,0,98075,47.5955,-121.974,3710,8156,890000,31,8,2014,0,3,3478,4446,0,0,0
4,2.5,3260,5974,2.0,0,1,3,9,2820,440,2007,0,98115,47.6772,-122.267,2260,6780,1050000,3,2,2015,0,8,2714,4520,0,1,1
4,3.5,3660,4760,2.0,0,0,3,9,2840,820,2014,0,98199,47.6482,-122.409,3210,4640,1110000,15,10,2014,0,0,1100,1430,0,1,1
4,2.5,2708,4772,2.0,0,0,3,9,2708,0,2014,0,98092,47.3413,-122.178,2502,4900,436952,3,10,2014,0,0,2064,2398,0,0,0
3,2.5,1800,2700,2.0,0,0,3,8,1800,0,2011,0,98126,47.5458,-122.369,1580,2036,365000,9,6,2014,0,3,900,456,0,0,1
3,2.5,1150,887,3.0,0,0,3,7,1150,0,2007,0,98133,47.7072,-122.356,1180,915,288000,25,6,2014,0,7,-263,-265,0,0,1
3,2.5,2230,4006,2.0,0,0,3,8,2230,0,2014,0,98133,47.73,-122.335,2230,4180,700000,20,2,2015,0,1,1776,1950,0,0,1
4,3.5,2490,5500,2.0,0,0,3,9,1780,710,2015,0,98136,47.5499,-122.393,1710,5500,899000,11,5,2015,0,0,3010,3790,0,1,1
3,2.5,2670,4534,2.0,0,0,3,9,2670,0,2007,0,98056,47.51,-122.184,3040,5079,465750,18,12,2014,0,7,1864,2039,0,0,0
2,2.5,1430,923,3.0,0,0,3,8,1410,20,2008,0,98103,47.6683,-122.355,1620,1505,485000,18,6,2014,0,6,-507,-115,0,1,1
5,2.75,2670,3800,2.0,0,0,3,8,2670,0,2014,0,98059,47.4783,-122.123,2670,3800,494995,3,6,2014,0,0,1130,1130,0,0,0
3,2.5,2555,5720,2.0,0,0,3,8,2555,0,2006,0,98031,47.386,-122.184,2844,5769,255000,2,2,2015,0,9,3165,2925,0,0,0
3,2.5,1970,6295,2.0,0,0,3,7,1970,0,2011,0,98065,47.5158,-121.874,2710,6009,530000,29,7,2014,0,3,4325,3299,0,0,0
3,2.0,1980,2674,3.0,0,0,3,8,1980,0,2007,0,98136,47.5524,-122.382,1440,2674,435000,16,6,2014,0,7,694,1234,0,0,1
3,2.5,2010,3300,2.0,0,0,3,9,1610,400,2014,0,98118,47.5573,-122.287,1660,4950,639000,11,8,2014,0,0,1290,3290,0,1,1
3,1.5,1270,1413,3.0,0,0,3,8,1270,0,2007,0,98115,47.6989,-122.317,1270,1413,440000,9,7,2014,0,7,143,143,0,0,1
4,2.5,3950,10856,3.0,0,0,3,10,3950,0,2013,0,98075,47.5818,-121.996,3200,10856,914500,15,5,2014,0,1,6906,7656,0,0,0
3,2.0,1870,5300,1.0,0,0,3,8,1870,0,2009,0,98053,47.7106,-122.02,1870,5050,580000,5,11,2014,0,5,3430,3180,0,0,0
1,1.5,1180,1688,2.0,0,0,3,8,1070,110,2007,0,98126,47.549,-122.372,1380,2059,250000,7,4,2015,0,8,508,679,0,1,1
3,2.5,1420,1269,3.0,0,0,3,7,1420,0,2007,0,98103,47.6904,-122.342,1420,1300,410000,16,3,2015,0,8,-151,-120,0,0,1
4,2.75,2810,5046,2.0,0,0,3,9,2810,0,2014,0,98038,47.3559,-122.022,3060,4934,531155,28,9,2014,0,0,2236,1874,0,0,0
3,2.5,1400,1529,2.0,0,0,3,7,1400,0,2005,0,98029,47.5535,-121.997,1440,1536,358000,19,9,2014,0,9,129,96,0,0,0
3,2.5,1950,5689,2.0,0,0,3,7,1950,0,2009,0,98065,47.5158,-121.873,2190,5653,425000,1,7,2014,0,5,3739,3463,0,0,0
3,2.25,1930,3462,2.0,0,0,3,7,1930,0,2004,0,98019,47.7453,-121.985,1930,2952,326000,11,7,2014,0,10,1532,1022,0,0,0
4,2.5,2210,4861,2.0,0,0,3,9,2210,0,2013,0,98117,47.6959,-122.364,1590,5080,650000,13,5,2014,0,1,2651,3490,0,0,1
4,3.5,2630,3757,2.0,0,0,3,10,2200,430,2008,0,98027,47.5322,-122.075,2620,2699,749950,14,5,2015,0,7,1127,79,0,1,0
3,1.75,1600,4888,1.0,0,0,3,6,1600,0,2014,0,98042,47.383,-122.097,2520,5700,239950,12,3,2015,0,1,3288,3180,0,0,0
3,2.5,1480,1590,2.0,0,0,3,8,1150,330,2010,0,98106,47.5302,-122.362,1480,5761,315000,9,6,2014,0,4,110,4281,0,1,1
2,2.5,750,1430,2.0,0,0,3,8,750,0,2006,0,98122,47.6093,-122.31,1320,2790,375000,23,5,2014,0,8,680,1470,0,0,1
3,1.5,1290,1213,3.0,0,0,3,8,1290,0,2007,0,98103,47.6965,-122.34,1360,1227,375000,27,4,2015,0,8,-77,-133,0,0,1
3,3.25,1340,1151,3.0,0,0,3,7,1340,0,2008,0,98103,47.6904,-122.346,1290,1200,349000,22,9,2014,0,6,-189,-90,0,0,1
2,1.5,1020,1049,3.0,0,0,3,8,1020,0,2008,0,98103,47.68,-122.348,1350,1395,450000,25,2,2015,0,7,29,45,0,0,1
3,3.0,2330,1944,2.5,0,0,3,8,1950,380,2014,0,98027,47.5446,-122.016,2290,1407,669950,14,10,2014,0,0,-386,-883,0,1,0
5,3.0,2360,5000,1.0,0,0,3,7,1390,970,2008,0,98103,47.6931,-122.33,2180,5009,504600,11,7,2014,0,6,2640,2829,0,1,1
3,2.5,1495,936,3.0,0,0,3,8,1405,90,2006,0,98144,47.593,-122.295,1495,1186,400000,2,6,2014,0,8,-559,-309,0,1,1
4,3.5,3770,8501,2.0,0,0,3,10,3770,0,2008,0,98033,47.6744,-122.196,1520,9660,1020000,1,7,2014,0,6,4731,8140,0,0,0
5,2.5,2890,13104,2.0,0,0,3,8,2890,0,2006,0,98019,47.7277,-121.958,3020,9300,518000,8,4,2015,0,9,10214,6280,0,0,0
3,2.75,1320,1125,3.0,0,0,3,8,1320,0,2008,0,98103,47.6598,-122.348,1320,1266,535000,13,8,2014,0,6,-195,-54,0,0,1
4,2.5,2330,4907,2.0,0,0,3,7,2330,0,2013,0,98042,47.359,-122.081,2300,3836,337500,21,7,2014,0,1,2577,1536,0,0,0
4,2.5,3120,5001,2.0,0,0,3,9,3120,0,2005,0,98023,47.2779,-122.349,3120,5244,380000,10,3,2015,0,10,1881,2124,0,0,0
5,3.0,2960,15152,2.0,0,0,3,9,2960,0,2004,0,98033,47.6689,-122.179,1850,9453,875000,10,7,2014,0,10,12192,7603,0,0,0
3,2.25,1630,1598,3.0,0,0,3,8,1630,0,2008,0,98103,47.6904,-122.347,1320,1605,385000,2,9,2014,0,6,-32,285,0,0,1
5,3.5,5230,8960,2.0,0,0,3,11,4450,780,2014,0,98004,47.5964,-122.201,2310,9603,1990000,1,12,2014,0,0,3730,7293,0,1,0
4,3.0,3150,6599,2.0,0,0,3,9,3150,0,2008,0,98056,47.5279,-122.199,2680,9430,649500,8,5,2015,0,7,3449,6750,0,0,0
4,3.75,3280,11000,2.0,0,0,3,10,2320,960,2008,0,98033,47.6855,-122.201,2400,8351,1050000,12,5,2014,0,6,7720,5951,0,1,0
4,2.5,3130,5795,2.0,0,0,3,9,3130,0,2008,0,98059,47.4997,-122.151,2950,5259,525000,3,10,2014,0,6,2665,2309,0,0,0
3,3.5,1240,1666,2.0,0,0,3,7,1000,240,2008,0,98136,47.5496,-122.388,1110,1027,402000,12,6,2014,0,6,426,-83,0,1,1
4,2.75,3560,8975,2.0,0,0,3,10,3560,0,2014,0,98004,47.6322,-122.209,3440,12825,1750000,1,11,2014,0,0,5415,9385,0,0,0
5,2.5,2170,2752,2.0,0,0,3,8,2170,0,2014,0,98106,47.5167,-122.347,1800,2752,359800,20,10,2014,0,0,582,952,0,0,1
3,2.5,1520,3003,2.0,0,0,3,7,1520,0,2009,0,98059,47.4876,-122.153,1820,3030,330000,25,9,2014,0,5,1483,1210,0,0,0
3,2.5,1270,1062,2.0,0,0,3,8,1060,210,2008,0,98105,47.6568,-122.321,1260,1112,433000,25,3,2015,0,7,-208,-148,0,1,1
4,3.25,3610,4000,2.0,0,0,3,9,2640,970,2007,0,98199,47.658,-122.396,1980,4000,1010000,12,11,2014,0,7,390,2020,0,1,1
3,2.75,3230,5200,2.0,0,0,3,9,2680,550,2014,0,98065,47.519,-121.878,3100,4900,599832,6,4,2015,0,1,1970,1800,0,1,0
5,3.0,2300,8214,2.0,0,0,3,8,2300,0,2013,0,98001,47.3052,-122.276,2594,4950,312891,23,6,2014,0,1,5914,2356,0,0,0
2,2.5,1460,1296,2.0,0,0,3,8,1160,300,2008,0,98144,47.5923,-122.296,1460,1296,449000,12,9,2014,0,6,-164,-164,0,1,1
3,2.5,1750,1548,3.0,0,0,3,9,1750,0,2013,0,98118,47.5532,-122.282,1750,3960,495000,27,5,2014,0,1,-202,2210,0,0,1
5,2.75,3030,10335,2.0,0,0,3,9,3030,0,2013,0,98056,47.5305,-122.184,2720,11213,819995,15,5,2014,0,1,7305,8493,0,0,0
3,3.5,1522,1465,2.0,0,0,3,8,1248,274,2006,0,98117,47.6922,-122.375,1522,1341,407500,13,11,2014,0,8,-57,-181,0,1,1
4,2.75,3220,9825,2.0,0,0,3,8,3220,0,2012,0,98059,47.4863,-122.143,2820,8566,579000,17,9,2014,0,2,6605,5746,0,0,0
5,2.75,3170,8093,2.0,0,0,3,9,3170,0,2014,0,98075,47.5933,-122.06,3210,7062,890776,11,8,2014,0,0,4923,3852,0,0,0
2,2.5,980,1010,3.0,0,0,3,8,980,0,2008,0,98117,47.6844,-122.387,980,1023,352500,20,1,2015,0,7,30,43,0,0,1
3,1.75,2340,7724,1.0,0,0,3,10,2340,0,2010,0,98058,47.4593,-122.134,3040,5787,529000,1,5,2015,0,5,5384,2747,0,0,0
3,2.25,1620,1425,3.0,0,0,3,8,1540,80,2009,0,98027,47.5405,-122.026,1620,1237,484000,27,3,2015,0,6,-195,-383,0,1,0
3,2.5,1910,4408,3.0,0,0,3,8,1910,0,2007,0,98133,47.7634,-122.35,1910,8154,400000,17,4,2015,0,8,2498,6244,0,0,1
3,2.5,2420,6847,2.0,0,0,3,9,2420,0,2009,0,98133,47.7329,-122.356,1180,8100,649950,17,4,2015,0,6,4427,6920,0,0,1
5,2.5,3220,10572,2.0,0,0,3,8,3220,0,2006,0,98019,47.7268,-121.957,2890,9090,534950,4,5,2015,0,9,7352,6200,0,0,0
4,2.5,3040,6425,2.0,0,0,3,8,3040,0,2008,0,98052,47.6788,-122.117,3040,7800,776000,6,5,2014,0,6,3385,4760,0,0,0
3,1.75,1496,1423,2.0,0,0,3,8,1248,248,2006,0,98133,47.715,-122.355,1460,1423,370000,1,5,2015,0,9,-73,-37,0,1,1
3,1.75,1630,1500,3.0,0,0,3,8,1630,0,2014,0,98103,47.6536,-122.354,1570,1335,610000,14,7,2014,0,0,-130,-235,0,0,1
5,3.5,4200,5400,2.0,0,0,3,9,3140,1060,2012,0,98052,47.7077,-122.12,3300,5564,850000,14,10,2014,0,2,1200,2264,0,1,0
3,2.5,2430,7049,2.0,0,0,3,8,2430,0,2007,0,98106,47.5399,-122.352,1770,7049,443000,5,11,2014,0,7,4619,5279,0,0,1
5,4.25,4010,8252,2.0,0,0,3,10,4010,0,2015,0,98075,47.5974,-122.013,3370,8252,1150000,3,2,2015,0,0,4242,4882,0,0,0
3,2.5,1510,1618,2.5,0,0,3,8,1330,180,2011,0,98199,47.6515,-122.384,1350,1397,453000,1,8,2014,0,3,108,47,0,1,1
4,3.5,2340,2810,2.0,0,2,3,8,1730,610,2011,0,98027,47.5403,-122.028,2600,2843,735000,10,4,2015,0,4,470,243,0,1,0
2,2.75,2700,8572,1.0,0,0,3,9,2700,0,2007,0,98053,47.7236,-122.033,2680,8569,810000,8,7,2014,0,7,5872,5889,0,0,0
3,3.5,4360,6240,2.0,0,3,3,10,2960,1400,2008,0,98103,47.6791,-122.354,1920,3910,1560000,17,6,2014,0,6,1880,1990,0,1,1
3,2.5,1350,886,3.0,0,0,3,8,1270,80,2006,0,98136,47.5491,-122.387,1350,886,377500,8,8,2014,0,8,-464,-464,0,1,1
3,3.25,1380,1120,3.0,0,0,3,8,1380,0,2008,0,98103,47.6617,-122.349,1310,1405,482000,18,6,2014,0,6,-260,95,0,0,1
2,2.5,1830,1988,2.0,0,0,3,9,1530,300,2011,0,98116,47.5779,-122.409,1800,2467,600000,18,8,2014,0,3,158,667,0,1,1
3,2.5,1470,1571,2.0,0,0,3,8,1180,290,2007,0,98116,47.5722,-122.387,1580,4329,420000,7,8,2014,0,7,101,2749,0,1,1
4,2.5,2940,9172,2.0,0,0,3,9,2940,0,2006,0,98001,47.3444,-122.269,2660,7955,480000,21,4,2015,0,9,6232,5295,0,0,0
2,2.0,1110,1095,3.0,0,0,3,7,980,130,2008,0,98136,47.5494,-122.388,1110,1083,406000,31,3,2015,0,7,-15,-27,0,1,1
4,2.5,2790,5602,2.0,0,0,3,8,2790,0,2009,0,98059,47.4959,-122.15,2790,5309,505000,13,5,2014,0,5,2812,2519,0,0,0
4,3.75,3790,8797,2.0,0,0,3,11,3290,500,2006,0,98039,47.6351,-122.236,2660,12150,1870000,27,2,2015,0,9,5007,9490,0,1,0
4,2.5,3570,6218,2.0,0,0,3,9,3570,0,2014,0,98052,47.7046,-122.123,3230,5972,942990,15,12,2014,0,0,2648,2742,0,0,0
3,2.25,1230,1097,3.0,0,0,3,8,1230,0,2009,0,98107,47.6697,-122.372,1420,1437,440000,1,10,2014,0,5,-133,17,0,0,1
3,3.25,1370,913,2.0,0,0,3,8,1100,270,2006,0,98116,47.5636,-122.388,1370,915,390000,26,6,2014,0,8,-457,-455,0,1,1
3,3.25,1380,1121,3.0,0,0,3,8,1380,0,2008,0,98103,47.6617,-122.349,1310,1405,475000,11,7,2014,0,6,-259,95,0,0,1
1,2.0,1070,675,2.0,0,0,3,8,880,190,2007,0,98118,47.5574,-122.284,1220,788,420000,7,4,2015,0,8,-395,-432,0,1,1
5,3.5,5150,12230,2.0,0,2,3,10,3700,1450,2007,0,98008,47.6249,-122.09,2940,13462,1380000,9,12,2014,0,7,7080,10522,0,1,0
6,3.0,2390,4000,2.0,0,0,3,7,2390,0,2014,0,98118,47.5173,-122.286,1680,5000,462500,2,3,2015,0,1,1610,3320,0,0,1
4,2.75,2460,8643,2.0,0,0,3,9,2460,0,2011,0,98059,47.4828,-122.133,3110,8626,579950,7,5,2015,0,4,6183,5516,0,0,0
4,2.5,3650,7090,2.0,0,0,3,10,3650,0,2008,0,98074,47.606,-122.052,3860,7272,861111,5,5,2015,0,7,3440,3412,0,0,0
3,2.25,1610,3764,2.0,0,0,3,7,1610,0,2012,0,98042,47.3589,-122.083,1610,3825,290000,28,4,2015,0,3,2154,2215,0,0,0
4,2.5,2610,4595,2.0,0,0,3,8,2610,0,2008,0,98028,47.7728,-122.235,2440,4588,535000,18,6,2014,0,6,1985,2148,0,0,0
3,2.5,1750,1381,3.0,0,0,3,8,1750,0,2008,0,98122,47.6021,-122.294,1940,4800,585000,17,2,2015,0,7,-369,2860,0,0,1
3,2.5,3310,5300,2.0,0,2,3,8,2440,870,2008,0,98136,47.5178,-122.389,2140,7500,670000,23,6,2014,0,6,1990,5360,0,1,1
4,3.75,5090,14823,1.0,0,0,3,11,4180,910,2013,0,98004,47.62,-122.207,3030,12752,3000000,7,4,2015,0,2,9733,9722,0,1,0
3,2.0,1060,1184,2.0,0,0,3,7,730,330,2006,0,98136,47.5443,-122.385,1270,1601,346000,3,12,2014,0,8,124,331,0,1,1
3,2.5,2100,4097,2.0,0,0,3,9,2100,0,2008,0,98004,47.5983,-122.2,1780,4764,999999,26,2,2015,0,7,1997,2984,0,0,0
3,1.75,1650,1180,3.0,0,0,3,8,1650,0,2014,0,98105,47.6636,-122.319,1720,1960,599000,11,8,2014,0,0,-470,240,0,0,1
4,2.5,2380,5737,2.0,0,0,3,7,2380,0,2010,0,98023,47.2815,-122.356,2380,5396,332000,15,10,2014,0,4,3357,3016,0,0,0
2,2.25,1170,1011,2.0,0,0,3,7,1170,0,2009,0,98027,47.5321,-122.073,1240,750,336750,12,6,2014,0,5,-159,-490,0,0,0
4,2.5,2531,6843,2.0,0,0,3,8,2531,0,2013,0,98030,47.385,-122.189,2604,6238,370000,11,12,2014,0,1,4312,3634,0,0,0
3,2.25,998,904,2.0,0,0,3,7,798,200,2007,0,98117,47.6983,-122.367,998,1110,324000,9,5,2014,0,7,-94,112,0,1,1
3,2.25,1333,1470,3.0,0,3,3,7,1333,0,2009,0,98125,47.7058,-122.302,1360,1680,338500,19,2,2015,0,6,137,320,0,0,1
5,3.5,4410,13000,2.0,0,3,3,10,2920,1490,2014,0,98006,47.5382,-122.111,5790,12969,1880000,13,1,2015,0,1,8590,7179,0,1,0
3,2.75,1160,1073,2.0,0,0,3,7,880,280,2007,0,98144,47.5788,-122.315,1250,5400,402723,10,4,2015,0,8,-87,4150,0,1,1
4,3.25,2630,7770,2.0,0,0,3,9,2630,0,2014,0,98126,47.5459,-122.377,1370,7770,715000,27,2,2015,0,1,5140,6400,0,0,1
3,1.5,1160,1031,3.0,0,0,3,8,1160,0,2008,0,98103,47.6538,-122.357,1268,1688,459000,7,10,2014,0,6,-129,420,0,0,1
3,2.5,2140,3628,2.0,0,0,3,8,1960,180,2006,0,98027,47.537,-122.074,2280,2812,589999,23,4,2015,0,9,1488,532,0,1,0
4,2.5,1980,5020,2.0,0,0,3,7,1980,0,2007,0,98056,47.5147,-122.19,1980,5064,405000,15,12,2014,0,7,3040,3084,0,0,0
3,2.5,3030,9053,2.0,0,0,3,8,3030,0,2009,0,98059,47.4945,-122.149,3010,6026,509900,7,7,2014,0,5,6023,3016,0,0,0
2,2.0,1490,1627,2.0,0,0,3,8,1190,300,2009,0,98126,47.5455,-122.375,1400,1498,327000,20,8,2014,0,5,137,98,0,1,1
3,2.5,1820,1866,2.0,0,0,3,8,1570,250,2008,0,98166,47.4643,-122.346,1660,6900,327500,31,12,2014,0,6,46,5240,0,1,1
3,2.0,1260,1125,2.0,0,0,3,7,810,450,2011,0,98106,47.5262,-122.361,1260,1172,249000,29,7,2014,0,3,-135,-88,0,1,1
5,4.5,4350,13405,2.0,0,0,3,11,4350,0,2014,0,98074,47.6018,-122.06,3990,7208,1380000,24,12,2014,0,0,9055,3218,0,0,0
1,1.25,1100,638,3.0,0,0,3,9,1100,0,2014,0,98112,47.6228,-122.307,1110,1933,516500,27,6,2014,0,0,-462,823,0,0,1
3,2.5,2198,6222,2.0,0,2,3,8,2198,0,2010,0,98198,47.3906,-122.304,2198,7621,388000,8,8,2014,0,4,4024,5423,0,0,1
3,2.25,1230,1380,3.0,0,0,3,8,1230,0,2013,0,98199,47.6521,-122.4,1760,5664,549000,30,9,2014,0,1,150,3904,0,0,1
2,2.0,1400,1512,2.0,0,0,3,8,940,460,2006,0,98107,47.6719,-122.392,1400,3500,553000,3,10,2014,0,8,112,2100,0,1,1
3,2.5,1410,1250,2.0,0,0,3,8,1140,270,2010,0,98119,47.6515,-122.375,1720,2825,530000,22,4,2015,0,5,-160,1105,0,1,1
3,2.5,2110,1339,2.0,0,0,3,8,1410,700,2014,0,98122,47.6088,-122.311,1630,2670,747450,20,8,2014,0,0,-771,1040,0,1,1
2,2.5,1590,2656,2.0,0,0,3,7,1220,370,2009,0,98106,47.5489,-122.364,1590,2306,305000,20,5,2014,0,5,1066,716,0,1,1
5,2.5,3370,4850,2.0,0,0,3,9,3370,0,2007,0,98056,47.5078,-122.169,2900,5570,540000,18,11,2014,0,7,1480,2670,0,0,0
5,4.0,4500,8130,2.0,0,0,3,10,4500,0,2007,0,98059,47.4832,-122.145,2840,8402,750000,15,1,2015,0,8,3630,5562,0,0,0
4,2.5,2930,5973,2.0,0,0,3,10,2930,0,2008,0,98030,47.3846,-122.186,3038,7095,422000,14,4,2015,0,7,3043,4057,0,0,0
4,2.5,2470,5100,2.0,0,0,3,8,2470,0,2005,0,98038,47.3622,-122.041,2240,5123,337000,20,10,2014,0,9,2630,2883,0,0,0
5,2.75,3080,5752,2.0,0,0,3,9,3080,0,2014,0,98059,47.4922,-122.153,3000,4650,579950,9,10,2014,0,0,2672,1650,0,0,0
4,2.75,2260,4440,2.0,0,0,3,7,2260,0,2014,0,98001,47.3507,-122.291,2260,4563,341780,26,2,2015,0,1,2180,2303,0,0,0
4,3.0,1670,2642,2.0,0,0,3,8,1350,320,2008,0,98109,47.6397,-122.345,1670,2594,710200,23,4,2015,0,7,972,924,0,1,1
3,3.25,1540,1428,3.0,0,0,3,9,1540,0,2013,0,98103,47.6648,-122.353,1660,3300,690000,18,6,2014,0,1,-112,1640,0,0,1
4,3.5,3830,8963,2.0,0,0,3,10,3120,710,2014,0,98004,47.599,-122.197,2190,10777,1700000,30,1,2015,0,1,5133,8587,0,1,0
2,2.5,980,1020,3.0,0,0,3,8,980,0,2008,0,98117,47.6844,-122.387,980,1023,329000,15,10,2014,0,6,40,43,0,0,1
3,2.5,1450,5008,1.0,0,0,3,7,840,610,2007,0,98106,47.5435,-122.357,2120,5019,330000,13,5,2014,0,7,3558,2899,0,1,1
4,3.5,2850,5577,2.0,0,0,3,8,1950,900,2014,0,98056,47.5252,-122.192,2850,5708,608500,2,5,2015,0,1,2727,2858,0,1,0
3,1.75,1140,1201,2.0,0,0,3,8,1140,0,2014,0,98108,47.5637,-122.295,1210,1552,230000,7,7,2014,0,0,61,342,0,0,1
4,3.5,3070,4684,2.0,0,0,3,10,2190,880,2009,0,98027,47.5316,-122.076,2290,2664,785000,20,5,2014,0,5,1614,374,0,1,0
3,3.0,1680,1570,3.0,0,0,3,8,1680,0,2014,0,98103,47.6572,-122.346,1640,4800,610950,7,5,2014,0,0,-110,3160,0,0,1
3,2.5,3087,5002,2.0,0,0,3,8,3087,0,2014,0,98023,47.2974,-122.349,2927,5183,399950,11,11,2014,0,0,1915,2256,0,0,0
4,3.25,1900,2631,2.0,0,0,3,9,1250,650,2014,0,98144,47.5869,-122.311,1710,4502,579000,23,1,2015,0,1,731,2792,0,1,1
2,1.5,940,1768,2.0,0,0,3,7,940,0,2009,0,98144,47.5925,-122.295,1130,1159,362500,23,6,2014,0,5,828,29,0,0,1
3,3.25,1730,1229,2.0,0,2,3,9,1320,410,2008,0,98119,47.6374,-122.369,1710,1686,645000,29,5,2014,0,6,-501,-24,0,1,1
3,3.0,2780,6000,2.0,0,0,3,9,2780,0,2013,0,98065,47.5184,-121.886,2850,6000,594866,3,10,2014,0,1,3220,3150,0,0,0
3,3.0,2780,6000,2.0,0,0,3,9,2780,0,2013,0,98065,47.5184,-121.886,2850,6000,625000,4,5,2015,0,2,3220,3150,0,0,0
3,2.25,1500,1290,2.0,0,0,3,8,1220,280,2006,0,98117,47.6785,-122.375,1460,1375,490000,12,11,2014,0,8,-210,-85,0,1,1
2,1.0,710,1157,2.0,0,0,4,7,710,0,1943,0,98102,47.6413,-122.329,1370,1173,399950,10,6,2014,0,71,447,-197,0,0,1
3,2.5,1260,900,2.0,0,0,3,7,940,320,2007,0,98116,47.5621,-122.384,1310,1415,380000,2,12,2014,0,7,-360,105,0,1,1
3,2.5,1870,5000,2.0,0,0,3,7,1870,0,2009,0,98042,47.3339,-122.055,2170,5399,270000,28,8,2014,0,5,3130,3229,0,0,0
2,2.5,1430,1201,3.0,0,0,3,8,1430,0,2009,0,98107,47.6707,-122.381,1430,1249,505000,15,10,2014,0,5,-229,-181,0,0,1
3,2.5,1520,1488,3.0,0,0,3,8,1520,0,2006,0,98125,47.7337,-122.309,1520,1497,385000,5,3,2015,0,9,-32,-23,0,0,1
2,1.5,1210,1278,2.0,0,0,3,8,1020,190,2007,0,98117,47.6756,-122.375,1210,1118,414500,13,11,2014,0,7,68,-92,0,1,1
3,2.5,2540,4760,2.0,0,0,3,8,2540,0,2010,0,98038,47.3452,-122.022,2540,4571,347500,10,9,2014,0,4,2220,2031,0,0,0
4,3.5,4910,9444,1.5,0,0,3,11,3110,1800,2007,0,98074,47.6502,-122.066,4560,11063,1220000,14,5,2014,0,7,4534,6503,0,1,0
4,2.75,2770,3852,2.0,0,0,3,8,2770,0,2014,0,98178,47.5001,-122.232,1810,5641,572000,2,10,2014,0,0,1082,3831,0,0,1
3,2.25,1190,1200,3.0,0,0,3,8,1190,0,2008,0,98103,47.6542,-122.346,1180,1224,475000,16,4,2015,0,7,10,44,0,0,1
5,3.75,4170,8142,2.0,0,2,3,10,4170,0,2006,0,98056,47.5354,-122.181,3030,7980,1090000,17,3,2015,0,9,3972,4950,0,0,0
4,2.75,2500,5995,2.0,0,0,3,8,2500,0,2008,0,98042,47.3749,-122.107,2530,5988,350000,17,10,2014,0,6,3495,3458,0,0,0
2,2.25,1530,981,3.0,0,0,3,8,1480,50,2006,0,98103,47.6533,-122.346,1530,1282,520000,31,10,2014,0,8,-549,-248,0,1,1
5,2.75,3600,9437,2.0,0,0,3,9,3600,0,2014,0,98059,47.4822,-122.131,3550,9421,679950,13,8,2014,0,0,5837,5871,0,0,0
4,3.25,3410,10125,2.0,0,0,3,10,3410,0,2007,0,98040,47.5653,-122.223,2290,10125,1580000,21,4,2015,0,8,6715,7835,0,0,0
4,2.5,3118,7866,2.0,0,2,3,9,3118,0,2014,0,98001,47.2931,-122.264,2673,6500,541800,13,10,2014,0,0,4748,3827,0,0,0
4,3.0,3990,7838,2.0,0,0,3,9,3990,0,2003,0,98053,47.6857,-122.046,3370,6814,810000,15,9,2014,0,11,3848,3444,0,0,0
5,3.75,4470,8088,2.0,0,0,3,11,4470,0,2008,0,98004,47.6321,-122.2,2780,8964,1540000,15,10,2014,0,6,3618,6184,0,0,0
3,2.5,1425,1179,3.0,0,0,3,8,1425,0,2008,0,98125,47.6963,-122.318,1285,1253,467000,7,4,2015,0,7,-246,-32,0,0,1
3,1.75,1500,11968,1.0,0,0,3,6,1500,0,2014,0,98010,47.3095,-122.002,1320,11303,224000,26,6,2014,0,0,10468,9983,0,0,0
3,2.5,2270,5536,2.0,0,0,3,8,2270,0,2003,0,98065,47.5389,-121.881,2270,5731,507250,25,8,2014,0,11,3266,3461,0,0,0
3,2.0,1490,1126,3.0,0,0,3,8,1490,0,2014,0,98144,47.5699,-122.288,1400,1230,429000,26,1,2015,0,1,-364,-170,0,0,1
4,2.5,2520,6023,2.0,0,0,3,9,2520,0,2014,0,98056,47.5137,-122.167,2520,6023,610685,14,10,2014,0,0,3503,3503,0,0,0
4,3.5,3510,7200,2.0,0,0,3,9,2600,910,2009,0,98136,47.5537,-122.398,2050,6200,1010000,26,3,2015,0,6,3690,4150,0,1,1
3,2.5,1310,1294,2.0,0,0,3,8,1180,130,2008,0,98116,47.5773,-122.409,1330,1265,475000,19,2,2015,0,7,-16,-65,0,1,1
3,2.5,1530,1131,3.0,0,0,3,8,1530,0,2009,0,98103,47.6993,-122.346,1530,1509,360000,21,5,2014,0,5,-399,-21,0,0,1
4,2.5,2310,5813,2.0,0,0,3,8,2310,0,2014,0,98146,47.5107,-122.362,1830,7200,400000,23,2,2015,0,1,3503,5370,0,0,1
2,0.75,1020,1350,2.0,0,0,3,7,1020,0,2009,0,98144,47.5944,-122.299,1020,2007,402101,23,6,2014,0,5,330,987,0,0,1
3,2.5,1600,2388,2.0,0,0,3,8,1600,0,2004,0,98027,47.5345,-122.069,1410,1287,400000,16,1,2015,0,11,788,-123,0,0,0
2,0.75,1020,1076,2.0,0,0,3,7,1020,0,2008,0,98144,47.5941,-122.299,1020,1357,325000,15,10,2014,0,6,56,337,0,0,1
